CLV-EDO,CLV-DTO,INS-SEM,ERR-SEM,CD-SEM,REP-SEM,ER-D-SEM,REIN-SEM,REEM-SEM,TOT-F-S,CRED-SEM,TOT-SEM,EST-OPER,DIAS-TRAB,remesa
1,1,109,9,53,68,7,9,0,255,127,382,13,1.5,201737
1,2,278,7,116,74,10,11,2,498,241,739,11,2,201737
1,3,226,7,147,74,6,26,0,486,253,739,11,2,201737
2,1,107,1,90,48,2,21,0,269,107,376,11,2,201737
2,2,126,2,70,48,0,13,0,259,46,305,7,2,201737
2,3,63,3,130,55,1,34,0,286,110,396,9,1.333333333,201737
2,4,78,5,83,26,0,3,0,195,65,260,6,2,201737
2,5,178,8,258,118,19,45,1,627,226,853,16,2,201737
2,6,65,2,90,60,9,9,0,235,76,311,7,2,201737
2,7,58,2,73,37,2,14,0,186,74,260,8,1.666666667,201737
2,8,101,2,164,71,0,21,0,359,111,470,8,2,201737
3,1,5,0,6,2,2,3,0,18,18,36,8,0.5,201737
3,2,0,0,0,0,0,0,0,0,0,0,0,0,201737
4,1,110,2,76,98,4,12,0,302,166,468,13,1.4,201737
4,2,52,0,54,74,3,7,0,190,60,250,14,1.4,201737
5,1,145,4,83,52,6,30,0,320,149,469,9,1.666666667,201737
5,2,122,2,43,41,2,11,0,221,139,360,10,1.2,201737
5,3,245,1,60,56,1,20,0,383,161,544,9,1.5,201737
5,4,325,4,112,31,4,23,1,500,135,635,7,1.666666667,201737
5,5,196,3,76,60,2,7,1,345,117,462,8,2,201737
5,6,116,3,73,30,1,17,0,240,30,270,11,1.5,201737
5,7,152,4,63,31,2,9,0,261,81,342,10,1.5,201737
6,1,116,4,67,39,1,14,0,241,134,375,12,2,201737
6,2,68,2,67,36,10,11,0,194,89,283,9,1.666666667,201737
7,1,34,2,20,45,2,4,0,107,78,185,3,0.5,201737
7,2,20,1,8,23,0,3,0,55,93,148,7,1,201737
7,3,34,1,57,25,2,11,0,130,480,610,7,1.666666667,201737
7,4,47,3,44,107,0,12,28,241,434,675,9,2,201737
7,5,62,1,45,235,10,9,38,400,166,566,9,1.333333333,201737
7,6,63,2,107,60,1,15,3,251,67,318,8,1.666666667,201737
7,7,41,3,61,156,10,16,0,287,73,360,8,1.5,201737
7,8,56,2,68,165,3,8,0,302,79,381,10,1,201737
7,9,85,10,113,114,4,26,0,352,137,489,9,1.666666667,201737
7,10,68,2,85,236,44,11,0,446,105,551,9,1.5,201737
7,11,0,0,0,0,0,0,0,0,321,321,2,1,201737
7,12,96,2,150,144,1,9,0,402,99,501,9,1.5,201737
7,13,24,1,108,2,0,11,0,146,173,319,7,1.333333333,201737
8,1,32,4,77,44,0,9,0,166,57,223,4,2,201737
8,2,165,7,217,89,5,40,1,524,167,691,17,1.666666667,201737
8,3,145,3,172,35,1,23,0,379,73,452,5,2,201737
8,4,18,3,27,19,3,11,0,81,9,90,2,2,201737
8,5,49,3,72,49,4,22,0,199,91,290,10,1.25,201737
8,6,306,7,106,79,5,26,2,531,105,636,9,1.5,201737
8,7,42,3,29,39,4,13,0,130,73,203,9,1.25,201737
8,8,236,4,54,41,2,23,0,360,56,416,5,3,201737
8,9,39,6,45,25,5,17,0,137,166,303,11,1.2,201737
9,1,46,1,48,37,12,17,0,161,147,308,6,2,201737
9,2,127,11,259,101,14,38,1,551,256,807,12,2,201737
9,3,57,7,125,77,13,31,1,311,116,427,7,2,201737
9,4,45,0,155,29,1,20,0,250,145,395,11,2,201737
9,5,77,2,104,44,8,18,0,253,94,347,7,2,201737
9,6,39,13,93,1,0,14,0,160,85,245,7,2,201737
9,7,39,2,76,56,4,13,0,190,119,309,9,2,201737
9,8,2,2,16,4,0,4,1,29,89,118,5,2,201737
9,9,45,1,120,1,0,8,0,175,67,242,5,2,201737
9,10,34,2,72,75,2,17,0,202,105,307,6,2,201737
9,11,56,2,149,26,3,26,0,262,109,371,7,2,201737
9,12,49,31,161,95,5,20,0,361,156,517,11,2,201737
9,13,55,2,97,28,6,16,2,206,77,283,4,2,201737
9,14,33,4,76,46,29,16,0,204,82,286,5,2,201737
9,15,114,1,228,145,5,49,0,542,243,785,8,2,201737
9,16,125,7,249,116,12,53,0,562,220,782,15,3,201737
9,17,41,3,70,78,3,16,0,211,102,313,6,2,201737
9,18,53,6,183,26,3,29,1,301,111,412,12,2,201737
9,19,57,9,132,16,12,28,0,254,104,358,5,2,201737
9,21,27,0,39,19,1,7,0,93,52,145,3,2,201737
9,22,47,2,62,42,11,19,6,189,74,263,5,2,201737
9,23,76,7,105,89,4,14,0,295,239,534,7,4,201737
9,24,86,4,188,84,13,35,1,411,155,566,12,2,201737
10,1,105,4,58,85,28,16,1,297,74,371,12,1.333333333,201737
10,2,78,0,59,48,6,21,0,212,101,313,9,1.5,201737
10,3,40,3,47,25,4,6,6,131,76,207,12,1.4,201737
10,4,211,3,111,80,3,24,0,432,95,527,10,1.5,201737
11,1,65,5,52,43,6,8,0,179,64,243,6,1.666666667,201737
11,2,79,3,50,56,6,16,0,210,66,276,7,2,201737
11,3,66,1,39,32,1,15,0,154,44,198,4,2,201737
11,4,49,2,67,28,0,11,0,157,82,239,9,1.5,201737
11,5,34,3,49,17,0,8,0,111,41,152,3,3,201737
11,6,29,1,63,24,0,16,0,133,49,182,6,1.5,201737
11,7,88,2,126,24,2,8,0,250,53,303,9,1.5,201737
11,8,51,4,62,52,5,9,0,183,80,263,9,1.75,201737
11,9,94,6,139,5,1,21,0,266,103,369,10,1.666666667,201737
11,10,83,6,81,47,2,14,2,235,112,347,11,1.6,201737
11,11,72,0,123,9,0,25,0,229,73,302,5,2,201737
11,12,44,6,105,68,3,14,0,240,97,337,7,2.5,201737
11,13,38,2,63,26,2,13,1,145,48,193,9,1.5,201737
11,14,59,6,53,61,5,16,0,200,85,285,8,1.5,201737
11,15,16,1,37,19,0,7,0,80,54,134,5,2,201737
12,1,23,3,37,12,5,7,0,87,79,166,10,1.2,201737
12,2,89,7,82,87,11,18,0,294,94,388,10,1.5,201737
12,3,64,4,61,76,5,10,0,220,55,275,11,1.2,201737
12,4,85,4,82,80,6,12,0,269,96,365,9,2,201737
12,5,51,6,57,39,3,5,0,161,59,220,10,1.25,201737
12,6,34,6,37,41,10,6,0,134,50,184,10,1.25,201737
12,7,66,5,70,65,3,14,2,225,61,286,6,1.5,201737
12,8,40,2,62,59,23,7,0,193,87,280,9,1.25,201737
12,9,80,4,68,103,7,10,0,272,87,359,9,1.666666667,201737
13,1,56,6,43,88,6,10,0,209,1458,1667,9,1.333333333,201737
13,2,37,8,20,31,10,4,0,110,32,142,6,1.333333333,201737
13,3,39,2,31,23,15,6,0,116,68,184,12,1.25,201737
13,4,51,2,62,45,10,13,6,189,88,277,9,1.666666667,201737
13,5,90,6,60,74,18,24,5,277,176,453,9,2,201737
13,6,139,6,172,74,4,21,0,416,180,596,11,2.333333333,201737
13,7,70,15,155,76,18,13,0,347,79,426,8,1.5,201737
14,1,27,1,17,11,2,8,1,67,45,112,5,1.25,201737
14,2,39,3,17,23,2,10,0,94,48,142,6,1.666666667,201737
14,3,52,3,37,17,1,22,0,132,91,223,11,1.4,201737
14,4,54,4,37,41,1,11,1,149,54,203,3,2,201737
14,5,61,3,109,51,7,17,0,248,80,328,10,1.5,201737
14,7,58,3,48,20,0,7,0,136,52,188,6,2,201737
14,8,154,9,217,79,8,36,1,504,117,621,10,1.6,201737
14,9,59,1,92,47,8,20,0,227,89,316,8,2,201737
14,10,40,4,58,23,0,7,0,132,44,176,3,2,201737
14,11,46,1,57,25,5,14,0,148,25,173,4,2,201737
14,12,55,5,116,19,1,7,0,203,94,297,11,1.5,201737
14,13,40,1,89,21,1,10,0,162,49,211,4,1,201737
14,15,45,3,45,29,4,9,0,135,57,192,10,1.6,201737
14,16,49,0,96,20,3,16,0,184,64,248,5,2,201737
14,17,20,2,15,10,1,4,1,53,25,78,9,1.25,201737
14,18,42,2,42,27,1,15,1,130,129,259,10,1.4,201737
14,19,39,2,24,33,6,8,0,112,35,147,9,1.25,201737
14,20,29,1,21,5,2,9,0,67,21,88,4,1.5,201737
15,1,42,2,39,13,9,12,0,117,47,164,7,1.333333333,201737
15,2,35,2,73,30,5,15,0,160,89,249,6,2,201737
15,3,99,8,86,68,13,32,0,306,127,433,10,1.666666667,201737
15,4,89,5,82,79,7,22,1,285,106,391,4,2,201737
15,5,59,3,76,60,1,9,0,208,153,361,8,1.666666667,201737
15,6,87,2,84,83,7,21,0,284,125,409,7,2.5,201737
15,8,37,3,33,41,0,10,0,124,57,181,4,2,201737
15,9,131,5,81,108,19,23,7,374,313,687,9,1.75,201737
15,10,67,2,86,59,11,24,0,249,101,350,9,2,201737
15,12,84,5,139,80,8,24,0,340,140,480,8,2,201737
15,13,37,3,123,12,3,17,0,195,91,286,8,2,201737
15,14,41,1,70,24,4,24,0,164,34,198,4,2,201737
15,15,72,7,96,57,1,30,0,263,116,379,6,2,201737
15,16,55,9,123,90,3,17,0,297,168,465,8,2,201737
15,17,56,9,119,94,3,22,1,304,134,438,8,2,201737
15,18,83,6,101,81,4,17,0,292,171,463,7,1.666666667,201737
15,19,19,18,20,30,1,4,0,92,35,127,4,2,201737
15,20,18,3,24,26,1,9,0,81,67,148,6,2,201737
15,21,4,0,7,0,0,2,0,13,22,35,2,1,201737
15,22,43,7,131,49,2,15,0,247,123,370,11,2,201737
15,23,60,2,70,59,1,12,0,204,101,305,5,1.5,201737
15,24,57,2,101,54,0,17,1,232,57,289,4,2,201737
15,25,99,6,140,64,4,28,0,341,117,458,6,2,201737
15,26,40,5,44,8,4,8,0,109,55,164,8,1,201737
15,27,104,4,99,83,3,21,0,314,192,506,9,1.666666667,201737
15,28,85,3,161,41,7,30,0,327,286,613,9,1.666666667,201737
15,29,64,6,95,89,1,15,0,270,57,327,8,2,201737
15,30,59,3,128,74,8,20,0,292,192,484,6,2,201737
15,31,34,13,77,76,1,19,0,220,88,308,6,2,201737
15,32,58,4,67,83,6,17,0,235,102,337,9,2,201737
15,33,80,0,150,65,3,22,0,320,212,532,7,2,201737
15,34,98,5,94,90,0,20,0,307,113,420,8,2,201737
15,35,61,4,55,42,3,24,0,189,96,285,7,2,201737
15,36,119,7,95,93,4,27,0,345,260,605,9,1.5,201737
15,37,62,3,70,46,7,16,0,204,68,272,3,1,201737
15,38,78,1,59,60,1,15,0,214,32,246,6,1.5,201737
15,39,74,13,139,149,9,26,3,413,265,678,4,2,201737
15,40,149,6,179,136,17,49,0,536,308,844,9,2,201737
15,41,147,14,246,150,8,22,1,588,251,839,11,2,201737
16,1,29,2,48,36,0,11,0,126,59,185,10,1.333333333,201737
16,2,21,2,13,29,2,5,0,72,53,125,9,1.25,201737
16,3,43,3,24,36,5,8,0,119,92,211,10,1.25,201737
16,4,54,4,34,21,5,10,0,128,80,208,8,1.5,201737
16,5,71,1,53,33,4,13,0,175,91,266,10,1.666666667,201737
16,6,63,6,32,52,7,7,0,167,74,241,12,1.5,201737
16,7,58,1,32,15,5,16,0,127,66,193,9,1.5,201737
16,8,124,5,117,108,1,20,2,377,139,516,12,2,201737
16,9,67,6,40,40,3,23,0,179,70,249,10,2,201737
16,10,64,4,55,51,4,9,0,187,86,273,6,2,201737
16,11,59,6,39,24,17,12,0,157,62,219,12,1.4,201737
16,12,28,4,40,25,2,7,0,106,72,178,10,1.25,201737
17,1,73,3,104,83,12,17,0,292,103,395,9,2.5,201737
17,2,69,1,76,54,6,10,0,216,49,265,9,1.666666667,201737
17,3,81,1,126,57,2,19,0,286,119,405,8,1.5,201737
17,4,69,1,117,42,6,20,0,255,126,381,10,1.666666667,201737
17,5,21,1,36,25,0,3,0,86,29,115,5,1.5,201737
18,1,21,3,19,15,10,5,0,73,38,111,7,1.5,201737
18,2,131,6,95,88,13,22,0,355,106,461,8,2.666666667,201737
18,3,41,2,85,22,0,8,0,158,57,215,5,1.25,201737
19,1,89,4,93,72,1,22,0,281,114,395,9,2,201737
19,2,190,5,226,81,23,33,0,558,130,688,10,2.5,201737
19,3,110,5,157,53,2,25,0,352,333,685,8,2,201737
19,4,69,0,42,32,4,8,2,157,74,231,5,2,201737
19,5,126,6,122,87,1,24,3,369,93,462,8,2,201737
19,6,60,4,52,28,3,13,1,161,57,218,5,2,201737
19,7,35,0,100,0,0,2,0,137,254,391,6,1.75,201737
19,8,1,0,6,2,0,1,0,10,321,331,7,2,201737
19,9,36,1,25,38,3,14,0,117,89,206,9,1.25,201737
19,10,69,1,67,41,0,18,1,197,74,271,5,2,201737
19,11,220,5,190,145,4,37,2,603,185,788,13,2.333333333,201737
19,12,45,3,119,47,1,15,0,230,134,364,8,2.25,201737
20,1,48,2,42,52,15,14,0,173,97,270,7,1.5,201737
20,2,18,0,13,28,4,0,0,63,27,90,6,1.333333333,201737
20,3,42,3,62,39,5,14,2,167,75,242,6,1.333333333,201737
20,4,27,5,25,45,6,14,0,122,38,160,6,1.333333333,201737
20,5,33,2,71,68,7,13,0,194,98,292,11,1.25,201737
20,6,42,4,28,81,49,7,1,212,238,450,8,1.25,201737
20,7,43,2,46,36,2,8,0,137,46,183,6,1.666666667,201737
20,8,136,4,179,118,1,39,10,487,171,658,13,2.5,201737
20,9,44,0,86,5,5,17,0,157,115,272,8,1.666666667,201737
20,10,43,5,55,56,1,12,0,172,96,268,9,1.25,201737
21,1,93,3,80,137,2,14,0,329,47,376,9,1.4,201737
21,2,64,2,89,48,1,11,0,215,34,249,9,1.2,201737
21,3,46,0,70,24,18,17,3,178,51,229,8,1.25,201737
21,4,50,1,98,3,1,25,0,178,45,223,6,1.25,201737
21,5,52,1,57,56,3,16,2,187,136,323,8,1.666666667,201737
21,6,86,1,116,84,7,24,0,318,81,399,6,3,201737
21,7,100,5,72,45,10,21,0,253,109,362,9,1.666666667,201737
21,8,68,5,116,23,11,13,0,236,41,277,10,1.2,201737
21,9,68,3,104,52,11,15,1,254,99,353,9,1.5,201737
21,10,98,9,77,71,9,23,0,287,117,404,7,2,201737
21,11,0,0,0,1,0,0,0,1,0,1,4,2,201737
21,12,199,5,257,94,7,41,1,604,213,817,15,2.5,201737
21,13,73,2,66,34,6,19,0,200,70,270,8,1.666666667,201737
21,14,80,3,110,22,7,14,0,236,106,342,13,1.333333333,201737
21,15,88,2,90,52,10,13,0,255,86,341,7,1.5,201737
22,1,33,18,36,78,24,6,0,195,62,257,11,1.2,201737
22,2,43,6,129,24,8,11,7,228,59,287,7,1.5,201737
22,3,95,7,159,129,3,21,0,414,107,521,10,2,201737
22,4,127,5,196,37,4,9,0,378,141,519,11,1.75,201737
22,5,38,2,56,6,2,3,0,107,75,182,10,1.5,201737
23,1,49,1,233,64,5,10,0,362,128,490,14,1.6,201737
23,2,60,2,72,45,6,9,0,194,117,311,10,1.25,201737
23,3,48,2,181,8,1,12,0,252,56,308,5,2,201737
23,4,80,1,245,5,0,4,0,335,78,413,6,2,201737
24,1,32,10,22,80,9,10,1,164,70,234,11,1.2,201737
24,2,25,3,41,26,1,6,0,102,79,181,6,1.5,201737
24,3,46,5,32,47,11,5,0,146,101,247,7,1.333333333,201737
24,4,45,7,29,41,5,16,10,153,116,269,5,1.5,201737
24,5,142,6,109,108,3,24,0,392,124,516,9,2.333333333,201737
24,6,122,9,78,99,7,14,0,329,157,486,9,2,201737
24,7,34,13,31,118,16,3,0,215,112,327,9,1.25,201737
25,1,25,0,48,28,3,13,0,117,100,217,14,1.75,201737
25,2,15,0,15,17,1,2,0,50,26,76,5,0.5,201737
25,3,30,4,19,33,3,9,0,98,73,171,9,1.6,201737
25,4,25,2,11,22,0,1,0,61,28,89,4,2,201737
25,5,56,2,127,38,8,12,0,243,112,355,7,1.666666667,201737
25,6,62,1,111,24,3,13,0,214,102,316,9,1.75,201737
25,7,36,1,60,30,0,15,0,142,70,212,7,2,201737
26,1,95,3,54,66,1,12,0,231,78,309,9,1.5,201737
26,2,110,5,112,98,1,23,0,349,110,459,13,1.4,201737
26,3,226,4,108,100,2,45,0,485,245,730,13,2.5,201737
26,4,14,3,13,25,2,7,0,64,22,86,10,1.2,201737
26,5,37,2,8,34,0,6,0,87,41,128,3,1.5,201737
26,6,50,1,58,56,1,19,0,185,111,296,10,1.333333333,201737
26,7,28,2,11,31,0,4,0,76,45,121,6,1,201737
27,1,58,1,31,61,3,6,0,160,104,264,8,1.5,201737
27,2,83,6,43,106,2,15,0,255,82,337,8,1.666666667,201737
27,3,75,2,33,97,4,8,0,219,85,304,7,1.666666667,201737
27,4,82,4,82,123,2,14,1,308,102,410,7,1.5,201737
27,5,26,3,18,58,1,7,0,113,107,220,6,1.333333333,201737
27,6,51,1,51,76,0,12,0,191,83,274,7,1.5,201737
28,1,95,4,127,74,0,12,0,312,149,461,13,2,201737
28,2,82,3,168,35,4,19,5,316,142,458,14,2,201737
28,3,28,2,38,27,1,7,0,103,42,145,7,1.333333333,201737
28,4,112,8,143,70,7,21,5,366,158,524,16,2,201737
28,5,65,3,35,58,0,13,0,174,88,262,10,1.25,201737
28,6,33,2,25,42,5,7,1,115,122,237,12,1,201737
28,7,114,3,95,71,8,22,0,313,86,399,8,2,201737
28,8,89,1,75,50,8,18,0,241,69,310,9,2,201737
28,9,43,0,94,20,0,14,4,175,50,225,4,2,201737
29,1,66,7,103,51,9,16,0,252,120,372,10,1.5,201737
29,2,133,8,122,126,8,13,10,420,179,599,12,1.6,201737
29,3,55,5,49,60,4,16,0,189,34,223,7,1.666666667,201737
30,1,25,1,27,23,1,9,6,92,14,106,7,1.333333333,201737
30,2,40,2,40,16,9,8,66,181,46,227,8,1.25,201737
30,3,55,1,54,31,9,18,5,173,137,310,6,1.666666667,201737
30,4,57,1,47,33,4,15,0,157,69,226,8,2,201737
30,5,75,3,62,73,2,26,0,241,88,329,7,1.5,201737
30,6,27,3,32,55,5,12,0,134,122,256,9,1.333333333,201737
30,7,48,4,59,64,10,15,5,205,58,263,12,1.25,201737
30,8,43,3,73,55,3,15,0,192,91,283,11,1.4,201737
30,9,41,1,47,24,11,17,7,148,39,187,8,1.5,201737
30,10,51,0,79,69,3,25,5,232,165,397,7,2.5,201737
30,11,69,1,72,52,2,20,0,216,130,346,6,1.5,201737
30,12,89,3,107,86,1,32,0,318,100,418,11,2,201737
30,13,38,4,46,70,12,9,1,180,38,218,10,1.4,201737
30,14,37,1,58,61,21,26,0,204,67,271,9,1.5,201737
30,15,74,2,48,51,6,31,8,220,87,307,11,1.666666667,201737
30,16,52,3,46,71,3,24,2,201,112,313,10,1.333333333,201737
30,17,14,0,9,17,1,4,0,45,44,89,4,1,201737
30,18,34,2,30,52,6,22,3,149,97,246,8,1.25,201737
30,19,31,4,47,43,3,25,2,155,68,223,13,1.6,201737
30,20,30,1,128,51,6,11,0,227,62,289,11,1.4,201737
31,1,52,6,41,69,2,14,0,184,43,227,8,1.5,201737
31,2,25,0,59,1,20,17,0,122,22,144,7,1.333333333,201737
31,3,207,8,249,87,14,39,0,604,155,759,14,2,201737
31,4,110,1,60,35,9,10,0,225,49,274,7,2,201737
31,5,58,1,66,28,3,8,0,164,98,262,7,1.333333333,201737
32,1,59,6,42,33,4,9,3,156,75,231,12,1.2,201737
32,2,29,6,31,29,5,6,0,106,37,143,13,1.142857143,201737
32,3,52,4,45,50,3,17,1,172,67,239,13,1.4,201737
32,4,79,5,49,64,4,18,2,221,148,369,12,1.4,201737
1,1,462,37,283,335,38,75,5,1235,811,2046,13,5.5,201738
1,2,734,54,588,290,46,93,4,1809,1456,3265,12,5,201738
1,3,655,34,549,257,17,88,1,1601,1311,2912,11,6,201738
2,1,290,2,312,220,7,69,0,900,223,1123,11,6,201738
2,2,452,16,425,340,4,122,0,1359,231,1590,7,6,201738
2,3,453,15,434,268,16,106,1,1293,357,1650,11,5.5,201738
2,4,289,7,293,122,2,33,0,746,118,864,6,6,201738
2,5,670,33,818,409,86,144,0,2160,375,2535,16,6.25,201738
2,6,309,18,377,235,20,54,1,1014,216,1230,7,6,201738
2,7,307,3,359,193,9,82,1,954,337,1291,12,4.5,201738
2,8,377,5,499,313,6,78,1,1279,297,1576,8,6,201738
3,1,290,5,251,172,15,55,0,788,384,1172,13,5.333333333,201738
3,2,115,6,262,170,4,20,0,577,400,977,9,5.666666667,201738
4,1,449,18,354,478,67,76,0,1442,1001,2443,13,5.4,201738
4,2,266,19,358,427,28,56,1,1155,584,1739,14,5.2,201738
5,1,479,17,332,205,17,72,0,1122,1266,2388,9,5.666666667,201738
5,2,665,15,312,204,13,92,1,1302,705,2007,10,5.2,201738
5,3,887,18,318,175,25,92,0,1515,812,2327,9,5.5,201738
5,4,645,12,431,149,7,97,2,1343,1095,2438,9,5.333333333,201738
5,5,641,9,278,200,4,56,3,1191,814,2005,8,6,201738
5,6,503,15,330,177,7,49,2,1083,105,1188,11,5.5,201738
5,7,418,8,218,122,6,57,0,829,168,997,10,5,201738
6,1,342,16,260,165,9,73,3,868,739,1607,12,5.8,201738
6,2,257,7,258,189,30,61,1,803,616,1419,9,5.666666667,201738
7,1,261,9,176,422,9,33,5,915,465,1380,9,4.25,201738
7,2,289,25,107,1091,118,34,2,1666,165,1831,9,4,201738
7,3,236,3,274,173,23,74,0,783,770,1553,7,4.666666667,201738
7,4,164,12,154,518,4,84,70,1006,33,1039,11,4,201738
7,5,226,10,102,785,17,49,108,1297,259,1556,11,3.333333333,201738
7,6,211,5,487,271,40,80,2,1096,590,1686,8,4,201738
7,7,146,22,342,668,46,52,0,1276,601,1877,8,4.25,201738
7,8,216,7,203,742,21,37,0,1226,415,1641,12,4,201738
7,9,272,23,324,372,24,99,1,1115,485,1600,9,4,201738
7,10,187,14,247,690,136,29,0,1303,377,1680,9,4.5,201738
7,11,103,0,110,155,0,24,0,392,4,396,6,3.333333333,201738
7,12,222,4,532,344,2,52,0,1156,257,1413,9,4,201738
7,13,185,9,675,15,0,46,0,930,366,1296,9,4.25,201738
8,1,297,5,234,125,5,37,0,703,337,1040,4,6,201738
8,2,645,31,772,316,34,123,1,1922,844,2766,17,5.666666667,201738
8,3,476,17,554,139,3,98,0,1287,408,1695,5,6,201738
8,4,140,12,191,103,10,47,3,506,305,811,9,5.5,201738
8,5,356,49,335,184,32,97,0,1053,336,1389,10,5.25,201738
8,6,856,27,461,327,21,122,2,1816,1080,2896,9,4.5,201738
8,7,266,19,143,183,6,72,0,689,275,964,8,5.25,201738
8,8,601,24,304,175,3,84,0,1191,477,1668,6,4,201738
8,9,264,15,202,142,18,107,19,767,307,1074,10,5.2,201738
9,1,117,12,158,139,29,57,0,512,527,1039,6,9,201738
9,2,516,32,940,400,17,125,4,2034,1049,3083,12,6,201738
9,3,281,22,493,353,47,113,4,1313,1192,2505,7,6,201738
9,4,178,5,693,121,13,72,0,1082,626,1708,11,6,201738
9,5,146,2,342,119,17,49,0,675,272,947,7,6,201738
9,6,140,29,381,3,3,46,0,602,292,894,7,6,201738
9,7,169,5,299,182,6,50,0,711,760,1471,9,6,201738
9,8,28,10,132,48,4,21,3,246,538,784,6,8,201738
9,9,167,5,456,11,2,36,0,677,310,987,5,6,201738
9,10,196,7,230,227,10,47,0,717,645,1362,6,6,201738
9,11,234,7,665,122,19,88,0,1135,1111,2246,7,6,201738
9,12,266,123,623,405,13,66,1,1497,682,2179,11,6,201738
9,13,164,13,286,179,35,38,8,723,871,1594,4,6,201738
9,14,138,5,238,118,61,60,0,620,598,1218,5,6,201738
9,15,352,21,703,500,20,101,0,1697,1918,3615,9,4.333333333,201738
9,16,439,40,709,332,54,102,0,1676,552,2228,15,7,201738
9,17,169,9,244,244,9,59,0,734,948,1682,6,6,201738
9,18,229,10,692,124,3,97,1,1156,308,1464,12,6,201738
9,19,254,30,489,96,53,77,0,999,587,1586,5,6,201738
9,21,106,7,243,129,9,42,1,537,495,1032,3,6,201738
9,22,205,13,286,183,61,62,19,829,340,1169,5,6,201738
9,23,294,15,424,322,42,77,0,1174,1188,2362,7,9,201738
9,24,367,25,624,316,52,106,2,1492,954,2446,12,6,201738
10,1,360,21,174,197,8,43,8,811,519,1330,12,5.333333333,201738
10,2,432,11,293,171,10,72,0,989,270,1259,9,5.5,201738
10,3,309,22,216,131,22,42,17,759,262,1021,12,5.4,201738
10,4,703,14,273,317,100,54,28,1489,1188,2677,10,3.8,201738
11,1,193,17,195,155,7,37,5,609,292,901,6,5.666666667,201738
11,2,212,18,192,209,17,45,8,701,393,1094,7,6,201738
11,3,228,8,181,125,6,40,0,588,276,864,4,6,201738
11,4,272,15,209,116,3,48,0,663,179,842,10,4.6,201738
11,5,272,20,364,181,6,74,0,917,415,1332,8,5.5,201738
11,6,148,6,292,46,4,58,1,555,298,853,8,4.666666667,201738
11,7,298,11,545,93,15,51,0,1013,459,1472,9,5.5,201738
11,8,235,28,248,293,22,54,0,880,603,1483,9,5.75,201738
11,9,304,13,517,49,0,74,0,957,382,1339,10,5.666666667,201738
11,10,282,33,302,281,13,68,4,983,469,1452,11,5.6,201738
11,11,359,11,449,18,1,55,0,893,159,1052,5,6,201738
11,12,242,27,362,273,8,52,0,964,548,1512,7,6.5,201738
11,13,231,7,333,95,9,53,10,738,191,929,8,5.5,201738
11,14,197,11,217,177,17,56,0,675,312,987,8,5.5,201738
11,15,146,15,218,127,1,34,0,541,291,832,5,6,201738
12,1,109,12,172,91,16,22,0,422,247,669,10,5.2,201738
12,2,243,37,361,337,41,62,0,1081,758,1839,10,5.5,201738
12,3,199,21,328,311,24,60,0,943,723,1666,11,5.2,201738
12,4,314,26,481,395,37,65,0,1318,1122,2440,9,6,201738
12,5,258,17,344,187,5,58,38,907,204,1111,10,5.25,201738
12,6,200,7,329,347,10,24,1,918,152,1070,10,5.25,201738
12,7,260,14,325,233,8,59,6,905,889,1794,6,5.5,201738
12,8,307,33,449,424,29,49,0,1291,602,1893,9,5.25,201738
12,9,340,27,370,733,24,63,5,1562,585,2147,9,5.666666667,201738
13,1,210,27,176,397,80,51,0,941,168,1109,9,5.333333333,201738
13,2,136,16,76,147,40,33,0,448,183,631,6,5.333333333,201738
13,3,127,12,267,107,70,52,0,635,231,866,12,5.25,201738
13,4,193,13,237,135,31,40,7,656,379,1035,9,5.666666667,201738
13,5,212,21,231,276,47,90,1,878,747,1625,9,5.75,201738
13,6,462,21,694,316,15,82,1,1591,654,2245,11,6,201738
13,7,244,18,336,163,24,49,0,834,299,1133,8,5.5,201738
14,1,170,31,134,112,20,56,11,534,348,882,6,5.5,201738
14,2,131,4,126,70,10,56,0,397,233,630,6,5.333333333,201738
14,3,298,11,205,59,5,87,0,665,509,1174,11,5.4,201738
14,4,235,15,166,196,5,53,3,673,400,1073,3,6,201738
14,5,290,22,421,215,39,64,0,1051,317,1368,11,5.5,201738
14,6,398,17,372,189,8,42,0,1026,435,1461,11,5,201738
14,7,166,6,241,75,0,44,0,532,251,783,6,6,201738
14,8,560,23,792,248,8,132,0,1763,892,2655,10,4.8,201738
14,9,324,19,454,219,9,79,0,1104,323,1427,8,6,201738
14,10,282,11,294,104,6,61,1,759,502,1261,7,4.5,201738
14,11,161,11,192,99,12,29,0,504,245,749,4,6,201738
14,12,262,9,434,75,7,58,0,845,372,1217,11,5.5,201738
14,13,201,5,381,51,6,55,0,699,122,821,8,5.5,201738
14,14,275,15,331,130,13,60,5,829,208,1037,7,6,201738
14,15,311,18,205,172,9,77,3,795,388,1183,10,5.6,201738
14,16,296,4,402,77,7,64,0,850,389,1239,5,6,201738
14,17,162,7,149,56,9,46,4,433,100,533,9,5.25,201738
14,18,229,24,193,138,13,58,8,663,366,1029,10,5.4,201738
14,19,202,26,211,150,16,46,10,661,405,1066,9,5.25,201738
14,20,142,1,162,17,0,36,0,358,77,435,4,5.5,201738
15,1,131,8,176,47,50,54,0,466,276,742,7,5.333333333,201738
15,2,260,8,363,161,36,56,4,888,286,1174,6,6,201738
15,3,292,27,302,214,33,86,0,954,393,1347,10,5.666666667,201738
15,4,269,15,250,258,24,76,2,894,973,1867,4,6,201738
15,5,242,24,280,224,2,60,1,833,464,1297,8,5.666666667,201738
15,6,316,17,327,255,36,58,6,1015,194,1209,7,6,201738
15,7,327,3,439,157,20,56,0,1002,363,1365,10,6,201738
15,8,119,9,122,127,11,33,2,423,337,760,4,6,201738
15,9,232,6,157,148,64,66,9,682,300,982,9,5.75,201738
15,10,220,14,275,208,34,53,0,804,530,1334,9,6,201738
15,11,197,7,310,142,14,38,0,708,194,902,8,4,201738
15,12,325,15,593,300,30,62,4,1329,451,1780,8,6,201738
15,13,173,4,353,42,7,46,0,625,643,1268,8,6,201738
15,14,134,6,274,71,13,55,0,553,0,553,4,6,201738
15,15,243,42,434,226,13,76,0,1034,511,1545,6,6,201738
15,16,305,21,467,370,12,75,0,1250,738,1988,8,6,201738
15,17,232,22,343,286,8,83,0,974,784,1758,8,6,201738
15,18,258,13,331,233,9,80,0,924,423,1347,7,5.666666667,201738
15,19,443,98,516,415,6,78,2,1558,595,2153,14,6,201738
15,20,134,5,169,148,6,32,0,494,313,807,6,5,201738
15,21,90,2,233,0,0,53,0,378,144,522,6,5.5,201738
15,22,286,31,625,220,6,74,1,1243,616,1859,14,6,201738
15,23,279,4,438,36,12,87,0,856,505,1361,7,5.333333333,201738
15,24,261,16,334,130,3,39,0,783,53,836,4,6,201738
15,25,313,26,560,179,8,87,0,1173,507,1680,6,6,201738
15,26,129,15,188,54,14,33,0,433,171,604,9,3.5,201738
15,27,340,14,318,293,1,82,0,1048,801,1849,9,5.666666667,201738
15,28,314,10,592,144,11,94,2,1167,335,1502,9,5.333333333,201738
15,29,277,15,443,317,6,95,0,1153,166,1319,8,6,201738
15,30,249,18,480,218,22,60,0,1047,367,1414,12,6,201738
15,31,246,32,256,201,6,72,0,813,186,999,6,6,201738
15,32,201,12,291,342,22,65,0,933,388,1321,9,6,201738
15,33,218,10,433,213,13,70,0,957,348,1305,7,6,201738
15,34,325,17,300,311,7,86,0,1046,657,1703,8,6,201738
15,35,262,7,329,116,7,100,0,821,298,1119,9,5.666666667,201738
15,36,279,17,182,241,49,59,0,827,365,1192,9,5.5,201738
15,37,300,16,423,148,18,74,1,980,338,1318,7,6,201738
15,38,254,21,353,277,3,62,0,970,480,1450,6,5.5,201738
15,39,142,14,268,197,11,43,0,675,332,1007,4,6,201738
15,40,416,17,432,199,9,121,0,1194,510,1704,9,6,201738
15,41,630,27,984,169,7,60,5,1882,414,2296,11,6,201738
16,1,144,14,175,153,5,53,0,544,337,881,10,5.333333333,201738
16,2,109,16,114,138,4,47,0,428,185,613,9,5,201738
16,3,149,11,136,213,25,44,0,578,579,1157,10,5.25,201738
16,4,185,5,171,96,14,57,0,528,312,840,8,5.5,201738
16,5,210,27,186,123,21,66,2,635,618,1253,10,5.666666667,201738
16,6,225,22,180,173,29,44,0,673,617,1290,12,5.5,201738
16,7,171,18,171,72,29,63,0,524,185,709,9,5.5,201738
16,8,395,32,471,336,18,90,0,1342,878,2220,12,6,201738
16,9,160,13,220,154,6,64,0,617,208,825,10,6,201738
16,10,222,12,259,210,2,57,0,762,415,1177,6,6,201738
16,11,202,15,196,99,71,89,2,674,333,1007,12,5.4,201738
16,12,150,13,225,127,7,45,3,570,385,955,10,5.25,201738
17,1,198,10,314,242,18,57,1,840,339,1179,10,4.666666667,201738
17,2,189,12,305,223,6,46,4,785,404,1189,9,5.666666667,201738
17,3,258,13,586,171,5,73,0,1106,410,1516,8,5.5,201738
17,4,253,16,403,169,3,68,1,913,417,1330,10,5.666666667,201738
17,5,77,6,177,72,7,25,0,364,80,444,5,5.5,201738
18,1,131,11,160,128,22,46,0,498,265,763,9,5.4,201738
18,2,580,27,380,310,28,82,0,1407,1232,2639,8,6.666666667,201738
18,3,254,18,383,152,5,66,0,878,489,1367,9,5.25,201738
19,1,269,19,303,227,9,81,3,911,701,1612,9,6,201738
19,2,527,16,632,188,83,96,0,1542,393,1935,10,6.5,201738
19,3,409,5,574,207,12,91,0,1298,740,2038,8,6,201738
19,4,220,5,192,90,19,37,20,583,174,757,5,6,201738
19,5,483,16,483,466,10,109,10,1577,395,1972,8,6,201738
19,6,153,6,146,109,7,36,2,459,279,738,5,6,201738
19,7,168,3,427,4,0,26,0,628,196,824,11,5,201738
19,8,51,1,60,21,1,7,0,141,33,174,7,6,201738
19,9,192,7,174,141,11,29,0,554,209,763,9,5.25,201738
19,10,252,8,207,155,2,64,0,688,482,1170,6,3.5,201738
19,11,863,26,696,419,10,162,7,2183,1416,3599,13,6.333333333,201738
19,12,257,8,386,178,11,56,2,898,249,1147,11,6.25,201738
20,1,195,11,217,256,44,47,0,770,281,1051,7,5.5,201738
20,2,111,3,275,68,9,37,1,504,89,593,6,5.333333333,201738
20,3,233,20,303,150,162,51,5,924,128,1052,6,5.333333333,201738
20,4,86,13,137,98,18,67,0,419,137,556,6,5.333333333,201738
20,5,167,6,472,94,5,54,0,798,220,1018,11,4.5,201738
20,6,163,12,157,469,242,49,4,1096,515,1611,8,5.25,201738
20,7,131,8,179,205,9,32,0,564,84,648,8,3.5,201738
20,8,460,14,541,336,10,120,23,1504,446,1950,13,5,201738
20,9,261,2,404,45,31,81,0,824,326,1150,8,5.666666667,201738
20,10,255,9,334,220,6,61,0,885,250,1135,9,5.25,201738
21,1,237,15,261,423,16,48,0,1000,392,1392,9,5.4,201738
21,2,187,15,277,109,9,61,0,658,72,730,9,5,201738
21,3,180,4,239,83,28,68,2,604,139,743,8,5.5,201738
21,4,217,3,403,8,0,90,3,724,204,928,6,5.25,201738
21,5,277,8,283,190,15,77,17,867,278,1145,8,5.666666667,201738
21,6,281,16,389,242,19,83,1,1031,281,1312,6,7,201738
21,7,280,14,257,186,38,74,0,849,254,1103,9,5.666666667,201738
21,8,165,9,326,188,15,63,1,767,105,872,10,5.2,201738
21,9,328,12,471,287,40,96,8,1242,319,1561,9,6,201738
21,10,304,12,332,211,23,72,1,955,326,1281,7,6,201738
21,11,11,0,24,5,2,5,0,47,0,47,4,6,201738
21,12,590,12,1003,340,46,156,2,2149,494,2643,16,4.666666667,201738
21,13,273,6,294,190,25,92,0,880,297,1177,8,5.666666667,201738
21,14,312,5,463,117,24,91,0,1012,239,1251,13,5.333333333,201738
21,15,227,5,375,211,30,54,0,902,399,1301,7,5.5,201738
22,1,202,56,198,426,48,23,0,953,441,1394,11,5.2,201738
22,2,142,16,274,97,20,38,7,594,269,863,7,5.5,201738
22,3,456,27,641,377,16,89,2,1608,804,2412,10,6,201738
22,4,427,18,663,176,12,72,0,1368,316,1684,10,4.5,201738
22,5,263,10,449,41,8,44,0,815,280,1095,10,5.5,201738
23,1,316,13,902,277,27,64,0,1599,392,1991,14,5.6,201738
23,2,340,28,429,557,15,76,0,1445,764,2209,10,5.25,201738
23,3,297,3,918,38,17,50,0,1323,374,1697,11,4.5,201738
23,4,325,3,770,11,3,24,0,1136,155,1291,6,6,201738
24,1,217,53,205,513,52,35,0,1075,264,1339,11,5,201738
24,2,125,16,155,141,15,40,0,492,325,817,6,5.5,201738
24,3,226,22,183,385,69,32,1,918,284,1202,9,5.25,201738
24,4,155,24,197,168,31,55,67,697,357,1054,5,5.5,201738
24,5,442,20,334,381,3,83,0,1263,777,2040,9,6.333333333,201738
24,6,420,33,482,429,20,110,0,1494,432,1926,9,6,201738
24,7,144,30,234,482,64,42,0,996,470,1466,9,5.25,201738
25,1,147,2,382,38,0,51,0,620,151,771,14,5.75,201738
25,2,266,20,291,277,11,76,0,941,279,1220,7,5.5,201738
25,3,242,9,277,229,18,66,4,845,224,1069,9,5.6,201738
25,4,168,10,154,213,4,39,0,588,179,767,8,4.333333333,201738
25,5,307,5,459,186,5,97,0,1059,189,1248,9,6,201738
25,6,315,4,523,75,18,87,0,1022,269,1291,9,5.75,201738
25,7,274,2,347,183,2,89,0,897,186,1083,7,6,201738
26,1,322,8,284,241,7,90,0,952,356,1308,9,5.5,201738
26,2,615,7,382,322,1,91,1,1419,329,1748,13,5.4,201738
26,3,747,21,387,455,8,152,1,1771,617,2388,14,4.666666667,201738
26,4,367,22,201,259,13,88,0,950,490,1440,10,5.2,201738
26,5,186,3,104,152,5,42,0,492,112,604,3,5.5,201738
26,6,550,10,320,332,4,96,0,1312,236,1548,10,5.333333333,201738
26,7,289,18,131,288,13,47,0,786,408,1194,10,5.25,201738
27,1,173,10,153,295,30,28,1,690,472,1162,9,5.5,201738
27,2,226,20,200,519,17,45,3,1030,459,1489,8,5.666666667,201738
27,3,231,15,146,409,4,41,0,846,344,1190,7,5.666666667,201738
27,4,243,5,293,547,8,38,2,1136,422,1558,8,4,201738
27,5,174,12,66,370,3,27,0,652,211,863,6,5.333333333,201738
27,6,269,18,246,373,4,79,0,989,354,1343,9,5.333333333,201738
28,1,365,23,470,301,6,66,0,1231,827,2058,13,6,201738
28,2,310,10,631,128,11,85,24,1199,645,1844,14,6,201738
28,3,135,9,163,147,8,37,0,499,286,785,7,5.333333333,201738
28,4,351,12,411,275,36,86,19,1190,808,1998,16,6,201738
28,5,183,38,196,378,37,71,0,903,588,1491,10,5.25,201738
28,6,120,23,189,441,52,38,10,873,91,964,14,4.5,201738
28,7,239,11,365,261,29,81,0,986,208,1194,8,6,201738
28,8,168,10,195,203,20,60,0,656,408,1064,9,6,201738
28,9,157,1,302,98,1,33,11,603,174,777,4,6,201738
29,1,297,15,413,239,24,77,0,1065,132,1197,10,5.5,201738
29,2,440,17,429,402,18,98,16,1420,0,1420,12,4.8,201738
29,3,185,36,152,252,13,49,0,687,123,810,7,5.666666667,201738
30,1,102,9,83,103,8,35,9,349,65,414,7,5.333333333,201738
30,2,149,38,159,101,37,59,293,836,223,1059,8,5.25,201738
30,3,221,15,274,102,47,60,39,758,249,1007,6,5.666666667,201738
30,4,191,3,260,100,11,47,0,612,202,814,8,6,201738
30,5,205,14,167,282,6,72,1,747,228,975,7,5.5,201738
30,6,140,8,146,106,21,40,0,461,72,533,9,5.333333333,201738
30,7,193,15,168,147,45,84,23,675,137,812,12,5.25,201738
30,8,233,21,311,232,14,100,0,911,178,1089,11,5.4,201738
30,9,234,8,182,121,29,70,31,675,256,931,8,5.5,201738
30,10,305,12,290,200,15,100,7,929,517,1446,7,6.5,201738
30,11,218,14,285,208,8,82,0,815,338,1153,6,5.5,201738
30,12,332,8,562,299,5,122,0,1328,511,1839,11,6.25,201738
30,13,246,6,211,214,40,60,5,782,272,1054,10,5.4,201738
30,14,234,28,270,185,98,124,0,939,266,1205,9,5.5,201738
30,15,269,10,244,204,29,115,40,911,247,1158,11,5.666666667,201738
30,16,349,7,268,248,46,110,13,1041,300,1341,10,5.333333333,201738
30,17,153,17,186,161,10,55,3,585,240,825,8,4.5,201738
30,18,185,21,166,199,11,57,9,648,141,789,8,5.25,201738
30,19,273,25,339,282,19,113,8,1059,121,1180,13,5.6,201738
30,20,343,9,330,276,40,72,1,1071,339,1410,11,5.4,201738
31,1,168,8,255,139,3,30,0,603,222,825,8,5.5,201738
31,2,159,3,250,16,56,44,0,528,127,655,7,5.333333333,201738
31,3,676,30,993,335,41,149,0,2224,465,2689,17,6.25,201738
31,4,234,5,252,114,33,35,0,673,136,809,4,7,201738
31,5,275,10,330,130,11,70,0,826,141,967,7,5.333333333,201738
32,1,255,42,235,186,55,88,29,890,207,1097,12,5.2,201738
32,2,192,31,156,164,55,43,3,644,237,881,13,5.142857143,201738
32,3,223,40,172,174,16,49,1,675,352,1027,13,4.8,201738
32,4,352,96,307,241,34,88,53,1171,373,1544,13,4.666666667,201738
1,1,342,27,191,214,57,48,6,885,926,1811,13,5,201739
1,2,438,41,452,222,41,85,6,1285,1432,2717,12,4.4,201739
1,3,413,31,475,208,21,99,1,1248,1455,2703,11,5.25,201739
2,1,202,6,203,138,1,57,0,607,711,1318,11,5,201739
2,2,305,12,318,267,5,102,0,1009,100,1109,7,5,201739
2,3,361,9,399,239,14,103,0,1125,603,1728,11,4.75,201739
2,4,185,4,256,90,2,30,0,567,258,825,6,5,201739
2,5,430,21,675,266,46,87,0,1525,1002,2527,16,5.25,201739
2,6,198,15,333,202,16,48,0,812,1368,2180,7,5,201739
2,7,238,0,306,204,7,76,0,831,491,1322,8,3.75,201739
2,8,250,8,434,219,7,61,0,979,1122,2101,8,5,201739
3,1,218,1,245,114,11,57,3,649,628,1277,13,5,201739
3,2,126,9,296,139,8,24,0,602,560,1162,9,5.333333333,201739
4,1,343,28,330,401,28,54,0,1184,947,2131,13,5.2,201739
4,2,227,18,311,321,37,55,2,971,758,1729,14,5.2,201739
5,1,336,10,279,182,19,57,0,883,718,1601,9,5,201739
5,2,420,12,223,150,9,64,0,878,537,1415,10,5,201739
5,3,493,13,286,148,21,83,0,1044,1268,2312,9,5,201739
5,4,429,18,420,141,2,90,7,1107,980,2087,9,5.333333333,201739
5,5,379,7,294,177,7,39,8,911,762,1673,8,5,201739
5,6,322,20,271,176,8,37,2,836,441,1277,11,5,201739
5,7,281,8,236,94,5,51,0,675,799,1474,11,3.666666667,201739
6,1,244,15,229,161,8,56,1,714,797,1511,12,5.2,201739
6,2,211,8,235,142,29,63,0,688,532,1220,9,5,201739
7,1,205,9,147,429,14,21,4,829,444,1273,9,5,201739
7,2,377,19,182,1356,62,64,0,2060,142,2202,9,5,201739
7,3,280,14,390,568,77,73,0,1402,485,1887,7,5,201739
7,4,190,20,328,379,2,53,45,1017,495,1512,11,5,201739
7,5,260,16,163,1377,29,40,116,2001,812,2813,11,5,201739
7,6,274,8,242,354,102,69,15,1064,661,1725,8,5,201739
7,7,175,18,378,484,19,50,0,1124,672,1796,8,5,201739
7,8,316,12,252,942,30,43,0,1595,833,2428,12,5,201739
7,9,290,11,331,458,19,65,2,1176,925,2101,9,5,201739
7,10,226,15,199,1037,22,45,0,1544,847,2391,9,5,201739
7,11,121,0,82,93,0,7,0,303,32,335,6,5,201739
7,12,320,35,608,259,17,36,0,1275,851,2126,9,5,201739
7,13,191,5,690,301,0,37,0,1224,534,1758,9,5,201739
8,1,138,5,164,88,5,30,0,430,725,1155,4,5,201739
8,2,485,26,572,319,23,99,1,1525,1096,2621,17,5,201739
8,3,317,10,415,90,7,48,0,887,1323,2210,5,6,201739
8,4,110,11,167,104,10,44,1,447,441,888,9,5,201739
8,5,236,20,253,148,18,82,0,757,375,1132,10,4.75,201739
8,6,452,24,370,245,21,119,4,1235,1503,2738,10,4,201739
8,7,204,14,166,134,1,51,0,570,309,879,8,4.25,201739
8,8,389,16,238,215,3,69,1,931,1240,2171,6,3.5,201739
8,9,203,24,126,134,12,65,3,567,337,904,10,3.8,201739
9,1,52,2,135,81,24,40,0,334,484,818,6,7,201739
9,2,273,77,759,260,11,102,1,1483,1623,3106,12,5,201739
9,3,144,18,359,232,22,64,4,843,982,1825,7,5,201739
9,4,151,5,482,98,8,57,0,801,1100,1901,11,5,201739
9,5,121,9,288,101,18,34,1,572,422,994,7,5,201739
9,6,106,26,281,4,3,38,0,458,317,775,7,5,201739
9,7,105,5,270,142,12,32,0,566,507,1073,9,5,201739
9,8,33,7,141,37,3,19,1,241,261,502,6,7,201739
9,9,87,5,346,0,1,31,0,470,670,1140,5,5,201739
9,10,100,9,160,173,8,35,1,486,658,1144,6,5,201739
9,11,143,3,533,101,13,70,0,863,1059,1922,7,5,201739
9,12,161,57,493,301,14,68,1,1095,608,1703,11,5,201739
9,13,117,5,242,131,22,37,4,558,787,1345,4,5,201739
9,14,99,6,192,79,50,39,0,465,718,1183,5,5,201739
9,15,219,15,610,480,12,112,0,1448,1444,2892,10,3,201739
9,16,273,23,478,267,20,94,0,1155,1087,2242,15,5,201739
9,17,103,9,157,180,2,31,0,482,707,1189,6,5,201739
9,18,168,8,545,89,4,75,0,889,754,1643,12,5,201739
9,19,156,15,402,112,36,59,1,781,733,1514,5,5,201739
9,20,1,3,1,0,1,2,0,8,0,8,5,5,201739
9,21,70,7,158,89,10,22,1,357,500,857,3,5,201739
9,22,118,3,209,133,49,35,11,558,547,1105,5,5,201739
9,23,218,11,313,276,25,57,0,900,1041,1941,7,7,201739
9,24,245,18,516,233,36,83,0,1131,1669,2800,12,5,201739
10,1,312,9,230,169,8,57,5,790,652,1442,12,4.5,201739
10,2,283,15,251,149,20,61,1,780,509,1289,9,5,201739
10,3,195,11,178,111,11,38,21,565,381,946,12,5,201739
10,4,488,16,383,258,18,68,0,1231,1283,2514,11,3.6,201739
11,1,141,11,147,111,6,39,2,457,426,883,6,5,201739
11,2,156,14,175,158,13,35,2,553,559,1112,7,5,201739
11,3,139,15,181,109,10,33,0,487,383,870,4,5,201739
11,4,204,8,185,135,1,33,1,567,324,891,9,3.4,201739
11,5,237,22,340,153,3,67,0,822,691,1513,8,5.5,201739
11,6,138,5,298,37,2,40,2,522,484,1006,8,5,201739
11,7,234,16,675,153,7,53,0,1138,577,1715,9,5,201739
11,8,197,25,203,253,24,43,0,745,730,1475,9,5,201739
11,9,221,14,431,51,6,73,1,797,394,1191,10,5,201739
11,10,180,19,264,185,13,57,12,730,688,1418,10,5,201739
11,11,207,14,367,23,1,47,0,659,625,1284,4,5,201739
11,12,204,23,324,212,7,71,0,841,618,1459,7,5.5,201739
11,13,182,15,245,114,17,56,9,638,445,1083,9,5,201739
11,14,146,11,175,139,5,49,0,525,738,1263,8,5,201739
11,15,92,19,154,91,1,34,0,391,532,923,5,5,201739
12,1,162,8,262,109,30,40,2,613,407,1020,10,4.8,201739
12,2,185,17,296,175,19,46,0,738,943,1681,10,4.75,201739
12,3,198,29,281,263,33,63,0,867,593,1460,11,4.2,201739
12,4,159,14,313,251,23,41,0,801,828,1629,9,4.333333333,201739
12,5,289,20,362,182,4,47,23,927,229,1156,10,5,201739
12,6,189,12,304,217,11,33,1,767,600,1367,10,5,201739
12,7,185,4,249,201,5,41,12,697,772,1469,6,5,201739
12,8,229,17,272,309,21,28,0,876,836,1712,9,4.25,201739
12,9,127,10,203,338,12,39,0,729,575,1304,9,4.666666667,201739
13,1,153,24,132,341,83,54,0,787,432,1219,9,5,201739
13,2,161,15,109,190,35,33,0,543,224,767,6,5,201739
13,3,126,18,125,217,49,46,0,581,397,978,12,5,201739
13,4,143,10,204,107,21,44,4,533,295,828,9,5,201739
13,5,177,15,251,218,37,71,2,771,942,1713,9,5,201739
13,6,281,22,574,239,9,63,0,1188,607,1795,11,5.333333333,201739
13,7,204,29,328,240,15,57,0,873,504,1377,8,5,201739
14,1,164,15,115,95,12,58,15,474,192,666,6,5,201739
14,2,156,7,123,65,10,70,0,431,195,626,6,5,201739
14,3,308,9,158,41,0,85,0,601,163,764,11,5,201739
14,4,204,11,157,160,7,42,4,585,388,973,3,5,201739
14,5,220,20,375,150,22,61,0,848,126,974,11,5,201739
14,6,413,13,366,184,11,48,1,1036,539,1575,11,5,201739
14,7,134,7,210,55,0,56,0,462,609,1071,6,5,201739
14,8,356,10,645,182,9,83,0,1285,583,1868,11,4.2,201739
14,9,266,11,383,188,8,69,0,925,123,1048,8,5,201739
14,10,291,8,357,115,4,49,0,824,429,1253,7,5,201739
14,11,111,4,142,81,16,24,0,378,258,636,4,5,201739
14,12,208,9,358,96,1,41,0,713,357,1070,11,5,201739
14,13,159,6,299,69,3,36,0,572,61,633,8,5,201739
14,14,204,12,302,128,5,51,1,703,527,1230,7,6,201739
14,15,288,19,295,119,11,87,5,824,229,1053,10,5,201739
14,16,193,4,353,64,2,46,0,662,233,895,5,5,201739
14,17,140,8,166,40,10,41,7,412,118,530,9,4,201739
14,18,211,8,259,71,13,61,11,634,92,726,10,5,201739
14,19,179,25,197,156,24,45,5,631,322,953,9,5,201739
14,20,115,1,197,0,0,17,0,330,38,368,4,5,201739
15,1,160,4,189,103,38,42,0,536,598,1134,7,5,201739
15,2,173,6,289,121,17,34,4,644,359,1003,6,5,201739
15,3,224,18,205,149,47,72,0,715,707,1422,10,5,201739
15,4,157,12,182,209,15,53,1,629,899,1528,4,5,201739
15,5,174,10,198,172,9,38,0,601,538,1139,8,5,201739
15,6,203,10,285,172,25,59,0,754,283,1037,7,5.5,201739
15,7,189,4,364,137,12,65,0,771,542,1313,10,5,201739
15,8,90,9,81,128,9,11,2,330,584,914,4,5,201739
15,9,181,5,129,103,33,39,6,496,353,849,9,5,201739
15,10,138,10,234,153,24,50,0,609,616,1225,9,5,201739
15,11,176,6,329,143,4,49,0,707,570,1277,8,5,201739
15,12,238,10,455,216,19,67,2,1007,1012,2019,8,5,201739
15,13,128,4,314,29,8,42,0,525,651,1176,8,5,201739
15,14,90,2,157,39,13,27,0,328,0,328,4,5,201739
15,15,139,13,399,62,3,54,0,670,583,1253,6,5,201739
15,16,237,19,397,254,8,66,0,981,1253,2234,8,5,201739
15,17,172,19,244,214,4,60,0,713,883,1596,8,5,201739
15,18,186,14,295,230,11,41,0,777,636,1413,7,5,201739
15,19,269,53,426,342,3,81,1,1175,779,1954,14,5,201739
15,20,84,5,150,151,9,30,0,429,376,805,6,5,201739
15,21,121,2,183,1,3,32,0,342,55,397,6,5,201739
15,22,282,28,461,207,3,65,0,1046,877,1923,14,5,201739
15,23,266,4,472,39,13,96,0,890,558,1448,7,5,201739
15,24,151,15,259,102,3,33,2,565,27,592,4,5,201739
15,25,190,16,462,108,5,46,0,827,718,1545,6,5,201739
15,26,84,9,133,42,8,38,0,314,397,711,8,2.5,201739
15,27,192,6,218,263,5,64,1,749,978,1727,9,5,201739
15,28,247,6,544,105,10,66,0,978,720,1698,9,5,201739
15,29,162,9,354,210,1,77,0,813,236,1049,8,5,201739
15,30,197,14,324,179,12,47,0,773,612,1385,12,5,201739
15,31,142,15,214,160,4,59,0,594,453,1047,6,5,201739
15,32,128,13,178,252,18,40,0,629,431,1060,9,5,201739
15,33,168,6,320,176,12,58,0,740,646,1386,7,5,201739
15,34,201,7,232,202,4,57,0,703,998,1701,8,5,201739
15,35,234,5,364,94,2,91,0,790,879,1669,9,5,201739
15,36,208,27,151,189,36,54,0,665,674,1339,9,5,201739
15,37,187,9,325,145,10,56,0,732,630,1362,7,5,201739
15,38,170,22,258,235,14,64,0,763,869,1632,6,5,201739
15,39,133,23,167,144,11,32,2,512,242,754,4,5,201739
15,40,273,8,305,163,3,80,0,832,894,1726,9,5,201739
15,41,354,15,624,189,3,41,0,1226,1318,2544,11,5,201739
16,1,138,9,235,77,3,56,0,518,170,688,10,5,201739
16,2,106,14,87,79,8,33,0,327,229,556,9,4.75,201739
16,3,132,19,130,181,22,30,0,514,469,983,10,4.5,201739
16,4,178,10,225,81,15,65,0,574,697,1271,8,5,201739
16,5,170,10,153,114,10,56,7,520,702,1222,10,5,201739
16,6,182,24,176,160,27,36,0,605,776,1381,12,5,201739
16,7,169,14,173,64,31,50,0,501,524,1025,9,5,201739
16,8,268,30,370,273,17,85,0,1043,1004,2047,12,5,201739
16,9,129,11,186,142,4,50,0,522,593,1115,10,5,201739
16,10,161,6,214,159,2,46,0,588,590,1178,6,5,201739
16,11,139,10,173,103,57,50,0,532,739,1271,12,4.8,201739
16,12,167,12,191,100,11,52,6,539,776,1315,10,5,201739
17,1,132,7,284,207,10,47,0,687,678,1365,10,4,201739
17,2,139,10,199,238,22,34,4,646,829,1475,9,5,201739
17,3,169,8,477,125,9,41,0,829,771,1600,8,5,201739
17,4,166,10,346,152,4,57,0,735,986,1721,10,5,201739
17,5,76,6,183,64,9,27,0,365,276,641,5,5,201739
18,1,140,13,118,99,16,56,0,442,390,832,9,6,201739
18,2,436,14,327,221,47,57,0,1102,1396,2498,8,6,201739
18,3,252,14,268,213,13,50,0,810,882,1692,9,6,201739
19,1,212,13,273,190,13,68,0,769,883,1652,9,5,201739
19,2,415,17,570,189,55,98,0,1344,961,2305,10,5.5,201739
19,3,319,11,454,175,17,93,0,1069,812,1881,8,5,201739
19,4,134,7,155,75,25,42,14,452,330,782,5,5,201739
19,5,350,19,429,349,12,104,8,1271,1040,2311,8,5,201739
19,6,112,3,150,95,7,34,3,404,410,814,5,5,201739
19,7,252,6,614,7,0,30,0,909,465,1374,11,5.5,201739
19,8,50,1,51,23,0,10,0,135,63,198,7,5,201739
19,9,120,6,95,136,11,34,0,402,338,740,9,4,201739
19,10,161,4,152,133,5,53,0,508,675,1183,5,2.5,201739
19,11,578,32,621,430,7,127,2,1797,1990,3787,13,5.333333333,201739
19,12,239,11,370,150,13,47,0,830,404,1234,9,6,201739
20,1,211,12,217,169,30,55,0,694,590,1284,7,5,201739
20,2,85,3,167,76,6,24,0,361,102,463,6,5,201739
20,3,129,17,379,215,137,69,1,947,166,1113,6,5,201739
20,4,141,15,184,196,28,53,0,617,178,795,6,5,201739
20,5,169,2,338,102,7,30,0,648,459,1107,11,4,201739
20,6,149,7,149,350,207,36,0,898,785,1683,8,5,201739
20,7,61,4,59,67,5,16,0,212,120,332,8,3.25,201739
20,8,441,10,493,407,11,87,15,1464,926,2390,10,2.333333333,201739
20,9,243,5,285,80,40,63,0,716,211,927,8,5,201739
20,10,251,6,265,232,11,72,0,837,736,1573,9,5,201739
21,1,213,6,206,304,12,35,5,781,691,1472,9,5,201739
21,2,205,10,260,98,24,60,0,657,66,723,9,5,201739
21,3,158,6,217,77,13,49,2,522,318,840,8,4.5,201739
21,4,193,1,381,9,1,83,3,671,214,885,6,5,201739
21,5,200,7,261,124,7,60,18,677,305,982,8,5,201739
21,6,171,7,288,184,16,50,3,719,319,1038,6,6,201739
21,7,190,5,181,140,20,68,0,604,194,798,9,5,201739
21,8,221,10,424,100,7,72,1,835,133,968,10,5,201739
21,9,209,5,354,213,29,76,7,893,283,1176,9,5,201739
21,10,212,7,248,190,12,47,0,716,200,916,7,5.5,201739
21,11,23,0,23,14,1,7,0,68,2,70,4,5,201739
21,12,432,11,810,279,35,109,2,1678,419,2097,15,3.666666667,201739
21,13,182,7,241,110,8,50,0,598,500,1098,8,5,201739
21,14,226,9,379,83,19,66,0,782,201,983,13,5,201739
21,15,183,9,371,128,20,55,0,766,527,1293,7,5,201739
22,1,187,47,198,408,30,29,0,899,809,1708,11,5,201739
22,2,163,9,299,74,14,40,4,603,652,1255,7,5,201739
22,3,362,30,590,309,21,81,3,1396,1363,2759,10,5.333333333,201739
22,4,245,21,529,123,6,42,0,966,658,1624,11,4,201739
22,5,143,22,367,5,14,24,0,575,524,1099,10,5,201739
23,1,240,5,786,247,20,39,0,1337,596,1933,14,5,201739
23,2,239,31,522,653,28,65,0,1538,853,2391,11,4.2,201739
23,3,260,2,983,62,11,40,0,1358,652,2010,11,5,201739
23,4,159,1,647,7,1,21,0,836,378,1214,6,5.5,201739
24,1,237,37,151,329,33,32,1,820,663,1483,11,5,201739
24,2,101,16,160,145,15,36,0,473,379,852,6,5,201739
24,3,171,22,369,350,50,49,3,1014,441,1455,9,4.25,201739
24,4,120,41,147,184,35,45,70,642,655,1297,5,5,201739
24,5,319,19,255,307,4,82,0,986,1100,2086,9,5.333333333,201739
24,6,296,34,376,355,11,79,2,1153,940,2093,9,5,201739
24,7,194,26,332,486,57,48,0,1143,857,2000,9,5,201739
25,1,145,1,300,48,0,42,0,536,596,1132,14,5,201739
25,2,210,14,231,206,26,74,0,761,836,1597,7,5,201739
25,3,305,8,270,154,12,48,2,799,666,1465,9,5,201739
25,4,132,6,183,182,11,70,0,584,520,1104,8,5,201739
25,5,213,9,351,135,2,76,0,786,725,1511,9,5.333333333,201739
25,6,288,6,462,63,15,75,0,909,585,1494,9,5,201739
25,7,192,5,268,149,1,70,0,685,849,1534,7,5,201739
26,1,267,9,239,252,9,82,0,858,865,1723,9,5,201739
26,2,458,9,322,309,5,62,0,1165,1012,2177,13,5,201739
26,3,625,10,312,408,9,129,0,1493,948,2441,14,4,201739
26,4,376,11,170,200,8,85,0,850,690,1540,10,5,201739
26,5,141,10,89,106,11,37,0,394,346,740,3,5,201739
26,6,461,16,267,238,3,66,0,1051,504,1555,10,5,201739
26,7,244,17,142,225,15,58,0,701,888,1589,10,5,201739
27,1,196,19,140,277,28,27,1,688,765,1453,9,5,201739
27,2,162,25,217,452,11,40,0,907,771,1678,8,5,201739
27,3,128,9,96,292,10,36,0,571,458,1029,7,5,201739
27,4,180,5,192,417,8,34,1,837,695,1532,8,3.666666667,201739
27,5,100,5,73,229,0,16,0,423,452,875,6,5,201739
27,6,172,14,302,310,3,44,0,845,700,1545,9,5,201739
28,1,260,13,306,238,0,41,0,858,926,1784,13,5,201739
28,2,287,3,495,99,12,62,15,973,880,1853,14,5.25,201739
28,3,124,7,104,138,7,46,0,426,594,1020,7,4.666666667,201739
28,4,275,23,344,229,26,70,17,984,949,1933,16,5,201739
28,5,191,26,175,330,39,53,0,814,746,1560,10,5,201739
28,6,90,12,110,199,37,15,4,467,408,875,14,2.5,201739
28,7,245,10,424,262,25,63,0,1029,753,1782,8,5,201739
28,8,124,14,178,171,13,55,0,555,559,1114,9,5,201739
28,9,159,0,233,109,4,25,19,549,507,1056,6,4.333333333,201739
29,1,225,21,336,190,19,48,0,839,605,1444,10,5,201739
29,2,267,19,271,345,24,70,18,1014,382,1396,13,4.4,201739
29,3,167,32,136,221,20,51,0,627,637,1264,7,5,201739
30,1,96,13,142,182,15,50,4,502,340,842,7,5,201739
30,2,142,32,238,101,50,47,211,821,524,1345,8,5,201739
30,3,172,6,220,125,84,56,22,685,516,1201,6,5,201739
30,4,120,3,236,81,11,46,0,497,510,1007,8,5,201739
30,5,154,12,165,220,2,61,0,614,571,1185,7,5,201739
30,6,99,11,187,134,13,39,0,483,233,716,9,5,201739
30,7,237,19,306,268,18,85,11,944,859,1803,12,5,201739
30,8,198,12,312,166,17,79,0,784,638,1422,11,5,201739
30,9,285,9,259,104,56,77,28,818,850,1668,8,5,201739
30,10,229,7,254,208,19,77,9,803,903,1706,7,5.5,201739
30,11,186,9,285,190,9,60,0,739,753,1492,6,5,201739
30,12,282,4,493,172,4,82,0,1037,1971,3008,11,5.25,201739
30,13,202,3,280,209,11,65,1,771,427,1198,10,5,201739
30,14,204,19,268,116,39,80,0,726,687,1413,9,5,201739
30,15,195,11,216,167,20,97,33,739,809,1548,11,5,201739
30,16,231,10,318,207,36,122,4,928,632,1560,10,5,201739
30,17,185,5,402,42,6,72,0,712,151,863,8,5,201739
30,18,254,12,182,249,17,100,41,855,598,1453,8,5,201739
30,19,166,14,265,212,2,61,17,737,612,1349,13,5,201739
30,20,232,1,455,28,1,68,0,785,771,1556,11,4.8,201739
31,1,133,10,183,174,3,30,0,533,399,932,8,5,201739
31,2,120,5,179,6,86,43,0,439,220,659,7,5,201739
31,3,466,27,782,287,33,113,0,1708,1501,3209,17,5.25,201739
31,4,154,4,208,86,19,22,0,493,426,919,4,6,201739
31,5,197,11,186,118,13,35,0,560,417,977,7,5,201739
32,1,171,28,143,185,26,49,24,626,389,1015,12,4.2,201739
32,2,182,50,181,148,48,46,4,659,412,1071,13,4.142857143,201739
32,3,157,39,184,184,15,52,1,632,696,1328,14,4.333333333,201739
32,4,221,93,240,213,38,60,72,937,641,1578,12,3.666666667,201739
1,1,403,29,229,292,69,58,3,1083,1059,2142,13,5.5,201740
1,2,593,47,509,329,56,101,4,1639,1462,3101,12,5,201740
1,3,584,44,558,342,40,108,0,1676,1651,3327,11,6,201740
2,1,329,12,327,288,5,94,0,1055,1307,2362,11,6,201740
2,2,489,25,334,339,14,111,0,1312,903,2215,7,6,201740
2,3,423,21,451,356,24,123,0,1398,1560,2958,12,4.6,201740
2,4,211,3,299,130,4,23,0,670,888,1558,6,6,201740
2,5,687,35,874,416,82,145,0,2239,2530,4769,16,6.25,201740
2,6,361,7,398,241,17,43,0,1067,1516,2583,7,6,201740
2,7,491,11,443,251,8,92,1,1297,1414,2711,12,5.5,201740
2,8,402,11,593,347,8,73,0,1434,1451,2885,8,6,201740
3,1,339,12,310,230,11,78,3,983,582,1565,13,5.333333333,201740
3,2,290,4,399,209,20,36,0,958,633,1591,9,5.666666667,201740
4,1,343,27,381,521,41,64,0,1377,1511,2888,15,4.666666667,201740
4,2,422,20,369,455,31,83,2,1382,959,2341,14,5.4,201740
5,1,410,15,408,188,14,91,0,1126,924,2050,9,5.666666667,201740
5,2,477,9,267,175,6,69,0,1003,1033,2036,10,5.2,201740
5,3,609,6,328,189,18,98,0,1248,1364,2612,9,5.5,201740
5,4,715,22,547,167,8,113,3,1575,1522,3097,9,6,201740
5,5,484,9,374,202,16,51,6,1142,1212,2354,8,6,201740
5,6,388,10,310,110,5,50,3,876,923,1799,11,5.5,201740
5,7,389,11,347,134,8,57,0,946,914,1860,10,3.666666667,201740
6,1,433,19,273,227,4,86,0,1042,923,1965,12,6,201740
6,2,257,13,298,190,48,59,0,865,728,1593,9,5.666666667,201740
7,1,154,7,127,424,10,21,5,748,1490,2238,9,3.75,201740
7,2,271,7,356,247,11,34,0,926,527,1453,9,4,201740
7,3,234,4,405,180,20,45,0,888,1263,2151,7,4.666666667,201740
7,4,94,12,44,281,6,13,34,484,848,1332,11,3,201740
7,5,251,17,148,828,17,42,79,1382,2010,3392,11,5,201740
7,6,250,13,199,367,33,59,1,922,927,1849,8,4.333333333,201740
7,7,109,24,398,706,54,35,0,1326,990,2316,8,4,201740
7,8,229,3,191,445,17,44,0,929,978,1907,12,2.75,201740
7,9,310,24,313,343,17,43,52,1102,1831,2933,9,5.666666667,201740
7,10,168,25,180,472,116,44,6,1011,1242,2253,9,5.5,201740
7,11,123,1,72,121,0,35,0,352,130,482,6,5,201740
7,12,274,8,500,371,9,60,0,1222,2049,3271,9,4.5,201740
7,13,89,69,195,168,0,21,0,542,574,1116,9,2.5,201740
8,1,220,7,219,78,8,48,0,580,830,1410,4,6,201740
8,2,533,41,707,250,31,85,1,1648,1622,3270,17,5.333333333,201740
8,3,406,16,515,144,9,62,0,1152,1498,2650,5,6,201740
8,4,286,12,341,171,13,81,2,906,714,1620,9,6,201740
8,5,379,19,338,205,26,96,0,1063,1111,2174,10,5.25,201740
8,6,747,31,488,382,24,145,5,1822,2277,4099,9,4.5,201740
8,7,284,30,186,175,9,69,0,753,594,1347,8,5.25,201740
8,8,504,25,305,206,8,88,0,1136,1550,2686,7,4,201740
8,9,256,15,158,133,10,57,0,629,847,1476,10,5.2,201740
9,1,60,4,88,67,17,14,0,250,323,573,6,3,201740
9,2,126,43,303,170,5,45,3,695,783,1478,12,2,201740
9,3,58,11,142,87,9,31,5,343,542,885,7,2,201740
9,4,67,3,205,38,4,18,0,335,667,1002,11,2,201740
9,5,53,1,170,59,9,29,0,321,436,757,7,2,201740
9,6,56,13,140,1,1,27,0,238,214,452,7,2,201740
9,7,65,7,174,120,1,26,0,393,413,806,9,2,201740
9,8,10,2,77,23,4,8,0,124,121,245,6,3,201740
9,9,38,0,183,1,0,16,0,238,350,588,5,2,201740
9,10,60,6,128,131,10,29,0,364,434,798,6,2,201740
9,11,95,11,233,147,15,41,0,542,633,1175,7,2,201740
9,12,41,36,163,116,3,29,0,388,526,914,11,2,201740
9,13,39,1,121,73,15,19,1,269,353,622,4,2,201740
9,14,52,3,111,62,43,30,0,301,484,785,5,2,201740
9,15,108,8,353,330,8,68,1,876,1103,1979,10,1.25,201740
9,16,98,16,289,177,8,50,0,638,591,1229,15,2,201740
9,17,85,4,134,150,4,31,0,408,456,864,6,2,201740
9,18,98,4,358,52,5,42,0,559,681,1240,12,2,201740
9,19,47,4,180,30,17,25,0,303,469,772,5,2,201740
9,20,1,0,1,0,0,1,0,3,0,3,5,2,201740
9,21,52,2,66,64,7,14,1,206,348,554,3,2,201740
9,22,96,8,139,113,40,25,10,431,439,870,5,2,201740
9,23,81,7,160,156,14,25,0,443,773,1216,7,3,201740
9,24,83,7,182,94,6,30,2,404,665,1069,13,2.5,201740
10,1,332,26,200,218,30,53,4,863,1039,1902,12,4.833333333,201740
10,2,426,16,275,229,20,71,4,1041,992,2033,9,5.5,201740
10,3,253,31,202,111,27,43,24,691,757,1448,12,5.4,201740
10,4,692,30,422,420,21,96,0,1681,1823,3504,12,4,201740
11,1,205,34,165,208,19,56,3,690,763,1453,6,5.666666667,201740
11,2,251,21,216,227,16,56,7,794,1076,1870,7,6,201740
11,3,242,18,227,218,7,67,0,779,970,1749,4,6,201740
11,4,246,24,219,241,5,43,0,778,663,1441,10,3.8,201740
11,5,347,38,398,320,13,86,0,1202,1272,2474,8,6.5,201740
11,6,178,7,337,84,8,64,3,681,788,1469,8,5.666666667,201740
11,7,281,12,431,123,15,46,0,908,1339,2247,9,5.5,201740
11,8,298,28,267,316,25,40,0,974,1243,2217,9,5.75,201740
11,9,298,51,431,342,11,100,2,1235,1201,2436,10,5.666666667,201740
11,10,249,18,263,239,17,74,14,874,1119,1993,11,5.6,201740
11,11,257,12,433,14,0,53,0,769,1030,1799,4,6,201740
11,12,389,21,459,317,7,60,0,1253,1396,2649,7,6.5,201740
11,13,223,15,315,126,17,67,16,779,791,1570,9,5.5,201740
11,14,215,18,206,170,12,45,0,666,919,1585,8,5.5,201740
11,15,115,34,169,152,4,34,2,510,687,1197,5,6,201740
12,1,115,10,215,81,7,28,1,457,558,1015,10,4.6,201740
12,2,210,19,286,176,7,51,0,749,1125,1874,10,5.25,201740
12,3,218,19,260,357,27,44,1,926,924,1850,11,5.2,201740
12,4,266,17,364,349,23,50,0,1069,1322,2391,9,6,201740
12,5,196,16,179,162,6,32,33,624,982,1606,10,4.75,201740
12,6,137,5,144,195,16,7,0,504,926,1430,10,4.5,201740
12,7,273,13,251,327,5,48,15,932,1026,1958,6,5.5,201740
12,8,213,14,299,228,34,28,0,816,1367,2183,9,5.25,201740
12,9,230,14,306,474,19,32,0,1075,1921,2996,9,5.666666667,201740
13,1,161,30,118,385,84,37,0,815,594,1409,9,5.333333333,201740
13,2,155,19,84,189,38,42,0,527,555,1082,6,5.333333333,201740
13,3,229,23,238,200,84,57,0,831,962,1793,12,5.25,201740
13,4,272,11,261,194,30,72,11,851,612,1463,9,5.666666667,201740
13,5,338,24,267,314,67,87,4,1101,1297,2398,9,5.75,201740
13,6,209,26,394,257,13,24,2,925,961,1886,12,4.25,201740
13,7,283,25,408,279,31,72,0,1098,1086,2184,9,5.75,201740
14,1,142,20,108,103,21,50,7,451,392,843,6,5.5,201740
14,2,336,13,170,111,11,83,0,724,718,1442,6,5.666666667,201740
14,3,446,15,268,65,6,88,0,888,719,1607,11,5.4,201740
14,4,282,6,167,196,12,53,1,717,706,1423,12,3.5,201740
14,5,308,15,424,192,26,51,0,1016,862,1878,11,5.25,201740
14,6,374,9,383,219,16,42,0,1043,584,1627,11,6,201740
14,7,240,6,248,118,0,47,0,659,434,1093,6,6,201740
14,8,703,30,658,416,25,125,1,1958,1709,3667,11,5,201740
14,9,464,15,365,253,36,66,0,1199,1018,2217,8,6,201740
14,10,291,16,405,146,4,64,0,926,895,1821,7,6,201740
14,11,268,9,194,154,25,53,0,703,552,1255,4,6,201740
14,12,322,12,458,129,2,54,0,977,1168,2145,11,5.5,201740
14,13,195,9,273,151,7,47,0,682,374,1056,8,6,201740
14,14,362,9,401,138,9,73,2,994,731,1725,7,7,201740
14,15,263,19,185,174,16,72,1,730,1043,1773,10,5.6,201740
14,16,328,5,462,117,3,74,0,989,582,1571,5,6,201740
14,17,193,23,185,120,24,48,7,600,304,904,9,4.5,201740
14,18,260,30,242,169,20,58,10,789,299,1088,10,5.4,201740
14,19,273,19,309,137,26,56,4,824,664,1488,9,5.25,201740
14,20,145,5,144,24,6,34,0,358,378,736,4,5.5,201740
15,1,164,10,144,50,59,43,0,470,593,1063,7,4.333333333,201740
15,2,172,8,308,132,16,33,6,675,657,1332,6,5,201740
15,3,277,18,323,160,49,66,0,893,950,1843,10,4.666666667,201740
15,4,186,10,205,187,22,69,34,713,1045,1758,4,5,201740
15,5,199,16,222,188,4,43,0,672,681,1353,8,4.666666667,201740
15,6,296,10,320,249,32,59,1,967,465,1432,7,5.5,201740
15,7,230,7,386,127,13,58,0,821,849,1670,10,5,201740
15,8,106,6,115,162,4,27,0,420,531,951,4,5,201740
15,9,258,3,148,167,48,34,8,666,696,1362,9,4.75,201740
15,10,168,16,214,191,32,39,0,660,660,1320,9,4.5,201740
15,11,188,5,326,117,9,42,0,687,1148,1835,8,5,201740
15,12,297,8,517,287,20,48,2,1179,1193,2372,8,5,201740
15,13,50,1,135,18,3,23,0,230,277,507,8,2,201740
15,14,108,7,197,49,8,34,0,403,0,403,4,5,201740
15,15,199,18,394,51,4,46,0,712,1253,1965,6,5,201740
15,16,259,25,412,298,7,85,0,1086,1402,2488,8,5,201740
15,17,57,8,110,79,4,26,0,284,473,757,8,2,201740
15,18,251,12,308,222,18,68,0,879,835,1714,7,4.666666667,201740
15,19,310,60,439,388,3,69,0,1269,1493,2762,14,5,201740
15,20,98,7,124,153,6,35,0,423,357,780,6,5,201740
15,21,71,1,146,1,0,19,0,238,209,447,6,4.5,201740
15,22,303,16,440,279,3,72,1,1114,658,1772,14,5,201740
15,23,113,1,216,15,4,47,0,396,425,821,7,3.333333333,201740
15,24,180,11,272,126,3,46,1,639,441,1080,4,5,201740
15,25,163,12,364,96,2,41,0,678,1110,1788,6,5,201740
15,26,105,9,185,64,10,35,0,408,563,971,8,2.5,201740
15,27,213,8,267,247,4,62,1,802,1110,1912,9,4.666666667,201740
15,28,307,2,487,143,8,70,0,1017,1200,2217,9,4.666666667,201740
15,29,197,8,319,215,1,62,0,802,692,1494,8,5,201740
15,30,157,6,468,74,9,37,0,751,764,1515,12,5,201740
15,31,151,19,245,145,2,39,0,601,634,1235,6,5,201740
15,32,162,9,190,249,14,45,0,669,1038,1707,9,5,201740
15,33,178,10,308,194,8,64,0,762,868,1630,7,5,201740
15,34,227,10,231,236,5,67,0,776,1051,1827,8,5,201740
15,35,215,8,262,88,3,63,0,639,800,1439,9,4.666666667,201740
15,36,267,14,212,173,35,54,0,755,1085,1840,9,4.5,201740
15,37,274,10,343,199,28,59,2,915,1341,2256,7,5,201740
15,38,243,9,228,240,8,67,0,795,1095,1890,6,4.5,201740
15,39,131,16,211,225,9,43,2,637,627,1264,4,5,201740
15,40,355,8,354,232,17,82,5,1053,1481,2534,9,5,201740
15,41,368,16,682,213,4,52,5,1340,2194,3534,11,5,201740
16,1,173,21,212,187,7,50,0,650,800,1450,10,4.333333333,201740
16,2,137,22,116,90,16,34,0,415,395,810,9,5,201740
16,3,194,16,247,224,28,58,0,767,695,1462,10,5,201740
16,4,219,6,227,128,18,82,0,680,737,1417,8,5.25,201740
16,5,272,19,209,172,15,100,5,792,826,1618,10,5,201740
16,6,200,29,169,176,28,54,0,656,823,1479,12,5.25,201740
16,7,189,28,182,107,22,82,0,610,689,1299,9,5.25,201740
16,8,433,26,465,400,15,108,1,1448,1946,3394,12,6,201740
16,9,249,11,237,171,22,70,0,760,1045,1805,10,5.5,201740
16,10,344,17,359,269,9,66,1,1065,1174,2239,8,4.333333333,201740
16,11,258,16,219,130,80,73,1,777,652,1429,12,5.2,201740
16,12,219,8,250,135,13,57,7,689,650,1339,10,5,201740
17,1,162,14,233,235,19,38,0,701,823,1524,12,3.25,201740
17,2,130,7,174,213,7,16,2,549,714,1263,9,4.666666667,201740
17,3,164,8,345,166,7,60,0,750,945,1695,8,4.5,201740
17,4,72,5,148,82,0,23,0,330,323,653,10,2.333333333,201740
17,5,71,5,73,97,13,19,0,278,358,636,5,4.5,201740
18,1,160,20,118,121,15,49,0,483,534,1017,9,5.4,201740
18,2,457,14,362,333,50,73,0,1289,1655,2944,10,5.25,201740
18,3,279,11,279,137,9,49,0,764,881,1645,9,5.75,201740
19,1,294,18,289,265,6,95,3,970,1024,1994,9,5,201740
19,2,424,13,653,226,65,108,0,1489,1332,2821,10,6.5,201740
19,3,461,11,557,251,24,90,1,1395,1324,2719,8,6,201740
19,4,209,14,218,143,30,55,10,679,232,911,5,6,201740
19,5,623,28,454,473,12,108,12,1710,2163,3873,8,6,201740
19,6,160,5,199,135,7,49,4,559,652,1211,5,5,201740
19,7,272,6,540,100,3,36,0,957,485,1442,10,5.5,201740
19,8,75,0,80,26,0,8,0,189,159,348,7,6,201740
19,9,262,13,222,186,16,55,0,754,519,1273,9,5.25,201740
19,10,263,10,207,222,3,65,0,770,777,1547,6,3.5,201740
19,11,819,28,779,515,9,156,1,2307,2188,4495,13,6.333333333,201740
19,12,336,11,532,190,12,52,1,1134,438,1572,9,6.333333333,201740
20,1,199,10,188,200,36,43,0,676,925,1601,7,5.5,201740
20,2,97,12,103,194,24,24,0,454,303,757,6,5.333333333,201740
20,3,98,11,125,152,86,25,0,497,126,623,6,4,201740
20,4,112,15,110,155,32,43,0,467,363,830,6,5,201740
20,5,255,26,267,494,97,55,1,1195,549,1744,11,5.25,201740
20,6,214,26,189,414,224,56,0,1123,850,1973,8,5.25,201740
20,7,0,0,0,0,0,0,0,0,0,0,0,0,201740
20,8,450,27,478,674,16,121,30,1796,2214,4010,15,4.333333333,201740
20,9,232,5,179,182,44,49,2,693,813,1506,8,5.666666667,201740
20,10,164,6,165,176,8,33,0,552,804,1356,9,4.5,201740
21,1,214,8,261,449,10,52,7,1001,980,1981,9,5.4,201740
21,2,174,15,221,110,7,53,0,580,493,1073,9,5.2,201740
21,3,234,10,346,100,27,65,3,785,965,1750,8,5.25,201740
21,4,174,2,316,26,2,53,0,573,417,990,6,5.25,201740
21,5,249,15,332,190,8,80,11,885,592,1477,8,5.666666667,201740
21,6,156,4,266,197,20,53,0,696,806,1502,6,6,201740
21,7,338,15,275,237,28,87,0,980,360,1340,9,5.666666667,201740
21,8,176,3,331,82,3,36,0,631,726,1357,10,5.2,201740
21,9,232,11,399,239,29,69,6,985,544,1529,9,5.5,201740
21,10,145,7,251,198,18,72,0,691,307,998,7,5.5,201740
21,11,16,0,24,19,3,8,0,70,26,96,4,6,201740
21,12,362,10,617,274,19,79,1,1362,1435,2797,15,3.666666667,201740
21,13,124,2,133,100,6,41,0,406,537,943,8,4.333333333,201740
21,14,203,6,345,70,17,76,0,717,435,1152,13,4.833333333,201740
21,15,235,11,338,203,33,67,0,887,1315,2202,7,5.5,201740
22,1,246,49,286,309,24,39,0,953,999,1952,11,5.2,201740
22,2,242,12,438,145,27,53,8,925,1068,1993,7,5.5,201740
22,3,455,80,688,470,29,99,3,1824,1663,3487,10,5.666666667,201740
22,4,312,29,565,305,15,77,0,1303,1503,2806,11,4.75,201740
22,5,189,10,417,77,16,35,1,745,665,1410,10,5.5,201740
23,1,337,6,1164,308,43,46,0,1904,2072,3976,14,5.6,201740
23,2,307,36,342,519,19,60,0,1283,1248,2531,10,4.2,201740
23,3,399,6,1069,224,112,55,0,1865,1739,3604,11,6,201740
23,4,233,8,814,84,15,34,0,1188,546,1734,6,6,201740
24,1,222,32,153,364,27,33,3,834,1031,1865,11,5.2,201740
24,2,186,11,183,154,7,42,0,583,442,1025,6,5.5,201740
24,3,252,32,331,413,86,49,2,1165,970,2135,9,5.25,201740
24,4,191,36,149,226,44,53,60,759,625,1384,5,5.5,201740
24,5,481,40,453,460,3,98,0,1535,1528,3063,9,6.333333333,201740
24,6,571,56,483,481,21,118,0,1730,1729,3459,11,4.333333333,201740
24,7,199,19,261,341,42,31,0,893,1217,2110,9,5.25,201740
25,1,207,1,320,57,0,58,0,643,1042,1685,14,5.75,201740
25,2,382,21,303,272,27,81,0,1086,1516,2602,7,5.5,201740
25,3,249,10,301,252,16,36,2,866,1038,1904,9,5.6,201740
25,4,232,14,181,214,9,57,0,707,754,1461,8,5.333333333,201740
25,5,696,7,514,226,5,118,0,1566,1452,3018,11,5,201740
25,6,332,5,455,77,21,71,0,961,878,1839,9,5.75,201740
25,7,373,5,401,214,4,90,0,1087,1342,2429,7,6,201740
26,1,361,12,295,260,14,81,0,1023,1049,2072,9,5.5,201740
26,2,632,5,432,384,5,98,0,1556,1478,3034,13,5.4,201740
26,3,841,25,492,567,13,186,0,2124,2199,4323,15,4.666666667,201740
26,4,336,10,218,246,17,89,1,917,784,1701,10,5.2,201740
26,5,233,2,122,110,7,45,0,519,437,956,3,5.5,201740
26,6,535,9,303,358,3,92,0,1300,1899,3199,10,5.333333333,201740
26,7,395,21,154,303,13,71,0,957,934,1891,10,5.5,201740
27,1,161,15,138,316,17,30,0,677,532,1209,9,5.5,201740
27,2,262,19,161,477,13,56,0,988,1247,2235,8,5.666666667,201740
27,3,243,14,129,381,7,37,0,811,900,1711,7,5.666666667,201740
27,4,249,11,278,682,13,41,7,1281,1297,2578,8,4.333333333,201740
27,5,158,3,94,276,6,24,0,561,672,1233,6,5.333333333,201740
27,6,269,37,265,509,9,65,0,1154,944,2098,9,5.333333333,201740
28,1,297,15,394,322,4,60,0,1092,1258,2350,13,6,201740
28,2,331,18,613,168,19,95,30,1274,1743,3017,14,6,201740
28,3,189,13,159,163,3,46,0,573,704,1277,7,5.333333333,201740
28,4,410,20,474,338,28,109,19,1398,1485,2883,16,6,201740
28,5,330,20,268,395,29,89,1,1132,924,2056,11,4.4,201740
28,6,247,17,266,394,69,49,9,1051,977,2028,14,5.166666667,201740
28,7,280,16,435,287,24,86,0,1128,1544,2672,8,6,201740
28,8,238,14,213,241,28,71,0,805,879,1684,9,6,201740
28,9,193,4,339,151,13,44,8,752,790,1542,6,5.666666667,201740
29,1,356,32,417,239,35,70,0,1149,1038,2187,10,5.5,201740
29,2,364,26,267,520,39,80,27,1323,1278,2601,15,4.333333333,201740
29,3,175,26,165,251,11,34,0,662,812,1474,7,5.666666667,201740
30,1,151,15,123,147,6,37,11,490,537,1027,7,5.333333333,201740
30,2,174,30,111,87,54,45,294,795,1355,2150,8,5.25,201740
30,3,260,16,318,180,67,69,26,936,999,1935,6,5.666666667,201740
30,4,155,5,213,107,18,44,0,542,999,1541,8,6,201740
30,5,229,13,175,304,7,94,0,822,911,1733,7,5.5,201740
30,6,181,11,173,214,29,54,0,662,705,1367,9,5.333333333,201740
30,7,332,21,340,192,47,124,20,1076,975,2051,12,5.25,201740
30,8,340,16,362,212,27,95,0,1052,1201,2253,11,5.4,201740
30,9,322,11,222,135,38,113,25,866,987,1853,8,5.5,201740
30,10,418,6,382,290,26,92,10,1224,1581,2805,7,6.5,201740
30,11,262,11,343,242,13,79,0,950,1005,1955,6,5.5,201740
30,12,475,30,611,386,13,138,2,1655,1832,3487,11,6.25,201740
30,13,194,8,216,165,24,51,2,660,790,1450,10,5.4,201740
30,14,315,24,319,209,51,114,0,1032,1064,2096,9,5.5,201740
30,15,271,15,220,194,39,97,47,883,826,1709,11,5.666666667,201740
30,16,353,10,347,277,24,110,7,1128,1276,2404,10,5.333333333,201740
30,17,184,10,343,87,3,71,1,699,348,1047,8,5.5,201740
30,18,214,22,165,218,7,102,43,771,838,1609,8,5.25,201740
30,19,255,9,270,203,17,66,10,830,1154,1984,13,5.6,201740
30,20,226,2,446,71,5,82,0,832,1193,2025,11,5.4,201740
31,1,260,22,196,314,22,40,0,854,750,1604,8,5.5,201740
31,2,143,11,126,15,107,50,0,452,346,798,7,5.333333333,201740
31,3,765,39,986,461,24,167,0,2442,2539,4981,17,6.25,201740
31,4,261,8,226,134,35,45,0,709,682,1391,4,7,201740
31,5,185,9,116,128,15,28,1,482,512,994,7,5.333333333,201740
32,1,269,34,237,206,23,82,24,875,1030,1905,12,5.2,201740
32,2,304,35,183,124,60,33,4,743,764,1507,13,5.142857143,201740
32,3,367,38,207,248,14,56,2,932,983,1915,15,4.666666667,201740
32,4,347,58,329,245,24,83,46,1132,1194,2326,13,4.666666667,201740
1,1,369,31,207,254,24,39,6,930,1224,2154,13,5.5,201741
1,2,418,29,458,286,51,78,3,1323,1683,3006,12,5,201741
1,3,411,54,547,297,27,104,0,1440,1424,2864,13,5,201741
2,1,344,8,339,311,7,92,0,1101,1231,2332,11,6,201741
2,2,413,4,290,316,4,105,0,1132,788,1920,9,4.333333333,201741
2,3,533,15,481,315,25,111,0,1480,1643,3123,12,4.6,201741
2,4,244,7,287,136,3,26,0,703,994,1697,6,6,201741
2,5,758,25,806,476,116,124,1,2306,2837,5143,16,6,201741
2,6,410,10,416,249,26,57,1,1169,1004,2173,7,6,201741
2,7,436,7,401,264,28,70,2,1208,1227,2435,12,5.75,201741
2,8,431,10,548,347,11,64,0,1411,1602,3013,8,6,201741
3,1,436,18,274,275,16,84,5,1108,847,1955,15,5,201741
3,2,249,8,430,219,9,29,1,945,812,1757,9,6,201741
4,1,443,21,270,433,29,57,0,1253,1175,2428,15,4.833333333,201741
4,2,364,8,406,482,32,72,4,1368,1086,2454,14,5.4,201741
5,1,517,6,289,202,11,74,0,1099,1373,2472,9,5.333333333,201741
5,2,370,17,264,201,13,46,0,911,814,1725,10,4.8,201741
5,3,494,15,234,245,24,88,0,1100,1341,2441,8,5,201741
5,4,679,29,435,301,8,124,7,1583,1320,2903,11,6,201741
5,5,451,7,266,264,24,54,2,1068,1023,2091,8,6,201741
5,6,254,12,250,183,6,45,3,753,913,1666,11,5.5,201741
5,7,308,8,230,127,26,40,0,739,784,1523,11,4,201741
6,1,311,19,261,213,1,77,2,884,914,1798,14,5.166666667,201741
6,2,280,11,243,171,55,39,0,799,923,1722,9,5.666666667,201741
7,1,264,16,165,584,17,50,2,1098,1113,2211,9,5.25,201741
7,2,362,18,454,936,44,55,6,1875,1034,2909,9,5.25,201741
7,3,268,3,402,159,107,60,0,999,1109,2108,7,5.333333333,201741
7,4,194,24,139,591,20,84,65,1117,1003,2120,11,5.4,201741
7,5,330,17,184,1154,22,53,111,1871,2375,4246,11,5.666666667,201741
7,6,262,14,226,320,17,76,6,921,1041,1962,8,5,201741
7,7,198,12,312,545,21,39,3,1130,1563,2693,8,5.5,201741
7,8,365,17,322,907,28,74,0,1713,1339,3052,12,5.25,201741
7,9,382,26,346,453,20,75,36,1338,1479,2817,9,5.666666667,201741
7,10,190,13,230,835,113,54,0,1435,1203,2638,9,5.5,201741
7,11,111,1,80,150,0,7,0,349,418,767,6,5.333333333,201741
7,12,323,7,505,464,5,44,0,1348,2146,3494,9,5.5,201741
7,13,169,11,362,247,1,48,0,838,1312,2150,9,5.25,201741
8,1,231,5,235,79,15,25,0,590,488,1078,4,6,201741
8,2,504,31,719,272,25,110,0,1661,943,2604,17,5.5,201741
8,3,378,25,437,189,18,76,0,1123,1120,2243,5,6,201741
8,4,266,8,426,63,6,64,0,833,767,1600,9,6,201741
8,5,321,22,235,177,19,76,0,850,1103,1953,10,4.5,201741
8,6,620,34,456,404,23,122,2,1661,1567,3228,9,4.5,201741
8,7,288,22,156,202,9,75,0,752,865,1617,8,4.75,201741
8,8,469,21,278,221,6,74,1,1070,1116,2186,7,4,201741
8,9,255,24,99,129,10,69,0,586,747,1333,10,5,201741
9,1,145,10,218,149,47,50,1,620,1015,1635,6,8,201741
9,2,499,123,809,640,55,133,141,2400,2381,4781,12,6,201741
9,3,286,32,427,480,31,104,10,1370,1666,3036,7,6,201741
9,4,0,0,0,0,0,0,0,0,1427,1427,11,6,201741
9,5,276,10,228,381,30,50,3,978,1398,2376,7,6,201741
9,6,165,13,320,67,25,49,0,639,831,1470,7,6,201741
9,7,248,6,378,323,9,56,0,1020,928,1948,9,6,201741
9,8,70,11,147,193,32,24,1,478,408,886,6,7,201741
9,9,169,11,454,31,135,42,5,847,832,1679,5,6,201741
9,10,211,8,318,413,19,81,1,1051,1028,2079,6,6,201741
9,11,341,13,492,513,35,103,0,1497,1305,2802,7,6,201741
9,12,103,41,222,282,7,32,0,687,790,1477,11,6,201741
9,13,224,16,319,314,52,48,6,979,904,1883,4,6,201741
9,14,199,5,197,257,87,81,0,826,811,1637,5,6,201741
9,15,474,26,752,1068,23,141,0,2484,2411,4895,11,3.5,201741
9,16,478,39,474,771,60,147,3,1972,2045,4017,15,7,201741
9,17,257,13,251,340,7,59,0,927,840,1767,6,6,201741
9,18,354,11,441,509,35,90,0,1440,2081,3521,12,6,201741
9,19,311,45,362,377,114,71,3,1283,1824,3107,5,6,201741
9,20,0,0,1,1,1,0,0,3,0,3,5,6,201741
9,21,165,9,186,76,24,41,152,653,586,1239,3,6,201741
9,22,288,16,280,321,110,68,6,1089,1591,2680,5,6,201741
9,23,293,9,369,552,26,65,2,1316,1486,2802,7,7,201741
9,24,373,19,549,613,61,102,2,1719,1802,3521,13,6.5,201741
10,1,236,15,158,198,19,47,10,683,523,1206,12,5,201741
10,2,341,19,252,268,28,76,3,987,1343,2330,9,5.25,201741
10,3,256,24,177,140,31,43,36,707,794,1501,12,5.4,201741
10,4,629,27,364,443,13,97,0,1573,1540,3113,12,4,201741
11,1,200,30,148,202,17,32,4,633,744,1377,6,5.333333333,201741
11,2,185,30,201,206,29,51,8,710,849,1559,7,6,201741
11,3,308,11,182,205,13,51,0,770,829,1599,4,6,201741
11,4,222,18,141,189,6,34,1,611,733,1344,10,3.8,201741
11,5,403,42,276,396,9,77,0,1203,1359,2562,8,6.5,201741
11,6,213,15,219,124,21,47,4,643,797,1440,8,5.666666667,201741
11,7,259,33,241,310,19,59,0,921,1195,2116,9,5.5,201741
11,8,262,25,247,314,21,56,0,925,1041,1966,9,5.75,201741
11,9,337,49,296,319,8,76,0,1085,1377,2462,10,5.666666667,201741
11,10,205,28,215,215,18,58,17,756,1044,1800,11,5.6,201741
11,11,283,9,437,21,2,45,1,798,871,1669,4,6,201741
11,12,411,21,344,345,8,61,0,1190,1303,2493,7,6.5,201741
11,13,198,25,212,146,34,34,20,669,960,1629,9,5.5,201741
11,14,222,28,218,200,13,62,0,743,754,1497,8,5.5,201741
11,15,130,33,109,145,5,26,0,448,561,1009,5,6,201741
12,1,98,17,161,64,6,22,8,376,438,814,10,4,201741
12,2,195,12,341,186,7,53,1,795,925,1720,10,5,201741
12,3,194,22,236,361,19,67,0,899,942,1841,11,5,201741
12,4,229,20,326,346,23,54,2,1000,1110,2110,9,5,201741
12,5,183,18,172,187,2,39,8,609,1056,1665,10,5,201741
12,6,137,10,119,235,10,21,0,532,672,1204,10,4.25,201741
12,7,176,22,219,274,16,39,13,759,804,1563,6,4.5,201741
12,8,231,17,293,249,22,22,0,834,1111,1945,9,4.25,201741
12,9,194,22,232,362,17,45,1,873,1283,2156,9,4.666666667,201741
13,1,138,18,106,363,89,43,0,757,637,1394,9,5.333333333,201741
13,2,160,20,96,166,57,42,0,541,744,1285,6,4.666666667,201741
13,3,111,15,157,173,73,32,0,561,877,1438,12,5.25,201741
13,4,215,21,191,217,42,53,11,750,1129,1879,9,5.666666667,201741
13,5,292,23,356,332,56,88,3,1150,1197,2347,9,5.75,201741
13,6,359,28,456,306,25,44,1,1219,2170,3389,13,4.75,201741
13,7,317,34,327,408,40,65,0,1191,1238,2429,9,5.5,201741
14,1,178,12,90,121,16,58,12,487,532,1019,6,5.5,201741
14,2,324,8,147,100,10,73,0,662,738,1400,6,5.666666667,201741
14,3,307,8,240,73,1,84,0,713,563,1276,11,5.4,201741
14,4,348,13,190,274,6,55,4,890,1209,2099,12,5.5,201741
14,5,354,19,411,185,48,65,1,1083,1154,2237,11,5.5,201741
14,6,379,14,359,226,11,43,0,1032,1139,2171,11,6,201741
14,7,294,9,218,106,1,47,0,675,643,1318,6,6,201741
14,8,730,26,629,468,20,129,0,2002,2413,4415,11,4.8,201741
14,9,453,24,310,270,20,65,0,1142,1750,2892,8,6,201741
14,10,359,15,395,170,4,64,0,1007,1058,2065,7,6,201741
14,11,203,9,160,149,22,50,0,593,794,1387,4,6,201741
14,12,386,7,418,126,1,74,0,1012,1091,2103,11,5.25,201741
14,13,218,3,273,159,6,46,0,705,846,1551,8,6,201741
14,14,370,19,324,233,10,68,4,1028,1019,2047,7,7,201741
14,15,238,21,175,189,8,69,3,703,875,1578,10,5.6,201741
14,16,408,23,286,198,15,55,0,985,963,1948,5,6,201741
14,17,182,15,166,85,15,46,4,513,455,968,9,4.75,201741
14,18,311,35,258,172,19,56,10,861,495,1356,10,5.4,201741
14,19,263,27,255,171,15,50,6,787,539,1326,9,5.25,201741
14,20,104,10,123,46,7,35,1,326,417,743,10,4.333333333,201741
15,1,227,9,249,84,76,56,0,701,617,1318,7,5.333333333,201741
15,2,218,6,347,146,28,43,0,788,780,1568,6,6,201741
15,3,306,18,305,216,38,98,0,981,1004,1985,10,5.666666667,201741
15,4,315,20,285,224,11,85,103,1043,867,1910,4,6,201741
15,5,249,18,294,197,5,62,3,828,1015,1843,8,5.666666667,201741
15,6,399,11,355,406,70,66,0,1307,1295,2602,7,6.5,201741
15,7,315,5,464,270,31,75,0,1160,1681,2841,10,6,201741
15,8,168,10,135,191,3,48,3,558,407,965,4,6,201741
15,9,249,4,177,172,55,44,4,705,813,1518,9,5.75,201741
15,10,278,15,307,328,35,54,0,1017,982,1999,9,6,201741
15,11,325,16,398,288,23,59,0,1109,956,2065,8,6,201741
15,12,392,13,581,411,26,56,0,1479,1774,3253,8,6,201741
15,13,179,7,362,81,31,50,0,710,829,1539,8,6,201741
15,14,146,14,171,179,17,42,0,569,514,1083,4,6,201741
15,15,281,27,393,173,10,81,0,965,1132,2097,6,6,201741
15,16,448,25,442,577,11,95,0,1598,1518,3116,8,6,201741
15,17,84,5,103,133,3,19,0,347,998,1345,8,5,201741
15,18,314,11,321,355,17,59,0,1077,1251,2328,7,5.666666667,201741
15,19,422,80,416,660,10,98,0,1686,1584,3270,14,6,201741
15,20,211,9,252,265,15,71,1,824,510,1334,6,6,201741
15,21,100,4,130,89,11,45,0,379,378,757,6,5.5,201741
15,22,525,33,495,657,15,128,0,1853,1377,3230,14,6,201741
15,23,267,5,305,227,19,82,0,905,1096,2001,7,5.333333333,201741
15,24,226,23,245,262,11,32,1,800,546,1346,4,6,201741
15,25,264,24,423,283,11,62,0,1067,1565,2632,6,6,201741
15,26,181,8,198,153,35,50,0,625,564,1189,9,3.5,201741
15,27,369,18,286,405,4,87,0,1169,1172,2341,9,5.666666667,201741
15,28,355,6,602,196,16,74,0,1249,1559,2808,9,5.666666667,201741
15,29,315,19,311,482,5,71,0,1203,1762,2965,8,6,201741
15,30,269,19,494,293,38,61,2,1176,1100,2276,12,6,201741
15,31,269,31,243,239,3,44,0,829,1446,2275,6,6,201741
15,32,256,17,262,376,24,65,0,1000,1085,2085,9,6,201741
15,33,319,7,329,415,16,59,0,1145,1249,2394,7,6,201741
15,34,308,15,252,355,3,70,0,1003,965,1968,8,6,201741
15,35,254,17,208,267,2,60,0,808,1027,1835,9,5.666666667,201741
15,36,251,15,189,256,45,60,0,816,1032,1848,9,5.5,201741
15,37,334,13,310,338,57,87,6,1145,1340,2485,7,6,201741
15,38,358,16,298,347,10,74,0,1103,988,2091,6,5.5,201741
15,39,271,19,255,345,21,45,1,957,1265,2222,4,6,201741
15,40,451,16,408,375,57,111,0,1418,1502,2920,9,6,201741
15,41,442,21,749,401,18,61,6,1698,2374,4072,11,6,201741
16,1,187,22,218,158,1,38,0,624,874,1498,10,5.333333333,201741
16,2,117,14,93,98,6,21,0,349,578,927,9,4.5,201741
16,3,187,20,155,242,30,45,0,679,703,1382,10,4.75,201741
16,4,208,13,201,128,12,68,0,630,680,1310,8,5.5,201741
16,5,322,27,231,183,26,85,1,875,740,1615,10,5.666666667,201741
16,6,231,25,181,151,28,51,0,667,687,1354,12,5.5,201741
16,7,187,16,178,120,27,57,0,585,637,1222,9,5,201741
16,8,395,37,435,377,9,93,2,1348,1522,2870,12,6,201741
16,9,294,17,244,189,13,67,0,824,905,1729,10,6,201741
16,10,236,20,287,277,7,53,0,880,866,1746,8,4.333333333,201741
16,11,224,22,214,124,76,62,2,724,736,1460,12,5,201741
16,12,160,19,211,101,15,45,4,555,653,1208,10,5.25,201741
17,1,336,29,301,410,28,74,1,1179,1379,2558,12,3.75,201741
17,2,249,12,272,359,14,38,2,946,902,1848,9,5.666666667,201741
17,3,302,10,289,412,13,49,0,1075,1187,2262,8,5.5,201741
17,4,158,7,221,339,14,37,37,813,1023,1836,10,5.333333333,201741
17,5,111,10,112,174,8,28,0,443,565,1008,5,5.5,201741
18,1,135,23,135,148,32,42,0,515,582,1097,9,5,201741
18,2,522,22,435,336,55,84,0,1454,1213,2667,10,5.25,201741
18,3,221,14,331,191,3,55,0,815,877,1692,9,5.75,201741
19,1,386,20,331,263,11,80,6,1097,1165,2262,9,6,201741
19,2,443,10,496,239,53,94,1,1336,1533,2869,10,6.5,201741
19,3,482,16,483,287,23,70,0,1361,1225,2586,8,6,201741
19,4,266,6,130,127,35,39,18,621,662,1283,5,6,201741
19,5,526,23,388,500,17,86,8,1548,2470,4018,8,6,201741
19,6,253,7,170,157,11,46,7,651,546,1197,5,6,201741
19,7,260,19,517,217,10,50,0,1073,625,1698,10,5.5,201741
19,8,63,3,62,38,1,10,0,177,80,257,7,6,201741
19,9,397,16,261,223,19,74,0,990,690,1680,9,5,201741
19,10,279,10,189,216,5,52,0,751,603,1354,5,3,201741
19,11,793,36,574,608,6,143,5,2165,2356,4521,13,6.333333333,201741
19,12,181,10,312,147,2,46,0,698,501,1199,8,4.333333333,201741
20,1,269,14,180,197,49,58,0,767,1053,1820,7,5.5,201741
20,2,71,5,74,95,27,24,0,296,363,659,6,5.333333333,201741
20,3,98,6,119,123,81,24,0,451,994,1445,6,4,201741
20,4,67,15,69,121,29,41,0,342,695,1037,6,5,201741
20,5,150,16,140,346,22,45,1,720,860,1580,11,5.25,201741
20,6,198,10,161,367,205,37,1,979,1482,2461,8,5.25,201741
20,7,82,5,77,221,5,15,0,405,492,897,6,4.25,201741
20,8,497,16,417,657,25,110,23,1745,3085,4830,13,4.333333333,201741
20,9,192,15,152,190,57,51,1,658,630,1288,8,5.666666667,201741
20,10,210,12,149,288,12,62,0,733,941,1674,9,5.25,201741
21,1,245,20,220,443,19,45,2,994,1054,2048,9,5.4,201741
21,2,281,24,201,166,68,63,2,805,670,1475,9,5.2,201741
21,3,284,11,319,171,55,80,12,932,810,1742,8,5.5,201741
21,4,156,7,171,49,50,57,1,491,818,1309,6,5.25,201741
21,5,243,9,290,123,27,77,19,788,803,1591,8,5.666666667,201741
21,6,461,10,437,397,27,96,4,1432,1657,3089,6,7,201741
21,7,313,19,298,240,61,105,1,1037,1048,2085,9,5.666666667,201741
21,8,218,16,177,157,53,50,5,676,889,1565,10,5.2,201741
21,9,348,16,404,400,63,90,6,1327,1584,2911,9,6,201741
21,10,356,15,350,268,27,58,2,1076,533,1609,7,6,201741
21,11,34,1,46,24,2,6,0,113,61,174,4,6,201741
21,12,738,11,851,630,50,125,4,2409,2721,5130,15,4.333333333,201741
21,13,255,6,231,156,38,66,3,755,1114,1869,8,5.666666667,201741
21,14,252,6,367,144,42,71,0,882,1099,1981,13,5.333333333,201741
21,15,325,6,429,264,58,77,0,1159,1347,2506,7,5.5,201741
22,1,194,39,227,295,33,25,0,813,1090,1903,11,5.2,201741
22,2,295,24,372,217,42,57,4,1011,778,1789,7,5.5,201741
22,3,268,286,626,417,17,87,1,1702,2413,4115,10,5.666666667,201741
22,4,358,23,601,389,15,76,0,1462,1908,3370,13,4,201741
22,5,222,24,335,156,23,50,1,811,944,1755,10,5,201741
23,1,346,8,1017,354,21,41,0,1787,2225,4012,14,5.6,201741
23,2,270,22,445,431,4,58,2,1232,1608,2840,10,4.2,201741
23,3,382,5,856,304,91,47,0,1685,2246,3931,11,6,201741
23,4,191,10,587,126,25,23,0,962,670,1632,6,6,201741
24,1,229,38,148,463,38,39,2,957,1285,2242,11,5.2,201741
24,2,170,9,187,172,20,61,0,619,700,1319,6,5.5,201741
24,3,276,39,197,503,82,37,2,1136,1343,2479,9,5.25,201741
24,4,217,27,200,247,26,81,51,849,757,1606,5,5.5,201741
24,5,425,32,386,384,7,82,0,1316,1530,2846,10,5,201741
24,6,510,46,463,440,21,115,0,1595,2278,3873,11,4.333333333,201741
24,7,169,26,189,357,43,35,0,819,1001,1820,9,5.25,201741
25,1,233,2,353,55,3,52,0,698,745,1443,14,5.75,201741
25,2,409,21,258,286,14,84,0,1072,1039,2111,7,5.5,201741
25,3,243,6,278,218,19,46,1,811,943,1754,9,5.6,201741
25,4,227,16,157,189,18,61,1,669,873,1542,8,5.333333333,201741
25,5,675,6,559,197,9,94,0,1540,1517,3057,11,4.75,201741
25,6,337,13,444,71,18,73,0,956,1118,2074,9,5.75,201741
25,7,415,12,402,260,4,92,0,1185,1039,2224,7,6,201741
26,1,361,15,313,252,13,73,0,1027,1176,2203,9,5.5,201741
26,2,537,9,396,405,5,98,0,1450,1495,2945,13,5.4,201741
26,3,919,20,441,479,9,152,0,2020,2262,4282,15,4.666666667,201741
26,4,396,21,266,263,30,101,1,1078,875,1953,10,5.2,201741
26,5,179,14,107,135,13,44,0,492,509,1001,3,5.5,201741
26,6,586,20,282,304,7,91,0,1290,1653,2943,10,5.333333333,201741
26,7,429,16,186,277,15,62,0,985,882,1867,10,5.5,201741
27,1,230,12,132,347,32,33,0,786,855,1641,9,5.5,201741
27,2,239,25,168,536,19,33,0,1020,1247,2267,8,5.666666667,201741
27,3,201,12,144,406,7,47,0,817,919,1736,7,5.666666667,201741
27,4,363,16,259,728,11,67,3,1447,1816,3263,9,3.25,201741
27,5,139,6,79,215,5,15,0,459,586,1045,6,5.333333333,201741
27,6,348,26,231,486,12,74,0,1177,987,2164,9,5.333333333,201741
28,1,245,14,343,227,5,36,2,872,1159,2031,13,6,201741
28,2,273,18,616,245,17,97,33,1299,1441,2740,14,6,201741
28,3,152,7,171,192,5,45,0,572,406,978,7,5.333333333,201741
28,4,424,23,389,324,31,86,16,1293,1378,2671,16,6,201741
28,5,370,28,230,368,29,77,0,1102,950,2052,11,4.4,201741
28,6,187,32,187,550,152,26,6,1140,934,2074,14,5.166666667,201741
28,7,324,22,387,263,23,68,0,1087,1811,2898,8,6,201741
28,8,243,18,225,246,15,50,0,797,857,1654,9,6,201741
28,9,138,17,285,188,15,31,13,687,896,1583,6,5.666666667,201741
29,1,310,19,398,227,38,68,0,1060,1375,2435,10,5.5,201741
29,2,354,23,240,516,27,75,32,1267,1855,3122,14,4.166666667,201741
29,3,165,25,127,278,13,46,0,654,739,1393,7,5.666666667,201741
30,1,111,8,104,112,23,42,9,409,587,996,7,5.333333333,201741
30,2,183,22,180,72,27,29,219,732,1078,1810,8,5.25,201741
30,3,246,19,266,140,41,81,47,840,1054,1894,6,5.666666667,201741
30,4,165,2,209,130,22,52,0,580,810,1390,8,6,201741
30,5,261,15,213,323,5,99,2,918,952,1870,7,5.5,201741
30,6,208,14,188,174,18,50,0,652,734,1386,9,5.333333333,201741
30,7,302,25,203,261,33,85,22,931,927,1858,12,5.25,201741
30,8,301,19,280,259,37,113,0,1009,1115,2124,11,5.4,201741
30,9,334,7,194,190,54,85,39,903,1030,1933,8,5.5,201741
30,10,358,10,373,337,29,111,7,1225,1318,2543,7,6.5,201741
30,11,348,16,394,320,16,106,0,1200,1456,2656,6,5.5,201741
30,12,460,12,506,540,24,126,0,1668,1540,3208,11,6.25,201741
30,13,255,11,182,296,34,64,3,845,1013,1858,10,5.4,201741
30,14,280,16,231,211,56,111,0,905,1030,1935,9,5.5,201741
30,15,243,18,192,246,22,95,30,846,1425,2271,11,5.666666667,201741
30,16,290,8,259,301,39,99,6,1002,1453,2455,10,5.333333333,201741
30,17,189,19,185,250,24,81,0,748,743,1491,8,5.5,201741
30,18,271,11,125,219,10,86,41,763,909,1672,8,5.25,201741
30,19,252,16,325,290,23,63,16,985,1359,2344,13,5.6,201741
30,20,243,8,339,254,51,68,17,980,1035,2015,11,5.4,201741
31,1,221,21,150,224,15,43,0,674,678,1352,8,5.5,201741
31,2,102,5,137,25,102,24,0,395,351,746,7,5.333333333,201741
31,3,704,29,845,522,55,152,0,2307,3492,5799,17,6.25,201741
31,4,232,4,241,173,43,52,0,745,1050,1795,4,7,201741
31,5,174,7,143,207,18,39,0,588,862,1450,7,5.333333333,201741
32,1,280,37,204,189,23,60,30,823,1084,1907,12,5.2,201741
32,2,332,27,183,160,50,56,3,811,857,1668,13,5.142857143,201741
32,3,396,37,205,189,15,71,5,918,773,1691,15,4.666666667,201741
32,4,328,92,281,245,25,97,69,1137,1449,2586,13,4.666666667,201741
1,1,346,25,244,266,55,50,11,997,1163,2160,13,5.5,201742
1,2,438,40,552,355,76,82,2,1545,1565,3110,11,5,201742
1,3,593,38,536,347,34,91,1,1640,1591,3231,13,5.2,201742
2,1,317,9,390,317,15,91,0,1139,1278,2417,11,6,201742
2,2,340,14,282,300,8,92,0,1036,1526,2562,9,4.333333333,201742
2,3,529,17,522,307,26,119,1,1521,1691,3212,12,4.6,201742
2,4,233,6,318,127,4,35,0,723,1115,1838,6,6,201742
2,5,658,26,869,539,82,166,3,2343,2939,5282,16,6.25,201742
2,6,361,11,431,274,20,51,0,1148,1134,2282,7,6,201742
2,7,449,11,419,298,19,79,3,1278,1459,2737,12,5.75,201742
2,8,392,12,572,370,7,80,0,1433,1997,3430,8,6,201742
3,1,380,12,277,314,22,88,2,1095,1123,2218,15,4.857142857,201742
3,2,256,6,408,197,25,36,0,928,943,1871,9,6,201742
4,1,369,26,305,491,23,63,0,1277,1276,2553,15,4.666666667,201742
4,2,331,19,308,413,39,51,4,1165,1231,2396,14,5.4,201742
5,1,584,19,350,232,26,78,1,1290,1177,2467,9,5.666666667,201742
5,2,310,16,243,245,28,64,1,907,657,1564,10,5,201742
5,3,440,22,231,289,34,87,0,1103,1057,2160,9,5.5,201742
5,4,641,37,481,336,21,119,4,1639,1517,3156,11,4.5,201742
5,5,401,11,324,330,19,67,12,1164,1365,2529,8,6,201742
5,6,243,17,255,166,4,37,7,729,763,1492,5,5,201742
5,7,292,17,152,147,4,36,0,648,1210,1858,9,3.666666667,201742
6,1,366,19,286,220,6,78,1,976,951,1927,14,5.166666667,201742
6,2,245,15,302,137,50,64,2,815,774,1589,9,5.666666667,201742
7,1,178,12,106,273,7,14,1,591,1432,2023,9,5.25,201742
7,2,380,12,168,1316,79,70,11,2036,474,2510,9,5.25,201742
7,3,285,11,291,268,189,57,0,1101,769,1870,7,5.333333333,201742
7,4,189,22,193,467,12,69,72,1024,1365,2389,11,5.4,201742
7,5,308,13,157,975,44,41,155,1693,2385,4078,11,5.666666667,201742
7,6,311,18,335,391,83,83,13,1234,1576,2810,8,5.333333333,201742
7,7,224,19,313,553,46,82,19,1256,985,2241,8,5.5,201742
7,8,400,18,283,826,28,105,0,1660,1861,3521,12,5.25,201742
7,9,329,23,406,486,30,113,2,1389,1515,2904,9,5.666666667,201742
7,10,226,19,256,849,112,61,0,1523,1554,3077,9,5.5,201742
7,11,166,2,84,253,0,13,0,518,335,853,6,5.333333333,201742
7,12,315,11,331,761,8,55,0,1481,1889,3370,9,5.5,201742
7,13,193,9,560,150,6,63,0,981,775,1756,9,5.25,201742
8,1,234,1,224,107,14,18,0,598,566,1164,4,6,201742
8,2,464,36,639,213,27,101,0,1480,2175,3655,17,5.666666667,201742
8,3,349,23,491,194,17,80,0,1154,1177,2331,5,6,201742
8,4,215,19,431,63,14,42,2,786,926,1712,9,6,201742
8,5,281,26,238,221,19,81,0,866,1318,2184,10,5.25,201742
8,6,454,33,419,404,21,127,8,1466,1714,3180,10,4.75,201742
8,7,311,27,208,227,9,72,0,854,901,1755,8,5.25,201742
8,8,362,26,309,267,9,94,0,1067,1149,2216,7,4,201742
8,9,314,22,142,127,18,85,4,712,684,1396,10,4.8,201742
9,1,144,17,212,161,35,45,0,614,753,1367,6,7,201742
9,2,452,137,586,793,65,132,173,2338,1636,3974,12,6,201742
9,3,268,49,382,612,32,110,4,1457,1152,2609,7,6,201742
9,4,26,0,27,56,6,3,0,118,1103,1221,11,6,201742
9,5,209,16,242,326,44,59,1,897,890,1787,7,6,201742
9,6,134,20,218,162,43,46,14,637,639,1276,7,6,201742
9,7,215,7,275,411,13,64,0,985,792,1777,9,6,201742
9,8,60,13,129,156,20,26,4,408,532,940,6,7,201742
9,9,222,20,339,261,176,55,2,1075,537,1612,5,6,201742
9,10,222,11,320,422,12,58,1,1046,816,1862,6,6,201742
9,11,282,8,454,590,37,94,0,1465,1141,2606,7,6,201742
9,12,189,107,352,529,23,87,2,1289,1822,3111,11,6,201742
9,13,227,24,231,399,42,59,11,993,745,1738,4,6,201742
9,14,196,8,189,209,66,73,0,741,602,1343,5,6,201742
9,15,493,60,891,1061,27,177,0,2709,2103,4812,11,3.5,201742
9,16,486,42,476,822,48,130,1,2005,1583,3588,15,7,201742
9,17,242,14,234,325,15,71,0,901,750,1651,6,6,201742
9,18,319,46,324,581,45,105,3,1423,1296,2719,12,6,201742
9,19,292,48,359,418,105,111,3,1336,1087,2423,5,6,201742
9,20,5,3,3,3,0,0,0,14,11,25,5,6,201742
9,21,143,7,168,24,37,34,214,627,462,1089,3,6,201742
9,22,281,21,303,355,103,59,12,1134,975,2109,5,6,201742
9,23,269,20,319,521,26,62,0,1217,1190,2407,7,7,201742
9,24,447,33,489,757,62,127,4,1919,1383,3302,13,6.5,201742
10,1,261,22,155,200,13,53,15,719,798,1517,12,5.166666667,201742
10,2,420,18,252,287,15,98,1,1091,1059,2150,9,5.5,201742
10,3,237,24,129,168,31,43,13,645,740,1385,12,5.4,201742
10,4,747,37,412,388,17,81,1,1683,1650,3333,12,4.2,201742
11,1,223,34,168,209,19,52,3,708,761,1469,6,5.666666667,201742
11,2,223,15,207,214,25,51,5,740,817,1557,7,6,201742
11,3,282,15,201,253,17,54,0,822,818,1640,4,6,201742
11,4,277,40,178,260,10,43,0,808,737,1545,10,3.8,201742
11,5,429,46,303,407,15,96,0,1296,1397,2693,8,6.5,201742
11,6,208,24,201,171,25,45,12,686,768,1454,8,5.666666667,201742
11,7,292,25,251,256,15,50,0,889,1157,2046,9,5.5,201742
11,8,280,34,272,306,35,50,0,977,1045,2022,9,5.75,201742
11,9,327,53,281,310,22,77,2,1072,1267,2339,10,5.666666667,201742
11,10,288,32,292,227,17,55,13,924,1023,1947,11,5.6,201742
11,11,289,22,421,44,7,42,0,825,683,1508,4,6,201742
11,12,346,34,372,355,14,58,0,1179,1450,2629,7,6.5,201742
11,13,281,25,214,192,20,56,23,811,928,1739,9,5.5,201742
11,14,202,15,208,207,16,30,0,678,697,1375,8,5.5,201742
11,15,118,37,134,160,2,30,0,481,605,1086,5,6,201742
12,1,114,18,204,98,76,36,23,569,635,1204,10,5.2,201742
12,2,261,35,229,385,17,55,0,982,940,1922,10,5.5,201742
12,3,268,40,282,387,100,49,9,1135,867,2002,11,5.2,201742
12,4,326,26,413,537,34,51,5,1392,1158,2550,9,6,201742
12,5,194,24,174,256,2,20,28,698,846,1544,10,5.25,201742
12,6,208,13,246,367,13,27,1,875,715,1590,10,5.25,201742
12,7,241,23,324,333,24,55,25,1025,871,1896,6,5.5,201742
12,8,293,24,446,252,36,33,1,1085,1017,2102,9,5.25,201742
12,9,239,12,234,557,16,37,4,1099,1253,2352,9,5.666666667,201742
13,1,147,22,114,310,76,39,0,708,1062,1770,9,5.333333333,201742
13,2,164,16,98,202,63,41,0,584,1052,1636,6,5.333333333,201742
13,3,199,17,170,219,57,71,0,733,893,1626,12,5.25,201742
13,4,201,16,201,254,53,53,20,798,1109,1907,9,5.666666667,201742
13,5,295,20,342,289,57,102,5,1110,1147,2257,9,5.75,201742
13,6,428,56,584,530,46,90,4,1738,2052,3790,13,4.75,201742
13,7,254,39,330,332,36,55,0,1046,1256,2302,9,5.5,201742
14,1,166,18,135,102,14,61,9,505,486,991,6,5.25,201742
14,2,228,9,180,104,6,61,0,588,701,1289,6,5.666666667,201742
14,3,397,9,194,87,12,79,0,778,1027,1805,11,5.4,201742
14,4,369,23,264,293,10,61,3,1023,1004,2027,12,6,201742
14,5,354,17,437,178,28,50,0,1064,1181,2245,11,5,201742
14,6,399,17,365,242,13,57,0,1093,1863,2956,11,6,201742
14,7,246,9,229,121,1,46,0,652,981,1633,6,6,201742
14,8,596,36,702,496,33,138,2,2003,1993,3996,13,3.833333333,201742
14,9,456,21,346,285,30,61,2,1201,1541,2742,8,6,201742
14,10,372,28,400,216,3,77,0,1096,1043,2139,7,6,201742
14,11,223,11,156,161,13,40,0,604,761,1365,4,6,201742
14,12,363,12,496,161,0,72,0,1104,996,2100,11,5.5,201742
14,13,196,9,268,172,7,56,0,708,863,1571,8,6,201742
14,14,363,20,323,255,12,74,8,1055,1017,2072,7,7,201742
14,15,268,40,252,194,27,101,7,889,969,1858,10,5.4,201742
14,16,407,26,283,222,15,61,1,1015,738,1753,5,6,201742
14,17,126,15,152,87,6,37,9,432,402,834,9,5.25,201742
14,18,189,25,194,117,19,45,19,608,677,1285,10,4.8,201742
14,19,273,34,243,180,32,67,6,835,737,1572,9,5,201742
14,20,99,6,147,49,7,25,1,334,476,810,10,5.666666667,201742
15,1,163,4,172,110,66,46,1,562,693,1255,7,5.333333333,201742
15,2,224,10,401,157,25,54,3,874,1189,2063,6,6,201742
15,3,278,17,289,222,63,89,1,959,1272,2231,10,6,201742
15,4,273,23,280,393,23,100,3,1095,997,2092,4,6,201742
15,5,200,23,258,210,11,45,6,753,861,1614,8,5.666666667,201742
15,6,293,11,328,355,62,67,2,1118,1722,2840,7,6.5,201742
15,7,308,23,309,361,32,87,0,1120,1033,2153,10,6,201742
15,8,132,13,176,213,8,36,1,579,499,1078,4,6,201742
15,9,298,11,120,182,66,47,10,734,1117,1851,9,5.75,201742
15,10,213,9,209,250,39,63,0,783,1285,2068,9,6,201742
15,11,241,13,331,348,27,57,0,1017,1060,2077,8,6,201742
15,12,342,18,543,453,36,54,0,1446,1834,3280,8,6,201742
15,13,147,15,228,153,44,63,0,650,631,1281,8,6,201742
15,14,135,14,146,172,34,42,0,543,540,1083,4,6,201742
15,15,226,56,233,302,28,83,0,928,1041,1969,6,6,201742
15,16,289,30,409,588,7,105,0,1428,1528,2956,8,6,201742
15,17,172,14,235,315,8,49,0,793,631,1424,8,6,201742
15,18,300,17,323,401,17,75,0,1133,1720,2853,7,5.666666667,201742
15,19,395,100,432,725,8,116,0,1776,2240,4016,14,6,201742
15,20,166,18,196,280,15,44,1,720,503,1223,6,6,201742
15,21,102,4,134,129,8,36,0,413,619,1032,6,5.5,201742
15,22,464,36,513,678,27,124,1,1843,1550,3393,14,6,201742
15,23,245,20,226,351,32,98,0,972,1217,2189,7,5.333333333,201742
15,24,229,21,270,301,12,57,2,892,980,1872,4,6,201742
15,25,218,34,406,318,3,69,0,1048,1556,2604,6,6,201742
15,26,192,8,202,174,27,47,0,650,509,1159,12,6,201742
15,27,330,16,340,448,2,100,2,1238,1158,2396,9,5.666666667,201742
15,28,298,15,453,279,23,90,0,1158,1412,2570,9,5.666666667,201742
15,29,255,12,228,429,5,70,0,999,1297,2296,8,4,201742
15,30,237,28,373,283,30,45,0,996,1051,2047,12,6,201742
15,31,250,48,193,323,10,56,0,880,1031,1911,6,6,201742
15,32,239,13,246,413,26,58,0,995,1278,2273,9,6,201742
15,33,295,12,359,368,30,78,0,1142,1620,2762,7,6,201742
15,34,266,20,229,343,7,72,0,937,1045,1982,8,6,201742
15,35,267,16,237,331,10,74,0,935,1345,2280,9,5.666666667,201742
15,36,253,20,201,205,70,61,0,810,876,1686,9,5.5,201742
15,37,321,31,322,372,52,81,0,1179,1235,2414,7,6,201742
15,38,281,19,297,343,13,75,0,1028,1077,2105,6,5.5,201742
15,39,207,24,333,315,17,41,1,938,1327,2265,4,6,201742
15,40,398,15,318,357,55,110,0,1253,1546,2799,9,6,201742
15,41,433,42,647,601,41,77,8,1849,2329,4178,11,6,201742
16,1,207,22,262,154,23,64,0,732,818,1550,10,5.333333333,201742
16,2,141,21,116,140,11,45,0,474,468,942,9,5.25,201742
16,3,195,17,144,258,23,48,0,685,671,1356,10,5.25,201742
16,4,228,27,211,137,25,64,1,693,675,1368,8,5.5,201742
16,5,274,23,186,196,20,87,4,790,842,1632,10,5.666666667,201742
16,6,195,23,166,164,24,40,1,613,667,1280,12,5.5,201742
16,7,215,23,172,150,31,74,0,665,740,1405,9,5.5,201742
16,8,402,35,486,424,16,114,0,1477,1625,3102,12,6,201742
16,9,267,22,284,205,8,77,0,863,872,1735,10,6,201742
16,10,286,17,367,364,19,79,0,1132,953,2085,8,4.666666667,201742
16,11,196,22,185,126,82,65,0,676,797,1473,12,5.4,201742
16,12,207,17,184,123,23,44,1,599,633,1232,10,5.25,201742
17,1,364,22,392,483,30,71,4,1366,1246,2612,12,3.75,201742
17,2,277,9,271,385,18,55,5,1020,1073,2093,9,5.666666667,201742
17,3,280,16,308,573,13,70,0,1260,1284,2544,8,5.5,201742
17,4,246,12,293,358,6,56,85,1056,999,2055,10,5.666666667,201742
17,5,107,13,114,217,13,24,0,488,494,982,5,5.5,201742
18,1,210,31,119,184,26,63,0,633,443,1076,9,5.4,201742
18,2,406,18,366,311,40,81,0,1222,1345,2567,10,5.5,201742
18,3,238,6,301,188,4,60,1,798,863,1661,9,5.75,201742
19,1,378,16,292,277,12,76,3,1054,1127,2181,9,6,201742
19,2,511,20,597,250,60,78,1,1517,1639,3156,10,6.5,201742
19,3,450,11,538,291,26,80,0,1396,1356,2752,8,6,201742
19,4,281,9,166,133,34,37,19,679,1083,1762,5,6,201742
19,5,543,26,421,542,18,114,8,1672,1944,3616,8,6,201742
19,6,242,8,183,179,6,55,4,677,663,1340,5,6,201742
19,7,241,11,478,174,4,31,0,939,829,1768,10,5.5,201742
19,8,74,2,105,52,1,10,0,244,79,323,7,6,201742
19,9,251,14,187,183,8,55,0,698,660,1358,9,5.25,201742
19,10,275,10,226,233,2,65,0,811,779,1590,6,3.5,201742
19,11,848,41,574,667,4,139,0,2273,2944,5217,13,6.333333333,201742
19,12,270,6,396,182,8,45,0,907,1069,1976,8,5.333333333,201742
20,1,220,11,182,214,28,52,0,707,854,1561,7,5.5,201742
20,2,85,7,77,93,43,23,0,328,315,643,6,5.333333333,201742
20,3,141,11,142,239,93,44,2,672,1182,1854,6,5.333333333,201742
20,4,74,11,55,142,23,29,0,334,562,896,6,5.333333333,201742
20,5,154,15,171,272,16,39,0,667,947,1614,11,4.5,201742
20,6,186,16,139,299,221,41,2,904,939,1843,8,5.25,201742
20,7,148,12,193,397,9,60,0,819,905,1724,8,5.75,201742
20,8,584,29,493,767,33,142,18,2066,2254,4320,15,4.666666667,201742
20,9,177,19,113,140,93,62,6,610,878,1488,8,5.333333333,201742
20,10,187,12,120,238,10,36,0,603,695,1298,9,5.25,201742
21,1,194,11,191,365,15,33,0,809,912,1721,9,5.4,201742
21,2,257,24,268,182,41,70,3,845,835,1680,9,5.2,201742
21,3,210,8,238,143,55,67,21,742,745,1487,8,5.5,201742
21,4,119,9,153,70,62,35,4,452,718,1170,6,5.25,201742
21,5,254,11,355,171,30,87,22,930,1134,2064,8,5.666666667,201742
21,6,388,20,325,451,37,90,18,1329,1886,3215,6,7,201742
21,7,267,8,270,154,72,82,2,855,1113,1968,9,5.666666667,201742
21,8,157,13,208,184,31,84,2,679,792,1471,10,5.2,201742
21,9,268,18,404,429,39,88,17,1263,1847,3110,9,6,201742
21,10,271,12,342,276,37,80,4,1022,1427,2449,7,6,201742
21,11,52,2,38,41,4,14,1,152,114,266,6,3.5,201742
21,12,614,18,755,628,106,171,6,2298,3311,5609,16,4.666666667,201742
21,13,234,9,249,250,65,64,0,871,880,1751,8,5.666666667,201742
21,14,228,7,320,170,68,90,0,883,1189,2072,13,5.333333333,201742
21,15,214,8,363,247,35,55,0,922,1135,2057,7,5.5,201742
22,1,372,51,301,321,23,30,0,1098,1108,2206,11,5.2,201742
22,2,279,18,339,221,43,37,9,946,1014,1960,7,5.5,201742
22,3,457,55,728,509,22,98,2,1871,1876,3747,10,6,201742
22,4,327,29,598,412,15,67,0,1448,1694,3142,12,3.8,201742
22,5,180,27,385,153,32,40,0,817,873,1690,10,5.5,201742
23,1,277,6,946,281,35,35,0,1580,2054,3634,14,5.6,201742
23,2,235,22,311,424,9,38,1,1040,1623,2663,10,4.2,201742
23,3,307,5,828,355,64,44,0,1603,2431,4034,11,6,201742
23,4,172,6,546,150,33,27,1,935,1022,1957,8,4.333333333,201742
24,1,240,26,178,300,33,26,2,805,777,1582,11,5.2,201742
24,2,177,13,174,155,6,44,0,569,583,1152,6,5.5,201742
24,3,304,34,258,465,107,40,2,1210,1046,2256,9,5.25,201742
24,4,270,33,200,213,40,70,52,878,1054,1932,5,5.5,201742
24,5,415,32,399,370,5,86,0,1307,1523,2830,9,4.75,201742
24,6,485,36,483,496,18,116,0,1634,1909,3543,11,4.333333333,201742
24,7,192,23,214,331,57,35,0,852,1008,1860,9,5.25,201742
25,1,215,8,198,211,12,50,0,694,728,1422,14,5.75,201742
25,2,406,23,298,331,17,81,0,1156,1123,2279,7,5.5,201742
25,3,236,20,279,315,16,40,3,909,984,1893,9,5.6,201742
25,4,225,16,124,262,23,67,9,726,760,1486,8,5.333333333,201742
25,5,448,8,441,256,14,86,0,1253,1493,2746,11,4.75,201742
25,6,383,9,474,93,13,95,0,1067,1139,2206,9,5.75,201742
25,7,330,13,250,352,8,71,0,1024,1215,2239,7,6,201742
26,1,418,15,295,268,7,72,0,1075,1132,2207,9,5.5,201742
26,2,512,17,458,373,2,101,0,1463,2010,3473,13,5.4,201742
26,3,840,26,456,532,21,194,0,2069,2178,4247,15,4.666666667,201742
26,4,356,24,181,244,18,77,0,900,958,1858,10,5.2,201742
26,5,113,8,62,81,4,36,0,304,369,673,3,5.5,201742
26,6,442,15,362,372,10,89,0,1290,1502,2792,10,5.333333333,201742
26,7,364,24,173,314,14,55,0,944,957,1901,10,5.5,201742
27,1,200,19,139,342,27,35,0,762,909,1671,9,5.5,201742
27,2,226,20,177,460,9,35,0,927,1084,2011,8,5.666666667,201742
27,3,215,9,142,428,8,45,0,847,915,1762,7,5.666666667,201742
27,4,371,19,307,701,11,54,0,1463,1544,3007,10,3.5,201742
27,5,201,2,118,292,11,25,1,650,428,1078,6,5.333333333,201742
27,6,280,17,242,497,4,53,0,1093,1204,2297,9,5.333333333,201742
28,1,340,17,418,315,24,52,0,1166,1272,2438,13,6,201742
28,2,323,24,590,293,22,91,43,1386,1364,2750,14,6,201742
28,3,134,14,131,165,6,38,0,488,511,999,7,5.333333333,201742
28,4,362,23,409,349,32,74,24,1273,1437,2710,16,6,201742
28,5,368,23,224,378,27,75,4,1099,1099,2198,13,3.833333333,201742
28,6,242,31,209,343,88,48,15,976,916,1892,14,5.166666667,201742
28,7,283,13,374,310,37,77,0,1094,1399,2493,8,6,201742
28,8,243,16,209,224,25,53,0,770,983,1753,9,6,201742
28,9,180,15,322,168,23,31,23,762,860,1622,6,5.666666667,201742
29,1,279,35,344,212,46,48,0,964,1438,2402,10,5.5,201742
29,2,358,27,264,499,24,101,31,1304,1970,3274,15,4.333333333,201742
29,3,164,29,132,250,11,40,0,626,820,1446,7,5.666666667,201742
30,1,159,11,98,190,19,51,8,536,598,1134,7,5.333333333,201742
30,2,195,20,137,81,57,36,281,807,1025,1832,8,5.25,201742
30,3,184,21,214,152,71,77,38,757,1101,1858,6,5.666666667,201742
30,4,171,7,230,150,20,45,0,623,679,1302,8,6,201742
30,5,266,20,226,312,5,98,0,927,1169,2096,7,5.5,201742
30,6,229,10,204,234,20,71,0,768,965,1733,9,5.333333333,201742
30,7,449,25,270,306,58,90,35,1233,1156,2389,12,5.25,201742
30,8,282,16,271,269,24,79,0,941,1313,2254,11,5.4,201742
30,9,340,10,198,157,30,84,29,848,921,1769,8,5.5,201742
30,10,315,22,364,269,27,98,15,1110,1234,2344,7,6.5,201742
30,11,290,13,350,264,20,84,0,1021,1277,2298,6,5.5,201742
30,12,465,30,508,581,26,123,0,1733,1774,3507,11,6.25,201742
30,13,248,8,168,302,42,69,7,844,899,1743,10,5.4,201742
30,14,251,31,290,278,78,102,0,1030,1148,2178,9,5.5,201742
30,15,260,11,178,254,40,95,34,872,1104,1976,11,5.666666667,201742
30,16,284,11,283,316,46,83,14,1037,1330,2367,10,5.333333333,201742
30,17,208,21,154,218,11,78,8,698,573,1271,8,5.5,201742
30,18,181,14,157,205,13,58,60,688,791,1479,8,5.25,201742
30,19,217,8,232,227,22,74,20,800,912,1712,13,5.6,201742
30,20,215,11,361,217,52,56,0,912,965,1877,11,5.4,201742
31,1,187,10,140,230,13,38,0,618,595,1213,8,5.5,201742
31,2,159,7,218,23,119,67,0,593,271,864,7,5.333333333,201742
31,3,617,57,875,537,81,163,0,2330,2624,4954,17,6.25,201742
31,4,449,12,304,209,29,50,0,1053,930,1983,6,4.5,201742
31,5,224,13,111,143,15,40,0,546,619,1165,7,5.333333333,201742
32,1,310,31,172,189,37,65,19,823,927,1750,12,5.2,201742
32,2,341,42,245,180,54,54,3,919,690,1609,13,4.714285714,201742
32,3,466,40,218,199,8,51,2,984,840,1824,15,4.666666667,201742
32,4,315,56,249,282,16,77,55,1050,1078,2128,12,4.5,201742
1,1,373,40,271,290,52,42,7,1075,929,2004,13,5.5,201743
1,2,391,50,502,324,69,77,2,1415,1762,3177,12,5.2,201743
1,3,353,43,560,345,43,91,1,1436,1539,2975,13,5.2,201743
2,1,287,6,347,302,11,66,0,1019,1176,2195,11,6,201743
2,2,406,14,303,339,4,115,0,1181,1600,2781,9,4.333333333,201743
2,3,484,23,415,313,13,98,0,1346,1558,2904,12,4.6,201743
2,4,226,10,319,166,7,33,0,761,838,1599,6,6,201743
2,5,633,32,833,524,68,155,5,2250,2692,4942,16,6.25,201743
2,6,285,18,408,257,14,67,0,1049,1248,2297,7,6,201743
2,7,483,17,494,284,31,68,0,1377,1580,2957,12,5.75,201743
2,8,391,9,561,382,11,85,1,1440,1525,2965,8,6,201743
3,1,317,17,295,319,13,81,3,1045,1307,2352,15,4.857142857,201743
3,2,217,5,436,212,8,42,0,920,1023,1943,9,6,201743
4,1,302,31,309,500,63,61,0,1266,1168,2434,15,4.666666667,201743
4,2,263,23,324,383,43,46,2,1084,1276,2360,14,5.2,201743
5,1,459,20,324,217,28,75,0,1123,1224,2347,9,5.666666667,201743
5,2,393,19,279,243,14,76,3,1027,1394,2421,10,5.2,201743
5,3,409,20,255,312,26,105,5,1132,1213,2345,9,5.5,201743
5,4,513,32,467,349,13,121,4,1499,1675,3174,11,4.75,201743
5,5,357,15,295,358,25,53,6,1109,1258,2367,8,6,201743
5,6,223,20,180,227,2,51,3,706,1286,1992,6,5.5,201743
5,7,276,16,192,211,13,40,0,748,694,1442,9,4,201743
6,1,322,20,278,213,7,76,0,916,915,1831,15,4.428571429,201743
6,2,240,15,254,166,40,73,1,789,980,1769,9,5.666666667,201743
7,1,136,10,98,379,4,18,1,646,1074,1720,9,4.75,201743
7,2,273,10,169,1229,157,34,1,1873,1387,3260,9,5.25,201743
7,3,337,5,278,310,50,50,0,1030,1356,2386,7,5.333333333,201743
7,4,274,16,218,531,27,135,78,1279,1229,2508,11,5.4,201743
7,5,318,15,175,1018,39,41,118,1724,1992,3716,11,6,201743
7,6,262,20,323,518,31,90,5,1249,1669,2918,8,5.666666667,201743
7,7,280,21,308,875,43,89,46,1662,1067,2729,8,5.5,201743
7,8,297,13,217,738,24,58,0,1347,2149,3496,12,5.25,201743
7,9,346,32,436,656,43,97,9,1619,1560,3179,9,5.666666667,201743
7,10,272,13,394,928,148,75,0,1830,1182,3012,9,5.5,201743
7,11,101,3,46,140,0,12,0,302,517,819,6,5.333333333,201743
7,12,401,19,377,1095,12,64,0,1968,1700,3668,9,5.5,201743
7,13,115,12,425,179,112,26,1,870,1241,2111,9,5.25,201743
8,1,227,13,270,93,18,30,0,651,647,1298,4,6,201743
8,2,443,23,640,280,35,102,3,1526,1934,3460,17,5.5,201743
8,3,363,31,466,223,18,70,0,1171,1112,2283,5,6,201743
8,4,214,7,341,67,12,63,1,705,977,1682,9,6,201743
8,5,342,25,258,240,26,98,0,989,878,1867,10,5.25,201743
8,6,427,35,408,413,18,136,1,1438,1589,3027,10,4.75,201743
8,7,241,23,195,178,9,41,0,687,838,1525,8,5.25,201743
8,8,373,22,336,307,8,90,0,1136,1035,2171,7,4,201743
8,9,326,17,219,160,21,110,17,870,734,1604,10,5.2,201743
9,1,134,12,207,183,30,62,0,628,718,1346,6,7,201743
9,2,523,88,679,921,60,149,155,2575,2209,4784,12,6,201743
9,3,285,42,340,619,31,110,7,1434,1766,3200,7,6,201743
9,4,183,12,314,710,40,66,8,1333,346,1679,11,6,201743
9,5,229,13,267,306,64,73,33,985,1005,1990,7,6,201743
9,6,116,16,211,183,55,40,19,640,665,1305,7,6,201743
9,7,166,16,278,447,12,62,0,981,999,1980,9,6,201743
9,8,62,25,162,209,38,39,6,541,652,1193,6,7,201743
9,9,168,14,255,411,42,43,2,935,878,1813,5,6,201743
9,10,222,12,339,373,20,85,64,1115,1043,2158,6,6,201743
9,11,279,11,399,668,47,92,2,1498,1407,2905,7,6,201743
9,12,196,117,349,696,21,73,4,1456,2065,3521,11,6,201743
9,13,196,12,270,425,52,77,13,1045,999,2044,4,6,201743
9,14,181,8,213,241,89,66,0,798,824,1622,5,6,201743
9,15,395,36,839,1302,29,182,11,2794,2521,5315,11,3.5,201743
9,16,417,38,467,895,37,147,0,2001,2474,4475,15,7,201743
9,17,227,8,252,380,14,80,0,961,837,1798,6,6,201743
9,18,270,29,380,668,30,97,4,1478,1511,2989,12,6,201743
9,19,281,55,323,458,79,87,8,1291,1346,2637,5,6,201743
9,20,7,3,2,9,0,0,0,21,1,22,5,6,201743
9,21,137,12,171,34,34,36,228,652,625,1277,3,6,201743
9,22,276,8,316,394,90,76,22,1182,1205,2387,5,6,201743
9,23,220,11,361,571,40,73,1,1277,1368,2645,7,7,201743
9,24,365,44,532,820,95,120,69,2045,1905,3950,13,6.5,201743
10,1,258,18,156,215,13,67,10,737,980,1717,12,4.833333333,201743
10,2,368,22,255,272,21,85,3,1026,1172,2198,9,5.25,201743
10,3,229,23,150,173,31,44,21,671,754,1425,12,5.4,201743
10,4,648,27,393,439,15,94,0,1616,1606,3222,12,4.2,201743
11,1,199,31,166,237,20,29,2,684,896,1580,6,5.666666667,201743
11,2,265,26,208,238,34,49,11,831,799,1630,7,6,201743
11,3,276,22,204,225,11,62,0,800,821,1621,4,6,201743
11,4,299,25,199,261,7,35,0,826,844,1670,10,3.8,201743
11,5,379,47,301,394,12,105,0,1238,1299,2537,8,6.5,201743
11,6,235,26,234,194,32,48,15,784,907,1691,8,5.666666667,201743
11,7,270,26,296,316,14,59,0,981,874,1855,9,5,201743
11,8,276,21,272,350,41,57,0,1017,974,1991,9,5.75,201743
11,9,329,58,304,368,19,83,2,1163,1295,2458,10,5.666666667,201743
11,10,283,34,312,280,18,68,15,1010,857,1867,11,5.6,201743
11,11,268,32,247,253,20,43,0,863,810,1673,4,6,201743
11,12,335,19,448,303,16,49,0,1170,1269,2439,7,6.5,201743
11,13,220,29,213,199,26,59,14,760,869,1629,9,5.5,201743
11,14,200,32,186,224,29,55,0,726,779,1505,8,5.5,201743
11,15,152,25,174,178,1,46,0,576,509,1085,6,6,201743
12,1,148,18,263,90,14,39,28,600,420,1020,10,4.4,201743
12,2,253,50,260,464,35,62,0,1124,848,1972,10,5.25,201743
12,3,277,44,351,554,42,64,2,1334,789,2123,11,4.8,201743
12,4,258,33,379,530,39,63,27,1329,1165,2494,9,6,201743
12,5,261,26,219,262,3,40,9,820,728,1548,10,5.25,201743
12,6,219,18,291,480,29,34,1,1072,758,1830,10,5,201743
12,7,275,22,273,421,11,42,64,1108,801,1909,6,5,201743
12,8,247,25,326,322,38,40,0,998,671,1669,9,4.5,201743
12,9,248,18,255,590,23,32,2,1168,1092,2260,9,5.666666667,201743
13,1,150,29,85,446,98,43,0,851,947,1798,9,5.333333333,201743
13,2,144,21,83,174,46,36,0,504,612,1116,6,5.333333333,201743
13,3,145,21,198,218,64,56,0,702,887,1589,12,5.25,201743
13,4,241,28,255,238,88,74,35,959,815,1774,9,5.666666667,201743
13,5,270,20,330,266,65,84,1,1036,1078,2114,9,5.75,201743
13,6,381,48,581,549,31,79,3,1672,1899,3571,13,5,201743
13,7,233,19,338,315,23,62,0,990,1264,2254,9,5.5,201743
14,1,190,33,127,97,19,72,13,551,617,1168,6,5.5,201743
14,2,241,11,175,90,15,77,1,610,680,1290,6,5.666666667,201743
14,3,328,20,207,110,12,92,0,769,859,1628,11,5.4,201743
14,4,285,16,208,300,16,46,3,874,956,1830,12,6,201743
14,5,315,21,429,195,51,61,0,1072,1059,2131,11,5.5,201743
14,6,333,13,316,218,11,49,0,940,556,1496,11,6,201743
14,7,253,12,237,76,0,32,0,610,745,1355,6,6,201743
14,8,600,25,641,487,20,117,0,1890,1914,3804,12,4,201743
14,9,350,26,327,314,16,65,0,1098,1323,2421,8,6,201743
14,10,335,17,357,208,4,62,0,983,1310,2293,7,6,201743
14,11,162,3,164,132,10,38,0,509,661,1170,4,6,201743
14,12,409,12,524,133,2,74,0,1154,979,2133,11,5.5,201743
14,13,184,13,247,172,8,50,0,674,1125,1799,8,6,201743
14,14,332,21,268,251,6,76,3,957,1028,1985,7,7,201743
14,15,285,30,212,217,21,73,7,845,847,1692,10,5.6,201743
14,16,338,17,332,206,9,75,0,977,892,1869,5,6,201743
14,17,142,23,163,98,8,53,19,506,512,1018,9,4.5,201743
14,18,238,25,168,135,25,61,16,668,752,1420,10,4.8,201743
14,19,234,22,229,162,17,45,15,724,784,1508,9,4.75,201743
14,20,131,5,163,67,3,29,1,399,375,774,10,5.666666667,201743
15,1,163,8,208,78,89,73,0,619,662,1281,7,5,201743
15,2,216,6,301,259,32,68,6,888,1035,1923,6,6,201743
15,3,285,17,321,232,69,103,0,1027,1142,2169,10,5.666666667,201743
15,4,322,19,293,399,30,112,9,1184,1133,2317,4,6,201743
15,5,208,26,259,242,11,49,0,795,758,1553,8,5.666666667,201743
15,6,313,23,335,359,70,74,0,1174,1653,2827,7,6.5,201743
15,7,292,17,294,370,44,74,0,1091,1611,2702,10,6,201743
15,8,130,14,162,228,9,45,3,591,606,1197,4,6,201743
15,9,272,12,124,169,77,33,5,692,945,1637,9,5.75,201743
15,10,233,13,262,276,45,86,0,915,1124,2039,9,6,201743
15,11,309,12,353,386,34,60,0,1154,1122,2276,8,6,201743
15,12,314,13,608,408,33,63,0,1439,1614,3053,8,6,201743
15,13,161,14,230,202,75,59,0,741,741,1482,8,6,201743
15,14,129,6,151,187,25,52,0,550,561,1111,4,6,201743
15,15,316,47,286,392,18,79,0,1138,1014,2152,6,6,201743
15,16,300,33,406,574,7,93,0,1413,1645,3058,8,6,201743
15,17,215,29,242,405,18,73,0,982,575,1557,8,6,201743
15,18,300,24,312,377,25,97,0,1135,1296,2431,7,5.666666667,201743
15,19,400,112,469,760,12,119,0,1872,2016,3888,14,6,201743
15,20,146,11,203,288,18,60,0,726,510,1236,6,6,201743
15,21,140,10,87,112,13,54,0,416,413,829,6,5.5,201743
15,22,403,46,494,699,22,124,0,1788,1707,3495,14,6,201743
15,23,251,13,252,317,29,92,0,954,877,1831,7,5.333333333,201743
15,24,186,18,278,294,13,50,4,843,1257,2100,4,6,201743
15,25,256,27,373,373,4,59,0,1092,1252,2344,6,6,201743
15,26,205,8,241,183,32,44,1,714,566,1280,10,2.333333333,201743
15,27,321,15,340,480,5,83,1,1245,1229,2474,9,5.666666667,201743
15,28,312,13,564,281,34,104,0,1308,1406,2714,9,5.666666667,201743
15,29,357,26,332,547,4,106,0,1372,1954,3326,8,6,201743
15,30,235,16,337,281,47,56,1,973,1077,2050,12,6,201743
15,31,246,40,255,351,11,61,0,964,1018,1982,6,6,201743
15,32,218,13,315,411,30,68,0,1055,1189,2244,9,6,201743
15,33,275,15,352,417,23,64,0,1146,1405,2551,7,6,201743
15,34,265,11,228,377,4,66,0,951,1000,1951,8,6,201743
15,35,315,21,275,327,11,99,0,1048,1135,2183,9,5.666666667,201743
15,36,280,30,219,243,38,61,0,871,905,1776,9,5.25,201743
15,37,347,38,358,414,52,93,1,1303,1233,2536,7,6,201743
15,38,258,25,303,353,11,84,0,1034,1178,2212,6,5.5,201743
15,39,218,22,317,354,13,48,1,973,1099,2072,4,6,201743
15,40,385,21,320,377,75,122,0,1300,1440,2740,9,6,201743
15,41,409,32,593,639,43,83,16,1815,2016,3831,11,6,201743
16,1,221,18,235,189,9,51,0,723,660,1383,10,5.333333333,201743
16,2,145,20,146,137,15,37,0,500,423,923,9,5.25,201743
16,3,191,24,180,220,33,54,0,702,790,1492,10,5.25,201743
16,4,242,18,196,138,13,79,0,686,710,1396,8,5.5,201743
16,5,290,32,219,217,26,71,6,861,852,1713,10,5.666666667,201743
16,6,240,18,197,205,28,58,6,752,718,1470,12,5.5,201743
16,7,223,24,182,161,21,56,0,667,788,1455,9,5.5,201743
16,8,445,29,538,445,16,94,5,1572,1482,3054,12,6,201743
16,9,293,21,294,215,9,61,0,893,874,1767,10,6,201743
16,10,233,23,314,259,10,70,0,909,918,1827,8,4.333333333,201743
16,11,207,17,203,133,64,85,2,711,879,1590,12,5.4,201743
16,12,189,17,221,122,21,59,1,630,585,1215,10,5.25,201743
17,1,399,18,435,545,17,77,4,1495,1315,2810,11,3.5,201743
17,2,267,7,261,499,22,48,14,1118,889,2007,9,5.666666667,201743
17,3,265,21,347,595,13,79,1,1321,1417,2738,8,5.5,201743
17,4,218,15,333,415,13,69,84,1147,1148,2295,10,5.666666667,201743
17,5,140,24,139,259,15,43,2,622,431,1053,5,5.5,201743
18,1,184,14,154,187,26,52,0,617,461,1078,9,5.4,201743
18,2,410,28,362,316,40,64,0,1220,1325,2545,10,5.5,201743
18,3,249,22,335,206,8,59,0,879,924,1803,9,5.75,201743
19,1,357,19,333,285,10,79,3,1086,1098,2184,9,6,201743
19,2,452,19,606,251,66,98,0,1492,1147,2639,10,6.5,201743
19,3,417,11,508,348,16,100,0,1400,1360,2760,8,6,201743
19,4,216,9,185,139,27,42,33,651,980,1631,5,6,201743
19,5,443,30,422,492,24,92,9,1512,1631,3143,8,6,201743
19,6,220,11,191,207,8,56,8,701,665,1366,5,6,201743
19,7,233,11,470,144,8,42,0,908,572,1480,10,4.75,201743
19,8,86,6,83,60,1,13,0,249,228,477,7,6,201743
19,9,189,23,189,187,21,49,0,658,516,1174,9,5.25,201743
19,10,377,13,276,280,10,68,2,1026,781,1807,7,2.666666667,201743
19,11,705,43,603,704,15,161,4,2235,2394,4629,13,6.333333333,201743
19,12,250,8,502,197,7,47,0,1011,933,1944,8,6,201743
20,1,206,12,164,194,31,51,0,658,747,1405,7,5.5,201743
20,2,82,5,123,125,26,18,0,379,501,880,6,5.333333333,201743
20,3,124,8,143,185,74,37,3,574,924,1498,6,5.333333333,201743
20,4,103,13,90,220,25,61,0,512,512,1024,6,5.333333333,201743
20,5,173,33,216,590,104,55,6,1177,1077,2254,11,5.25,201743
20,6,203,7,258,349,398,43,1,1259,1267,2526,8,5.25,201743
20,7,183,14,227,372,14,71,0,881,625,1506,8,3.75,201743
20,8,508,38,492,768,35,169,42,2052,2190,4242,15,4.666666667,201743
20,9,177,6,109,172,50,43,3,560,960,1520,8,5.333333333,201743
20,10,314,11,265,336,23,60,0,1009,593,1602,9,5.25,201743
21,1,224,4,215,454,10,51,0,958,588,1546,9,5.2,201743
21,2,196,16,185,160,60,37,3,657,621,1278,9,5.2,201743
21,3,285,13,348,182,87,90,10,1015,800,1815,8,5.5,201743
21,4,158,3,262,110,147,61,15,756,604,1360,6,5.25,201743
21,5,251,15,375,190,33,91,49,1004,1079,2083,8,5.666666667,201743
21,6,337,18,365,568,35,83,41,1447,1508,2955,6,7,201743
21,7,238,9,327,117,116,88,2,897,1262,2159,9,5.666666667,201743
21,8,320,19,342,326,63,123,2,1195,573,1768,10,5.2,201743
21,9,281,20,419,442,51,98,33,1344,1689,3033,9,6,201743
21,10,301,19,340,333,37,76,6,1112,1610,2722,7,6,201743
21,11,50,2,61,58,12,12,0,195,100,295,6,3.5,201743
21,12,558,23,735,750,114,158,6,2344,3262,5606,16,4.666666667,201743
21,13,358,13,324,359,75,115,4,1248,969,2217,8,5.666666667,201743
21,14,216,14,358,169,64,84,0,905,905,1810,13,5.166666667,201743
21,15,322,15,392,237,64,72,5,1107,1158,2265,7,5.5,201743
22,1,277,62,253,304,40,39,0,975,576,1551,11,5.2,201743
22,2,253,28,355,231,27,49,18,961,998,1959,7,5.5,201743
22,3,530,33,674,569,22,89,2,1919,2002,3921,10,6,201743
22,4,411,32,575,393,15,76,0,1502,1721,3223,13,4,201743
22,5,239,32,389,151,33,51,1,896,807,1703,10,5.5,201743
23,1,322,7,977,357,59,42,0,1764,1892,3656,14,4.8,201743
23,2,320,47,359,511,22,49,0,1308,1083,2391,10,4.2,201743
23,3,389,14,942,419,48,59,0,1871,2262,4133,11,6,201743
23,4,284,5,713,290,51,58,2,1403,1425,2828,8,4.666666667,201743
24,1,229,61,199,516,58,28,5,1096,944,2040,11,5.2,201743
24,2,176,18,184,186,20,49,0,633,614,1247,6,5.5,201743
24,3,218,56,241,620,145,46,1,1327,1263,2590,9,5.25,201743
24,4,175,30,195,175,38,68,72,753,1004,1757,5,5.5,201743
24,5,369,18,356,447,6,81,0,1277,1384,2661,9,4.75,201743
24,6,450,35,452,472,16,109,0,1534,1615,3149,11,4.333333333,201743
24,7,228,30,254,558,62,34,0,1166,1117,2283,9,5.25,201743
25,1,214,12,192,246,15,72,0,751,835,1586,14,5.75,201743
25,2,437,27,308,335,15,110,0,1232,1192,2424,7,5.5,201743
25,3,259,13,248,298,24,64,3,909,922,1831,9,5.4,201743
25,4,308,18,140,265,16,52,16,815,684,1499,8,5.333333333,201743
25,5,461,18,300,477,22,92,0,1370,1371,2741,11,4.75,201743
25,6,318,7,548,66,13,89,0,1041,1045,2086,9,5.75,201743
25,7,380,9,270,355,10,85,0,1109,1166,2275,7,6,201743
26,1,360,9,291,275,6,81,0,1022,1121,2143,9,5.5,201743
26,2,428,9,371,351,2,73,0,1234,1385,2619,13,5.4,201743
26,3,605,36,475,589,18,193,1,1917,2089,4006,15,4.666666667,201743
26,4,338,19,191,254,18,96,0,916,883,1799,10,5.2,201743
26,5,205,11,121,128,12,41,0,518,498,1016,3,5.5,201743
26,6,362,7,302,373,6,115,0,1165,1361,2526,10,5.333333333,201743
26,7,278,22,146,305,21,54,0,826,916,1742,10,5.5,201743
27,1,194,14,146,319,11,22,0,706,658,1364,9,5,201743
27,2,240,22,219,636,22,43,0,1182,965,2147,8,5.666666667,201743
27,3,198,6,140,379,11,39,0,773,910,1683,7,5.666666667,201743
27,4,331,17,274,635,9,53,1,1320,1383,2703,10,3.5,201743
27,5,171,7,124,384,12,26,0,724,452,1176,6,5.333333333,201743
27,6,244,24,246,492,8,48,0,1062,1289,2351,9,5.333333333,201743
28,1,350,15,428,345,14,56,1,1209,1124,2333,13,6,201743
28,2,328,27,544,294,19,73,45,1330,1480,2810,14,6,201743
28,3,175,17,193,209,6,52,0,652,691,1343,7,5.333333333,201743
28,4,349,20,364,328,26,90,22,1199,1408,2607,16,6,201743
28,5,400,35,247,444,22,60,2,1210,1232,2442,13,3.833333333,201743
28,6,291,32,205,431,81,40,14,1094,1153,2247,14,5.166666667,201743
28,7,323,20,417,347,30,74,0,1211,1182,2393,8,6,201743
28,8,238,16,275,248,35,61,0,873,778,1651,9,6,201743
28,9,127,14,248,153,16,24,14,596,856,1452,6,5.666666667,201743
29,1,294,35,348,253,29,48,0,1007,1263,2270,10,5.5,201743
29,2,357,33,270,576,31,90,30,1387,1540,2927,12,4,201743
29,3,155,30,165,284,16,48,0,698,720,1418,7,5.333333333,201743
30,1,147,10,111,134,8,30,6,446,404,850,7,5.333333333,201743
30,2,128,14,154,90,35,41,186,648,814,1462,8,5.25,201743
30,3,195,13,230,162,45,58,52,755,975,1730,6,5.666666667,201743
30,4,144,11,221,154,34,54,0,618,677,1295,8,6,201743
30,5,254,12,214,295,6,76,1,858,790,1648,7,5.5,201743
30,6,208,5,190,177,20,52,0,652,585,1237,9,5.333333333,201743
30,7,210,23,247,255,36,83,10,864,917,1781,12,5.25,201743
30,8,282,20,297,305,44,84,0,1032,943,1975,11,5.4,201743
30,9,276,12,181,169,33,78,32,781,872,1653,8,5.5,201743
30,10,342,25,367,296,21,85,19,1155,1153,2308,9,4.666666667,201743
30,11,285,23,374,275,12,82,0,1051,1012,2063,6,5.5,201743
30,12,415,18,588,583,38,136,0,1778,1699,3477,11,6.25,201743
30,13,210,13,151,278,36,62,8,758,839,1597,10,5.4,201743
30,14,265,21,276,205,71,98,0,936,1022,1958,9,5.5,201743
30,15,309,14,215,244,37,95,70,984,1063,2047,11,5.666666667,201743
30,16,267,12,237,323,30,92,11,972,1302,2274,10,5.333333333,201743
30,17,174,13,164,205,21,65,13,655,462,1117,8,5.5,201743
30,18,266,16,168,282,11,74,29,846,705,1551,8,5.25,201743
30,19,186,9,164,210,34,60,5,668,809,1477,13,5,201743
30,20,228,13,355,289,49,64,1,999,976,1975,11,5.4,201743
31,1,267,23,182,292,21,38,0,823,612,1435,8,5.5,201743
31,2,185,8,220,18,141,48,0,620,582,1202,7,5.333333333,201743
31,3,660,40,927,552,35,168,0,2382,2681,5063,17,6.25,201743
31,4,273,7,262,171,36,54,0,803,813,1616,6,4,201743
31,5,269,7,144,196,26,44,0,686,419,1105,7,5.333333333,201743
32,1,317,34,234,191,21,74,16,887,795,1682,12,5.2,201743
32,2,281,36,199,153,45,59,6,779,993,1772,13,5.142857143,201743
32,3,479,51,244,277,12,68,4,1135,895,2030,15,4.833333333,201743
32,4,362,78,301,292,23,109,34,1199,1250,2449,13,4.666666667,201743
1,1,278,41,278,283,61,42,6,989,1059,2048,13,5.5,201744
1,2,326,33,483,326,70,100,5,1343,1445,2788,12,5,201744
1,3,290,31,577,370,36,106,1,1411,1441,2852,13,5,201744
2,1,291,13,311,239,11,92,0,957,1013,1970,11,6,201744
2,2,353,16,296,374,4,104,0,1147,1844,2991,9,4.333333333,201744
2,3,431,25,461,349,13,110,0,1389,1414,2803,12,4.6,201744
2,4,175,5,320,145,6,33,0,684,793,1477,6,6,201744
2,5,581,24,868,522,103,157,0,2255,2654,4909,16,6.25,201744
2,6,318,15,405,287,12,62,0,1099,1073,2172,7,6,201744
2,7,405,11,468,291,21,94,0,1290,1348,2638,12,5.75,201744
2,8,353,12,554,410,13,83,1,1426,1444,2870,8,6,201744
3,1,263,9,267,256,15,76,2,888,1169,2057,15,5,201744
3,2,195,5,362,213,11,43,0,829,1114,1943,9,6,201744
4,1,323,19,358,508,31,91,0,1330,1336,2666,15,4.666666667,201744
4,2,291,22,342,426,22,60,2,1165,1498,2663,14,5.2,201744
5,1,401,18,362,263,20,90,1,1155,1289,2444,9,5.666666667,201744
5,2,309,18,313,269,10,47,0,966,983,1949,10,5.2,201744
5,3,340,21,274,298,28,75,2,1038,1222,2260,9,5.5,201744
5,4,454,33,478,414,11,135,12,1537,1527,3064,11,4.75,201744
5,5,326,23,330,379,21,66,7,1152,1197,2349,8,6,201744
5,6,197,27,221,267,11,43,9,775,879,1654,6,5.5,201744
5,7,228,21,221,206,15,38,0,729,883,1612,9,4,201744
6,1,248,22,282,226,2,74,2,856,903,1759,14,4.428571429,201744
6,2,198,8,250,143,40,73,0,712,828,1540,9,5.666666667,201744
7,1,233,20,207,493,12,51,2,1018,1155,2173,9,5.25,201744
7,2,266,19,109,1364,26,29,13,1826,1875,3701,9,5.25,201744
7,3,300,8,218,555,70,56,0,1207,1344,2551,7,5.333333333,201744
7,4,206,15,210,609,22,65,88,1215,841,2056,11,5.4,201744
7,5,419,13,196,839,25,60,148,1700,1824,3524,11,6,201744
7,6,299,15,325,406,63,103,14,1225,1141,2366,9,4.25,201744
7,7,265,27,423,884,60,113,46,1818,1220,3038,8,5.5,201744
7,8,296,19,217,865,25,49,0,1471,2189,3660,12,5.25,201744
7,9,502,47,523,858,92,141,22,2185,1511,3696,11,5,201744
7,10,331,13,387,785,250,57,0,1823,1045,2868,9,5.5,201744
7,11,123,3,76,226,2,20,0,450,567,1017,6,5.333333333,201744
7,12,320,17,359,908,14,69,0,1687,1662,3349,9,5.5,201744
7,13,173,20,510,285,39,30,0,1057,703,1760,9,5.25,201744
8,1,207,2,275,108,16,29,0,637,624,1261,4,6,201744
8,2,481,48,645,369,29,93,3,1668,1842,3510,17,5.666666667,201744
8,3,292,24,439,309,10,64,0,1138,1107,2245,5,6,201744
8,4,211,6,377,90,15,60,1,760,893,1653,9,6,201744
8,5,301,30,309,221,21,63,0,945,1120,2065,10,5.25,201744
8,6,331,39,436,438,25,149,5,1423,1495,2918,10,4.75,201744
8,7,234,28,209,264,10,93,0,838,801,1639,8,5.25,201744
8,8,244,18,298,315,5,83,0,963,1174,2137,7,4,201744
8,9,281,24,183,180,21,69,15,773,673,1446,10,5.2,201744
9,1,154,16,172,145,29,53,0,569,768,1337,6,7,201744
9,2,401,64,683,1078,61,149,121,2557,2140,4697,12,6,201744
9,3,210,31,288,626,29,100,14,1298,1429,2727,7,6,201744
9,4,202,9,310,733,24,80,5,1363,897,2260,11,6,201744
9,5,194,17,286,259,52,76,40,924,932,1856,7,6,201744
9,6,128,24,185,209,48,58,19,671,916,1587,7,6,201744
9,7,110,4,218,374,8,56,0,770,1016,1786,9,6,201744
9,8,93,18,171,218,50,49,13,612,600,1212,6,7,201744
9,9,149,7,216,367,44,63,3,849,1332,2181,5,6,201744
9,10,152,11,286,368,20,63,97,997,1038,2035,6,6,201744
9,11,208,14,416,673,30,95,2,1438,1458,2896,7,6,201744
9,12,184,62,431,773,16,101,4,1571,1817,3388,11,6,201744
9,13,153,16,262,438,46,64,12,991,964,1955,4,6,201744
9,14,172,12,207,254,58,67,0,770,780,1550,5,6,201744
9,15,371,28,794,1364,27,207,3,2794,2714,5508,11,3.75,201744
9,16,319,43,456,843,39,134,0,1834,2681,4515,15,7,201744
9,17,157,8,233,395,6,68,0,867,924,1791,6,6,201744
9,18,249,27,406,692,40,111,24,1549,1403,2952,12,6,201744
9,19,258,45,318,540,105,81,9,1356,1347,2703,5,6,201744
9,20,4,0,8,9,0,1,0,22,18,40,5,6,201744
9,21,111,5,164,64,39,44,221,648,614,1262,3,6,201744
9,22,205,21,284,379,90,85,32,1096,1073,2169,5,6,201744
9,23,259,22,396,517,49,86,4,1333,1370,2703,7,7,201744
9,24,365,31,551,787,79,152,126,2091,1964,4055,13,6.5,201744
10,1,229,28,192,192,55,67,8,771,890,1661,12,4.833333333,201744
10,2,330,25,277,257,27,73,10,999,1184,2183,9,5.5,201744
10,3,206,21,134,196,18,38,29,642,674,1316,12,5.4,201744
10,4,538,28,401,475,12,90,0,1544,1625,3169,12,4.2,201744
11,1,193,58,209,329,23,45,10,867,730,1597,6,5.666666667,201744
11,2,215,37,197,256,20,55,9,789,795,1584,7,6,201744
11,3,213,14,195,207,18,51,0,698,813,1511,4,6,201744
11,4,217,35,202,275,14,35,0,778,1035,1813,10,3.8,201744
11,5,337,45,308,405,8,91,0,1194,1246,2440,8,6.5,201744
11,6,155,27,204,204,21,52,3,666,725,1391,8,5.666666667,201744
11,7,263,62,408,583,21,80,0,1417,1050,2467,9,5.5,201744
11,8,234,33,262,330,32,57,0,948,1005,1953,9,5.75,201744
11,9,272,66,304,335,7,77,2,1063,1190,2253,10,5.666666667,201744
11,10,237,27,313,318,10,77,14,996,947,1943,11,5.6,201744
11,11,243,30,225,262,24,55,0,839,806,1645,4,6,201744
11,12,267,29,380,394,12,70,0,1152,1324,2476,7,6.5,201744
11,13,200,20,226,189,17,45,27,724,793,1517,9,5.5,201744
11,14,209,25,208,214,12,39,0,707,701,1408,8,5.5,201744
11,15,124,28,145,181,3,40,0,521,555,1076,6,6,201744
12,1,163,17,328,73,76,41,25,723,540,1263,10,5.2,201744
12,2,275,48,325,484,37,55,0,1224,920,2144,10,5.5,201744
12,3,228,44,358,503,94,66,2,1295,1080,2375,11,5,201744
12,4,215,34,384,609,34,77,55,1408,1245,2653,9,6,201744
12,5,186,13,206,238,19,31,22,715,638,1353,10,5.25,201744
12,6,155,17,173,520,35,26,1,927,677,1604,10,5.25,201744
12,7,222,21,249,421,12,67,71,1063,1167,2230,8,4,201744
12,8,280,23,383,444,26,30,0,1186,984,2170,9,5.25,201744
12,9,205,25,256,603,21,39,9,1158,1109,2267,9,5.666666667,201744
13,1,155,26,130,400,86,44,0,841,1001,1842,9,5.333333333,201744
13,2,157,12,121,237,69,44,0,640,796,1436,6,5.333333333,201744
13,3,158,31,195,286,59,64,0,793,556,1349,12,5.25,201744
13,4,247,18,272,248,58,69,8,920,856,1776,9,5.666666667,201744
13,5,272,18,427,288,54,90,6,1155,1191,2346,9,5.75,201744
13,6,438,42,731,600,47,75,0,1933,1744,3677,13,4.75,201744
13,7,216,25,364,331,29,75,0,1040,1201,2241,9,5.5,201744
14,1,180,12,149,103,16,69,6,535,541,1076,6,5.25,201744
14,2,223,12,197,97,8,74,0,611,574,1185,6,5.666666667,201744
14,3,342,15,222,95,14,109,0,797,904,1701,11,5.4,201744
14,4,317,26,247,334,20,69,8,1021,1057,2078,12,6,201744
14,5,287,19,497,218,31,64,5,1121,1103,2224,11,5.5,201744
14,6,297,11,395,255,13,58,0,1029,1065,2094,11,6,201744
14,7,168,9,186,83,1,25,1,473,582,1055,6,5,201744
14,8,536,37,723,541,32,140,1,2010,2218,4228,12,4.166666667,201744
14,9,304,25,352,335,27,89,1,1133,1395,2528,8,6,201744
14,10,306,18,374,252,11,64,0,1025,1188,2213,7,6,201744
14,11,133,17,154,186,23,54,1,568,589,1157,4,6,201744
14,12,293,15,484,137,2,60,0,991,1003,1994,11,5.5,201744
14,13,200,11,240,180,2,66,0,699,810,1509,8,6,201744
14,14,242,26,294,265,12,87,6,932,999,1931,7,7,201744
14,15,237,21,190,182,17,85,5,737,812,1549,10,5.6,201744
14,16,225,22,260,181,7,49,0,744,1155,1899,5,6,201744
14,17,209,23,159,108,22,54,10,585,789,1374,9,5.25,201744
14,18,295,40,287,163,27,76,15,903,876,1779,10,5.4,201744
14,19,207,23,248,185,22,51,21,757,864,1621,9,5.25,201744
14,20,114,5,154,71,5,39,0,388,337,725,10,5.666666667,201744
15,1,170,9,200,135,73,49,0,636,748,1384,7,5.333333333,201744
15,2,226,20,290,314,58,43,8,959,899,1858,6,6,201744
15,3,253,22,332,223,54,53,0,937,1056,1993,10,5.666666667,201744
15,4,237,20,301,375,27,70,10,1040,1129,2169,4,6,201744
15,5,203,16,242,276,18,72,0,827,1046,1873,8,5.666666667,201744
15,6,229,18,343,345,54,91,0,1080,1425,2505,7,6.5,201744
15,7,248,24,333,328,36,75,0,1044,1292,2336,10,6,201744
15,8,116,18,147,182,6,42,2,513,564,1077,4,6,201744
15,9,279,13,117,200,90,47,12,758,759,1517,9,5.75,201744
15,10,191,11,266,250,39,68,0,825,928,1753,9,6,201744
15,11,250,8,324,356,30,64,0,1032,1109,2141,8,6,201744
15,12,322,21,525,388,21,65,0,1342,1717,3059,8,6,201744
15,13,156,11,219,184,57,65,0,692,717,1409,8,6,201744
15,14,104,8,135,162,21,45,0,475,543,1018,4,6,201744
15,15,238,39,264,335,15,85,0,976,1023,1999,6,6,201744
15,16,298,39,437,634,10,94,0,1512,1604,3116,8,6,201744
15,17,180,19,198,354,13,57,0,821,910,1731,8,6,201744
15,18,319,19,353,474,34,113,0,1312,1318,2630,7,5.666666667,201744
15,19,316,92,466,742,12,109,0,1737,2171,3908,14,6,201744
15,20,130,11,203,231,9,55,1,640,503,1143,6,6,201744
15,21,97,12,116,185,22,61,0,493,406,899,6,5.5,201744
15,22,365,43,477,705,21,124,1,1736,2000,3736,14,6,201744
15,23,254,18,271,348,30,113,0,1034,1003,2037,7,5.333333333,201744
15,24,144,15,245,281,18,62,2,767,984,1751,4,6,201744
15,25,214,34,390,264,1,89,0,992,1241,2233,6,6,201744
15,26,178,11,215,184,35,39,0,662,611,1273,10,2.333333333,201744
15,27,266,20,257,407,4,88,0,1042,1162,2204,9,5.666666667,201744
15,28,268,17,494,264,30,85,0,1158,1265,2423,9,5.666666667,201744
15,29,238,21,323,535,7,79,0,1203,1419,2622,8,6,201744
15,30,234,19,423,320,37,72,0,1105,1455,2560,12,6,201744
15,31,229,42,237,344,10,64,0,926,982,1908,6,6,201744
15,32,204,11,296,466,41,94,0,1112,1023,2135,9,6,201744
15,33,279,6,379,419,24,92,0,1199,1390,2589,7,6,201744
15,34,220,11,176,336,9,65,0,817,1008,1825,8,6,201744
15,35,293,19,238,339,8,87,0,984,1008,1992,9,5.666666667,201744
15,36,285,24,230,295,58,57,0,949,866,1815,9,5.5,201744
15,37,258,31,325,427,50,79,1,1171,1281,2452,7,6,201744
15,38,245,25,265,397,9,69,0,1010,1080,2090,6,5.5,201744
15,39,151,20,301,343,18,61,1,895,1023,1918,4,6,201744
15,40,367,23,358,389,75,137,0,1349,1370,2719,9,6,201744
15,41,454,45,654,643,38,70,13,1917,1702,3619,11,6,201744
16,1,220,23,284,178,11,75,0,791,623,1414,10,5.333333333,201744
16,2,119,20,124,145,14,33,0,455,372,827,9,5.25,201744
16,3,194,22,167,260,37,43,0,723,699,1422,10,5.25,201744
16,4,199,16,212,173,33,83,0,716,647,1363,8,5.5,201744
16,5,241,26,216,191,22,79,8,783,856,1639,10,5.666666667,201744
16,6,223,35,240,217,47,49,0,811,722,1533,12,5.5,201744
16,7,169,16,196,186,29,71,0,667,595,1262,9,5.5,201744
16,8,345,35,504,425,13,95,2,1419,1508,2927,12,6,201744
16,9,233,24,280,225,14,66,0,842,855,1697,10,6,201744
16,10,260,14,298,322,12,77,0,983,975,1958,8,4.333333333,201744
16,11,215,21,203,141,89,60,1,730,811,1541,12,5.4,201744
16,12,181,12,196,136,7,57,0,589,528,1117,10,5.25,201744
17,1,266,25,368,541,24,82,5,1311,1396,2707,12,3.75,201744
17,2,196,21,285,503,7,73,6,1091,1144,2235,9,5.666666667,201744
17,3,250,21,375,582,15,82,0,1325,1355,2680,8,5.5,201744
17,4,297,21,331,467,8,66,108,1298,1075,2373,10,5.666666667,201744
17,5,115,14,135,237,17,39,0,557,567,1124,5,5.5,201744
18,1,238,24,200,201,27,68,0,758,611,1369,9,5.4,201744
18,2,380,29,377,286,45,93,0,1210,1292,2502,10,5.5,201744
18,3,230,13,368,211,9,43,0,874,698,1572,9,5.75,201744
19,1,366,14,362,326,18,100,5,1191,1124,2315,9,6,201744
19,2,398,20,644,270,63,68,0,1463,1765,3228,10,6.5,201744
19,3,424,14,528,375,25,100,0,1466,1439,2905,8,6,201744
19,4,195,12,165,155,38,37,19,621,751,1372,5,6,201744
19,5,462,41,422,580,28,119,13,1665,1689,3354,8,6,201744
19,6,148,12,160,193,9,53,7,582,660,1242,5,6,201744
19,7,260,17,430,212,5,51,0,975,1114,2089,10,4.75,201744
19,8,87,3,104,90,2,21,0,307,308,615,7,6,201744
19,9,189,17,150,212,23,35,0,626,614,1240,9,5.25,201744
19,10,343,8,220,273,12,62,0,918,838,1756,8,3,201744
19,11,708,44,598,766,8,165,9,2298,2289,4587,13,6.333333333,201744
19,12,250,13,369,217,11,64,1,925,742,1667,8,6,201744
20,1,242,20,238,274,42,57,0,873,767,1640,7,5.5,201744
20,2,154,14,149,175,30,48,0,570,416,986,6,5.333333333,201744
20,3,154,15,168,198,71,43,1,650,843,1493,6,5.333333333,201744
20,4,114,12,122,209,37,66,0,560,429,989,6,5.333333333,201744
20,5,130,20,171,331,50,58,3,763,681,1444,11,4.25,201744
20,6,261,23,272,497,405,51,3,1512,890,2402,8,5.25,201744
20,7,260,22,319,616,15,104,0,1336,852,2188,8,5.75,201744
20,8,401,24,459,830,48,134,34,1930,2203,4133,15,4.666666667,201744
20,9,203,18,136,189,64,61,6,677,858,1535,8,5.666666667,201744
20,10,295,16,265,391,31,78,0,1076,416,1492,9,5.25,201744
21,1,218,9,267,478,22,59,0,1053,917,1970,9,5.4,201744
21,2,255,37,263,169,71,69,14,878,746,1624,9,5.2,201744
21,3,298,14,309,184,70,78,4,957,767,1724,8,5.5,201744
21,4,219,9,327,123,108,79,25,890,677,1567,6,5.25,201744
21,5,227,12,359,204,22,83,92,999,1013,2012,8,5.666666667,201744
21,6,301,20,346,538,27,78,24,1334,1462,2796,6,7,201744
21,7,258,13,352,103,120,103,34,983,1176,2159,9,5.666666667,201744
21,8,256,19,292,269,36,87,7,966,616,1582,10,5.2,201744
21,9,294,25,436,503,42,87,22,1409,1722,3131,9,6,201744
21,10,280,8,331,361,25,94,11,1110,1630,2740,7,6,201744
21,11,57,1,65,39,12,18,0,192,176,368,6,3.5,201744
21,12,451,16,741,766,81,150,25,2230,2859,5089,15,4.333333333,201744
21,13,264,22,313,456,43,88,13,1199,1035,2234,8,5.666666667,201744
21,14,308,15,487,130,126,118,4,1188,819,2007,13,5.333333333,201744
21,15,225,17,385,246,47,83,1,1004,1002,2006,7,5.5,201744
22,1,266,47,270,376,49,29,0,1037,977,2014,11,5.2,201744
22,2,195,26,322,249,42,36,14,884,858,1742,7,5.5,201744
22,3,381,53,702,561,28,91,2,1818,2019,3837,10,6,201744
22,4,274,35,604,370,27,69,0,1379,1524,2903,13,4,201744
22,5,216,17,369,194,43,55,1,895,973,1868,10,5.5,201744
23,1,331,10,1197,353,91,60,1,2043,2033,4076,14,5.6,201744
23,2,304,30,463,546,12,71,0,1426,1154,2580,10,4.2,201744
23,3,346,4,962,411,29,69,0,1821,1872,3693,11,6,201744
23,4,217,8,574,234,17,38,0,1088,1589,2677,7,4.333333333,201744
24,1,228,54,217,450,44,34,4,1031,757,1788,11,5.2,201744
24,2,154,22,202,181,16,42,0,617,660,1277,6,5.5,201744
24,3,251,72,293,560,206,51,0,1433,1415,2848,9,5.25,201744
24,4,143,29,197,204,58,54,80,765,850,1615,5,5.5,201744
24,5,301,23,401,463,5,94,0,1287,1284,2571,10,5,201744
24,6,524,42,492,497,19,106,0,1680,1658,3338,11,4.666666667,201744
24,7,257,40,315,520,62,57,0,1251,660,1911,9,5.25,201744
25,1,225,18,199,226,24,57,0,749,715,1464,14,5.75,201744
25,2,314,26,279,344,19,88,0,1070,1172,2242,7,5.5,201744
25,3,206,16,286,286,27,64,2,887,993,1880,9,5.6,201744
25,4,236,24,149,251,16,58,7,741,809,1550,8,5.333333333,201744
25,5,335,19,319,459,27,83,0,1242,1596,2838,11,5,201744
25,6,314,9,535,81,22,82,0,1043,1024,2067,9,5.75,201744
25,7,302,17,251,377,7,82,1,1037,1110,2147,7,6,201744
26,1,267,22,288,270,8,93,0,948,988,1936,9,5.5,201744
26,2,340,7,419,399,2,97,0,1264,1337,2601,13,5.4,201744
26,3,469,25,499,576,22,171,0,1762,2021,3783,15,4.666666667,201744
26,4,195,12,186,259,8,80,0,740,904,1644,10,5.2,201744
26,5,252,13,147,127,12,53,0,604,512,1116,3,5.5,201744
26,6,286,13,336,374,2,83,0,1094,1213,2307,10,5.333333333,201744
26,7,250,25,169,299,12,52,0,807,904,1711,10,5.5,201744
27,1,196,24,182,420,23,34,0,879,679,1558,9,5.5,201744
27,2,206,12,179,480,7,37,0,921,874,1795,8,5.666666667,201744
27,3,178,6,132,358,8,45,0,727,822,1549,7,5.666666667,201744
27,4,278,13,286,721,15,58,0,1371,1432,2803,9,3.5,201744
27,5,154,4,117,316,10,24,2,627,599,1226,6,5.333333333,201744
27,6,261,19,216,487,10,59,0,1052,1342,2394,9,5.333333333,201744
28,1,300,14,423,339,8,78,0,1162,1143,2305,13,6,201744
28,2,291,27,571,299,38,75,39,1340,1180,2520,14,6,201744
28,3,163,22,138,175,6,41,0,545,464,1009,7,5.333333333,201744
28,4,359,38,447,342,36,100,31,1353,1291,2644,16,6,201744
28,5,253,22,240,354,28,88,2,987,1079,2066,13,3.833333333,201744
28,6,192,33,190,405,128,29,24,1001,1211,2212,14,5.166666667,201744
28,7,271,19,490,369,38,84,0,1271,1191,2462,8,6,201744
28,8,216,22,253,283,27,77,1,879,764,1643,9,6,201744
28,9,170,8,255,171,21,34,20,679,627,1306,11,4,201744
29,1,318,39,403,277,45,78,0,1160,1097,2257,10,5.5,201744
29,2,351,28,324,529,43,108,35,1418,1455,2873,14,4.166666667,201744
29,3,170,37,177,297,13,50,0,744,821,1565,7,5.666666667,201744
30,1,133,13,145,207,31,48,20,597,541,1138,7,5.333333333,201744
30,2,161,26,162,79,42,37,333,840,805,1645,8,5.25,201744
30,3,194,20,231,168,59,71,57,800,874,1674,6,5.666666667,201744
30,4,129,4,221,164,23,58,1,600,651,1251,8,5.5,201744
30,5,199,14,168,307,12,90,0,790,921,1711,7,5.5,201744
30,6,198,12,199,187,16,49,0,661,748,1409,9,5.333333333,201744
30,7,287,26,207,263,47,67,22,919,1258,2177,12,5.25,201744
30,8,299,13,263,276,45,73,0,969,1044,2013,11,5.4,201744
30,9,279,18,207,194,67,79,39,883,1034,1917,8,5.5,201744
30,10,289,9,418,322,37,121,15,1211,1234,2445,9,4.666666667,201744
30,11,225,5,296,256,8,73,0,863,1204,2067,6,5.5,201744
30,12,378,14,547,551,19,151,0,1660,1841,3501,11,6.25,201744
30,13,246,16,203,338,64,92,2,961,903,1864,10,5.4,201744
30,14,248,34,300,297,106,129,0,1114,1084,2198,9,5.5,201744
30,15,287,15,246,272,44,107,101,1072,902,1974,11,5.666666667,201744
30,16,263,14,264,337,56,102,21,1057,1044,2101,10,5.333333333,201744
30,17,212,16,220,272,24,72,9,825,620,1445,8,5.5,201744
30,18,214,17,152,248,19,74,60,784,824,1608,8,5.25,201744
30,19,206,14,219,243,25,69,11,787,900,1687,13,5.6,201744
30,20,242,14,286,274,64,68,0,948,921,1869,11,5.4,201744
31,1,270,18,240,383,21,72,0,1004,550,1554,8,5.5,201744
31,2,158,6,169,27,106,33,0,499,516,1015,7,5.333333333,201744
31,3,526,42,999,601,31,158,0,2357,2318,4675,17,6.25,201744
31,4,364,8,280,205,27,50,0,934,713,1647,6,4.5,201744
31,5,178,8,176,223,17,32,0,634,521,1155,7,5.333333333,201744
32,1,252,35,227,211,39,69,30,863,837,1700,12,5.2,201744
32,2,283,46,254,176,76,55,6,896,995,1891,13,5.142857143,201744
32,3,265,54,203,250,9,66,2,849,970,1819,15,4.666666667,201744
32,4,330,78,309,273,25,87,52,1154,1233,2387,14,4.666666667,201744
1,1,291,43,268,344,45,59,5,1055,1023,2078,13,5.5,201745
1,2,296,52,531,285,85,84,3,1336,1377,2713,11,4.8,201745
1,3,380,43,491,370,44,80,0,1408,1386,2794,13,5,201745
2,1,219,10,340,248,9,60,1,887,1070,1957,11,6,201745
2,2,279,15,324,402,1,94,0,1115,1395,2510,9,4.333333333,201745
2,3,350,20,402,277,17,101,1,1168,1310,2478,11,4.4,201745
2,4,161,7,290,133,2,30,0,623,747,1370,6,6,201745
2,5,475,25,881,477,92,124,1,2075,2321,4396,16,6.25,201745
2,6,273,3,435,235,23,49,0,1018,1091,2109,7,6,201745
2,7,337,12,430,297,20,74,2,1172,1232,2404,12,5.75,201745
2,8,300,15,527,355,10,63,1,1271,1383,2654,8,6,201745
3,1,285,9,278,276,11,95,0,954,1064,2018,15,4.857142857,201745
3,2,173,3,408,234,18,41,0,877,932,1809,9,6,201745
4,1,233,23,318,517,27,55,0,1173,1516,2689,15,4.666666667,201745
4,2,238,16,243,345,27,48,5,922,1105,2027,14,5.2,201745
5,1,385,19,363,254,25,102,0,1148,1222,2370,9,5.666666667,201745
5,2,317,14,273,267,17,59,4,951,1139,2090,10,5.2,201745
5,3,288,26,237,301,30,90,9,981,1048,2029,9,5.5,201745
5,4,469,48,536,423,12,131,24,1643,1618,3261,11,4.75,201745
5,5,291,26,313,378,26,63,12,1109,1205,2314,8,6,201745
5,6,193,17,179,204,12,22,6,633,759,1392,6,5.5,201745
5,7,249,16,191,192,9,43,0,700,905,1605,8,3.666666667,201745
6,1,222,17,305,243,4,67,1,859,846,1705,14,4.428571429,201745
6,2,186,13,272,177,55,48,0,751,712,1463,9,5.666666667,201745
7,1,162,6,133,425,6,29,4,765,950,1715,9,5.25,201745
7,2,290,28,170,589,187,24,23,1311,1475,2786,9,5.25,201745
7,3,245,3,202,429,69,40,0,988,816,1804,7,5.333333333,201745
7,4,174,8,175,675,26,62,195,1315,1028,2343,11,5.4,201745
7,5,361,15,206,704,67,52,155,1560,2080,3640,11,5.666666667,201745
7,6,300,16,355,425,98,102,11,1307,1471,2778,9,4.5,201745
7,7,265,26,355,798,70,95,32,1641,1839,3480,8,5.5,201745
7,8,339,19,296,810,37,73,0,1574,1481,3055,12,5.25,201745
7,9,373,36,520,649,86,118,22,1804,1616,3420,11,5,201745
7,10,292,16,365,604,214,58,0,1549,1841,3390,9,5.5,201745
7,11,127,3,105,200,3,13,0,451,908,1359,6,5.333333333,201745
7,12,300,12,317,773,14,49,0,1465,1972,3437,9,5.5,201745
7,13,143,17,612,60,111,32,0,975,801,1776,9,5.25,201745
8,1,265,11,312,157,13,51,0,809,635,1444,4,6,201745
8,2,181,23,219,81,17,46,0,567,2098,2665,17,5.666666667,201745
8,3,307,20,432,299,7,90,2,1157,1167,2324,5,6,201745
8,4,262,11,472,170,25,82,0,1022,679,1701,9,6,201745
8,5,291,24,222,219,25,81,0,862,805,1667,10,5.25,201745
8,6,240,39,353,302,18,104,2,1058,1443,2501,9,4.5,201745
8,7,264,25,179,195,6,59,0,728,783,1511,8,5.25,201745
8,8,204,15,354,300,6,83,0,962,980,1942,7,4,201745
8,9,221,19,177,150,24,71,6,668,631,1299,10,5.2,201745
9,1,98,10,203,93,76,53,1,534,565,1099,6,7,201745
9,2,382,92,602,1061,62,165,123,2487,2193,4680,12,6,201745
9,3,193,36,375,605,36,114,15,1374,1260,2634,7,6,201745
9,4,224,10,290,688,30,79,10,1331,1237,2568,11,6,201745
9,5,156,16,276,53,75,58,177,811,946,1757,7,6,201745
9,6,134,40,184,221,55,78,27,739,707,1446,7,6,201745
9,7,108,8,204,403,6,53,0,782,894,1676,9,6,201745
9,8,72,29,164,175,34,37,8,519,556,1075,6,7,201745
9,9,135,18,197,397,46,62,2,857,1046,1903,5,6,201745
9,10,144,8,302,137,14,63,228,896,1050,1946,6,6,201745
9,11,190,14,429,691,40,91,6,1461,1465,2926,7,6,201745
9,12,143,77,373,666,18,89,7,1373,1641,3014,11,6,201745
9,13,159,11,221,382,35,61,3,872,938,1810,4,6,201745
9,14,144,8,209,145,151,70,0,727,744,1471,5,6,201745
9,15,275,41,714,1203,18,149,3,2403,2703,5106,11,3.75,201745
9,16,298,42,414,814,38,110,0,1716,1972,3688,15,7,201745
9,17,142,10,187,369,16,63,0,787,853,1640,6,6,201745
9,18,223,34,412,692,39,96,41,1537,1489,3026,12,6,201745
9,19,220,32,355,447,82,80,2,1218,1304,2522,5,6,201745
9,20,3,5,7,4,0,2,0,21,21,42,5,6,201745
9,21,121,14,223,31,40,61,184,674,636,1310,3,6,201745
9,22,192,15,262,383,87,73,30,1042,1093,2135,5,6,201745
9,23,226,11,419,185,122,92,219,1274,1283,2557,7,7,201745
9,24,385,35,698,721,137,167,196,2339,1951,4290,13,6.5,201745
10,1,179,19,149,173,22,53,13,608,661,1269,12,4.833333333,201745
10,2,292,15,286,244,20,73,5,935,984,1919,9,5.5,201745
10,3,217,26,134,226,18,42,47,710,583,1293,12,5.4,201745
10,4,352,25,409,469,18,93,0,1366,1528,2894,12,4.8,201745
11,1,158,35,171,277,16,37,12,706,722,1428,6,4.666666667,201745
11,2,179,21,188,213,20,55,11,687,755,1442,7,5,201745
11,3,137,13,158,176,13,42,0,539,696,1235,4,5,201745
11,4,181,26,190,237,11,56,2,703,810,1513,10,3.4,201745
11,5,272,52,249,314,13,87,0,987,1181,2168,8,5.5,201745
11,6,148,21,181,192,25,50,7,624,691,1315,8,4.666666667,201745
11,7,167,28,225,236,11,56,0,723,872,1595,9,4.5,201745
11,8,166,35,268,287,27,60,0,843,858,1701,9,4.75,201745
11,9,213,51,280,314,9,72,2,941,1005,1946,10,4.666666667,201745
11,10,207,27,233,279,13,76,16,851,897,1748,11,4.6,201745
11,11,214,31,188,214,11,50,0,708,900,1608,4,5,201745
11,12,209,20,301,341,11,62,0,944,1103,2047,7,5.5,201745
11,13,167,26,208,148,19,49,16,633,735,1368,9,4.5,201745
11,14,153,11,187,178,12,53,0,594,629,1223,8,4.5,201745
11,15,122,11,129,159,2,24,0,447,519,966,6,5,201745
12,1,184,17,284,132,113,40,3,773,605,1378,10,5.2,201745
12,2,208,29,229,411,22,77,0,976,1228,2204,10,5.5,201745
12,3,222,23,274,500,101,66,5,1191,1363,2554,11,5.2,201745
12,4,188,28,301,485,32,64,56,1154,1310,2464,9,6,201745
12,5,199,16,153,276,10,41,13,708,696,1404,10,5.25,201745
12,6,227,18,230,439,39,27,2,982,876,1858,10,5.25,201745
12,7,268,21,247,463,6,56,25,1086,967,2053,8,4,201745
12,8,242,23,329,344,27,27,1,993,1195,2188,9,5.25,201745
12,9,165,20,233,514,19,38,10,999,1132,2131,9,5.666666667,201745
13,1,191,31,221,588,144,55,0,1230,882,2112,9,5.333333333,201745
13,2,145,13,108,225,53,41,1,586,489,1075,6,5.333333333,201745
13,3,215,26,201,208,46,72,0,768,830,1598,12,5.25,201745
13,4,266,16,312,248,74,51,9,976,798,1774,9,5.666666667,201745
13,5,274,11,417,280,73,106,1,1162,1090,2252,9,5.75,201745
13,6,465,53,742,675,41,95,6,2077,1686,3763,13,4.75,201745
13,7,218,31,390,294,35,45,0,1013,964,1977,9,5.5,201745
14,1,151,16,85,89,17,40,9,407,331,738,6,5.25,201745
14,2,176,14,179,82,14,56,0,521,592,1113,6,5.666666667,201745
14,3,287,17,234,141,4,95,1,779,700,1479,11,5.4,201745
14,4,285,34,299,316,12,86,4,1036,901,1937,12,6,201745
14,5,235,20,453,200,33,63,7,1011,1144,2155,11,5.5,201745
14,6,257,11,339,252,18,52,0,929,904,1833,11,6,201745
14,7,183,3,233,95,1,20,0,535,585,1120,6,6,201745
14,8,522,30,739,534,36,131,2,1994,1973,3967,13,4.333333333,201745
14,9,292,22,378,363,34,91,0,1180,1129,2309,8,6,201745
14,10,280,20,376,247,7,76,0,1006,1010,2016,7,6,201745
14,11,135,7,211,144,15,51,0,563,529,1092,4,6,201745
14,12,349,14,499,143,7,83,0,1095,963,2058,11,5.5,201745
14,13,192,13,245,200,6,59,0,715,922,1637,8,6,201745
14,14,234,15,305,271,8,69,2,904,1064,1968,7,7,201745
14,15,270,41,214,216,23,80,3,847,915,1762,10,5.6,201745
14,16,174,11,212,137,8,46,0,588,1037,1625,5,6,201745
14,17,171,10,171,100,9,72,8,541,657,1198,9,5.25,201745
14,18,239,20,214,142,18,35,13,681,715,1396,10,5.4,201745
14,19,191,18,197,203,11,51,3,674,875,1549,9,5.25,201745
14,20,143,6,188,67,3,36,0,443,392,835,10,5.666666667,201745
15,1,204,11,259,127,101,62,0,764,833,1597,7,5.333333333,201745
15,2,203,15,324,287,40,62,3,934,1125,2059,6,6,201745
15,3,273,18,304,230,47,85,0,957,977,1934,10,5.666666667,201745
15,4,240,11,258,344,41,86,6,986,1094,2080,4,6,201745
15,5,176,17,206,256,11,44,0,710,906,1616,8,5.666666667,201745
15,6,217,17,311,384,60,79,1,1069,1240,2309,7,6.5,201745
15,7,215,11,290,335,31,61,0,943,1144,2087,10,6,201745
15,8,95,12,124,184,4,32,1,452,558,1010,4,6,201745
15,9,216,12,119,222,79,52,10,710,737,1447,9,5.75,201745
15,10,181,11,260,246,34,72,0,804,912,1716,9,6,201745
15,11,228,15,293,319,28,52,0,935,1104,2039,8,6,201745
15,12,273,17,533,440,22,58,0,1343,1569,2912,8,6,201745
15,13,119,13,225,166,62,62,0,647,739,1386,8,6,201745
15,14,85,11,130,171,23,47,0,467,551,1018,4,6,201745
15,15,180,27,261,317,19,73,0,877,1061,1938,6,6,201745
15,16,270,26,416,634,4,90,1,1441,1432,2873,8,6,201745
15,17,140,10,191,333,13,53,0,740,969,1709,8,6,201745
15,18,290,19,367,402,29,95,0,1202,1294,2496,7,5.666666667,201745
15,19,306,90,439,608,7,99,0,1549,2069,3618,14,6,201745
15,20,116,5,183,258,15,40,0,617,1030,1647,6,6,201745
15,21,113,9,111,164,15,70,0,482,440,922,6,5.5,201745
15,22,331,29,481,626,19,112,1,1599,2517,4116,14,6,201745
15,23,250,24,231,341,34,98,0,978,1114,2092,7,5.333333333,201745
15,24,136,7,211,245,13,52,1,665,756,1421,4,6,201745
15,25,252,28,372,326,7,67,0,1052,1124,2176,6,6,201745
15,26,219,13,176,190,24,52,1,675,539,1214,11,3,201745
15,27,239,19,285,393,4,72,0,1012,1255,2267,9,5.666666667,201745
15,28,296,12,471,305,33,86,0,1203,1347,2550,9,5.666666667,201745
15,29,258,23,325,531,9,96,0,1242,1479,2721,8,6,201745
15,30,256,23,386,380,43,47,0,1135,1153,2288,12,6,201745
15,31,174,35,215,347,12,52,0,835,914,1749,6,6,201745
15,32,219,15,281,431,35,77,0,1058,1230,2288,9,6,201745
15,33,227,12,299,397,13,80,1,1029,1294,2323,7,6,201745
15,34,199,13,217,326,5,71,0,831,908,1739,8,6,201745
15,35,291,15,201,313,6,91,0,917,943,1860,9,5.666666667,201745
15,36,235,25,206,275,94,63,0,898,907,1805,9,5.5,201745
15,37,244,39,341,410,41,76,3,1154,1312,2466,7,6,201745
15,38,180,33,291,330,21,55,0,910,1276,2186,6,5.5,201745
15,39,147,17,263,320,11,62,0,820,972,1792,4,6,201745
15,40,313,24,274,355,58,117,2,1143,1392,2535,9,6,201745
15,41,380,26,554,606,51,67,11,1695,1863,3558,11,6,201745
16,1,182,10,234,198,13,47,0,684,633,1317,10,5.333333333,201745
16,2,132,15,131,147,4,42,0,471,535,1006,9,5.25,201745
16,3,143,19,127,237,21,39,0,586,668,1254,10,5.25,201745
16,4,227,20,196,154,16,85,0,698,665,1363,8,5.5,201745
16,5,238,29,245,219,25,73,12,841,771,1612,10,5.666666667,201745
16,6,203,36,184,193,45,47,0,708,699,1407,12,5.5,201745
16,7,175,15,183,152,23,65,0,613,686,1299,9,5.5,201745
16,8,322,33,485,442,13,103,6,1404,1439,2843,12,6,201745
16,9,208,23,221,183,15,70,0,720,878,1598,10,6,201745
16,10,215,15,315,316,4,50,0,915,1138,2053,8,5,201745
16,11,183,19,169,129,79,65,1,645,585,1230,12,5.4,201745
16,12,163,18,229,149,19,47,3,628,600,1228,10,5.25,201745
17,1,220,21,336,508,20,99,3,1207,1406,2613,12,3.75,201745
17,2,190,5,307,425,6,43,11,987,909,1896,9,5.666666667,201745
17,3,237,12,400,582,21,66,0,1318,1138,2456,8,5.5,201745
17,4,218,19,313,396,17,71,107,1141,1182,2323,10,5.666666667,201745
17,5,116,15,108,269,14,45,3,570,574,1144,5,5.5,201745
18,1,182,14,156,182,25,69,0,628,813,1441,9,5.4,201745
18,2,353,25,444,338,33,79,0,1272,1260,2532,10,5.75,201745
18,3,222,20,402,243,6,54,0,947,798,1745,9,6,201745
19,1,261,17,344,273,14,83,9,1001,1097,2098,9,6,201745
19,2,393,19,607,292,60,81,0,1452,1494,2946,10,6.5,201745
19,3,371,12,614,347,17,77,0,1438,1319,2757,8,6,201745
19,4,155,4,173,127,18,34,21,532,680,1212,5,6,201745
19,5,437,23,461,510,19,111,7,1568,1553,3121,8,6,201745
19,6,124,11,171,163,9,40,4,522,643,1165,5,6,201745
19,7,201,9,473,192,1,42,1,919,874,1793,10,4.5,201745
19,8,67,4,101,86,3,13,0,274,248,522,7,6,201745
19,9,239,8,212,224,28,49,0,760,802,1562,9,5,201745
19,10,247,11,242,244,5,46,0,795,1030,1825,7,3.666666667,201745
19,11,579,51,592,751,18,181,5,2177,2259,4436,13,6.333333333,201745
19,12,197,9,377,179,6,46,0,814,786,1600,8,5.333333333,201745
20,1,201,10,144,189,45,43,0,632,693,1325,7,5.5,201745
20,2,173,11,181,155,34,20,0,574,803,1377,6,5.333333333,201745
20,3,165,12,195,275,121,60,1,829,642,1471,6,5.333333333,201745
20,4,143,18,178,247,39,91,1,717,417,1134,6,5.333333333,201745
20,5,243,28,363,428,271,77,1,1411,986,2397,11,5.25,201745
20,6,192,18,265,316,286,40,1,1118,741,1859,8,5.25,201745
20,7,222,17,444,553,22,84,0,1342,1134,2476,8,5.75,201745
20,8,456,21,423,698,35,116,49,1798,2001,3799,15,4.666666667,201745
20,9,254,17,185,257,55,69,5,842,587,1429,8,5.666666667,201745
20,10,176,17,178,291,14,64,0,740,801,1541,9,5.25,201745
21,1,207,10,241,405,26,38,0,927,1148,2075,9,5.4,201745
21,2,286,38,234,211,82,67,21,939,834,1773,9,5.2,201745
21,3,255,8,280,183,70,74,26,896,991,1887,8,5.5,201745
21,4,170,9,230,129,95,58,28,719,683,1402,6,5.25,201745
21,5,197,8,368,141,26,70,24,834,1140,1974,8,5.666666667,201745
21,6,270,11,359,473,26,74,30,1243,1382,2625,6,7,201745
21,7,223,11,287,71,120,74,11,797,1100,1897,9,5.666666667,201745
21,8,224,11,281,242,51,65,4,878,966,1844,10,5.2,201745
21,9,265,19,401,402,57,121,21,1286,1607,2893,9,6,201745
21,10,240,18,376,333,22,87,9,1085,1432,2517,7,6,201745
21,11,50,3,113,29,30,19,3,247,203,450,6,3.5,201745
21,12,417,23,730,618,139,142,49,2118,2552,4670,16,4.666666667,201745
21,13,241,10,269,397,34,101,3,1055,1169,2224,8,5.666666667,201745
21,14,196,9,396,131,60,83,6,881,737,1618,13,5.333333333,201745
21,15,219,20,447,264,40,82,4,1076,1111,2187,7,5.5,201745
22,1,254,45,223,291,44,37,0,894,1065,1959,11,5.2,201745
22,2,175,27,313,159,34,39,22,769,872,1641,7,5.5,201745
22,3,335,46,599,498,18,93,3,1592,1736,3328,10,6,201745
22,4,261,33,561,429,22,73,0,1379,1473,2852,13,4,201745
22,5,163,19,348,194,25,50,2,801,829,1630,10,5.5,201745
23,1,301,9,1029,353,94,57,0,1843,1965,3808,14,5.6,201745
23,2,231,38,402,468,15,56,0,1210,1309,2519,11,4.4,201745
23,3,312,5,850,429,16,60,1,1673,1996,3669,11,6,201745
23,4,161,7,591,185,25,22,0,991,1988,2979,7,4.666666667,201745
24,1,221,43,184,375,39,33,2,897,966,1863,11,5.2,201745
24,2,143,16,166,160,9,37,0,531,614,1145,6,5.5,201745
24,3,217,47,259,605,78,57,0,1263,1440,2703,9,5.25,201745
24,4,181,29,224,211,41,79,55,820,866,1686,5,5.5,201745
24,5,255,27,382,448,2,105,0,1219,1230,2449,10,5,201745
24,6,639,36,469,486,23,96,0,1749,1516,3265,11,5.333333333,201745
24,7,224,31,312,531,61,54,0,1213,970,2183,9,5.25,201745
25,1,166,21,209,239,18,48,0,701,808,1509,14,5.75,201745
25,2,332,16,312,366,14,100,0,1140,1111,2251,7,5.5,201745
25,3,198,14,219,318,14,44,2,809,787,1596,9,5.6,201745
25,4,229,16,171,297,8,53,6,780,865,1645,8,5.333333333,201745
25,5,265,16,357,439,20,85,0,1182,1379,2561,11,5,201745
25,6,246,9,500,99,12,73,1,940,1096,2036,9,5.75,201745
25,7,264,16,271,343,11,93,0,998,1117,2115,7,6,201745
26,1,242,5,267,249,6,64,0,833,1073,1906,9,5.5,201745
26,2,301,12,442,393,7,109,0,1264,1372,2636,13,5.4,201745
26,3,428,36,460,573,14,160,0,1671,1809,3480,15,5.333333333,201745
26,4,229,23,205,245,12,63,1,778,991,1769,10,5.2,201745
26,5,76,6,81,84,1,26,0,274,430,704,3,4.5,201745
26,6,252,17,306,360,4,96,0,1035,1187,2222,10,5.333333333,201745
26,7,176,19,168,289,15,51,1,719,835,1554,10,5.5,201745
27,1,171,22,160,390,20,47,0,810,578,1388,9,5.5,201745
27,2,192,14,169,502,6,44,0,927,1001,1928,8,5.666666667,201745
27,3,219,15,139,383,12,29,0,797,884,1681,7,5.666666667,201745
27,4,264,14,219,621,14,59,1,1192,1242,2434,10,3.5,201745
27,5,148,8,82,270,6,25,3,542,814,1356,6,5.333333333,201745
27,6,224,27,263,474,5,74,0,1067,919,1986,9,5,201745
28,1,261,14,406,322,8,43,1,1055,1242,2297,13,6,201745
28,2,281,26,509,308,31,64,52,1271,1301,2572,14,6,201745
28,3,128,14,187,146,6,28,0,509,479,988,7,5.333333333,201745
28,4,343,34,420,348,37,106,21,1309,1305,2614,16,6,201745
28,5,292,26,231,389,23,68,2,1031,1165,2196,12,4,201745
28,6,306,22,245,509,220,42,24,1368,945,2313,14,5.166666667,201745
28,7,296,18,514,344,40,83,0,1295,1233,2528,8,6,201745
28,8,185,12,245,241,28,76,0,787,874,1661,11,5.666666667,201745
28,9,129,5,285,152,15,35,28,649,624,1273,9,6,201745
29,1,281,29,397,255,49,68,2,1081,993,2074,10,5.5,201745
29,2,378,19,289,485,23,84,31,1309,1297,2606,15,4.5,201745
29,3,157,39,162,354,15,74,0,801,633,1434,7,5.666666667,201745
30,1,188,21,138,213,17,53,10,640,610,1250,7,5.333333333,201745
30,2,169,27,115,98,69,36,443,957,881,1838,8,5.25,201745
30,3,195,14,248,216,73,57,40,843,869,1712,6,5.666666667,201745
30,4,148,8,252,163,23,63,1,658,645,1303,8,6,201745
30,5,227,17,228,322,9,83,0,886,952,1838,7,5.5,201745
30,6,158,18,180,224,20,57,0,657,667,1324,9,5.333333333,201745
30,7,280,24,236,274,55,97,36,1002,867,1869,12,5.25,201745
30,8,267,15,296,324,32,108,0,1042,1180,2222,11,5.4,201745
30,9,271,14,185,163,38,64,34,769,800,1569,8,5.5,201745
30,10,289,24,378,346,24,110,23,1194,1139,2333,9,5,201745
30,11,200,14,260,320,16,76,0,886,1020,1906,6,5.5,201745
30,12,343,31,538,595,30,138,0,1675,1705,3380,11,6.25,201745
30,13,187,14,153,296,42,58,5,755,791,1546,10,5.4,201745
30,14,228,32,299,288,110,96,0,1053,1094,2147,9,5.5,201745
30,15,256,10,223,249,43,90,51,922,1122,2044,11,5.666666667,201745
30,16,239,10,219,339,36,95,20,958,952,1910,10,5.333333333,201745
30,17,188,23,175,270,32,81,18,787,976,1763,8,5.5,201745
30,18,155,12,141,200,6,58,16,588,651,1239,8,5.25,201745
30,19,189,13,193,320,26,67,29,837,675,1512,13,5.4,201745
30,20,174,27,192,297,64,51,0,805,817,1622,11,5.4,201745
31,1,231,6,189,342,9,40,0,817,728,1545,8,5.5,201745
31,2,156,27,158,24,183,57,0,605,626,1231,7,5.333333333,201745
31,3,473,32,876,594,47,144,0,2166,2397,4563,17,6.25,201745
31,4,128,12,249,201,46,36,0,672,1218,1890,6,6,201745
31,5,172,16,160,228,25,36,0,637,640,1277,7,5.333333333,201745
32,1,255,42,195,210,27,62,14,805,896,1701,12,5.2,201745
32,2,263,35,209,143,48,58,4,760,855,1615,13,5.142857143,201745
32,3,349,43,200,241,17,47,3,900,901,1801,15,5,201745
32,4,268,63,279,226,27,86,54,1003,1304,2307,13,4.666666667,201745
1,1,185,29,184,222,47,21,2,690,769,1459,13,4.5,201746
1,2,204,32,368,246,62,52,6,970,1061,2031,12,4.2,201746
1,3,164,32,350,298,29,88,0,961,1174,2135,13,4.2,201746
2,1,160,11,260,192,5,55,0,683,780,1463,11,5,201746
2,2,245,8,262,325,3,90,0,933,1067,2000,9,3.666666667,201746
2,3,284,21,389,271,10,81,0,1056,1260,2316,11,3.6,201746
2,4,145,6,247,132,11,29,0,570,569,1139,6,5,201746
2,5,420,25,810,483,88,119,4,1949,2064,4013,16,5.25,201746
2,6,222,11,370,235,10,58,0,906,955,1861,7,5,201746
2,7,285,13,372,273,22,70,2,1037,1092,2129,12,4.75,201746
2,8,235,15,452,346,10,58,0,1116,1252,2368,8,5,201746
3,1,222,22,273,272,14,78,0,881,845,1726,15,4.142857143,201746
3,2,180,2,370,161,14,31,1,759,759,1518,9,5,201746
4,1,136,6,165,270,49,41,0,667,932,1599,15,3.833333333,201746
4,2,193,14,250,284,35,41,2,819,911,1730,14,4.4,201746
5,1,317,10,325,232,18,74,0,976,1000,1976,9,4.666666667,201746
5,2,189,14,199,211,11,37,2,663,780,1443,10,4.2,201746
5,3,212,24,237,317,28,79,2,899,863,1762,9,4.5,201746
5,4,322,32,383,333,11,107,7,1195,1404,2599,11,4,201746
5,5,261,14,263,325,10,54,7,934,1035,1969,8,5,201746
5,6,146,7,124,177,7,23,1,485,680,1165,7,4.5,201746
5,7,184,11,174,179,2,35,3,588,666,1254,8,3,201746
6,1,167,11,211,164,4,64,2,623,712,1335,14,3.714285714,201746
6,2,159,6,221,153,34,45,0,618,566,1184,9,4.666666667,201746
7,1,150,3,71,209,5,14,6,458,714,1172,9,4.25,201746
7,2,135,12,82,445,168,13,5,860,654,1514,9,4.25,201746
7,3,150,3,154,200,57,21,0,585,1188,1773,7,4.333333333,201746
7,4,90,6,118,353,19,35,74,695,968,1663,11,4.4,201746
7,5,203,11,105,393,13,43,70,838,1137,1975,11,4.666666667,201746
7,6,197,22,214,318,25,69,6,851,1098,1949,8,3.5,201746
7,7,163,16,205,590,27,48,15,1064,1644,2708,8,4.5,201746
7,8,198,14,262,635,21,43,1,1174,1198,2372,12,4.25,201746
7,9,217,24,283,357,35,56,58,1030,1282,2312,11,4,201746
7,10,164,9,196,536,65,38,0,1008,1535,2543,9,4.5,201746
7,11,136,2,135,148,4,13,0,438,977,1415,6,4.333333333,201746
7,12,179,5,186,410,6,27,0,813,1433,2246,9,4.5,201746
7,13,96,13,411,64,179,25,1,789,457,1246,9,4.25,201746
8,1,200,12,280,116,18,35,0,661,594,1255,4,5,201746
8,2,76,8,95,52,2,15,0,248,696,944,11,2.5,201746
8,3,258,20,345,266,13,67,0,969,1082,2051,5,5,201746
8,4,166,7,309,94,10,49,1,636,885,1521,9,4,201746
8,5,234,18,193,167,10,54,0,676,978,1654,10,4.25,201746
8,6,226,15,369,321,29,100,2,1062,986,2048,7,2.75,201746
8,7,189,30,167,177,9,64,0,636,743,1379,8,4.25,201746
8,8,113,35,125,137,4,27,0,441,651,1092,7,3,201746
8,9,143,12,125,93,12,46,2,433,532,965,10,3.8,201746
9,1,90,8,138,0,122,38,0,396,431,827,6,5,201746
9,2,337,82,428,810,45,124,112,1938,1997,3935,12,5,201746
9,3,184,40,295,476,30,77,3,1105,870,1975,7,5,201746
9,4,174,17,251,597,27,62,2,1130,1070,2200,11,5,201746
9,5,136,9,215,10,60,56,249,735,773,1508,7,5,201746
9,6,107,53,131,104,55,49,20,519,606,1125,7,5,201746
9,7,107,16,193,373,6,41,0,736,680,1416,9,5,201746
9,8,43,11,84,145,31,29,1,344,506,850,6,5,201746
9,9,97,5,130,281,34,33,4,584,742,1326,5,5,201746
9,10,129,17,240,43,15,57,266,767,849,1616,6,5,201746
9,11,185,12,310,524,45,83,8,1167,1148,2315,7,5,201746
9,12,149,38,367,620,10,71,10,1265,1132,2397,11,5,201746
9,13,166,18,191,356,40,44,10,825,870,1695,4,5,201746
9,14,123,7,179,55,175,56,0,595,646,1241,5,5,201746
9,15,279,27,770,1206,15,136,6,2439,2102,4541,11,4.75,201746
9,16,310,34,357,677,34,100,0,1512,1474,2986,15,6,201746
9,17,132,5,218,297,10,46,0,708,626,1334,6,5,201746
9,18,222,23,286,527,23,92,54,1227,1238,2465,12,5,201746
9,19,198,42,256,369,73,59,9,1006,1086,2092,5,5,201746
9,20,4,3,2,6,1,1,0,17,24,41,5,5,201746
9,21,88,7,124,13,27,37,155,451,517,968,3,5,201746
9,22,173,9,205,318,74,48,30,857,890,1747,5,5,201746
9,23,183,14,276,15,67,46,303,904,1098,2002,7,5,201746
9,24,293,32,466,530,95,101,218,1735,1754,3489,13,5,201746
10,1,138,17,153,183,22,36,13,562,640,1202,12,4.166666667,201746
10,2,219,10,206,211,12,44,6,708,873,1581,8,3.5,201746
10,3,172,18,132,151,12,49,19,553,499,1052,12,4.4,201746
10,4,297,23,318,413,13,70,0,1134,1305,2439,12,3.8,201746
11,1,131,30,143,215,15,26,4,564,725,1289,6,4.666666667,201746
11,2,171,18,205,191,25,43,2,655,701,1356,7,5,201746
11,3,171,18,172,228,5,37,0,631,558,1189,4,5,201746
11,4,142,22,159,197,1,28,0,549,732,1281,10,3.2,201746
11,5,281,39,270,354,12,89,0,1045,1041,2086,8,5.5,201746
11,6,170,26,210,206,22,51,4,689,629,1318,8,4.666666667,201746
11,7,183,21,220,290,10,44,0,768,984,1752,9,4.5,201746
11,8,177,20,186,261,24,31,0,699,802,1501,9,4.75,201746
11,9,234,42,237,302,7,51,2,875,942,1817,10,4.666666667,201746
11,10,152,26,201,172,8,46,14,619,810,1429,11,4.6,201746
11,11,180,29,176,215,12,49,0,661,1231,1892,4,5,201746
11,12,197,13,319,335,9,31,0,904,978,1882,7,5.5,201746
11,13,143,16,168,184,24,34,32,601,659,1260,9,4.5,201746
11,14,150,29,151,175,17,37,0,559,661,1220,8,4.5,201746
11,15,110,25,107,164,0,32,0,438,483,921,6,5,201746
12,1,108,17,184,86,45,27,0,467,683,1150,10,4.2,201746
12,2,158,20,150,321,6,37,0,692,985,1677,10,4.5,201746
12,3,119,20,173,211,39,40,2,604,976,1580,11,4.2,201746
12,4,150,14,246,326,22,32,38,828,1041,1869,9,4.666666667,201746
12,5,110,6,65,150,0,11,4,346,718,1064,10,4.25,201746
12,6,93,5,87,203,20,18,0,426,842,1268,10,4.25,201746
12,7,162,16,141,285,10,37,18,669,840,1509,6,3,201746
12,8,161,8,157,197,13,18,0,554,748,1302,9,4.25,201746
12,9,144,13,173,406,11,13,7,767,939,1706,9,4.666666667,201746
13,1,102,16,59,247,52,37,0,513,700,1213,9,4.333333333,201746
13,2,104,14,81,171,49,22,0,441,484,925,6,4.333333333,201746
13,3,116,12,129,178,47,35,0,517,615,1132,12,4.25,201746
13,4,118,11,164,139,40,36,16,524,593,1117,9,4.666666667,201746
13,5,190,13,268,239,54,64,3,831,876,1707,9,4.75,201746
13,6,384,39,576,517,34,73,2,1625,1493,3118,13,4.25,201746
13,7,152,15,218,220,18,49,0,672,730,1402,9,4.5,201746
14,1,158,14,118,92,15,31,8,436,482,918,6,4.5,201746
14,2,144,12,144,85,9,48,0,442,487,929,6,4.666666667,201746
14,3,240,15,208,94,4,79,3,643,570,1213,11,4.4,201746
14,4,214,18,235,299,14,58,3,841,912,1753,12,5,201746
14,5,203,11,357,154,33,47,3,808,986,1794,11,4.5,201746
14,6,200,6,304,214,6,34,0,764,808,1572,11,5,201746
14,7,158,6,194,89,1,37,0,485,476,961,6,5,201746
14,8,331,37,599,442,22,130,2,1563,1978,3541,13,3.833333333,201746
14,9,213,26,297,267,23,67,0,893,1121,2014,8,5,201746
14,10,197,26,350,225,11,67,1,877,865,1742,7,5,201746
14,11,119,5,148,145,17,38,0,472,483,955,4,5,201746
14,12,285,10,427,148,3,60,0,933,946,1879,11,4.5,201746
14,13,170,13,194,143,9,38,0,567,692,1259,8,5,201746
14,14,179,19,282,225,9,59,1,774,836,1610,7,6,201746
14,15,184,28,193,205,15,49,13,687,744,1431,10,4.6,201746
14,16,162,12,186,128,17,30,1,536,845,1381,5,5,201746
14,17,117,19,134,107,11,39,23,450,434,884,9,4.25,201746
14,18,185,22,248,148,18,49,9,679,533,1212,10,4.4,201746
14,19,163,18,203,184,29,53,3,653,654,1307,9,4.25,201746
14,20,98,10,124,67,4,26,0,329,259,588,10,4.666666667,201746
15,1,137,4,114,88,56,31,0,430,444,874,7,4.333333333,201746
15,2,159,16,186,229,41,48,3,682,928,1610,6,5,201746
15,3,143,9,178,178,20,33,1,562,841,1403,10,4.666666667,201746
15,4,187,14,223,301,19,57,13,814,878,1692,4,5,201746
15,5,122,13,142,190,3,37,0,507,739,1246,8,4.666666667,201746
15,6,190,15,278,326,40,61,1,911,1269,2180,7,5.5,201746
15,7,188,13,246,310,35,45,0,837,960,1797,10,5,201746
15,8,107,13,122,148,6,29,0,425,435,860,4,5,201746
15,9,187,7,68,183,78,27,12,562,691,1253,9,4.75,201746
15,10,144,9,199,222,44,49,0,667,755,1422,9,5,201746
15,11,204,9,234,297,22,44,0,810,866,1676,8,5,201746
15,12,214,5,392,363,15,60,0,1049,1241,2290,8,5,201746
15,13,106,10,138,147,71,42,0,514,610,1124,8,5,201746
15,14,82,2,104,132,23,25,0,368,505,873,4,5,201746
15,15,203,32,208,293,19,68,0,823,860,1683,6,5,201746
15,16,217,25,269,463,4,55,1,1034,1340,2374,8,5,201746
15,17,128,5,168,285,17,51,0,654,620,1274,8,5,201746
15,18,192,21,239,270,24,55,0,801,988,1789,7,4.666666667,201746
15,19,233,70,376,573,9,84,1,1346,1586,2932,14,5,201746
15,20,109,6,150,216,13,33,0,527,906,1433,6,5,201746
15,21,85,5,79,120,14,25,1,329,368,697,6,4.5,201746
15,22,292,35,329,518,17,101,0,1292,2450,3742,14,5,201746
15,23,178,13,139,217,21,48,0,616,799,1415,7,4.333333333,201746
15,24,127,10,164,261,9,40,1,612,724,1336,4,5,201746
15,25,172,14,262,248,3,35,0,734,945,1679,6,5,201746
15,26,137,3,148,128,21,28,0,465,586,1051,14,4.333333333,201746
15,27,192,10,208,335,5,63,0,813,939,1752,9,4.666666667,201746
15,28,219,16,377,253,36,60,0,961,1197,2158,9,4.666666667,201746
15,29,214,16,222,435,5,59,0,951,1200,2151,8,5,201746
15,30,149,16,271,262,28,35,2,763,1088,1851,12,5,201746
15,31,151,28,147,272,7,39,0,644,804,1448,6,5,201746
15,32,131,8,214,348,21,29,0,751,1001,1752,9,5,201746
15,33,169,7,208,317,16,48,0,765,1027,1792,7,5,201746
15,34,186,11,145,284,6,52,0,684,755,1439,8,5,201746
15,35,200,14,160,250,12,63,0,699,835,1534,9,4.666666667,201746
15,36,172,5,171,179,41,29,0,597,706,1303,9,4.25,201746
15,37,211,14,253,327,29,79,7,920,1070,1990,7,5,201746
15,38,200,16,206,286,6,56,0,770,830,1600,6,4.5,201746
15,39,120,17,178,265,14,41,0,635,742,1377,4,5,201746
15,40,296,16,227,329,38,86,1,993,1102,2095,9,5,201746
15,41,287,26,427,516,37,56,12,1361,1569,2930,11,5,201746
16,1,117,7,195,115,7,27,0,468,652,1120,10,4.333333333,201746
16,2,107,10,86,112,13,13,0,341,371,712,9,4.25,201746
16,3,133,11,132,188,26,26,0,516,691,1207,10,4.25,201746
16,4,157,16,182,102,24,67,0,548,639,1187,8,4.5,201746
16,5,182,20,173,168,15,60,4,622,668,1290,10,4.666666667,201746
16,6,155,17,133,168,32,16,0,521,572,1093,12,4.5,201746
16,7,115,18,126,118,21,42,0,440,543,983,9,4.5,201746
16,8,274,18,408,343,5,83,2,1133,1180,2313,12,5,201746
16,9,185,19,161,156,11,61,0,593,669,1262,10,5,201746
16,10,159,12,272,246,7,37,0,733,723,1456,8,4,201746
16,11,155,20,139,93,72,36,0,515,529,1044,12,4.4,201746
16,12,158,17,180,97,16,40,0,508,526,1034,10,4.25,201746
17,1,206,19,307,396,31,52,5,1016,1096,2112,12,3.5,201746
17,2,108,7,204,371,6,46,11,753,774,1527,9,4.666666667,201746
17,3,169,17,279,521,16,47,0,1049,1149,2198,8,4.5,201746
17,4,152,10,229,364,12,47,73,887,949,1836,10,4.666666667,201746
17,5,66,6,91,172,9,37,2,383,432,815,5,4.5,201746
18,1,130,11,99,111,10,28,0,389,603,992,9,4.4,201746
18,2,199,17,293,235,56,65,0,865,1107,1972,10,4.75,201746
18,3,176,17,307,169,4,39,0,712,646,1358,9,5,201746
19,1,259,14,318,306,17,64,2,980,1005,1985,9,5,201746
19,2,263,14,545,260,49,92,0,1223,1587,2810,10,5.5,201746
19,3,292,19,455,293,16,70,0,1145,1283,2428,8,5,201746
19,4,121,8,150,122,29,56,25,511,551,1062,5,5,201746
19,5,320,23,376,434,10,88,2,1253,1509,2762,8,5,201746
19,6,108,8,196,156,9,42,7,526,565,1091,5,5,201746
19,7,194,4,546,165,7,41,0,957,1120,2077,10,4.5,201746
19,8,56,2,99,74,2,16,0,249,153,402,7,5,201746
19,9,233,17,188,204,23,44,0,709,783,1492,9,4.25,201746
19,10,152,10,209,246,7,67,0,691,785,1476,8,2.666666667,201746
19,11,478,41,508,711,10,141,3,1892,2144,4036,13,5.333333333,201746
19,12,181,5,447,176,7,42,3,861,957,1818,8,5,201746
20,1,149,8,160,154,34,33,0,538,663,1201,7,4.5,201746
20,2,122,10,96,83,25,28,0,364,479,843,6,4.333333333,201746
20,3,108,5,96,114,77,35,1,436,356,792,6,4.333333333,201746
20,4,51,12,57,160,22,13,0,315,482,797,6,4.333333333,201746
20,5,123,11,159,249,27,37,13,619,757,1376,11,4.25,201746
20,6,143,10,85,191,89,16,0,534,1083,1617,8,4.25,201746
20,7,204,16,373,333,34,84,0,1044,1044,2088,8,4.75,201746
20,8,246,24,268,515,17,51,33,1154,1309,2463,15,4,201746
20,9,123,13,129,183,41,49,3,541,547,1088,8,4.666666667,201746
20,10,74,6,54,121,7,19,0,281,665,946,9,4.25,201746
21,1,154,15,160,296,12,28,0,665,877,1542,9,4.4,201746
21,2,175,16,140,117,26,37,1,512,751,1263,9,4.2,201746
21,3,206,8,183,129,52,64,12,654,781,1435,8,4.5,201746
21,4,126,7,131,47,93,69,57,530,510,1040,6,4.25,201746
21,5,127,6,224,117,15,41,21,551,854,1405,8,4.666666667,201746
21,6,234,14,270,388,31,66,22,1025,1161,2186,6,6,201746
21,7,141,11,182,73,83,65,17,572,761,1333,9,4.666666667,201746
21,8,186,9,170,153,41,55,0,614,808,1422,10,4.2,201746
21,9,193,11,281,342,37,68,12,944,1223,2167,9,5,201746
21,10,170,5,318,233,30,51,11,818,1028,1846,7,5,201746
21,11,39,2,58,31,14,11,5,160,213,373,6,3,201746
21,12,361,12,565,431,90,101,90,1650,1957,3607,15,3.666666667,201746
21,13,167,7,153,331,17,46,1,722,983,1705,8,4.666666667,201746
21,14,147,1,195,69,45,40,3,500,863,1363,13,4.333333333,201746
21,15,167,5,239,177,34,42,4,668,803,1471,7,4.5,201746
22,1,125,17,90,200,22,14,0,468,871,1339,11,3.2,201746
22,2,132,16,228,135,36,26,26,599,717,1316,7,3.5,201746
22,3,303,40,453,362,19,73,1,1251,1393,2644,10,3.666666667,201746
22,4,185,17,432,290,18,52,0,994,1117,2111,13,2.6,201746
22,5,112,16,232,113,19,22,1,515,610,1125,10,3.5,201746
23,1,250,8,805,339,14,32,0,1448,1484,2932,14,4.6,201746
23,2,176,40,316,436,12,32,0,1012,1144,2156,10,3.4,201746
23,3,283,12,797,380,20,46,0,1538,1456,2994,11,5,201746
23,4,132,3,471,147,21,19,0,793,1259,2052,8,3.666666667,201746
24,1,124,37,132,277,22,22,1,615,818,1433,11,4.2,201746
24,2,100,12,120,135,10,37,0,414,506,920,6,4.5,201746
24,3,165,33,166,595,84,37,0,1080,1135,2215,9,4.25,201746
24,4,134,17,162,130,33,46,50,572,604,1176,5,4.5,201746
24,5,203,28,313,394,10,61,0,1009,1073,2082,9,4,201746
24,6,366,25,348,440,20,71,0,1270,1232,2502,11,4,201746
24,7,148,20,233,369,26,35,0,831,916,1747,9,4.25,201746
25,1,145,15,147,190,8,43,0,548,605,1153,14,3.5,201746
25,2,252,15,265,255,29,55,0,871,1014,1885,7,2,201746
25,3,178,14,177,248,18,44,2,681,586,1267,9,3.6,201746
25,4,193,17,115,208,10,49,10,602,592,1194,8,2.666666667,201746
25,5,218,8,221,339,15,64,0,865,1169,2034,11,3,201746
25,6,204,4,379,110,11,60,0,768,861,1629,9,3.5,201746
25,7,211,14,203,302,5,66,0,801,902,1703,7,2.5,201746
26,1,206,6,219,207,3,62,0,703,779,1482,9,4.5,201746
26,2,192,6,314,313,3,68,0,896,1066,1962,13,4.4,201746
26,3,351,20,421,533,12,117,0,1454,1560,3014,15,4.333333333,201746
26,4,139,10,157,208,9,68,0,591,689,1280,10,4.2,201746
26,5,28,4,39,56,3,26,0,156,281,437,3,4.5,201746
26,6,179,11,247,279,2,73,0,791,939,1730,10,4.333333333,201746
26,7,142,11,148,217,10,33,0,561,699,1260,10,4.5,201746
27,1,123,11,108,232,15,26,0,515,598,1113,9,4.5,201746
27,2,180,13,117,359,3,23,0,695,941,1636,8,4.666666667,201746
27,3,141,13,89,298,4,30,0,575,731,1306,7,4.666666667,201746
27,4,240,15,200,566,7,39,4,1071,1102,2173,10,3.5,201746
27,5,126,8,67,191,7,15,0,414,716,1130,6,4.333333333,201746
27,6,251,13,171,432,30,0,0,897,756,1653,9,4.333333333,201746
28,1,219,11,279,250,7,47,0,813,957,1770,13,5,201746
28,2,242,10,435,222,28,49,48,1034,1180,2214,14,5,201746
28,3,141,21,142,164,14,39,1,522,485,1007,7,4.333333333,201746
28,4,276,18,315,269,36,68,19,1001,1106,2107,16,5,201746
28,5,214,21,172,270,16,59,0,752,834,1586,12,3,201746
28,6,198,28,164,531,99,30,11,1061,835,1896,14,4.333333333,201746
28,7,229,17,355,290,34,65,0,990,1114,2104,8,5,201746
28,8,172,21,186,230,26,60,0,695,693,1388,11,4.666666667,201746
28,9,117,5,223,144,11,23,12,535,525,1060,9,5,201746
29,1,195,22,227,179,28,34,2,687,929,1616,10,4.5,201746
29,2,239,14,144,372,10,47,16,842,1117,1959,14,3.833333333,201746
29,3,106,13,100,219,10,22,0,470,500,970,7,4.666666667,201746
30,1,92,12,93,155,16,27,11,406,331,737,7,4.333333333,201746
30,2,100,15,91,57,27,20,124,434,559,993,8,4.25,201746
30,3,135,9,172,116,31,36,24,523,665,1188,6,4.666666667,201746
30,4,122,6,204,167,20,38,1,558,534,1092,8,5,201746
30,5,150,7,189,262,11,60,0,679,652,1331,7,4.5,201746
30,6,154,8,138,187,14,33,0,534,570,1104,9,4.333333333,201746
30,7,154,12,170,182,30,40,19,607,796,1403,12,4.25,201746
30,8,164,10,192,194,32,60,1,653,766,1419,11,4.4,201746
30,9,148,8,127,126,23,38,13,483,768,1251,8,4.5,201746
30,10,153,11,228,243,17,55,8,715,969,1684,9,4,201746
30,11,197,13,258,279,12,62,0,821,855,1676,6,4.5,201746
30,12,316,23,454,523,20,114,0,1450,1464,2914,11,5.25,201746
30,13,188,8,137,249,41,50,1,674,773,1447,10,4.4,201746
30,14,141,16,188,129,51,52,0,577,812,1389,9,4.5,201746
30,15,185,12,152,173,23,55,36,636,744,1380,11,4.666666667,201746
30,16,173,11,177,253,23,74,14,725,845,1570,10,4.333333333,201746
30,17,96,10,107,156,18,28,2,417,955,1372,8,4.25,201746
30,18,131,10,114,150,7,36,13,461,765,1226,8,4.25,201746
30,19,209,10,172,187,33,43,48,702,698,1400,13,4.6,201746
30,20,150,11,152,292,46,44,0,695,761,1456,11,4.4,201746
31,1,154,19,162,182,16,33,0,566,718,1284,8,4.5,201746
31,2,89,5,93,16,122,19,0,344,296,640,7,4.333333333,201746
31,3,329,32,525,338,45,73,0,1342,1822,3164,17,4.5,201746
31,4,141,6,205,161,25,28,0,566,610,1176,6,3.5,201746
31,5,117,12,89,170,10,38,0,436,550,986,7,4.333333333,201746
32,1,177,18,152,151,18,28,10,554,690,1244,12,4.2,201746
32,2,147,27,153,120,29,27,6,509,572,1081,13,4.142857143,201746
32,3,154,36,156,201,11,43,3,604,1112,1716,15,4.333333333,201746
32,4,198,56,227,222,31,57,44,835,837,1672,13,3.833333333,201746
1,1,237,50,258,267,44,55,4,915,1000,1915,13,5.5,201747
1,2,282,47,577,334,78,99,3,1420,1308,2728,12,5,201747
1,3,250,42,621,391,46,77,0,1427,1298,2725,13,5.2,201747
2,1,195,11,313,272,15,67,0,873,953,1826,11,6,201747
2,2,284,13,330,475,6,130,0,1238,1395,2633,9,4.666666667,201747
2,3,411,19,555,388,30,179,0,1582,1306,2888,11,4.8,201747
2,4,176,7,325,184,7,41,0,740,656,1396,6,6,201747
2,5,522,25,1052,612,95,206,2,2514,2355,4869,16,6.25,201747
2,6,291,12,455,301,14,64,0,1137,1038,2175,7,6,201747
2,7,362,14,508,363,22,82,6,1357,1397,2754,12,5.75,201747
2,8,307,12,570,424,13,94,0,1420,1301,2721,8,6,201747
3,1,272,13,360,352,18,129,3,1147,894,2041,15,5.142857143,201747
3,2,186,11,437,212,11,36,0,893,894,1787,9,6,201747
4,1,319,21,408,583,59,70,1,1461,1327,2788,15,5,201747
4,2,266,25,382,436,38,64,4,1215,867,2082,14,5.4,201747
5,1,349,10,452,370,25,111,0,1317,1257,2574,9,5.666666667,201747
5,2,161,18,192,198,14,36,1,620,778,1398,10,5.2,201747
5,3,159,27,271,411,34,85,0,987,1119,2106,9,5.5,201747
5,4,395,51,578,474,14,154,9,1675,1386,3061,11,5.75,201747
5,5,266,21,326,432,17,83,17,1162,1137,2299,8,6,201747
5,6,159,19,204,324,14,41,19,780,732,1512,7,5.5,201747
5,7,210,18,208,207,4,48,0,694,594,1288,9,4,201747
6,1,251,20,298,278,4,64,6,921,908,1829,14,4.857142857,201747
6,2,203,10,294,196,70,68,0,841,671,1512,9,5.666666667,201747
7,1,289,9,255,638,15,27,6,1239,1318,2557,9,5.25,201747
7,2,262,6,159,224,117,35,1,804,1786,2590,9,5.25,201747
7,3,270,7,179,221,68,50,0,795,618,1413,7,5.333333333,201747
7,4,217,24,208,529,17,45,159,1199,1287,2486,11,5.4,201747
7,5,380,16,300,661,23,52,168,1600,1822,3422,11,5.666666667,201747
7,6,249,13,323,580,49,78,12,1304,1251,2555,8,4.25,201747
7,7,332,27,302,723,60,82,42,1568,2026,3594,8,5.5,201747
7,8,394,15,293,750,33,84,0,1569,2089,3658,12,5.25,201747
7,9,364,20,520,532,50,122,178,1786,1846,3632,11,5.5,201747
7,10,245,13,371,681,135,55,0,1500,1998,3498,9,5.5,201747
7,11,173,8,304,279,19,17,0,800,329,1129,6,5.333333333,201747
7,12,278,17,333,688,6,60,0,1382,1753,3135,9,5.5,201747
7,13,218,26,675,132,317,71,0,1439,1095,2534,9,5.25,201747
8,1,253,9,334,150,13,29,0,788,777,1565,4,6,201747
8,2,272,13,385,233,19,72,0,994,828,1822,12,3.666666667,201747
8,3,271,34,459,310,9,83,3,1169,1199,2368,5,6,201747
8,4,225,19,504,209,27,86,1,1071,1185,2256,9,6,201747
8,5,287,26,322,253,27,75,2,992,829,1821,10,5.25,201747
8,6,271,27,433,410,46,105,1,1293,1094,2387,7,3.25,201747
8,7,208,28,171,229,12,73,0,721,760,1481,6,4,201747
8,8,313,57,321,307,13,84,0,1095,897,1992,12,6,201747
8,9,241,73,179,154,17,57,21,742,650,1392,10,4.8,201747
9,1,133,11,210,6,162,52,0,574,594,1168,6,7,201747
9,2,396,101,612,965,74,187,216,2551,2938,5489,12,6,201747
9,3,237,44,393,619,47,114,24,1478,1420,2898,7,6,201747
9,4,260,17,413,776,41,96,9,1612,1456,3068,11,6,201747
9,5,164,22,259,5,79,81,335,945,917,1862,7,6,201747
9,6,140,94,195,158,58,70,29,744,744,1488,7,6,201747
9,7,139,11,288,491,9,58,0,996,873,1869,9,6,201747
9,8,49,22,167,163,27,47,8,483,517,1000,6,7,201747
9,9,140,10,235,401,44,65,5,900,834,1734,5,6,201747
9,10,156,16,361,22,27,70,380,1032,1000,2032,6,6,201747
9,11,274,21,465,738,43,104,9,1654,1574,3228,7,6,201747
9,12,213,69,473,786,18,119,19,1697,1717,3414,11,6,201747
9,13,199,18,321,449,44,81,9,1121,980,2101,4,6,201747
9,14,142,12,192,103,234,77,0,760,791,1551,5,6,201747
9,15,379,36,909,1221,17,187,12,2761,3006,5767,11,4.5,201747
9,16,305,68,503,876,34,154,0,1940,2062,4002,15,7,201747
9,17,153,10,273,426,11,65,0,938,919,1857,6,6,201747
9,18,270,46,413,696,53,141,34,1653,1640,3293,12,6,201747
9,19,305,47,391,506,108,104,10,1471,1265,2736,5,6,201747
9,20,6,4,14,27,2,5,0,58,15,73,5,6,201747
9,21,126,17,193,22,73,70,285,786,697,1483,3,6,201747
9,22,206,11,259,378,103,68,36,1061,1100,2161,5,6,201747
9,23,185,14,342,24,75,83,461,1184,1329,2513,7,7,201747
9,24,371,52,648,723,149,170,316,2429,2305,4734,13,6.5,201747
10,1,259,42,219,255,42,59,9,885,804,1689,12,5,201747
10,2,243,18,245,263,26,59,16,870,955,1825,9,5.25,201747
10,3,274,28,181,224,18,86,74,885,510,1395,12,5.4,201747
10,4,451,34,445,465,17,68,0,1480,1405,2885,12,4.8,201747
11,1,163,58,228,278,15,55,7,804,710,1514,6,5.666666667,201747
11,2,205,23,264,263,26,66,7,854,777,1631,7,6,201747
11,3,224,27,208,306,18,48,0,831,665,1496,4,6,201747
11,4,212,46,193,295,5,45,0,796,831,1627,10,4,201747
11,5,368,56,354,467,16,117,0,1378,1154,2532,8,6.5,201747
11,6,213,36,332,319,31,80,6,1017,752,1769,8,5.666666667,201747
11,7,247,51,293,471,20,55,0,1137,1187,2324,9,5.5,201747
11,8,216,40,323,400,23,54,0,1056,925,1981,9,5.75,201747
11,9,289,79,378,435,12,99,1,1293,1106,2399,10,5.666666667,201747
11,10,193,38,260,280,21,55,14,861,851,1712,11,5.6,201747
11,11,239,38,246,272,23,73,0,891,1053,1944,4,6,201747
11,12,232,38,373,435,16,60,0,1154,1053,2207,7,6.5,201747
11,13,255,38,296,236,36,57,39,957,805,1762,9,5.5,201747
11,14,202,38,224,238,18,63,1,784,744,1528,8,5.5,201747
11,15,134,38,214,198,6,48,0,638,578,1216,6,6,201747
12,1,123,18,217,151,40,34,11,594,631,1225,10,5,201747
12,2,235,36,249,436,21,76,0,1053,1252,2305,10,5.5,201747
12,3,213,30,214,388,112,42,2,1001,1090,2091,11,5.2,201747
12,4,225,24,337,162,60,59,345,1212,1210,2422,9,6,201747
12,5,247,17,204,294,2,35,16,815,839,1654,10,5.25,201747
12,6,233,17,322,484,44,17,2,1119,1287,2406,10,5.25,201747
12,7,289,34,272,469,13,60,84,1221,1193,2414,8,4,201747
12,8,239,25,352,325,8,18,0,967,1441,2408,9,5.25,201747
12,9,224,18,246,501,23,51,43,1106,1094,2200,9,5.666666667,201747
13,1,158,24,208,541,129,43,0,1103,994,2097,9,5.333333333,201747
13,2,154,21,114,240,80,41,0,650,789,1439,6,5.333333333,201747
13,3,204,27,232,277,81,95,0,916,1029,1945,12,5.25,201747
13,4,234,16,317,281,82,57,9,996,1042,2038,9,5.666666667,201747
13,5,251,25,388,287,93,96,7,1147,1212,2359,9,5.75,201747
13,6,343,54,776,608,31,85,4,1901,2019,3920,13,5.5,201747
13,7,213,29,347,340,39,58,0,1026,1141,2167,9,5.5,201747
14,1,171,32,111,109,29,59,13,524,600,1124,6,5.25,201747
14,2,192,28,191,112,19,76,0,618,550,1168,6,5.666666667,201747
14,3,345,18,217,124,14,78,5,801,850,1651,11,5.4,201747
14,4,256,24,279,381,22,72,7,1041,1060,2101,12,6,201747
14,5,220,19,408,215,38,61,7,968,1106,2074,11,5.5,201747
14,6,277,14,388,257,11,56,0,1003,1206,2209,11,6,201747
14,7,162,7,239,107,0,39,1,555,422,977,6,6,201747
14,8,360,28,723,607,35,140,0,1893,2089,3982,12,4.5,201747
14,9,282,26,344,404,29,68,0,1153,1120,2273,8,6,201747
14,10,276,47,406,347,13,103,0,1192,1092,2284,7,6,201747
14,11,138,19,182,174,41,36,4,594,583,1177,4,6,201747
14,12,285,17,496,174,4,60,0,1036,999,2035,11,5.5,201747
14,13,244,13,259,188,21,48,0,773,768,1541,8,6,201747
14,14,203,31,313,320,14,63,10,954,915,1869,7,7,201747
14,15,223,34,225,239,16,89,5,831,770,1601,10,5.6,201747
14,16,166,10,170,135,23,48,1,553,596,1149,5,4,201747
14,17,210,33,145,128,24,66,28,634,623,1257,9,5.25,201747
14,18,254,22,219,170,27,62,21,775,851,1626,10,5.4,201747
14,19,220,21,218,239,45,59,11,813,773,1586,9,5.25,201747
14,20,152,9,172,62,4,37,4,440,444,884,10,5,201747
15,1,134,12,128,95,119,28,0,516,576,1092,7,5.333333333,201747
15,2,212,16,289,324,57,54,2,954,1004,1958,6,6,201747
15,3,228,16,277,262,34,62,0,879,935,1814,10,5.666666667,201747
15,4,291,19,309,439,32,96,24,1210,1057,2267,4,6,201747
15,5,181,23,216,273,11,27,0,731,773,1504,8,5.666666667,201747
15,6,265,14,338,390,51,84,1,1143,1306,2449,7,6.5,201747
15,7,204,19,309,368,43,64,0,1007,1100,2107,10,6,201747
15,8,164,17,172,234,8,38,0,633,526,1159,4,6,201747
15,9,214,13,104,180,101,36,11,659,697,1356,9,5.75,201747
15,10,174,16,277,311,42,53,0,873,905,1778,9,5,201747
15,11,258,13,319,419,38,76,0,1123,1735,2858,8,6,201747
15,12,288,21,605,540,36,82,0,1572,1353,2925,8,5,201747
15,13,151,10,201,232,86,52,0,732,673,1405,8,5,201747
15,14,117,8,121,171,30,49,0,496,474,970,4,5,201747
15,15,212,44,291,419,33,82,0,1081,988,2069,6,6,201747
15,16,251,39,390,616,14,82,6,1398,1381,2779,8,5,201747
15,17,155,14,220,377,19,66,2,853,905,1758,8,5,201747
15,18,289,23,329,427,19,67,1,1155,1276,2431,7,5.666666667,201747
15,19,322,91,527,775,9,108,0,1832,1838,3670,14,6,201747
15,20,118,16,204,266,14,54,1,673,931,1604,6,6,201747
15,21,137,14,122,174,9,60,1,517,588,1105,6,5.5,201747
15,22,363,52,487,725,31,138,4,1800,2354,4154,14,6,201747
15,23,211,27,245,386,49,120,0,1038,588,1626,7,5.333333333,201747
15,24,156,17,250,296,11,42,3,775,1269,2044,4,6,201747
15,25,247,39,364,325,11,63,0,1049,1037,2086,6,6,201747
15,26,189,12,257,228,32,60,0,778,653,1431,10,3.333333333,201747
15,27,277,23,313,491,9,107,0,1220,1117,2337,9,5.333333333,201747
15,28,272,18,502,347,47,100,0,1286,1294,2580,9,5.666666667,201747
15,29,292,32,328,563,16,96,0,1327,1339,2666,8,6,201747
15,30,236,24,424,375,45,52,1,1157,1343,2500,12,6,201747
15,31,195,48,246,396,21,66,0,972,897,1869,6,6,201747
15,32,223,19,265,425,38,62,0,1032,1049,2081,9,6,201747
15,33,270,15,294,432,32,79,0,1122,1112,2234,7,6,201747
15,34,204,17,223,394,7,63,0,908,909,1817,8,6,201747
15,35,325,28,241,375,20,92,0,1081,1078,2159,9,5.333333333,201747
15,36,257,27,225,283,48,56,0,896,1079,1975,9,5.25,201747
15,37,269,33,361,485,61,94,16,1319,1222,2541,7,6,201747
15,38,234,30,304,379,14,65,0,1026,981,2007,6,5.5,201747
15,39,180,16,291,356,13,55,1,912,857,1769,4,6,201747
15,40,353,22,384,458,81,113,1,1412,1213,2625,9,6,201747
15,41,311,38,616,690,49,90,18,1812,1694,3506,11,6,201747
16,1,190,30,238,215,10,49,0,732,879,1611,10,5.333333333,201747
16,2,101,20,167,221,19,35,0,563,485,1048,9,5.25,201747
16,3,160,14,200,221,44,45,0,684,655,1339,10,5.25,201747
16,4,204,34,188,163,35,61,0,685,766,1451,8,5.5,201747
16,5,227,36,217,225,39,74,13,831,861,1692,10,5.666666667,201747
16,6,184,27,169,206,50,52,0,688,750,1438,12,5.5,201747
16,7,236,27,167,203,39,64,0,736,733,1469,9,5.5,201747
16,8,380,49,457,473,19,102,3,1483,1526,3009,12,6,201747
16,9,255,27,265,262,22,77,0,908,775,1683,10,6,201747
16,10,186,19,323,340,7,65,0,940,979,1919,8,5.666666667,201747
16,11,236,26,169,157,115,77,3,783,740,1523,12,5.4,201747
16,12,206,22,224,164,26,59,0,701,716,1417,10,5.25,201747
17,1,266,21,416,602,21,92,6,1424,1318,2742,12,4.5,201747
17,2,175,15,304,452,7,64,25,1042,1151,2193,9,5.666666667,201747
17,3,248,29,452,687,18,83,0,1517,1289,2806,8,5.5,201747
17,4,248,26,385,389,20,69,106,1243,1153,2396,10,5.666666667,201747
17,5,139,18,144,221,16,32,52,622,537,1159,5,5.5,201747
18,1,238,28,170,191,32,70,0,729,909,1638,9,5.4,201747
18,2,365,27,433,360,57,98,0,1340,1253,2593,10,6,201747
18,3,158,13,430,202,2,51,0,856,869,1725,9,5.75,201747
19,1,249,16,336,357,31,86,0,1075,991,2066,9,6,201747
19,2,363,16,635,299,64,82,0,1459,1859,3318,10,6.5,201747
19,3,330,16,545,381,22,82,0,1376,1426,2802,8,6,201747
19,4,160,15,217,165,28,57,32,674,560,1234,5,6,201747
19,5,368,22,480,596,23,99,10,1598,1470,3068,8,6,201747
19,6,133,4,210,221,7,56,9,640,568,1208,5,6,201747
19,7,273,10,596,237,6,46,0,1168,1232,2400,10,5.5,201747
19,8,70,3,98,94,0,23,1,289,347,636,7,6,201747
19,9,306,22,303,319,17,68,0,1035,728,1763,9,5.25,201747
19,10,210,12,244,311,7,91,0,875,747,1622,7,2.666666667,201747
19,11,518,45,661,838,20,168,4,2254,2138,4392,13,6.333333333,201747
19,12,237,14,514,205,9,60,2,1041,1031,2072,8,6,201747
20,1,232,22,223,294,53,75,0,899,834,1733,7,5.5,201747
20,2,198,8,201,192,25,47,0,671,628,1299,6,5.333333333,201747
20,3,236,23,261,246,249,61,2,1078,473,1551,6,5.333333333,201747
20,4,92,13,93,180,29,55,0,462,472,934,6,5.333333333,201747
20,5,194,12,277,349,131,62,3,1028,820,1848,11,5.25,201747
20,6,289,14,266,472,240,42,1,1324,1205,2529,8,5.25,201747
20,7,212,19,470,420,9,114,0,1244,1270,2514,8,5.5,201747
20,8,473,41,408,852,34,136,62,2006,1883,3889,15,5.333333333,201747
20,9,207,20,174,263,89,76,4,833,829,1662,8,5.333333333,201747
20,10,221,15,244,317,22,51,0,870,1119,1989,9,5.25,201747
21,1,192,9,258,412,17,48,0,936,890,1826,9,5.4,201747
21,2,212,28,234,177,28,62,24,765,1018,1783,9,5.2,201747
21,3,256,14,292,173,63,85,19,902,1100,2002,8,5.5,201747
21,4,159,17,178,95,99,86,91,725,666,1391,6,5.25,201747
21,5,208,10,331,183,32,87,29,880,1141,2021,8,5.666666667,201747
21,6,276,15,380,515,53,90,40,1369,1217,2586,6,7,201747
21,7,264,18,302,106,154,96,42,982,1141,2123,9,5.666666667,201747
21,8,223,13,255,234,81,67,4,877,865,1742,10,5.2,201747
21,9,259,19,412,439,57,86,16,1288,1374,2662,9,6,201747
21,10,216,19,341,344,31,74,27,1052,1183,2235,7,6,201747
21,11,76,5,117,95,33,25,6,357,202,559,6,4,201747
21,12,451,24,812,621,148,153,109,2318,2249,4567,15,4.666666667,201747
21,13,255,16,270,393,48,72,5,1059,1082,2141,8,5.666666667,201747
21,14,213,9,322,148,78,64,12,846,1077,1923,13,5.166666667,201747
21,15,237,15,395,262,57,62,9,1037,1068,2105,7,5.5,201747
22,1,285,61,251,416,113,49,0,1175,1274,2449,11,5.2,201747
22,2,177,31,314,237,54,46,20,879,828,1707,7,5.5,201747
22,3,353,53,732,643,57,87,5,1930,1827,3757,10,6,201747
22,4,371,40,642,508,32,82,1,1676,1675,3351,12,4,201747
22,5,183,18,381,222,57,44,2,907,914,1821,10,5.5,201747
23,1,251,5,1101,405,41,51,0,1854,1816,3670,14,5.6,201747
23,2,239,20,324,497,17,73,0,1170,1177,2347,11,4.4,201747
23,3,381,4,999,461,31,54,1,1931,1756,3687,11,6,201747
23,4,179,7,611,279,40,37,1,1154,1238,2392,8,5.666666667,201747
24,1,193,32,215,366,57,30,2,895,1075,1970,11,5.2,201747
24,2,127,25,245,222,21,53,0,693,572,1265,6,5.5,201747
24,3,190,62,260,635,149,44,0,1340,1253,2593,9,5.25,201747
24,4,168,39,173,266,49,56,60,811,827,1638,5,5.5,201747
24,5,284,29,398,475,15,88,0,1289,1264,2553,9,4.75,201747
24,6,464,42,510,572,29,109,0,1726,1715,3441,11,5.666666667,201747
24,7,283,28,327,417,60,44,0,1159,1341,2500,9,5.25,201747
25,1,183,18,236,247,33,62,0,779,708,1487,14,5.75,201747
25,2,285,24,327,365,35,89,0,1125,1177,2302,7,5.5,201747
25,3,206,19,271,385,45,37,6,969,888,1857,9,5.6,201747
25,4,219,14,148,270,17,54,5,727,640,1367,8,5.333333333,201747
25,5,343,15,352,463,13,97,0,1283,1259,2542,11,5.25,201747
25,6,315,15,323,273,26,86,2,1040,1053,2093,9,5.75,201747
25,7,284,9,260,419,5,96,0,1073,1075,2148,7,6,201747
26,1,270,14,298,310,12,104,0,1008,978,1986,9,5.5,201747
26,2,283,6,441,425,7,92,0,1254,1046,2300,13,5.4,201747
26,3,421,28,467,682,11,185,0,1794,1723,3517,15,5.333333333,201747
26,4,236,30,194,272,13,115,0,860,848,1708,10,5.2,201747
26,5,80,10,104,123,10,43,0,370,406,776,3,5.5,201747
26,6,227,16,330,397,2,104,0,1076,1045,2121,10,5.333333333,201747
26,7,229,12,212,325,11,48,1,838,775,1613,10,5.5,201747
27,1,165,14,158,371,20,34,0,762,835,1597,9,4.5,201747
27,2,175,17,135,415,9,26,0,777,989,1766,8,4.666666667,201747
27,3,179,9,127,424,9,38,0,786,695,1481,7,4.666666667,201747
27,4,217,15,275,661,11,73,0,1252,1261,2513,10,3.75,201747
27,5,138,11,132,278,9,27,0,595,450,1045,6,4.333333333,201747
27,6,163,24,246,533,15,63,0,1044,690,1734,9,4.333333333,201747
28,1,263,25,454,399,6,60,0,1207,1114,2321,13,6,201747
28,2,254,29,545,318,24,82,58,1310,1288,2598,14,6,201747
28,3,191,18,185,224,17,54,0,689,682,1371,7,5.333333333,201747
28,4,324,27,451,383,36,100,27,1348,1406,2754,16,6,201747
28,5,245,23,254,360,15,66,0,963,1029,1992,13,4.166666667,201747
28,6,241,34,204,409,135,37,15,1075,1204,2279,14,5.166666667,201747
28,7,297,21,469,405,46,94,0,1332,1303,2635,8,6,201747
28,8,210,30,253,302,55,92,0,942,844,1786,11,5.666666667,201747
28,9,132,12,238,158,12,34,21,607,558,1165,9,6,201747
29,1,309,45,355,362,66,57,0,1194,1013,2207,10,5.5,201747
29,2,339,23,296,562,28,96,19,1363,1301,2664,15,4.5,201747
29,3,172,25,160,341,5,43,0,746,639,1385,7,5.333333333,201747
30,1,199,24,146,233,30,56,25,713,701,1414,7,5.333333333,201747
30,2,175,37,146,123,65,34,440,1020,1024,2044,8,5.25,201747
30,3,168,13,265,186,84,64,66,846,803,1649,6,5.666666667,201747
30,4,142,9,307,243,32,52,0,785,663,1448,8,6,201747
30,5,213,10,226,330,13,96,0,888,853,1741,7,5.5,201747
30,6,166,12,231,211,19,50,0,689,835,1524,9,5.333333333,201747
30,7,269,15,269,360,88,86,22,1109,1145,2254,12,5.25,201747
30,8,244,17,259,301,54,73,2,950,1087,2037,11,5.4,201747
30,9,208,18,225,209,64,77,60,861,896,1757,8,5.5,201747
30,10,250,18,414,391,27,112,19,1231,1123,2354,9,5.333333333,201747
30,11,231,19,413,306,21,81,0,1071,918,1989,6,5.5,201747
30,12,379,35,599,635,33,170,0,1851,1755,3606,11,6.25,201747
30,13,219,19,200,375,70,67,4,954,915,1869,10,5.4,201747
30,14,261,27,329,273,107,97,0,1094,1210,2304,9,5.5,201747
30,15,257,15,214,310,60,112,84,1052,1110,2162,11,5.666666667,201747
30,16,241,13,272,366,79,120,28,1119,1101,2220,10,5,201747
30,17,157,28,180,242,43,72,8,730,1109,1839,8,5.5,201747
30,18,241,24,151,270,17,86,43,832,1045,1877,8,5.25,201747
30,19,279,15,326,183,101,70,83,1057,931,1988,13,5.6,201747
30,20,203,16,218,427,119,74,0,1057,1067,2124,11,5.4,201747
31,1,248,18,197,397,5,54,0,919,1127,2046,8,5.5,201747
31,2,145,10,193,22,175,48,0,593,654,1247,7,5.333333333,201747
31,3,479,85,919,674,64,161,0,2382,1760,4142,17,6.25,201747
31,4,217,13,283,263,36,35,0,847,629,1476,6,5,201747
31,5,186,8,163,224,33,39,0,653,577,1230,7,5.333333333,201747
32,1,198,34,182,190,24,58,20,706,736,1442,12,5.2,201747
32,2,317,46,254,204,93,60,5,979,1039,2018,13,5.142857143,201747
32,3,375,51,219,263,23,70,1,1002,996,1998,15,5.333333333,201747
32,4,218,80,277,233,50,84,36,978,1004,1982,13,4.666666667,201747
1,1,326,46,241,342,57,42,12,1066,1003,2069,13,5.5,201748
1,2,295,32,450,331,85,64,3,1260,1256,2516,12,5,201748
1,3,231,35,524,347,42,77,2,1258,1347,2605,13,5.6,201748
2,1,212,13,291,255,13,84,1,869,925,1794,11,6,201748
2,2,311,18,385,481,2,113,0,1310,1054,2364,9,4.666666667,201748
2,3,289,13,415,361,21,92,0,1191,1261,2452,11,4,201748
2,4,163,3,317,209,6,33,0,731,667,1398,6,6,201748
2,5,501,25,967,590,122,150,2,2357,2209,4566,16,6.25,201748
2,6,247,16,442,350,23,76,0,1154,1013,2167,7,6,201748
2,7,265,13,486,311,23,67,5,1170,1074,2244,12,5.75,201748
2,8,316,21,612,496,17,77,0,1539,1301,2840,8,6,201748
3,1,256,15,380,329,32,111,1,1124,1064,2188,15,5.142857143,201748
3,2,191,8,487,228,13,37,0,964,789,1753,9,6,201748
4,1,279,29,344,556,102,81,1,1392,1144,2536,15,4.833333333,201748
4,2,279,18,315,406,22,72,5,1117,1286,2403,14,5.4,201748
5,1,273,27,412,276,31,96,0,1115,1139,2254,9,6,201748
5,2,236,30,273,330,15,64,2,950,1155,2105,10,5.2,201748
5,3,243,25,257,411,29,92,0,1057,1158,2215,9,5.5,201748
5,4,409,47,501,483,16,134,5,1595,1423,3018,11,5.25,201748
5,5,267,17,340,436,23,74,15,1172,1107,2279,8,6,201748
5,6,179,17,207,261,18,46,5,733,763,1496,7,5.5,201748
5,7,209,12,212,248,15,51,0,747,586,1333,9,4,201748
6,1,188,20,290,259,8,87,12,864,771,1635,14,4.571428571,201748
6,2,191,15,258,202,73,58,3,800,827,1627,9,5.666666667,201748
7,1,247,18,201,848,29,44,7,1394,605,1999,9,5.25,201748
7,2,227,5,151,508,220,30,0,1141,1552,2693,9,5.25,201748
7,3,313,12,170,531,124,36,0,1186,1011,2197,7,5.333333333,201748
7,4,191,13,225,499,9,68,255,1260,1081,2341,11,5.4,201748
7,5,448,24,303,674,53,44,124,1670,1658,3328,11,5.666666667,201748
7,6,295,21,397,470,53,96,33,1365,1102,2467,8,4.25,201748
7,7,254,27,335,1051,56,79,49,1851,1197,3048,8,5.5,201748
7,8,294,13,259,941,25,71,0,1603,1540,3143,12,5.25,201748
7,9,343,23,478,547,42,85,177,1695,1456,3151,11,4.75,201748
7,10,302,23,427,829,162,61,0,1804,988,2792,9,5.5,201748
7,11,184,5,138,430,13,28,0,798,126,924,6,5.333333333,201748
7,12,296,16,354,1011,14,75,0,1766,1133,2899,9,5.5,201748
7,13,209,17,349,138,133,36,0,882,973,1855,9,5.25,201748
8,1,256,9,376,190,19,42,0,892,723,1615,4,6,201748
8,2,289,27,441,311,20,51,0,1139,634,1773,12,3.666666667,201748
8,3,299,23,456,362,9,73,2,1224,1023,2247,5,6,201748
8,4,211,13,486,243,30,96,1,1080,967,2047,9,6,201748
8,5,208,31,269,234,17,75,0,834,911,1745,10,5.25,201748
8,6,191,22,397,364,42,118,2,1136,1089,2225,6,3,201748
8,7,182,36,218,193,4,68,0,701,708,1409,8,5.25,201748
8,8,184,50,315,365,8,74,0,996,655,1651,12,5.5,201748
8,9,230,24,180,170,20,61,0,685,639,1324,10,5.2,201748
9,1,137,9,197,160,58,54,0,615,476,1091,6,7,201748
9,2,439,90,880,970,80,176,236,2871,2517,5388,12,6,201748
9,3,232,48,419,659,53,107,5,1523,1298,2821,7,6,201748
9,4,270,17,369,734,35,92,12,1529,1393,2922,11,6,201748
9,5,154,11,294,3,91,67,339,959,868,1827,7,6,201748
9,6,123,75,183,161,60,67,28,697,627,1324,7,6,201748
9,7,165,13,365,474,7,48,1,1073,831,1904,9,6,201748
9,8,72,33,152,133,47,44,8,489,419,908,6,7,201748
9,9,145,12,232,393,47,64,10,903,838,1741,5,6,201748
9,10,142,14,353,72,29,95,312,1017,838,1855,6,6,201748
9,11,279,14,521,665,48,118,17,1662,1433,3095,7,6,201748
9,12,208,53,529,777,18,108,13,1706,1481,3187,11,6,201748
9,13,180,19,312,414,53,69,14,1061,961,2022,4,6,201748
9,14,139,10,215,230,149,88,0,831,687,1518,5,6,201748
9,15,322,34,916,1305,27,198,7,2809,2434,5243,11,4.75,201748
9,16,335,53,523,843,39,148,2,1943,1800,3743,15,7,201748
9,17,178,10,289,397,16,75,0,965,833,1798,6,6,201748
9,18,223,32,405,685,47,115,66,1573,1467,3040,12,6,201748
9,19,276,52,411,535,78,96,7,1455,1293,2748,5,6,201748
9,20,8,2,14,20,2,4,0,50,34,84,5,6,201748
9,21,116,8,218,16,60,54,249,721,617,1338,3,6,201748
9,22,225,12,280,361,97,78,57,1110,962,2072,5,6,201748
9,23,205,21,362,23,70,82,441,1204,1113,2317,7,7,201748
9,24,386,32,687,470,176,174,283,2208,2016,4224,13,6.5,201748
10,1,171,15,154,198,28,42,16,624,588,1212,12,4.666666667,201748
10,2,252,18,260,288,20,51,5,894,895,1789,9,5.5,201748
10,3,202,28,147,214,18,47,24,680,683,1363,12,5.4,201748
10,4,389,39,424,485,17,76,0,1430,1364,2794,12,4.8,201748
11,1,202,46,271,367,13,44,7,950,734,1684,6,5.666666667,201748
11,2,230,28,245,262,42,42,4,853,737,1590,7,6,201748
11,3,201,30,230,271,18,62,0,812,698,1510,4,6,201748
11,4,231,38,202,277,7,51,0,806,737,1543,10,3.8,201748
11,5,331,60,330,510,13,70,0,1314,1109,2423,8,6.5,201748
11,6,208,20,268,274,52,61,6,889,800,1689,8,5.666666667,201748
11,7,212,51,253,343,17,63,0,939,817,1756,9,5.5,201748
11,8,209,40,240,358,38,45,1,931,888,1819,9,5.75,201748
11,9,282,65,377,407,13,104,4,1252,1100,2352,10,5.666666667,201748
11,10,250,57,323,391,16,60,25,1122,906,2028,11,5.6,201748
11,11,203,21,271,261,20,43,0,819,858,1677,4,6,201748
11,12,249,29,366,444,13,69,0,1170,1050,2220,7,6.5,201748
11,13,216,29,245,223,43,68,36,860,802,1662,9,5.5,201748
11,14,194,35,255,248,17,55,2,806,633,1439,8,5.5,201748
11,15,143,32,195,206,4,34,0,614,496,1110,6,6,201748
12,1,185,43,237,100,126,35,2,728,686,1414,10,5,201748
12,2,270,48,292,512,69,80,0,1271,846,2117,10,5.5,201748
12,3,249,31,365,404,55,50,28,1182,1012,2194,11,5.2,201748
12,4,228,36,344,32,45,61,449,1195,1149,2344,9,6,201748
12,5,240,15,220,365,1,49,9,899,585,1484,10,5.25,201748
12,6,265,47,301,606,105,33,2,1359,404,1763,10,5.25,201748
12,7,266,27,267,445,15,57,39,1116,908,2024,8,4,201748
12,8,272,31,347,359,14,36,0,1059,833,1892,9,5.25,201748
12,9,215,21,318,498,23,42,36,1153,915,2068,9,5.666666667,201748
13,1,190,41,201,510,154,52,0,1148,851,1999,9,5.333333333,201748
13,2,139,18,92,199,104,38,0,590,516,1106,6,5.333333333,201748
13,3,156,23,157,250,81,48,0,715,641,1356,12,5.25,201748
13,4,220,19,273,292,70,68,6,948,877,1825,9,5.666666667,201748
13,5,264,24,311,362,75,91,3,1130,1005,2135,9,5.75,201748
13,6,371,39,796,656,62,108,4,2036,1946,3982,13,5.75,201748
13,7,164,19,311,346,25,56,1,922,885,1807,9,5.5,201748
14,1,195,22,117,95,28,57,2,516,552,1068,6,5.5,201748
14,2,160,14,167,131,21,77,0,570,499,1069,6,5.666666667,201748
14,3,256,14,226,124,19,88,7,734,652,1386,11,5.4,201748
14,4,232,16,279,371,12,71,6,987,949,1936,12,6,201748
14,5,237,17,391,242,28,57,3,975,1021,1996,11,5.5,201748
14,6,260,8,331,253,15,55,0,922,1418,2340,11,6,201748
14,7,177,8,293,98,2,49,0,627,528,1155,6,6,201748
14,8,355,31,715,602,39,144,4,1890,1775,3665,13,4.833333333,201748
14,9,273,18,321,384,48,85,0,1129,1088,2217,8,6,201748
14,10,257,30,422,295,21,117,1,1143,1038,2181,7,6,201748
14,11,115,14,186,161,28,34,3,541,533,1074,4,6,201748
14,12,295,16,511,164,5,68,0,1059,1218,2277,11,5.5,201748
14,13,177,10,252,183,18,54,0,694,720,1414,8,6,201748
14,14,211,27,276,314,23,73,7,931,829,1760,7,7,201748
14,15,209,44,238,250,29,72,4,846,820,1666,10,5.6,201748
14,16,311,23,299,289,48,70,10,1050,745,1795,5,6,201748
14,17,189,23,153,115,19,72,19,590,601,1191,9,5.25,201748
14,18,254,37,223,172,23,65,24,798,956,1754,10,5.4,201748
14,19,181,35,222,253,34,71,19,815,624,1439,9,5.25,201748
14,20,136,12,214,100,4,57,0,523,402,925,10,5.666666667,201748
15,1,311,14,173,136,175,73,0,882,822,1704,7,5.333333333,201748
15,2,229,17,233,289,67,44,5,884,867,1751,6,6,201748
15,3,227,12,237,242,31,67,0,816,1085,1901,10,5.666666667,201748
15,4,225,24,293,329,24,68,17,980,846,1826,4,6,201748
15,5,191,15,240,292,11,36,1,786,694,1480,8,5.666666667,201748
15,6,207,11,339,406,41,66,2,1072,1059,2131,7,6.5,201748
15,7,255,10,307,394,50,76,0,1092,926,2018,10,6,201748
15,8,118,12,137,253,17,32,1,570,551,1121,4,6,201748
15,9,230,9,83,190,70,41,8,631,612,1243,9,5.75,201748
15,10,219,5,247,316,41,49,0,877,776,1653,9,6,201748
15,11,276,16,334,436,36,69,0,1167,932,2099,8,6,201748
15,12,316,24,566,491,22,62,0,1481,1293,2774,8,6,201748
15,13,139,14,177,246,82,48,0,706,638,1344,8,6,201748
15,14,82,9,147,176,26,36,0,476,473,949,4,6,201748
15,15,226,34,332,391,20,97,0,1100,947,2047,6,6,201748
15,16,306,36,376,602,11,83,0,1414,1409,2823,8,6,201748
15,17,151,16,202,304,7,48,2,730,661,1391,8,6,201748
15,18,265,21,298,387,34,97,3,1105,1035,2140,7,5.666666667,201748
15,19,317,75,528,764,17,110,0,1811,1661,3472,14,6,201748
15,20,118,11,192,292,12,53,1,679,676,1355,6,6,201748
15,21,122,5,136,195,16,47,0,521,398,919,6,5.5,201748
15,22,378,46,524,743,17,127,2,1837,1766,3603,14,6,201748
15,23,237,16,217,352,33,81,0,936,958,1894,7,5.333333333,201748
15,24,184,11,225,284,11,32,4,751,997,1748,4,6,201748
15,25,266,31,343,306,18,58,0,1022,1014,2036,6,6,201748
15,26,194,5,216,195,25,52,0,687,750,1437,14,3.666666667,201748
15,27,304,20,367,488,2,100,0,1281,1135,2416,9,5.666666667,201748
15,28,310,16,451,392,36,96,0,1301,1238,2539,9,5.666666667,201748
15,29,255,41,379,592,10,89,0,1366,1255,2621,8,6,201748
15,30,278,27,438,421,46,52,1,1263,977,2240,12,6,201748
15,31,219,36,235,376,25,60,0,951,843,1794,6,6,201748
15,32,239,18,268,412,40,69,0,1046,873,1919,9,6,201748
15,33,258,11,368,434,16,78,0,1165,1059,2224,7,6,201748
15,34,225,9,230,360,6,74,0,904,787,1691,8,6,201748
15,35,293,28,215,414,21,99,0,1070,915,1985,9,5.666666667,201748
15,36,268,27,214,279,73,63,0,924,760,1684,9,5.5,201748
15,37,292,24,296,483,67,96,9,1267,1027,2294,7,6,201748
15,38,282,20,306,381,10,91,0,1090,978,2068,6,5.5,201748
15,39,170,17,270,343,12,66,1,879,793,1672,4,6,201748
15,40,404,32,332,408,77,129,0,1382,1268,2650,9,6,201748
15,41,395,41,631,661,40,89,17,1874,1913,3787,11,6,201748
16,1,166,24,262,251,10,54,0,767,640,1407,10,5.333333333,201748
16,2,160,26,166,227,15,38,0,632,498,1130,9,5.25,201748
16,3,193,27,147,229,33,41,0,670,548,1218,10,5.25,201748
16,4,262,24,215,204,30,94,0,829,688,1517,8,5.5,201748
16,5,264,49,275,312,54,108,0,1062,770,1832,10,5.666666667,201748
16,6,231,37,177,232,47,55,1,780,720,1500,12,5.5,201748
16,7,214,21,160,180,22,65,0,662,573,1235,9,5.5,201748
16,8,339,46,548,513,19,120,3,1588,1313,2901,12,6,201748
16,9,272,25,263,243,19,82,0,904,809,1713,10,6,201748
16,10,247,22,325,407,9,70,0,1080,760,1840,8,5.666666667,201748
16,11,225,17,209,151,109,71,7,789,671,1460,12,5.4,201748
16,12,170,21,169,174,6,54,0,594,560,1154,10,5.25,201748
17,1,277,29,431,560,20,121,5,1443,1230,2673,12,4.5,201748
17,2,170,8,287,421,7,59,25,977,922,1899,9,5.666666667,201748
17,3,252,42,458,599,20,108,0,1479,1369,2848,8,5.5,201748
17,4,250,33,384,396,18,85,111,1277,1135,2412,10,5.666666667,201748
17,5,94,16,146,134,22,31,51,494,447,941,5,5.5,201748
18,1,180,16,145,137,19,30,0,527,472,999,9,5.4,201748
18,2,332,31,444,372,83,70,0,1332,1100,2432,10,6,201748
18,3,197,14,424,208,7,57,0,907,1031,1938,9,6,201748
19,1,233,20,300,283,12,94,3,945,988,1933,9,6,201748
19,2,370,19,647,332,72,98,0,1538,1550,3088,10,6.5,201748
19,3,349,13,545,373,25,88,0,1393,1555,2948,8,6,201748
19,4,135,10,208,178,33,48,41,653,644,1297,5,6,201748
19,5,416,28,491,591,19,97,7,1649,1485,3134,8,6,201748
19,6,107,10,237,209,11,59,3,636,590,1226,5,6,201748
19,7,252,17,426,248,17,66,0,1026,1015,2041,10,5.5,201748
19,8,60,4,106,100,4,15,0,289,314,603,7,6,201748
19,9,221,18,225,191,33,39,0,727,736,1463,9,5.25,201748
19,10,253,14,354,393,10,102,1,1127,744,1871,8,4,201748
19,11,504,53,665,797,21,155,13,2208,2095,4303,13,6.333333333,201748
19,12,236,15,478,205,9,68,3,1014,1167,2181,8,6,201748
20,1,177,9,207,267,59,48,0,767,627,1394,7,5.5,201748
20,2,123,14,129,203,35,25,0,529,665,1194,6,5.333333333,201748
20,3,126,11,145,227,92,38,2,641,736,1377,6,5.333333333,201748
20,4,140,22,124,178,52,65,0,581,530,1111,6,5.333333333,201748
20,5,200,26,219,317,85,54,4,905,972,1877,11,5.25,201748
20,6,172,8,197,363,158,31,2,931,1287,2218,8,5.25,201748
20,7,249,19,424,382,13,76,0,1163,879,2042,8,5.5,201748
20,8,555,36,527,960,43,196,68,2385,1670,4055,15,5.333333333,201748
20,9,203,12,150,211,67,54,20,717,609,1326,8,4.333333333,201748
20,10,252,22,170,375,30,57,0,906,590,1496,9,4.5,201748
21,1,278,20,268,508,27,64,0,1165,1196,2361,9,5.4,201748
21,2,266,27,277,231,89,67,1,958,919,1877,9,5.2,201748
21,3,236,10,359,197,73,71,5,951,889,1840,8,5.5,201748
21,4,212,11,237,97,67,60,60,744,762,1506,6,5.25,201748
21,5,261,16,311,221,39,80,64,992,1021,2013,8,5.666666667,201748
21,6,285,17,379,482,46,97,43,1349,955,2304,6,7,201748
21,7,308,17,328,78,177,94,29,1031,1002,2033,9,5.666666667,201748
21,8,195,11,203,238,82,51,9,789,859,1648,10,5.2,201748
21,9,270,21,427,414,42,86,24,1284,1204,2488,9,6,201748
21,10,251,19,308,339,38,64,35,1054,947,2001,7,6,201748
21,11,110,2,120,60,26,20,5,343,206,549,6,4,201748
21,12,447,26,774,630,118,138,138,2271,2017,4288,15,4.666666667,201748
21,13,273,18,266,409,39,95,4,1104,922,2026,8,5.666666667,201748
21,14,253,18,320,166,81,91,2,931,1010,1941,13,5.333333333,201748
21,15,243,21,373,281,59,63,5,1045,961,2006,7,5.5,201748
22,1,272,59,229,425,89,34,0,1108,724,1832,11,5.2,201748
22,2,192,55,336,420,88,49,23,1163,993,2156,7,5.5,201748
22,3,340,31,700,566,20,99,2,1758,1628,3386,10,6,201748
22,4,389,38,600,468,27,89,0,1611,1404,3015,12,4.4,201748
22,5,173,29,340,248,31,56,2,879,866,1745,10,5.5,201748
23,1,296,5,1057,376,94,53,0,1881,1708,3589,14,5.6,201748
23,2,229,23,351,461,27,45,0,1136,980,2116,10,4.2,201748
23,3,359,7,934,478,47,49,2,1876,1743,3619,11,6,201748
23,4,186,10,601,293,51,34,0,1175,1233,2408,10,4.75,201748
24,1,202,46,193,490,59,29,0,1019,745,1764,11,5.2,201748
24,2,152,12,193,170,24,33,0,584,516,1100,6,5.5,201748
24,3,222,68,252,674,125,66,0,1407,1171,2578,9,5.25,201748
24,4,202,37,265,237,57,59,98,955,664,1619,5,5.5,201748
24,5,281,40,428,490,8,97,0,1344,1127,2471,10,5,201748
24,6,304,52,484,552,24,115,0,1531,1823,3354,11,5.666666667,201748
24,7,211,31,311,642,94,52,0,1341,1111,2452,9,5.25,201748
25,1,191,17,208,270,16,58,0,760,700,1460,14,5.75,201748
25,2,281,27,302,372,25,85,0,1092,1020,2112,7,5.5,201748
25,3,229,15,240,340,49,47,2,922,871,1793,9,5.6,201748
25,4,232,19,183,293,12,71,17,827,643,1470,8,5.333333333,201748
25,5,311,14,286,449,22,98,0,1180,1099,2279,11,5.25,201748
25,6,239,10,309,280,44,78,0,960,984,1944,9,5.75,201748
25,7,259,14,282,420,6,89,0,1070,912,1982,7,6,201748
26,1,220,12,286,280,15,99,0,912,884,1796,9,5.5,201748
26,2,250,14,427,419,7,88,0,1205,1161,2366,13,5.4,201748
26,3,390,33,499,610,13,170,1,1716,1542,3258,15,5.333333333,201748
26,4,155,13,180,214,13,64,0,639,670,1309,10,5.2,201748
26,5,138,6,114,144,5,45,0,452,498,950,3,5.5,201748
26,6,191,20,333,373,1,79,0,997,939,1936,10,5.333333333,201748
26,7,175,13,168,238,13,33,0,640,710,1350,10,5.5,201748
27,1,169,18,168,363,19,38,0,775,835,1610,9,5.5,201748
27,2,311,20,269,603,20,58,0,1281,1006,2287,8,5.666666667,201748
27,3,211,12,150,504,11,49,0,937,748,1685,7,5.666666667,201748
27,4,284,19,304,788,21,57,1,1474,1308,2782,10,4.25,201748
27,5,126,1,114,300,6,29,0,576,522,1098,6,5.333333333,201748
27,6,242,33,304,764,3,77,0,1423,1195,2618,9,5.333333333,201748
28,1,261,23,419,361,5,70,0,1139,989,2128,13,6,201748
28,2,263,21,589,336,34,74,57,1374,1305,2679,14,6,201748
28,3,160,14,178,201,7,29,3,592,551,1143,7,5.333333333,201748
28,4,281,34,424,371,36,85,39,1270,1172,2442,16,6,201748
28,5,258,22,269,463,38,58,0,1108,969,2077,13,4.166666667,201748
28,6,241,34,223,431,124,46,19,1118,1371,2489,14,5.166666667,201748
28,7,322,15,512,386,42,76,0,1353,1166,2519,8,6,201748
28,8,204,22,257,279,45,69,1,877,1002,1879,11,5.666666667,201748
28,9,158,9,223,147,17,37,24,615,679,1294,9,6,201748
29,1,286,33,354,344,49,56,0,1122,1087,2209,10,5.5,201748
29,2,312,17,280,601,26,107,27,1370,1314,2684,14,4.333333333,201748
29,3,176,35,176,358,19,51,0,815,761,1576,7,5.666666667,201748
30,1,151,17,141,207,16,34,34,600,559,1159,7,5.333333333,201748
30,2,157,28,110,112,62,24,378,871,728,1599,8,5.25,201748
30,3,194,25,295,202,127,74,72,989,806,1795,6,5.666666667,201748
30,4,148,5,269,234,43,67,0,766,640,1406,8,6,201748
30,5,199,19,206,353,18,81,0,876,856,1732,7,5.5,201748
30,6,179,16,179,202,15,43,0,634,600,1234,9,5.333333333,201748
30,7,247,23,347,232,45,65,35,994,893,1887,12,5.25,201748
30,8,232,19,292,292,52,84,1,972,970,1942,11,5.4,201748
30,9,218,20,163,179,58,67,51,756,654,1410,8,5.5,201748
30,10,227,16,393,410,29,99,17,1191,1119,2310,9,4.666666667,201748
30,11,223,15,354,362,13,100,0,1067,905,1972,6,5.5,201748
30,12,336,14,580,629,38,151,0,1748,1595,3343,11,6.25,201748
30,13,214,10,184,317,70,54,1,850,831,1681,10,5.4,201748
30,14,221,30,248,248,84,75,0,906,918,1824,9,5.5,201748
30,15,230,16,249,285,47,122,91,1040,873,1913,11,5.666666667,201748
30,16,205,17,261,357,48,110,31,1029,972,2001,10,5.333333333,201748
30,17,201,33,187,285,47,71,0,824,919,1743,8,5.5,201748
30,18,205,10,177,249,30,58,20,749,657,1406,8,5.25,201748
30,19,155,22,202,149,62,70,66,726,851,1577,13,5.6,201748
30,20,176,10,198,323,71,57,0,835,914,1749,11,5.2,201748
31,1,261,20,243,409,18,54,0,1005,935,1940,8,5.5,201748
31,2,146,10,190,43,201,52,0,642,554,1196,7,5.333333333,201748
31,3,426,59,825,607,67,136,0,2120,1790,3910,17,6.25,201748
31,4,104,9,250,240,24,41,0,668,630,1298,4,3.5,201748
31,5,221,14,172,304,30,54,0,795,530,1325,7,5.333333333,201748
32,1,228,47,201,201,24,77,15,793,785,1578,12,5.2,201748
32,2,217,61,182,239,71,53,7,830,606,1436,13,5.142857143,201748
32,3,356,40,191,263,20,55,4,929,769,1698,15,5.166666667,201748
32,4,296,95,287,294,67,73,53,1165,963,2128,13,4.666666667,201748
1,1,172,40,192,214,68,34,5,725,675,1400,13,4.5,201749
1,2,209,34,426,351,58,67,8,1153,1010,2163,12,4.2,201749
1,3,231,38,438,344,38,68,0,1157,1221,2378,13,4.4,201749
2,1,152,7,235,211,7,61,0,673,875,1548,11,5,201749
2,2,284,22,287,398,8,115,0,1114,1148,2262,9,3.666666667,201749
2,3,283,17,412,360,16,120,0,1208,1304,2512,12,3.8,201749
2,4,145,2,285,140,5,29,0,606,685,1291,6,5,201749
2,5,384,20,784,501,106,146,1,1942,2174,4116,16,5,201749
2,6,225,10,401,260,26,74,1,997,1026,2023,7,5,201749
2,7,271,19,424,328,25,80,5,1152,1054,2206,12,4.75,201749
2,8,228,8,502,386,9,70,0,1203,1314,2517,8,5,201749
3,1,169,15,272,289,18,80,3,846,1036,1882,15,4.142857143,201749
3,2,123,2,423,199,14,30,0,791,823,1614,9,5,201749
4,1,206,15,246,411,55,53,0,986,964,1950,15,3.833333333,201749
4,2,219,20,268,367,47,36,3,960,874,1834,14,4.4,201749
5,1,293,26,378,250,31,90,0,1068,1029,2097,9,5,201749
5,2,191,14,240,225,15,58,0,743,701,1444,10,4.2,201749
5,3,224,26,220,301,30,84,0,885,975,1860,9,4.5,201749
5,4,245,27,432,385,10,117,3,1219,1493,2712,11,4.75,201749
5,5,172,13,267,351,22,63,9,897,957,1854,8,5,201749
5,6,105,10,163,225,7,40,16,566,524,1090,7,4.5,201749
5,7,145,17,196,266,64,35,1,724,477,1201,10,3,201749
6,1,152,22,293,230,4,49,7,757,781,1538,14,3.714285714,201749
6,2,132,23,211,159,43,53,2,623,772,1395,9,4.666666667,201749
7,1,292,7,160,415,7,38,10,929,944,1873,9,4.25,201749
7,2,163,15,141,640,72,19,0,1050,2179,3229,9,4.25,201749
7,3,253,5,176,171,118,47,0,770,977,1747,7,4.333333333,201749
7,4,137,18,182,429,18,71,135,990,911,1901,11,4.4,201749
7,5,317,17,229,660,26,46,70,1365,1440,2805,11,4.666666667,201749
7,6,266,10,287,497,83,68,26,1237,1183,2420,8,3.5,201749
7,7,224,21,298,680,114,61,21,1419,1035,2454,8,4.5,201749
7,8,237,18,252,665,75,55,0,1302,1427,2729,12,4.25,201749
7,9,257,17,344,420,23,79,115,1255,1533,2788,11,3.75,201749
7,10,194,14,239,672,111,54,0,1284,1495,2779,9,4.5,201749
7,11,157,11,145,256,39,20,0,628,1239,1867,6,4.333333333,201749
7,12,229,9,289,763,14,56,0,1360,1203,2563,9,4.5,201749
7,13,123,17,198,505,50,36,0,929,1095,2024,9,4.25,201749
8,1,183,8,359,174,12,39,0,775,755,1530,4,5,201749
8,2,287,15,423,291,28,70,1,1115,1027,2142,17,3,201749
8,3,249,28,367,291,12,64,5,1016,1086,2102,5,5,201749
8,4,190,12,357,207,36,69,0,871,1053,1924,9,5,201749
8,5,169,16,192,183,18,69,0,647,766,1413,10,4.25,201749
8,6,155,21,274,277,49,73,2,851,1149,2000,7,2.5,201749
8,7,181,16,160,159,7,66,0,589,652,1241,8,4.25,201749
8,8,151,29,284,306,6,80,0,856,1041,1897,12,4,201749
8,9,159,27,128,158,18,38,0,528,603,1131,10,4,201749
9,1,107,9,153,137,55,36,0,497,570,1067,6,6,201749
9,2,381,75,656,765,55,148,265,2345,2585,4930,12,5,201749
9,3,177,27,353,540,28,84,13,1222,1331,2553,7,5,201749
9,4,201,16,290,567,21,69,2,1166,1452,2618,11,5,201749
9,5,107,15,227,0,60,68,301,778,848,1626,7,5,201749
9,6,118,56,163,124,49,44,18,572,675,1247,7,5,201749
9,7,110,10,273,410,5,48,7,863,942,1805,9,5,201749
9,8,37,19,116,124,27,15,4,342,381,723,6,6,201749
9,9,119,7,187,300,39,37,7,696,847,1543,5,5,201749
9,10,124,15,268,69,17,63,310,866,887,1753,6,5,201749
9,11,193,17,413,555,28,102,11,1319,1534,2853,7,5,201749
9,12,169,31,420,599,15,88,12,1334,1490,2824,11,5,201749
9,13,155,19,238,356,54,47,9,878,1021,1899,4,5,201749
9,14,111,4,179,201,100,59,0,654,681,1335,5,5,201749
9,15,255,24,707,981,24,169,8,2168,2414,4582,11,3,201749
9,16,283,32,454,721,51,109,11,1661,1815,3476,15,6,201749
9,17,152,7,197,358,14,49,0,777,859,1636,6,5,201749
9,18,196,23,339,569,34,87,63,1311,1428,2739,12,5,201749
9,19,231,30,277,458,91,80,8,1175,1353,2528,5,5,201749
9,20,11,1,16,16,2,4,0,50,43,93,5,5,201749
9,21,97,11,148,9,46,31,224,566,723,1289,3,5,201749
9,22,161,9,200,276,72,70,54,842,997,1839,5,5,201749
9,23,149,13,309,7,68,63,386,995,1120,2115,7,6,201749
9,24,311,29,502,455,148,130,203,1778,2160,3938,13,5.5,201749
10,1,302,28,147,228,20,81,8,814,546,1360,12,3.833333333,201749
10,2,183,20,208,254,23,36,3,727,693,1420,9,4.5,201749
10,3,153,17,134,172,8,33,34,551,640,1191,12,4.4,201749
10,4,291,24,350,431,16,72,0,1184,1193,2377,11,3.4,201749
11,1,152,42,206,343,22,44,9,818,695,1513,6,4.666666667,201749
11,2,164,21,219,220,25,48,11,708,716,1424,7,5,201749
11,3,154,26,184,248,10,45,0,667,710,1377,4,5,201749
11,4,172,27,173,287,10,39,0,708,640,1348,10,3.2,201749
11,5,257,29,265,386,14,74,0,1025,1184,2209,8,5.5,201749
11,6,168,27,215,256,21,38,1,726,768,1494,8,4.666666667,201749
11,7,193,36,187,359,16,41,0,832,779,1611,9,4.5,201749
11,8,165,23,198,302,25,44,2,759,873,1632,9,4.75,201749
11,9,213,36,275,329,2,54,2,911,1006,1917,10,4.666666667,201749
11,10,184,34,226,254,19,51,20,788,760,1548,11,4.6,201749
11,11,171,17,152,194,14,47,0,595,792,1387,4,5,201749
11,12,186,30,314,313,12,48,0,903,1058,1961,7,5.5,201749
11,13,132,42,176,161,18,31,30,590,656,1246,9,4.5,201749
11,14,167,31,177,240,15,41,0,671,668,1339,8,4.5,201749
11,15,90,25,143,189,0,27,0,474,530,1004,6,5,201749
12,1,171,33,256,160,93,27,1,741,664,1405,10,4.2,201749
12,2,226,53,267,437,44,51,0,1078,911,1989,10,4.5,201749
12,3,144,20,272,267,173,47,28,951,616,1567,11,4.2,201749
12,4,180,24,286,13,34,46,396,979,1190,2169,9,5,201749
12,5,182,18,187,301,7,32,3,730,612,1342,10,4.25,201749
12,6,198,32,185,319,74,21,2,831,572,1403,10,4.25,201749
12,7,279,17,252,434,10,40,101,1133,967,2100,8,3.666666667,201749
12,8,245,22,305,306,13,31,0,922,767,1689,9,4.25,201749
12,9,231,11,231,456,23,22,21,995,1011,2006,9,4.666666667,201749
13,1,145,30,178,349,129,36,0,867,939,1806,9,4.333333333,201749
13,2,135,27,118,198,67,32,0,577,380,957,6,4.333333333,201749
13,3,123,12,137,155,78,53,0,558,471,1029,12,4.25,201749
13,4,186,26,198,259,112,59,5,845,928,1773,9,4.666666667,201749
13,5,193,13,302,265,87,68,2,930,940,1870,9,4.75,201749
13,6,335,36,611,614,40,84,1,1721,1724,3445,13,4.5,201749
13,7,150,13,228,247,12,35,0,685,842,1527,9,4.5,201749
14,1,132,12,93,100,28,52,12,429,457,886,6,4,201749
14,2,188,16,153,93,13,62,0,525,534,1059,6,4.666666667,201749
14,3,206,7,169,85,2,65,2,536,554,1090,11,4.2,201749
14,4,191,27,198,321,13,55,1,806,899,1705,12,5,201749
14,5,165,19,314,186,27,31,1,743,866,1609,11,4.5,201749
14,6,120,5,280,193,8,46,0,652,848,1500,11,5,201749
14,7,156,5,241,90,1,28,0,521,506,1027,6,5,201749
14,8,325,28,564,479,27,107,0,1530,1551,3081,13,3.666666667,201749
14,9,186,27,262,334,26,56,0,891,963,1854,8,5,201749
14,10,162,19,358,271,19,63,0,892,1018,1910,7,5,201749
14,11,92,8,107,152,15,31,1,406,501,907,4,5,201749
14,12,217,9,411,186,7,52,0,882,977,1859,11,4.5,201749
14,13,128,11,198,131,16,53,0,537,644,1181,8,5,201749
14,14,143,12,241,291,9,71,5,772,727,1499,7,6,201749
14,15,156,32,185,194,34,50,3,654,773,1427,10,4.6,201749
14,16,204,28,246,223,31,69,4,805,835,1640,5,5,201749
14,17,130,16,158,80,17,45,7,453,415,868,9,4.25,201749
14,18,116,13,127,106,21,30,29,442,708,1150,10,4,201749
14,19,203,34,198,242,38,63,11,789,876,1665,9,4.25,201749
14,20,100,6,182,73,0,28,0,389,414,803,10,4.666666667,201749
15,1,0,0,0,0,0,0,0,0,0,0,0,0,201749
15,2,0,0,0,0,0,0,0,0,0,0,0,0,201749
15,3,0,0,0,0,0,0,0,0,0,0,0,0,201749
15,4,0,0,0,0,0,0,0,0,0,0,0,0,201749
15,5,0,0,0,0,0,0,0,0,0,0,0,0,201749
15,6,0,0,0,0,0,0,0,0,0,0,0,0,201749
15,7,0,0,0,0,0,0,0,0,0,0,0,0,201749
15,8,0,0,0,0,0,0,0,0,0,0,0,0,201749
15,9,0,0,0,0,0,0,0,0,0,0,0,0,201749
15,10,0,0,0,0,0,0,0,0,0,0,0,0,201749
15,11,0,0,0,0,0,0,0,0,0,0,0,0,201749
15,12,0,0,0,0,0,0,0,0,0,0,0,0,201749
15,13,0,0,0,0,0,0,0,0,0,0,0,0,201749
15,14,0,0,0,0,0,0,0,0,0,0,0,0,201749
15,15,0,0,0,0,0,0,0,0,0,0,0,0,201749
15,16,0,0,0,0,0,0,0,0,0,0,0,0,201749
15,17,0,0,0,0,0,0,0,0,0,0,0,0,201749
15,18,0,0,0,0,0,0,0,0,0,0,0,0,201749
15,19,0,0,0,0,0,0,0,0,0,0,0,0,201749
15,20,0,0,0,0,0,0,0,0,0,0,0,0,201749
15,21,0,0,0,0,0,0,0,0,0,0,0,0,201749
15,22,0,0,0,0,0,0,0,0,0,0,0,0,201749
15,23,0,0,0,0,0,0,0,0,0,0,0,0,201749
15,24,0,0,0,0,0,0,0,0,0,0,0,0,201749
15,25,0,0,0,0,0,0,0,0,0,0,0,0,201749
15,26,0,0,0,0,0,0,0,0,0,0,0,0,201749
15,27,0,0,0,0,0,0,0,0,0,0,0,0,201749
15,28,0,0,0,0,0,0,0,0,0,0,0,0,201749
15,29,0,0,0,0,0,0,0,0,0,0,0,0,201749
15,30,0,0,0,0,0,0,0,0,0,0,0,0,201749
15,31,0,0,0,0,0,0,0,0,0,0,0,0,201749
15,32,0,0,0,0,0,0,0,0,0,0,0,0,201749
15,33,0,0,0,0,0,0,0,0,0,0,0,0,201749
15,34,0,0,0,0,0,0,0,0,0,0,0,0,201749
15,35,0,0,0,0,0,0,0,0,0,0,0,0,201749
15,36,0,0,0,0,0,0,0,0,0,0,0,0,201749
15,37,0,0,0,0,0,0,0,0,0,0,0,0,201749
15,38,0,0,0,0,0,0,0,0,0,0,0,0,201749
15,39,0,0,0,0,0,0,0,0,0,0,0,0,201749
15,40,0,0,0,0,0,0,0,0,0,0,0,0,201749
15,41,0,0,0,0,0,0,0,0,0,0,0,0,201749
16,1,121,8,150,136,7,33,0,455,448,903,10,3.666666667,201749
16,2,116,25,106,181,15,40,0,483,424,907,9,4,201749
16,3,140,14,96,168,23,36,0,477,509,986,10,3.5,201749
16,4,153,21,189,159,21,62,0,605,634,1239,8,4.5,201749
16,5,160,37,208,214,33,72,20,744,702,1446,10,4.666666667,201749
16,6,160,28,139,175,57,40,0,599,588,1187,12,4.5,201749
16,7,151,19,154,153,25,51,1,554,566,1120,9,4.5,201749
16,8,242,24,428,392,12,92,1,1191,1392,2583,12,5,201749
16,9,193,17,225,207,12,62,1,717,743,1460,10,5,201749
16,10,149,13,250,258,7,37,0,714,899,1613,8,4.666666667,201749
16,11,166,30,168,132,75,45,4,620,557,1177,12,4.4,201749
16,12,149,13,151,118,28,38,0,497,450,947,10,3.5,201749
17,1,205,18,346,478,30,79,6,1162,1357,2519,12,3.5,201749
17,2,138,7,204,356,9,43,11,768,853,1621,9,4.666666667,201749
17,3,200,27,350,429,18,64,0,1088,1106,2194,8,4.5,201749
17,4,193,20,265,300,12,73,84,947,1148,2095,10,4.666666667,201749
17,5,82,10,127,113,6,32,39,409,531,940,5,4.5,201749
18,1,127,9,177,160,17,42,0,532,531,1063,9,4.4,201749
18,2,227,20,392,300,57,61,0,1057,1174,2231,10,5,201749
18,3,191,14,278,143,9,44,0,679,748,1427,9,4.75,201749
19,1,209,16,278,275,10,83,2,873,868,1741,9,5,201749
19,2,311,15,491,328,49,71,2,1267,1633,2900,10,5.5,201749
19,3,226,16,410,305,18,75,0,1050,1436,2486,8,4,201749
19,4,89,4,142,120,14,42,20,431,447,878,5,4,201749
19,5,257,25,323,434,9,70,27,1145,1293,2438,8,4,201749
19,6,88,7,179,159,6,53,9,501,521,1022,5,5,201749
19,7,181,5,400,148,3,31,0,768,805,1573,10,4,201749
19,8,56,1,64,54,1,20,0,196,213,409,7,4,201749
19,9,174,13,198,204,22,54,0,665,641,1306,9,4,201749
19,10,126,8,182,201,5,67,0,589,799,1388,7,2.333333333,201749
19,11,422,47,481,639,23,132,6,1750,1868,3618,13,5.333333333,201749
19,12,163,10,381,176,10,47,2,789,841,1630,8,4.666666667,201749
20,1,199,14,217,199,40,61,0,730,733,1463,7,4.5,201749
20,2,116,16,156,112,33,19,0,452,436,888,6,4.333333333,201749
20,3,111,13,124,175,65,33,0,521,709,1230,6,4.333333333,201749
20,4,107,20,95,264,46,44,0,576,629,1205,6,4,201749
20,5,159,18,285,209,172,42,26,911,1067,1978,11,4.25,201749
20,6,115,11,124,194,102,17,1,564,842,1406,8,4.25,201749
20,7,167,28,313,218,83,58,0,867,984,1851,8,4.75,201749
20,8,414,27,451,693,29,137,54,1805,2002,3807,15,4,201749
20,9,175,10,143,189,65,56,12,650,1005,1655,8,4.666666667,201749
20,10,180,18,178,347,18,50,0,791,685,1476,9,4.25,201749
21,1,189,8,251,324,22,39,0,833,1074,1907,9,4.4,201749
21,2,207,18,202,168,49,48,1,693,768,1461,9,4.2,201749
21,3,241,9,273,210,49,82,18,882,776,1658,8,4.5,201749
21,4,127,7,143,58,61,36,52,484,558,1042,6,4.25,201749
21,5,189,14,248,177,29,62,33,752,776,1528,8,4.666666667,201749
21,6,213,13,310,432,40,79,46,1133,1406,2539,6,6,201749
21,7,196,9,229,57,131,63,20,705,977,1682,9,4.666666667,201749
21,8,139,14,153,206,65,33,5,615,637,1252,10,4.2,201749
21,9,202,9,341,363,43,85,23,1066,1295,2361,9,5,201749
21,10,192,12,270,274,28,77,39,892,1005,1897,7,5,201749
21,11,85,3,130,92,34,23,10,377,244,621,6,4,201749
21,12,357,22,638,436,91,111,171,1826,2072,3898,15,4,201749
21,13,235,11,223,330,36,80,1,916,1028,1944,8,4.666666667,201749
21,14,181,13,271,117,77,45,18,722,798,1520,13,4.333333333,201749
21,15,184,12,352,258,64,74,3,947,960,1907,7,4.5,201749
22,1,170,44,193,309,84,29,0,829,765,1594,11,4.2,201749
22,2,173,36,279,311,47,52,6,904,780,1684,7,4.5,201749
22,3,304,40,601,474,37,94,5,1555,1635,3190,10,5,201749
22,4,265,40,463,395,32,65,1,1261,1466,2727,13,3.6,201749
22,5,176,22,317,192,28,38,2,775,753,1528,10,4.5,201749
23,1,204,6,834,373,62,39,0,1518,1723,3241,14,4.6,201749
23,2,168,20,403,566,16,33,1,1207,1118,2325,10,3.2,201749
23,3,298,13,785,419,32,44,1,1592,1670,3262,11,5,201749
23,4,179,4,555,262,32,42,0,1074,983,2057,10,4,201749
24,1,163,37,141,361,40,32,1,775,726,1501,11,4.2,201749
24,2,160,18,149,177,7,24,0,535,529,1064,6,4.5,201749
24,3,159,43,203,660,97,42,0,1204,1149,2353,9,4.25,201749
24,4,193,33,223,214,32,52,65,812,770,1582,5,4.5,201749
24,5,205,27,325,421,12,73,0,1063,1105,2168,10,4.25,201749
24,6,367,30,415,478,19,66,0,1375,1561,2936,11,4.333333333,201749
24,7,226,34,294,451,74,29,0,1108,826,1934,9,4.25,201749
25,1,112,14,202,201,17,53,0,599,652,1251,14,4.75,201749
25,2,234,19,273,329,17,73,0,945,1021,1966,7,4.5,201749
25,3,220,23,226,341,24,54,3,891,878,1769,9,4.6,201749
25,4,149,16,122,249,14,46,0,596,543,1139,8,3.666666667,201749
25,5,204,13,264,380,14,73,0,948,1074,2022,11,4,201749
25,6,182,17,328,253,25,88,0,893,851,1744,9,4.75,201749
25,7,237,7,275,334,7,71,0,931,903,1834,7,5,201749
26,1,221,13,230,214,5,77,0,760,773,1533,9,4.5,201749
26,2,169,9,284,314,2,63,0,841,992,1833,13,4.4,201749
26,3,252,13,412,539,6,141,1,1364,1512,2876,15,4.333333333,201749
26,4,148,16,167,210,11,69,0,621,711,1332,10,4.2,201749
26,5,51,6,96,94,7,33,0,287,265,552,3,4.5,201749
26,6,135,8,267,343,1,76,0,830,899,1729,10,4.333333333,201749
26,7,159,13,147,264,11,36,0,630,681,1311,10,4.5,201749
27,1,162,14,154,336,12,31,0,709,664,1373,9,4.5,201749
27,2,240,30,222,523,25,55,1,1096,762,1858,8,4.666666667,201749
27,3,136,13,132,350,9,36,0,676,788,1464,7,4.666666667,201749
27,4,246,8,256,676,11,57,1,1255,1263,2518,10,3.25,201749
27,5,112,6,78,396,4,37,1,634,406,1040,6,4.333333333,201749
27,6,158,12,216,412,3,40,0,841,989,1830,9,4.333333333,201749
28,1,193,17,361,291,5,65,0,932,1050,1982,13,5,201749
28,2,223,13,426,250,23,72,42,1049,1210,2259,14,4.75,201749
28,3,139,16,149,169,8,32,0,513,525,1038,7,4.333333333,201749
28,4,298,28,346,355,24,86,21,1158,1189,2347,16,5,201749
28,5,200,16,211,293,19,52,0,791,866,1657,13,3.166666667,201749
28,6,122,24,161,404,76,23,18,828,859,1687,14,4.166666667,201749
28,7,240,20,416,365,29,72,0,1142,1206,2348,8,5,201749
28,8,158,12,223,266,38,46,0,743,835,1578,11,4.666666667,201749
28,9,113,12,223,169,18,27,30,592,727,1319,9,5,201749
29,1,239,44,272,256,54,49,0,914,1024,1938,10,4.5,201749
29,2,223,13,218,444,23,70,24,1015,1095,2110,15,3.833333333,201749
29,3,128,25,120,262,13,38,0,586,612,1198,7,4.666666667,201749
30,1,93,15,135,137,36,20,20,456,497,953,7,4.333333333,201749
30,2,147,16,167,76,47,29,239,721,738,1459,8,4.25,201749
30,3,169,16,203,177,83,70,58,776,736,1512,6,4.666666667,201749
30,4,129,5,219,202,24,40,0,619,678,1297,8,5,201749
30,5,172,10,198,321,31,69,0,801,801,1602,7,4.5,201749
30,6,148,11,163,171,41,45,0,579,465,1044,9,4.333333333,201749
30,7,171,33,241,320,78,58,20,921,648,1569,12,4.25,201749
30,8,224,13,268,285,40,73,1,904,868,1772,11,4.4,201749
30,9,189,17,153,167,50,59,60,695,682,1377,8,4.5,201749
30,10,224,11,345,291,41,65,19,996,1087,2083,9,4.333333333,201749
30,11,172,13,279,320,15,73,0,872,901,1773,6,4.5,201749
30,12,286,17,488,516,22,110,0,1439,1570,3009,11,5.25,201749
30,13,193,20,181,322,47,59,1,823,838,1661,10,4.4,201749
30,14,174,15,220,219,85,58,0,771,771,1542,9,4.5,201749
30,15,256,17,183,218,44,96,53,867,922,1789,11,4.666666667,201749
30,16,153,12,191,292,38,78,22,786,901,1687,10,4.333333333,201749
30,17,165,22,138,209,27,47,0,608,793,1401,8,4.5,201749
30,18,182,10,123,216,17,41,36,625,547,1172,8,4.25,201749
30,19,148,17,182,78,178,56,84,743,921,1664,13,4.6,201749
30,20,170,20,174,441,110,85,0,1000,811,1811,11,4.4,201749
31,1,184,20,221,369,18,42,0,854,650,1504,8,4.5,201749
31,2,101,3,116,28,167,30,0,445,452,897,7,4.333333333,201749
31,3,323,44,638,559,49,115,0,1728,1856,3584,21,4.25,201749
31,4,236,10,271,221,27,42,0,807,758,1565,6,5.5,201749
31,5,204,10,122,232,15,14,0,597,540,1137,7,4.333333333,201749
32,1,156,30,132,147,19,32,11,527,601,1128,12,4.2,201749
32,2,167,51,170,153,91,36,2,670,389,1059,13,4.142857143,201749
32,3,187,40,185,211,16,58,9,706,836,1542,15,4.333333333,201749
32,4,162,40,197,234,20,39,30,722,777,1499,13,3.833333333,201749
1,1,205,39,250,267,51,32,7,851,887,1738,13,5,201750
1,2,220,24,485,384,74,77,10,1274,1208,2482,12,5,201750
1,3,272,47,586,396,29,95,2,1427,1176,2603,13,5.4,201750
2,1,161,4,261,264,8,62,0,760,810,1570,11,6,201750
2,2,313,18,322,474,6,123,0,1256,1118,2374,9,4.666666667,201750
2,3,328,21,495,385,36,117,0,1382,1140,2522,11,4.2,201750
2,4,119,8,292,180,11,41,0,651,629,1280,6,6,201750
2,5,421,28,839,554,137,158,2,2139,2209,4348,16,6.25,201750
2,6,215,7,429,349,24,68,0,1092,1011,2103,7,6,201750
2,7,285,12,480,375,31,68,15,1266,977,2243,12,5.75,201750
2,8,285,14,584,488,17,64,0,1452,1394,2846,8,6,201750
3,1,175,13,279,278,19,75,3,842,923,1765,15,5,201750
3,2,180,8,454,237,14,46,0,939,906,1845,9,6,201750
4,1,222,27,399,545,61,56,0,1310,1284,2594,15,4.833333333,201750
4,2,234,20,373,409,29,47,3,1115,1164,2279,14,5.4,201750
5,1,280,19,405,352,32,92,0,1180,1048,2228,9,6,201750
5,2,258,26,342,544,31,75,6,1282,850,2132,10,5.2,201750
5,3,220,27,261,356,44,85,0,993,948,1941,9,5.5,201750
5,4,287,30,512,438,22,142,12,1443,1726,3169,11,5,201750
5,5,245,22,308,514,24,55,8,1176,1091,2267,8,6,201750
5,6,163,16,201,228,4,48,11,671,754,1425,7,5.5,201750
5,7,215,20,224,303,52,63,3,880,751,1631,10,3.666666667,201750
6,1,149,24,276,255,6,76,7,793,837,1630,14,4.571428571,201750
6,2,153,16,251,172,48,62,1,703,741,1444,9,5.666666667,201750
7,1,221,9,146,457,8,20,10,871,914,1785,9,5.75,201750
7,2,239,9,121,596,286,49,9,1309,1658,2967,9,5.25,201750
7,3,320,3,138,349,119,55,1,985,637,1622,7,5.333333333,201750
7,4,165,21,191,859,15,54,177,1482,1146,2628,11,5.4,201750
7,5,386,16,245,612,26,68,57,1410,1332,2742,11,5.666666667,201750
7,6,296,26,383,652,50,84,10,1501,1339,2840,8,4.25,201750
7,7,311,32,391,795,131,110,19,1789,1391,3180,8,5.5,201750
7,8,289,24,335,999,45,64,0,1756,1681,3437,12,5.25,201750
7,9,298,25,469,528,41,109,155,1625,1695,3320,11,4.5,201750
7,10,276,19,382,586,199,59,0,1521,1386,2907,9,5.5,201750
7,11,106,0,105,133,28,11,0,383,686,1069,6,5.333333333,201750
7,12,305,7,432,888,17,61,0,1710,1272,2982,9,5.5,201750
7,13,156,20,176,616,28,46,0,1042,1201,2243,9,5,201750
8,1,243,14,401,247,20,41,0,966,797,1763,4,6,201750
8,2,319,33,443,316,23,66,2,1202,1382,2584,12,5.5,201750
8,3,234,35,364,391,13,83,7,1127,1140,2267,5,6,201750
8,4,183,13,430,276,43,89,5,1039,1020,2059,9,6,201750
8,5,242,29,291,242,27,73,0,904,962,1866,10,5.25,201750
8,6,184,24,346,382,35,90,4,1065,987,2052,6,4,201750
8,7,160,20,201,202,15,48,0,646,691,1337,8,5.25,201750
8,8,181,30,301,328,8,90,0,938,1203,2141,12,4,201750
8,9,270,28,145,261,30,78,0,812,652,1464,10,5,201750
9,1,130,17,191,166,64,48,0,616,540,1156,6,7,201750
9,2,406,82,752,904,84,164,269,2661,2798,5459,12,6,201750
9,3,191,32,405,504,40,89,4,1265,1299,2564,7,6,201750
9,4,235,17,371,647,51,91,4,1416,1288,2704,11,6,201750
9,5,161,18,283,92,77,67,209,907,812,1719,7,6,201750
9,6,126,45,192,167,53,42,20,645,604,1249,7,6,201750
9,7,139,8,292,475,12,60,3,989,902,1891,9,6,201750
9,8,53,20,165,150,17,32,8,445,502,947,6,7,201750
9,9,137,8,169,300,47,65,9,735,738,1473,5,6,201750
9,10,152,20,353,113,34,98,243,1013,940,1953,6,6,201750
9,11,248,16,508,671,42,99,14,1598,1383,2981,7,6,201750
9,12,197,31,486,702,24,92,16,1548,1632,3180,11,6,201750
9,13,150,18,282,395,50,72,10,977,966,1943,4,6,201750
9,14,147,7,212,273,97,65,0,801,699,1500,5,6,201750
9,15,415,34,934,1127,24,183,9,2726,2367,5093,11,4.25,201750
9,16,286,46,510,456,76,141,212,1727,1689,3416,15,7,201750
9,17,158,9,226,338,19,66,0,816,743,1559,6,6,201750
9,18,249,34,368,696,31,118,38,1534,1427,2961,12,6,201750
9,19,280,43,325,526,97,97,5,1373,1227,2600,5,6,201750
9,20,9,0,30,41,5,11,1,97,44,141,5,6,201750
9,21,94,10,193,41,59,48,170,615,592,1207,3,6,201750
9,22,161,16,264,278,105,86,52,962,944,1906,5,6,201750
9,23,152,22,339,130,67,71,369,1150,1098,2248,7,7,201750
9,24,357,39,625,530,137,140,247,2075,1896,3971,13,6.5,201750
10,1,210,22,189,218,7,57,15,718,456,1174,12,4.666666667,201750
10,2,223,14,236,314,26,51,9,873,858,1731,9,5.5,201750
10,3,225,33,168,230,14,62,54,786,761,1547,12,5.4,201750
10,4,355,26,429,494,15,78,0,1397,1395,2792,12,4.8,201750
11,1,174,63,255,553,22,50,10,1127,840,1967,6,5.666666667,201750
11,2,209,28,250,288,34,61,14,884,784,1668,7,6,201750
11,3,203,22,215,278,12,71,0,801,740,1541,4,6,201750
11,4,201,39,189,313,14,46,0,802,720,1522,10,3.8,201750
11,5,298,41,372,497,12,96,2,1318,1167,2485,8,6.5,201750
11,6,183,28,292,301,41,76,7,928,840,1768,8,5.666666667,201750
11,7,221,28,254,460,25,52,0,1040,912,1952,9,5.5,201750
11,8,222,33,205,387,31,60,0,938,875,1813,9,5.75,201750
11,9,258,62,345,437,12,87,1,1202,1124,2326,10,5.666666667,201750
11,10,204,37,246,305,14,55,23,884,802,1686,11,5.6,201750
11,11,218,23,220,291,16,58,0,826,731,1557,4,6,201750
11,12,233,36,357,456,9,64,0,1155,1103,2258,7,6.5,201750
11,13,237,44,254,278,36,65,41,955,848,1803,9,5.5,201750
11,14,211,30,246,287,21,54,7,856,815,1671,8,5.5,201750
11,15,158,47,190,199,4,39,0,637,559,1196,6,6,201750
12,1,171,27,273,166,83,31,9,760,670,1430,10,5,201750
12,2,225,47,256,434,35,63,0,1060,926,1986,10,5.25,201750
12,3,202,61,337,489,85,42,39,1255,987,2242,11,5.2,201750
12,4,179,24,365,95,45,52,406,1166,1054,2220,9,6,201750
12,5,247,20,236,301,3,34,19,860,757,1617,10,4.25,201750
12,6,262,30,390,317,54,25,0,1078,784,1862,10,5.25,201750
12,7,254,34,386,565,43,63,43,1388,1152,2540,8,4,201750
12,8,262,31,530,350,11,29,0,1213,976,2189,9,5.25,201750
12,9,227,31,253,503,13,35,26,1088,998,2086,9,5.666666667,201750
13,1,199,40,206,646,221,68,0,1380,969,2349,9,5.333333333,201750
13,2,190,21,149,301,82,54,0,797,639,1436,6,5.333333333,201750
13,3,281,33,266,385,105,74,1,1145,982,2127,12,5.25,201750
13,4,222,18,238,284,51,41,0,854,940,1794,9,5.666666667,201750
13,5,265,17,352,346,92,102,7,1181,1169,2350,9,5.75,201750
13,6,415,36,694,719,41,104,2,2011,2171,4182,13,5.25,201750
13,7,152,26,365,366,28,68,0,1005,959,1964,9,5.5,201750
14,1,155,17,115,97,19,42,11,456,433,889,6,4.5,201750
14,2,179,8,171,140,19,71,0,588,552,1140,6,5.666666667,201750
14,3,286,14,239,144,10,86,2,781,730,1511,11,5.4,201750
14,4,224,22,245,403,16,73,6,989,897,1886,12,6,201750
14,5,252,20,395,262,33,60,2,1024,879,1903,11,5.5,201750
14,6,218,11,383,250,12,61,0,935,886,1821,11,6,201750
14,7,156,15,294,99,0,51,0,615,616,1231,6,6,201750
14,8,311,29,642,574,35,128,2,1721,1868,3589,13,4.833333333,201750
14,9,245,40,313,393,31,66,0,1088,990,2078,8,6,201750
14,10,214,31,378,300,9,76,0,1008,982,1990,7,6,201750
14,11,109,17,170,196,20,49,1,562,494,1056,4,6,201750
14,12,259,10,534,194,11,61,0,1069,1015,2084,11,5.25,201750
14,13,165,13,223,175,13,45,0,634,626,1260,8,4.5,201750
14,14,167,15,298,317,10,77,1,885,894,1779,7,7,201750
14,15,195,23,170,225,19,65,11,708,648,1356,10,5.6,201750
14,16,243,26,267,265,37,75,5,918,911,1829,5,6,201750
14,17,169,21,144,128,31,62,27,582,631,1213,9,5.25,201750
14,18,242,33,254,183,55,57,28,852,1035,1887,10,5.4,201750
14,19,245,38,334,275,31,74,20,1017,699,1716,9,5.25,201750
14,20,154,10,219,86,7,46,1,523,466,989,10,5.666666667,201750
15,1,214,17,133,127,119,47,1,658,634,1292,7,5.333333333,201750
15,2,166,7,188,279,42,53,8,743,786,1529,6,5,201750
15,3,265,22,262,298,46,69,1,963,981,1944,10,5.666666667,201750
15,4,218,15,248,339,32,72,10,934,908,1842,4,5,201750
15,5,165,15,194,237,5,55,1,672,652,1324,8,4.666666667,201750
15,6,154,12,256,309,53,44,1,829,959,1788,7,5.5,201750
15,7,209,14,234,324,38,55,0,874,869,1743,10,5,201750
15,8,90,16,116,169,9,26,0,426,457,883,4,5,201750
15,9,203,9,122,181,68,36,4,623,614,1237,9,4.75,201750
15,10,157,10,200,264,51,52,0,734,747,1481,9,5,201750
15,11,186,9,250,369,29,46,1,890,916,1806,8,5,201750
15,12,252,17,469,453,19,60,0,1270,1335,2605,8,5,201750
15,13,124,9,165,207,58,38,0,601,565,1166,8,5,201750
15,14,76,13,107,163,9,36,0,404,442,846,4,5,201750
15,15,180,36,213,348,12,78,0,867,917,1784,6,5,201750
15,16,245,26,338,510,4,66,2,1191,1139,2330,8,5,201750
15,17,145,16,168,237,9,61,1,637,510,1147,8,5,201750
15,18,235,27,274,363,26,73,0,998,1056,2054,7,4.666666667,201750
15,19,286,71,501,751,5,94,0,1708,1708,3416,14,6,201750
15,20,96,8,147,265,14,31,1,562,572,1134,6,5,201750
15,21,131,7,104,165,7,51,0,465,438,903,6,4.5,201750
15,22,337,43,511,762,29,125,1,1808,1830,3638,14,6,201750
15,23,250,11,216,300,27,65,0,869,929,1798,7,4.333333333,201750
15,24,136,12,183,241,3,37,1,613,709,1322,4,5,201750
15,25,214,28,284,262,7,43,0,838,875,1713,6,5,201750
15,26,163,11,227,177,28,56,0,662,719,1381,11,2.666666667,201750
15,27,275,18,281,473,12,79,1,1139,1022,2161,9,5.666666667,201750
15,28,253,19,429,293,35,73,0,1102,1011,2113,9,4.666666667,201750
15,29,293,41,353,603,13,91,0,1394,1330,2724,8,6,201750
15,30,269,20,499,433,41,74,6,1342,1457,2799,12,6,201750
15,31,240,37,216,363,11,63,0,930,1000,1930,6,6,201750
15,32,174,15,235,378,35,57,0,894,958,1852,9,6,201750
15,33,214,12,262,370,17,52,0,927,983,1910,7,5,201750
15,34,213,21,241,385,9,60,1,930,782,1712,8,6,201750
15,35,308,13,217,329,21,89,0,977,1117,2094,9,4.666666667,201750
15,36,272,25,226,280,48,36,0,887,838,1725,9,4.5,201750
15,37,186,17,253,382,47,56,13,954,974,1928,7,5,201750
15,38,201,15,235,343,7,76,0,877,891,1768,6,4.5,201750
15,39,158,15,240,260,12,44,3,732,707,1439,4,6,201750
15,40,249,20,263,338,85,122,4,1081,1105,2186,9,5,201750
15,41,361,44,634,754,37,82,16,1928,1875,3803,11,6,201750
16,1,144,18,221,118,26,31,0,558,370,928,10,4.333333333,201750
16,2,116,23,123,146,15,34,0,457,500,957,9,4.25,201750
16,3,127,16,137,212,35,33,0,560,708,1268,10,4.25,201750
16,4,154,27,191,139,25,75,0,611,486,1097,8,4.5,201750
16,5,234,43,193,218,19,92,8,807,779,1586,10,5.666666667,201750
16,6,235,33,156,176,66,57,0,723,682,1405,12,4,201750
16,7,249,25,205,205,66,96,0,846,705,1551,9,5.5,201750
16,8,265,27,389,423,15,82,3,1204,1284,2488,12,5,201750
16,9,227,19,246,224,13,68,1,798,722,1520,10,5,201750
16,10,145,19,271,298,11,61,0,805,973,1778,8,4.666666667,201750
16,11,198,31,186,145,99,83,3,745,743,1488,12,3.8,201750
16,12,219,13,186,127,39,44,0,628,517,1145,10,4.25,201750
17,1,213,19,435,568,27,89,7,1358,1124,2482,12,4.75,201750
17,2,153,9,298,400,6,48,18,932,893,1825,9,5.666666667,201750
17,3,240,26,441,570,20,80,1,1378,1312,2690,8,5.5,201750
17,4,212,31,403,403,10,76,99,1234,1006,2240,10,5.333333333,201750
17,5,103,15,133,140,11,34,50,486,588,1074,5,5.5,201750
18,1,177,15,144,171,22,42,0,571,490,1061,9,5.4,201750
18,2,259,27,430,339,52,84,0,1191,1238,2429,10,5.75,201750
18,3,214,23,352,260,8,45,0,902,845,1747,9,5.75,201750
19,1,241,23,285,352,26,88,4,1019,963,1982,9,5,201750
19,2,297,12,550,260,75,66,0,1260,1306,2566,10,6.5,201750
19,3,263,20,523,334,30,86,1,1257,2042,3299,8,5,201750
19,4,139,9,160,153,27,42,24,554,649,1203,5,5,201750
19,5,334,29,426,508,22,78,44,1441,1459,2900,8,5,201750
19,6,105,10,167,208,5,44,8,547,529,1076,5,5,201750
19,7,211,16,492,226,10,46,0,1001,1101,2102,10,4.5,201750
19,8,72,4,123,96,1,15,0,311,263,574,7,5,201750
19,9,247,20,215,255,51,56,0,844,522,1366,9,4.25,201750
19,10,156,12,198,257,6,54,0,683,1006,1689,7,2.666666667,201750
19,11,454,47,597,763,23,134,1,2019,1735,3754,13,5.333333333,201750
19,12,185,14,472,175,6,45,4,901,1046,1947,8,5,201750
20,1,220,17,225,278,76,62,0,878,788,1666,7,5.5,201750
20,2,200,12,153,175,36,35,0,611,525,1136,6,5.333333333,201750
20,3,166,15,186,213,60,53,1,694,717,1411,6,5.333333333,201750
20,4,162,21,131,202,40,49,0,605,627,1232,6,5,201750
20,5,171,13,216,219,100,56,18,793,877,1670,11,5,201750
20,6,210,14,189,342,99,36,0,890,857,1747,8,5.25,201750
20,7,200,19,344,374,108,64,0,1109,1065,2174,8,5,201750
20,8,518,29,607,900,48,147,68,2317,1964,4281,15,5,201750
20,9,174,13,158,191,50,70,19,675,744,1419,8,5.333333333,201750
20,10,235,18,243,404,16,42,0,958,970,1928,9,5.25,201750
21,1,240,11,243,365,17,42,0,918,1131,2049,9,4.4,201750
21,2,204,6,202,201,44,64,1,722,708,1430,9,4,201750
21,3,277,16,314,173,64,76,12,932,884,1816,8,4.5,201750
21,4,209,15,264,96,110,47,69,810,767,1577,6,4.25,201750
21,5,176,10,273,198,29,84,33,803,691,1494,8,4.666666667,201750
21,6,201,10,304,390,24,92,24,1045,1200,2245,6,6,201750
21,7,231,19,289,59,139,68,18,823,966,1789,9,4.666666667,201750
21,8,211,9,211,262,70,58,6,827,803,1630,10,4,201750
21,9,201,14,345,405,38,95,16,1114,1095,2209,9,5,201750
21,10,209,6,283,277,25,71,10,881,917,1798,7,5,201750
21,11,44,0,80,84,12,12,0,232,345,577,6,3.5,201750
21,12,361,21,645,421,121,124,126,1819,1794,3613,14,3.666666667,201750
21,13,226,16,241,248,33,88,0,852,907,1759,8,4.666666667,201750
21,14,173,10,237,135,55,66,7,683,771,1454,13,4.333333333,201750
21,15,182,7,228,244,34,47,1,743,947,1690,7,4.5,201750
22,1,228,52,270,396,58,48,0,1052,1173,2225,11,5.2,201750
22,2,196,24,339,248,46,44,25,922,867,1789,7,5.5,201750
22,3,377,50,677,628,49,95,6,1882,1596,3478,10,6,201750
22,4,368,32,597,508,30,83,0,1618,1401,3019,13,4.4,201750
22,5,178,29,410,235,36,55,2,945,809,1754,10,5.5,201750
23,1,245,11,1153,455,134,47,0,2045,1901,3946,14,5.6,201750
23,2,216,29,439,516,21,47,0,1268,1089,2357,10,4.2,201750
23,3,292,7,920,503,43,67,0,1832,1761,3593,11,6,201750
23,4,152,7,597,258,48,37,0,1099,1169,2268,10,4.75,201750
24,1,191,45,215,419,66,32,1,969,862,1831,11,5.2,201750
24,2,101,23,194,187,15,34,0,554,590,1144,6,5.5,201750
24,3,152,49,251,576,117,41,0,1186,1227,2413,9,5.25,201750
24,4,224,38,248,232,49,72,91,954,845,1799,5,5.5,201750
24,5,207,36,393,516,8,102,0,1262,1331,2593,9,4.75,201750
24,6,365,44,528,590,26,110,0,1663,1487,3150,11,4.666666667,201750
24,7,297,34,434,482,104,59,0,1410,1238,2648,9,5.25,201750
25,1,162,21,246,234,12,60,0,735,739,1474,14,4.25,201750
25,2,234,26,366,384,21,90,0,1121,986,2107,7,2.5,201750
25,3,228,15,300,340,52,46,3,984,1013,1997,9,4.4,201750
25,4,192,16,176,304,10,53,15,766,886,1652,8,3.333333333,201750
25,5,234,14,299,465,12,115,0,1139,1001,2140,11,3.25,201750
25,6,290,26,356,309,42,87,1,1111,1065,2176,9,4.25,201750
25,7,231,14,295,385,7,77,0,1009,972,1981,7,3,201750
26,1,195,12,318,293,14,70,0,902,829,1731,9,5.5,201750
26,2,187,14,359,382,2,69,1,1014,1196,2210,13,5.4,201750
26,3,361,19,466,555,13,172,0,1586,1585,3171,15,5.666666667,201750
26,4,165,8,176,227,35,82,1,694,697,1391,10,5.2,201750
26,5,124,22,129,136,7,53,0,471,408,879,3,5.5,201750
26,6,163,14,339,385,4,90,0,995,976,1971,10,5.333333333,201750
26,7,188,25,208,333,26,37,1,818,637,1455,10,5.5,201750
27,1,162,18,173,410,13,32,0,808,893,1701,9,5.5,201750
27,2,220,15,196,593,18,64,0,1106,991,2097,8,5.666666667,201750
27,3,240,8,190,430,16,37,0,921,809,1730,7,5.666666667,201750
27,4,359,19,328,734,15,63,4,1522,1404,2926,10,4,201750
27,5,159,5,130,314,6,46,0,660,771,1431,6,5.333333333,201750
27,6,193,27,198,432,2,59,0,911,1100,2011,9,5.333333333,201750
28,1,264,20,421,428,13,65,0,1211,1105,2316,13,6,201750
28,2,269,14,497,389,29,93,86,1377,1174,2551,14,6,201750
28,3,183,25,214,280,14,34,0,750,725,1475,7,5.333333333,201750
28,4,336,29,385,393,40,83,41,1307,1122,2429,16,6,201750
28,5,240,22,239,432,18,62,1,1014,950,1964,12,3.666666667,201750
28,6,222,49,260,639,133,49,28,1380,1085,2465,14,5.166666667,201750
28,7,254,31,498,406,67,98,0,1354,1190,2544,8,6,201750
28,8,218,22,293,321,38,62,2,956,886,1842,11,5.666666667,201750
28,9,165,13,271,187,15,42,39,732,607,1339,9,6,201750
29,1,274,42,317,356,60,68,0,1117,1004,2121,10,5.5,201750
29,2,319,24,277,558,32,85,42,1337,1176,2513,14,4.333333333,201750
29,3,162,27,159,259,13,43,0,663,735,1398,7,5.666666667,201750
30,1,165,17,135,232,40,46,24,659,529,1188,7,4.333333333,201750
30,2,167,29,169,96,79,52,352,944,754,1698,8,5,201750
30,3,186,15,235,176,114,56,109,891,840,1731,6,5.666666667,201750
30,4,158,11,262,213,31,53,0,728,702,1430,8,6,201750
30,5,192,13,189,331,12,75,0,812,847,1659,7,5.5,201750
30,6,206,21,232,261,34,66,0,820,702,1522,9,5.333333333,201750
30,7,308,40,295,358,125,82,22,1230,911,2141,12,5.25,201750
30,8,257,17,311,327,52,73,1,1038,821,1859,11,5,201750
30,9,206,14,237,185,54,74,48,818,814,1632,8,5.5,201750
30,10,195,7,300,324,26,82,12,946,806,1752,9,4,201750
30,11,150,15,288,261,7,50,0,771,784,1555,6,4.5,201750
30,12,243,37,438,547,30,124,0,1419,1368,2787,11,5,201750
30,13,204,17,161,397,101,58,10,948,849,1797,10,5.4,201750
30,14,205,19,286,267,177,79,0,1033,921,1954,9,5.5,201750
30,15,235,18,210,250,48,93,67,921,843,1764,11,5,201750
30,16,190,8,214,314,81,79,28,914,865,1779,10,4.333333333,201750
30,17,164,29,141,237,43,68,0,682,827,1509,8,5,201750
30,18,225,18,156,304,35,71,59,868,680,1548,8,5.25,201750
30,19,217,16,202,110,120,58,59,782,738,1520,13,5.6,201750
30,20,186,25,221,371,105,83,1,992,755,1747,11,5,201750
31,1,228,21,233,485,24,43,0,1034,765,1799,8,5.5,201750
31,2,133,9,160,24,191,37,0,554,564,1118,7,5.333333333,201750
31,3,382,58,820,567,94,137,0,2058,1840,3898,21,6.666666667,201750
31,4,93,15,278,246,29,54,0,715,702,1417,6,5,201750
31,5,263,12,171,266,11,48,0,771,680,1451,7,5.333333333,201750
32,1,247,34,190,239,34,62,24,830,684,1514,12,5.2,201750
32,2,260,61,250,249,89,53,3,965,1144,2109,13,5.142857143,201750
32,3,265,53,232,274,19,59,15,917,833,1750,15,5.166666667,201750
32,4,234,95,305,280,31,82,74,1101,970,2071,12,4.5,201750
1,1,233,33,283,310,54,54,7,974,1141,2115,13,5.5,201751
1,2,218,51,406,333,59,75,7,1149,1365,2514,12,5,201751
1,3,248,49,509,349,36,89,1,1281,1199,2480,13,5.2,201751
2,1,190,11,254,253,11,46,3,768,807,1575,11,6,201751
2,2,227,18,323,400,3,82,0,1053,1193,2246,9,4.666666667,201751
2,3,355,30,471,428,16,136,2,1438,1385,2823,11,4.4,201751
2,4,132,11,276,185,12,31,0,647,705,1352,6,6,201751
2,5,394,21,777,532,128,133,5,1990,2143,4133,16,6,201751
2,6,212,14,469,323,22,68,0,1108,1034,2142,7,6,201751
2,7,243,14,421,315,21,55,3,1072,991,2063,12,5.75,201751
2,8,253,6,527,436,10,71,0,1303,1433,2736,8,6,201751
3,1,137,5,290,286,22,92,4,836,1080,1916,15,5,201751
3,2,151,6,464,224,17,35,1,898,953,1851,9,6,201751
4,1,244,25,303,514,82,67,0,1235,1347,2582,15,4.666666667,201751
4,2,180,27,442,389,62,65,2,1167,1202,2369,14,5.4,201751
5,1,233,11,299,267,24,70,0,904,1154,2058,9,6,201751
5,2,156,12,237,318,13,37,2,775,875,1650,10,6,201751
5,3,167,11,256,331,44,66,0,875,947,1822,9,6,201751
5,4,224,17,331,312,15,102,12,1013,1195,2208,11,6,201751
5,5,202,24,289,399,11,56,11,992,1018,2010,8,6,201751
5,6,152,11,149,232,6,36,11,597,734,1331,7,5.5,201751
5,7,138,8,146,208,11,34,0,545,698,1243,10,3.666666667,201751
6,1,190,13,289,270,3,72,1,838,886,1724,14,4.428571429,201751
6,2,160,19,269,184,58,48,2,740,873,1613,9,5.666666667,201751
7,1,190,15,192,532,10,43,7,989,1220,2209,9,5.25,201751
7,2,301,26,218,1250,61,46,0,1902,976,2878,9,5.25,201751
7,3,280,9,157,186,220,35,0,887,1271,2158,7,5.333333333,201751
7,4,183,21,225,594,10,56,92,1181,1513,2694,11,5.4,201751
7,5,312,13,213,782,23,68,38,1449,1273,2722,11,5.666666667,201751
7,6,238,15,366,564,42,80,14,1319,970,2289,9,4.5,201751
7,7,272,28,310,752,65,56,2,1485,1750,3235,8,5.5,201751
7,8,299,28,292,966,83,77,0,1745,1770,3515,12,5.25,201751
7,9,310,30,488,777,36,90,60,1791,1704,3495,11,5,201751
7,10,202,18,323,798,171,53,0,1565,2153,3718,9,5.5,201751
7,11,129,8,78,215,17,19,0,466,892,1358,6,5.333333333,201751
7,12,235,18,317,669,8,57,0,1304,1955,3259,9,5.5,201751
7,13,187,38,234,620,16,54,0,1149,1517,2666,9,5.25,201751
8,1,207,8,298,201,13,33,0,760,859,1619,4,6,201751
8,2,240,23,379,273,14,51,0,980,1200,2180,17,5.5,201751
8,3,198,20,326,347,9,54,5,959,1091,2050,5,6,201751
8,4,177,18,363,223,28,61,3,873,932,1805,9,6,201751
8,5,199,20,217,234,20,55,0,745,632,1377,10,5.25,201751
8,6,166,20,268,289,32,74,3,852,915,1767,8,4.333333333,201751
8,7,194,32,152,184,12,56,0,630,712,1342,8,5.25,201751
8,8,145,40,275,277,5,76,0,818,906,1724,12,4,201751
8,9,104,15,119,117,15,42,0,412,460,872,10,4.6,201751
9,1,117,14,140,148,77,47,0,543,646,1189,6,7,201751
9,2,377,86,716,1104,72,118,13,2486,2941,5427,12,6,201751
9,3,211,42,395,487,42,90,10,1277,1517,2794,7,6,201751
9,4,252,20,349,569,51,80,7,1328,1434,2762,11,6,201751
9,5,149,11,289,304,63,63,19,898,937,1835,7,6,201751
9,6,119,26,187,199,51,46,7,635,632,1267,7,6,201751
9,7,114,15,282,428,15,48,1,903,964,1867,9,6,201751
9,8,56,11,139,129,21,32,10,398,486,884,6,7,201751
9,9,106,13,203,280,38,43,9,692,830,1522,5,6,201751
9,10,146,10,329,382,23,77,19,986,956,1942,6,6,201751
9,11,252,24,475,588,36,79,3,1457,1573,3030,7,6,201751
9,12,171,38,478,642,23,116,1,1469,1607,3076,11,6,201751
9,13,171,25,294,371,58,52,18,989,980,1969,4,6,201751
9,14,139,8,202,242,99,65,0,755,746,1501,5,6,201751
9,15,353,26,939,1028,28,167,4,2545,2506,5051,11,3.75,201751
9,16,278,47,503,668,122,136,6,1760,1831,3591,15,7,201751
9,17,184,8,234,292,23,61,0,802,867,1669,6,6,201751
9,18,204,28,377,590,51,93,7,1350,1485,2835,12,6,201751
9,19,247,31,339,474,76,70,6,1243,1353,2596,5,6,201751
9,20,24,3,43,37,13,7,2,129,57,186,5,6,201751
9,21,133,7,185,183,59,45,69,681,696,1377,3,6,201751
9,22,193,14,227,282,92,61,35,904,974,1878,5,6,201751
9,23,166,16,317,477,55,68,62,1161,1129,2290,7,7,201751
9,24,342,28,578,660,132,131,109,1980,2076,4056,13,6.5,201751
10,1,170,23,138,203,13,44,19,610,548,1158,12,4.666666667,201751
10,2,190,14,233,270,27,52,11,797,837,1634,9,5.5,201751
10,3,153,34,160,187,8,49,43,634,872,1506,12,5.4,201751
10,4,293,28,348,446,5,68,0,1188,1340,2528,11,4.2,201751
11,1,190,87,305,543,23,45,8,1201,1018,2219,6,5.666666667,201751
11,2,223,33,251,286,39,52,16,900,840,1740,7,6,201751
11,3,162,16,226,305,22,53,0,784,792,1576,4,6,201751
11,4,182,35,189,260,5,58,0,729,861,1590,11,3.8,201751
11,5,324,45,358,461,16,82,1,1287,1249,2536,8,6.5,201751
11,6,181,29,230,283,28,67,6,824,901,1725,8,5.666666667,201751
11,7,242,25,232,306,20,50,0,875,1123,1998,9,5.5,201751
11,8,266,31,253,345,30,45,0,970,909,1879,9,5.75,201751
11,9,312,53,308,401,14,74,8,1170,1223,2393,10,5.666666667,201751
11,10,216,53,246,349,17,66,36,983,1060,2043,11,5.6,201751
11,11,200,26,206,271,23,48,0,774,715,1489,4,6,201751
11,12,284,31,371,424,7,69,0,1186,1112,2298,7,6.5,201751
11,13,265,30,254,212,29,48,42,880,848,1728,9,5.5,201751
11,14,224,29,200,272,18,56,2,801,773,1574,8,5.5,201751
11,15,144,40,193,200,6,54,0,637,602,1239,6,6,201751
12,1,170,22,274,136,77,30,2,711,876,1587,10,5,201751
12,2,198,44,241,356,34,66,1,940,1161,2101,10,5.25,201751
12,3,214,29,275,353,47,52,0,970,765,1735,11,5.2,201751
12,4,220,38,356,461,51,46,24,1196,1121,2317,9,6,201751
12,5,201,15,204,198,1,26,12,657,1033,1690,10,5.25,201751
12,6,140,14,189,374,15,11,0,743,1415,2158,10,5.25,201751
12,7,171,16,266,326,15,59,26,879,1367,2246,8,4.333333333,201751
12,8,191,18,473,286,26,35,0,1029,990,2019,9,5.25,201751
12,9,185,20,249,343,21,36,9,863,1100,1963,9,5.666666667,201751
13,1,170,26,145,415,145,41,0,942,1219,2161,9,5.333333333,201751
13,2,134,20,102,273,54,41,0,624,555,1179,6,5.333333333,201751
13,3,150,25,165,260,79,59,0,738,733,1471,12,5.25,201751
13,4,218,20,245,213,55,66,1,818,838,1656,9,5.666666667,201751
13,5,241,17,340,376,99,91,3,1167,1120,2287,9,5.75,201751
13,6,354,38,655,666,33,101,2,1849,2094,3943,13,5.25,201751
13,7,178,22,261,345,28,39,0,873,926,1799,9,5.5,201751
14,1,178,23,146,103,26,64,20,560,554,1114,6,5.5,201751
14,2,175,27,149,136,19,54,0,560,665,1225,6,5.666666667,201751
14,3,245,16,214,143,8,72,3,701,669,1370,11,5.4,201751
14,4,226,31,226,345,15,63,5,911,968,1879,12,6,201751
14,5,174,13,396,251,42,42,1,919,884,1803,11,5.5,201751
14,6,260,11,388,332,16,49,2,1058,878,1936,11,6,201751
14,7,175,12,248,125,0,62,0,622,623,1245,6,6,201751
14,8,317,32,713,657,23,127,1,1870,1652,3522,12,4.5,201751
14,9,221,25,292,390,36,66,0,1030,1019,2049,8,6,201751
14,10,234,23,395,296,9,96,0,1053,1016,2069,7,6,201751
14,11,130,15,130,188,29,36,2,530,519,1049,4,6,201751
14,12,260,16,426,189,4,49,1,945,941,1886,11,5.5,201751
14,13,182,11,223,165,24,41,0,646,682,1328,8,4.5,201751
14,14,181,21,282,306,14,65,6,875,811,1686,7,7,201751
14,15,283,42,221,302,29,81,9,967,838,1805,10,5.6,201751
14,16,253,19,285,237,26,73,2,895,943,1838,5,6,201751
14,17,205,36,185,152,33,82,26,719,667,1386,9,5.25,201751
14,18,282,21,240,205,23,63,32,866,926,1792,10,5.2,201751
14,19,228,42,284,311,62,66,24,1017,963,1980,9,5.25,201751
14,20,149,5,225,89,10,46,2,526,458,984,10,5.666666667,201751
15,1,222,13,148,130,133,46,0,692,671,1363,7,5.333333333,201751
15,2,189,17,218,306,54,48,8,840,840,1680,6,5.5,201751
15,3,259,17,271,329,26,54,0,956,815,1771,10,5.666666667,201751
15,4,251,17,264,446,29,106,21,1134,1032,2166,4,6,201751
15,5,200,15,210,281,14,48,0,768,688,1456,8,5.666666667,201751
15,6,168,16,301,417,66,59,5,1032,914,1946,7,6.5,201751
15,7,215,14,314,414,48,62,1,1068,896,1964,10,6,201751
15,8,105,12,135,218,11,38,2,521,496,1017,4,6,201751
15,9,250,19,119,216,118,44,23,789,661,1450,9,5.75,201751
15,10,157,20,251,297,53,68,0,846,847,1693,9,6,201751
15,11,249,8,297,461,38,58,0,1111,1046,2157,8,6,201751
15,12,240,20,600,494,20,63,0,1437,1470,2907,8,6,201751
15,13,167,12,196,245,73,45,0,738,718,1456,8,6,201751
15,14,90,14,103,184,15,29,0,435,440,875,4,6,201751
15,15,209,44,281,435,21,88,0,1078,929,2007,6,6,201751
15,16,269,21,336,614,8,74,3,1325,1213,2538,8,6,201751
15,17,153,18,203,287,8,58,0,727,461,1188,8,6,201751
15,18,213,18,330,391,30,94,0,1076,1041,2117,7,5.666666667,201751
15,19,278,64,456,754,11,104,1,1668,1640,3308,14,6,201751
15,20,116,12,215,280,13,54,2,692,610,1302,6,6,201751
15,21,122,5,91,198,9,54,0,479,382,861,6,5.5,201751
15,22,324,43,519,816,21,100,2,1825,1736,3561,14,6,201751
15,23,195,19,244,344,35,73,0,910,1145,2055,7,5.333333333,201751
15,24,189,31,222,293,23,35,3,796,716,1512,4,6,201751
15,25,232,26,333,378,25,56,0,1050,1002,2052,6,6,201751
15,26,160,4,196,200,43,56,0,659,742,1401,10,2.333333333,201751
15,27,251,18,302,471,11,94,3,1150,1159,2309,9,5.333333333,201751
15,28,300,20,478,390,42,93,0,1323,1267,2590,9,5.666666667,201751
15,29,260,31,305,629,13,71,0,1309,1314,2623,8,6,201751
15,30,241,21,452,403,37,71,1,1226,1256,2482,12,6,201751
15,31,201,35,210,390,21,51,0,908,757,1665,6,6,201751
15,32,186,13,248,371,44,45,0,907,882,1789,9,6,201751
15,33,264,12,339,462,25,75,0,1177,1016,2193,7,6,201751
15,34,211,15,235,417,9,51,0,938,859,1797,8,6,201751
15,35,285,19,228,380,16,89,0,1017,947,1964,9,5.666666667,201751
15,36,263,14,312,372,67,62,2,1092,889,1981,9,5.5,201751
15,37,288,28,321,455,61,68,13,1234,1302,2536,7,6,201751
15,38,209,26,270,431,9,60,0,1005,1017,2022,6,5.5,201751
15,39,182,21,286,370,15,57,8,939,902,1841,4,6,201751
15,40,324,15,284,378,117,104,6,1228,1189,2417,9,6,201751
15,41,312,37,611,678,50,86,32,1806,1743,3549,11,6,201751
16,1,249,36,270,306,9,56,0,926,685,1611,10,5.333333333,201751
16,2,155,31,133,187,21,55,0,582,630,1212,9,5.25,201751
16,3,217,23,205,295,59,54,0,853,711,1564,10,5.25,201751
16,4,252,36,218,209,48,83,0,846,933,1779,8,5.5,201751
16,5,250,30,205,239,20,78,3,825,1029,1854,10,4.666666667,201751
16,6,315,39,186,307,47,83,1,978,890,1868,12,5.5,201751
16,7,190,43,163,205,33,44,0,678,665,1343,9,4.5,201751
16,8,312,41,489,555,21,96,7,1521,1363,2884,12,6,201751
16,9,232,18,229,276,23,84,2,864,829,1693,10,6,201751
16,10,221,13,288,312,7,57,0,898,798,1696,8,4.666666667,201751
16,11,281,40,224,198,141,94,0,978,883,1861,12,5.4,201751
16,12,231,39,235,210,42,77,0,834,736,1570,10,5.25,201751
17,1,212,12,433,444,29,95,0,1225,1373,2598,12,4,201751
17,2,160,9,281,326,10,50,10,846,1021,1867,9,5.666666667,201751
17,3,230,26,384,508,29,73,0,1250,1349,2599,8,5.5,201751
17,4,227,22,405,419,13,86,1,1173,1291,2464,10,5.666666667,201751
17,5,124,10,134,195,11,26,3,503,536,1039,5,5.5,201751
18,1,157,28,215,186,31,56,0,673,732,1405,9,5.4,201751
18,2,281,35,409,331,75,85,1,1217,1206,2423,10,5.5,201751
18,3,194,25,360,249,7,60,0,895,897,1792,9,5.75,201751
19,1,198,13,289,298,21,84,6,909,915,1824,9,6,201751
19,2,295,8,587,290,65,69,0,1314,1456,2770,10,6.5,201751
19,3,252,18,497,360,21,58,1,1207,1445,2652,8,6,201751
19,4,96,6,154,177,27,25,39,524,491,1015,5,6,201751
19,5,314,22,376,580,10,81,31,1414,1461,2875,8,6,201751
19,6,96,5,154,203,9,46,7,520,564,1084,5,6,201751
19,7,222,18,415,235,4,46,1,941,1027,1968,10,5.5,201751
19,8,42,3,84,75,0,6,0,210,289,499,7,6,201751
19,9,210,18,258,325,30,51,0,892,936,1828,9,5.25,201751
19,10,181,15,194,310,8,67,0,775,738,1513,8,2.666666667,201751
19,11,454,53,610,791,10,150,3,2071,2144,4215,13,6.333333333,201751
19,12,191,12,328,224,5,44,8,812,1079,1891,8,6,201751
20,1,201,15,174,238,68,45,0,741,793,1534,7,5.5,201751
20,2,111,13,124,141,16,18,0,423,511,934,6,5.333333333,201751
20,3,141,17,706,164,115,48,0,1191,855,2046,6,5.333333333,201751
20,4,69,13,83,204,34,28,0,431,646,1077,6,5.333333333,201751
20,5,153,16,236,237,20,28,3,693,852,1545,11,5.25,201751
20,6,168,11,177,303,174,41,1,875,1276,2151,8,5.25,201751
20,7,207,19,308,453,11,51,0,1049,1143,2192,8,5.75,201751
20,8,544,29,562,922,33,127,63,2280,2198,4478,15,5.333333333,201751
20,9,203,15,191,233,77,58,0,777,734,1511,8,5.666666667,201751
20,10,230,18,270,399,35,48,0,1000,1049,2049,9,5.25,201751
21,1,203,25,227,516,38,40,0,1049,1178,2227,9,5.4,201751
21,2,191,27,207,190,47,45,0,707,947,1654,9,5.2,201751
21,3,257,17,344,184,83,79,16,980,1002,1982,8,5.25,201751
21,4,204,16,204,187,75,62,18,766,884,1650,6,5.25,201751
21,5,191,10,250,219,33,72,25,800,1084,1884,8,5.666666667,201751
21,6,254,15,361,501,45,74,34,1284,1254,2538,6,7,201751
21,7,256,16,279,248,64,77,2,942,996,1938,9,5.666666667,201751
21,8,179,8,235,216,76,46,3,763,946,1709,10,5.2,201751
21,9,215,22,394,457,68,84,17,1257,1177,2434,9,6,201751
21,10,200,19,345,354,37,75,14,1044,1050,2094,7,6,201751
21,11,83,2,121,67,25,24,1,323,439,762,6,5,201751
21,12,395,26,814,814,92,151,29,2321,2269,4590,15,4.666666667,201751
21,13,243,11,279,328,44,84,0,989,1158,2147,8,5.666666667,201751
21,14,264,14,239,265,82,90,0,954,1063,2017,13,5.333333333,201751
21,15,258,17,418,353,39,65,1,1151,1028,2179,7,5.5,201751
22,1,203,40,191,354,65,34,0,887,1119,2006,11,5.2,201751
22,2,216,20,398,249,44,50,9,986,896,1882,7,5.5,201751
22,3,310,46,649,603,35,93,4,1740,1826,3566,10,6,201751
22,4,274,25,584,456,29,77,0,1445,1683,3128,13,4.6,201751
22,5,160,27,369,193,37,46,3,835,865,1700,10,5.5,201751
23,1,250,4,1114,437,33,45,0,1883,1708,3591,14,5.6,201751
23,2,235,33,414,445,24,50,0,1201,1230,2431,10,4.2,201751
23,3,288,10,919,487,52,42,1,1799,1995,3794,11,6,201751
23,4,204,8,630,301,57,47,0,1247,1186,2433,10,4.75,201751
24,1,151,57,163,370,40,21,2,804,1144,1948,11,5.2,201751
24,2,127,19,158,169,13,44,0,530,682,1212,6,5.5,201751
24,3,172,50,281,623,143,34,0,1303,1505,2808,9,5.25,201751
24,4,163,25,194,189,53,42,65,731,823,1554,5,5.5,201751
24,5,248,31,367,492,8,92,0,1238,1190,2428,9,4.75,201751
24,6,290,41,479,608,24,96,0,1538,1617,3155,11,5.333333333,201751
24,7,227,24,310,561,75,46,0,1243,1553,2796,9,5.25,201751
25,1,173,20,273,262,32,57,0,817,802,1619,14,5.75,201751
25,2,201,26,310,446,23,96,0,1102,1084,2186,7,5.5,201751
25,3,183,25,272,374,46,48,3,951,980,1931,9,5.6,201751
25,4,208,20,228,324,10,59,30,879,849,1728,8,5.333333333,201751
25,5,195,15,298,458,20,83,0,1069,1097,2166,11,4.75,201751
25,6,218,25,390,319,59,80,1,1092,951,2043,9,5.75,201751
25,7,223,20,267,403,1,95,0,1009,1067,2076,7,6,201751
26,1,201,13,290,288,11,66,0,869,1032,1901,9,5.5,201751
26,2,178,14,344,387,5,73,0,1001,1099,2100,13,5.4,201751
26,3,283,19,477,589,11,145,0,1524,1675,3199,15,5.333333333,201751
26,4,134,17,147,228,15,71,0,612,719,1331,10,5.2,201751
26,5,46,9,71,93,2,24,0,245,250,495,3,5.5,201751
26,6,185,16,335,386,4,75,0,1001,954,1955,10,5.333333333,201751
26,7,176,25,170,318,18,58,0,765,711,1476,10,5.5,201751
27,1,148,16,181,421,28,40,0,834,846,1680,9,5.5,201751
27,2,205,16,217,535,20,48,0,1041,1252,2293,8,5.666666667,201751
27,3,257,10,144,403,13,43,0,870,827,1697,7,5.666666667,201751
27,4,252,16,297,706,18,76,4,1369,1329,2698,10,3.75,201751
27,5,136,2,151,291,5,24,0,609,602,1211,6,5.333333333,201751
27,6,150,21,219,556,4,51,0,1001,1388,2389,9,5.333333333,201751
28,1,175,16,321,304,11,46,0,873,925,1798,13,6,201751
28,2,234,11,446,323,22,63,69,1168,1352,2520,14,6,201751
28,3,146,19,183,221,6,44,0,619,581,1200,7,5.333333333,201751
28,4,264,24,283,286,27,60,30,974,1079,2053,16,6,201751
28,5,194,36,223,427,34,75,1,990,993,1983,13,3.833333333,201751
28,6,225,53,232,525,184,48,21,1288,1055,2343,14,5.166666667,201751
28,7,229,16,445,417,42,78,0,1227,1305,2532,8,6,201751
28,8,155,25,233,277,36,65,1,792,876,1668,11,5.666666667,201751
28,9,107,8,194,152,9,24,22,516,713,1229,9,6,201751
29,1,289,55,303,350,63,47,1,1108,1151,2259,10,5.5,201751
29,2,244,27,259,548,31,84,40,1233,1331,2564,13,4.166666667,201751
29,3,158,22,138,283,13,49,0,663,695,1358,7,5.666666667,201751
30,1,102,15,124,164,24,37,13,479,577,1056,7,5.333333333,201751
30,2,205,32,143,99,59,38,290,866,876,1742,8,5.25,201751
30,3,152,15,225,187,101,65,54,799,881,1680,6,4.666666667,201751
30,4,120,2,218,208,35,49,0,632,667,1299,8,5,201751
30,5,139,18,185,283,18,53,0,696,722,1418,7,4.5,201751
30,6,165,9,133,180,9,36,0,532,573,1105,9,4.333333333,201751
30,7,158,11,259,190,35,69,23,745,898,1643,12,4.25,201751
30,8,199,15,377,308,40,70,1,1010,1009,2019,11,5.4,201751
30,9,184,11,162,154,47,65,64,687,704,1391,8,4.5,201751
30,10,207,14,339,415,30,103,20,1128,1350,2478,9,5,201751
30,11,185,9,386,351,13,81,0,1025,1225,2250,6,5.5,201751
30,12,267,14,473,530,20,109,0,1413,1585,2998,11,5.25,201751
30,13,188,12,172,266,46,55,5,744,936,1680,10,4.4,201751
30,14,148,13,245,220,77,60,0,763,761,1524,9,4.5,201751
30,15,290,21,249,274,55,91,93,1073,1053,2126,11,5.666666667,201751
30,16,215,12,247,368,60,96,41,1039,1007,2046,10,5.333333333,201751
30,17,159,12,163,234,40,56,0,664,924,1588,8,4.5,201751
30,18,153,9,139,204,14,41,16,576,717,1293,8,4.25,201751
30,19,167,17,160,220,37,49,37,687,801,1488,13,4.6,201751
30,20,225,18,227,419,117,60,0,1066,1122,2188,11,5.4,201751
31,1,139,19,204,325,21,52,0,760,957,1717,8,5.5,201751
31,2,166,23,166,28,181,36,0,600,466,1066,7,5.333333333,201751
31,3,379,69,824,673,83,117,0,2145,2013,4158,21,4.5,201751
31,4,93,14,300,257,39,48,0,751,1012,1763,6,6,201751
31,5,165,19,134,253,28,27,0,626,897,1523,7,5.333333333,201751
32,1,174,42,183,217,26,50,13,705,728,1433,12,5.2,201751
32,2,189,49,175,184,45,45,3,690,762,1452,13,5.142857143,201751
32,3,249,54,187,291,23,56,13,873,894,1767,15,4.833333333,201751
32,4,252,72,286,244,50,76,59,1039,1198,2237,13,4.666666667,201751
1,1,172,30,208,238,41,36,5,730,927,1657,13,5.5,201752
1,2,184,31,353,289,52,55,13,977,1129,2106,11,4.8,201752
1,3,189,40,366,284,33,67,2,981,1436,2417,13,5.6,201752
2,1,149,8,214,233,7,39,3,653,774,1427,11,6,201752
2,2,219,10,296,397,7,87,0,1016,1213,2229,9,4.666666667,201752
2,3,293,20,490,397,15,106,0,1321,1543,2864,11,4.4,201752
2,4,112,4,272,154,8,29,0,579,663,1242,6,6,201752
2,5,387,23,739,523,118,100,8,1898,1984,3882,16,5.75,201752
2,6,183,11,417,305,23,48,0,987,1070,2057,7,6,201752
2,7,196,8,358,314,10,61,1,948,1103,2051,12,5.75,201752
2,8,232,9,492,416,7,53,0,1209,1312,2521,8,6,201752
3,1,143,7,244,246,12,76,2,730,921,1651,15,5,201752
3,2,140,7,383,191,9,26,0,756,957,1713,9,6,201752
4,1,207,25,290,517,60,51,0,1150,1419,2569,15,4.666666667,201752
4,2,196,10,291,423,17,49,1,987,1319,2306,14,5.4,201752
5,1,221,20,361,272,19,77,0,970,1278,2248,9,6,201752
5,2,102,8,151,264,9,18,2,554,852,1406,10,6,201752
5,3,130,18,178,318,14,50,0,708,969,1677,9,6,201752
5,4,163,18,253,328,10,71,9,852,1417,2269,11,5,201752
5,5,173,18,230,348,18,42,26,855,1177,2032,8,6,201752
5,6,136,12,148,220,8,21,13,558,936,1494,7,5.5,201752
5,7,82,7,120,150,6,15,0,380,648,1028,10,3.666666667,201752
6,1,169,19,245,259,4,75,10,781,830,1611,15,4.571428571,201752
6,2,188,17,287,166,64,59,3,784,737,1521,9,5.666666667,201752
7,1,225,13,150,758,9,28,3,1186,1464,2650,9,5.25,201752
7,2,232,15,170,848,14,46,0,1325,1034,2359,9,5.25,201752
7,3,300,10,231,430,393,45,0,1409,831,2240,7,5.333333333,201752
7,4,107,13,168,419,10,45,81,843,1723,2566,11,5.4,201752
7,5,270,14,176,686,12,36,35,1229,1343,2572,11,5.666666667,201752
7,6,235,10,269,441,63,64,14,1096,1687,2783,9,4.5,201752
7,7,215,23,241,545,82,54,1,1161,1767,2928,8,5.5,201752
7,8,286,13,287,896,25,66,0,1573,1480,3053,12,5.25,201752
7,9,189,27,382,551,32,84,40,1305,1450,2755,11,4.5,201752
7,10,197,11,267,588,104,38,0,1205,1350,2555,9,5.5,201752
7,11,114,9,65,217,27,15,0,447,1240,1687,6,5.333333333,201752
7,12,220,12,278,566,3,45,2,1126,1967,3093,9,5.5,201752
7,13,165,20,169,861,13,40,0,1268,867,2135,9,5.25,201752
8,1,207,6,302,231,17,37,0,800,949,1749,4,6,201752
8,2,280,18,334,274,28,50,3,987,1324,2311,17,5.5,201752
8,3,233,18,323,329,13,46,2,964,1157,2121,5,6,201752
8,4,190,12,311,238,24,55,0,830,1096,1926,8,6,201752
8,5,183,16,231,171,10,59,0,670,876,1546,10,5.25,201752
8,6,180,16,248,320,25,78,1,868,1108,1976,7,4,201752
8,7,197,23,127,197,12,61,0,617,792,1409,8,5.25,201752
8,8,173,30,258,333,9,60,0,863,1097,1960,12,4,201752
8,9,137,12,104,96,15,43,1,408,812,1220,10,4.8,201752
9,1,128,7,124,122,46,36,0,463,501,964,6,7,201752
9,2,290,66,512,838,63,105,7,1881,2422,4303,12,6,201752
9,3,175,34,330,445,35,79,14,1112,1147,2259,7,6,201752
9,4,219,15,261,445,42,62,2,1046,1285,2331,11,6,201752
9,5,138,11,238,289,69,68,31,844,853,1697,7,6,201752
9,6,107,17,161,172,41,38,8,544,629,1173,7,6,201752
9,7,106,9,189,384,6,45,0,739,876,1615,9,6,201752
9,8,33,24,96,129,12,22,4,320,419,739,6,7,201752
9,9,104,7,153,247,44,41,13,609,665,1274,5,6,201752
9,10,127,11,304,304,15,65,0,826,958,1784,6,6,201752
9,11,181,9,348,494,48,80,7,1167,1354,2521,7,6,201752
9,12,166,46,461,506,35,101,3,1318,1417,2735,11,6,201752
9,13,150,8,212,349,50,59,15,843,881,1724,4,6,201752
9,14,126,9,165,221,96,45,0,662,757,1419,5,6,201752
9,15,244,26,782,934,11,198,3,2198,2320,4518,12,4,201752
9,16,284,41,420,609,59,104,0,1517,1668,3185,15,7,201752
9,17,139,11,190,294,13,68,0,715,779,1494,6,6,201752
9,18,220,33,313,576,39,74,4,1259,1441,2700,12,6,201752
9,19,243,37,232,395,82,52,15,1056,1168,2224,5,6,201752
9,20,29,2,43,43,9,8,0,134,97,231,5,6,201752
9,21,97,6,149,149,49,32,22,504,580,1084,3,6,201752
9,22,134,11,141,223,97,59,25,690,865,1555,5,6,201752
9,23,145,11,263,409,48,59,47,982,1041,2023,7,7,201752
9,24,269,23,464,593,112,137,71,1669,1855,3524,13,6.5,201752
10,1,124,19,120,193,15,34,18,523,501,1024,12,4.666666667,201752
10,2,166,9,157,197,19,41,12,601,830,1431,9,5.5,201752
10,3,138,17,142,162,9,38,32,538,829,1367,12,5.4,201752
10,4,231,14,268,329,8,37,0,887,1306,2193,12,4.6,201752
11,1,209,72,265,514,18,39,6,1123,1136,2259,6,5.666666667,201752
11,2,176,25,177,239,24,37,8,686,830,1516,7,6,201752
11,3,169,18,179,241,21,44,0,672,770,1442,4,6,201752
11,4,138,40,138,294,7,25,0,642,857,1499,10,3.8,201752
11,5,255,34,249,441,15,71,0,1065,1257,2322,8,6.5,201752
11,6,159,26,206,224,34,42,7,698,761,1459,8,5.666666667,201752
11,7,214,18,208,302,14,46,0,802,1104,1906,9,5.5,201752
11,8,204,30,168,313,34,38,1,788,978,1766,9,5.75,201752
11,9,257,51,288,359,6,72,2,1035,1135,2170,10,5.666666667,201752
11,10,239,49,233,311,13,68,36,949,1188,2137,11,5.6,201752
11,11,176,27,183,223,21,32,0,662,850,1512,4,6,201752
11,12,226,35,281,371,6,47,0,966,1212,2178,7,6.5,201752
11,13,204,29,176,230,23,58,37,757,966,1723,9,5.5,201752
11,14,197,26,178,189,19,51,0,660,816,1476,8,5.5,201752
11,15,119,23,116,170,5,20,0,453,525,978,6,6,201752
12,1,151,28,209,132,34,29,6,589,671,1260,10,5,201752
12,2,159,38,182,304,23,50,0,756,1273,2029,10,5.5,201752
12,3,150,34,239,331,21,37,1,813,1298,2111,11,5.2,201752
12,4,207,21,261,391,23,41,14,958,1213,2171,9,6,201752
12,5,231,19,214,278,1,26,16,785,1127,1912,10,5.25,201752
12,6,168,22,148,330,32,22,8,730,1215,1945,10,5.25,201752
12,7,184,14,244,279,12,50,32,815,1206,2021,8,4,201752
12,8,240,17,419,351,24,26,0,1077,1297,2374,9,5.25,201752
12,9,172,14,209,362,21,32,7,817,1105,1922,9,5.666666667,201752
13,1,163,30,152,557,138,50,0,1090,1302,2392,9,5.333333333,201752
13,2,152,18,145,242,63,53,0,673,861,1534,6,5.333333333,201752
13,3,174,22,146,214,71,57,0,684,901,1585,12,5.25,201752
13,4,170,28,191,265,98,46,5,803,1005,1808,9,5.666666667,201752
13,5,204,24,352,307,94,66,7,1054,1162,2216,9,5.75,201752
13,6,289,35,509,579,26,72,4,1514,2109,3623,13,5,201752
13,7,130,15,227,286,20,52,0,730,847,1577,9,5.5,201752
14,1,184,20,129,106,15,61,9,524,518,1042,6,5.5,201752
14,2,175,11,142,125,29,55,0,537,569,1106,6,5.666666667,201752
14,3,235,17,209,144,12,83,14,714,823,1537,11,5.4,201752
14,4,159,10,170,288,5,62,9,703,759,1462,12,6,201752
14,5,198,16,304,211,32,49,0,810,956,1766,11,5.5,201752
14,6,199,6,392,252,8,56,0,913,941,1854,11,6,201752
14,7,125,7,253,113,2,32,0,532,628,1160,6,6,201752
14,8,262,20,526,482,15,94,0,1399,1779,3178,13,4.333333333,201752
14,9,212,19,262,321,31,48,0,893,1056,1949,8,5.5,201752
14,10,235,26,364,311,18,71,0,1025,992,2017,7,6,201752
14,11,100,9,131,183,13,37,4,477,530,1007,4,6,201752
14,12,258,8,433,155,9,56,1,920,1057,1977,11,5.5,201752
14,13,157,15,225,172,22,42,0,633,598,1231,8,6,201752
14,14,160,26,200,297,11,61,3,758,936,1694,7,7,201752
14,15,225,29,168,217,20,51,5,715,850,1565,10,5.6,201752
14,16,225,11,280,255,37,65,5,878,872,1750,5,6,201752
14,17,151,14,158,99,20,54,17,513,632,1145,9,4.5,201752
14,18,174,18,154,137,26,42,18,569,814,1383,10,5.4,201752
14,19,174,30,203,235,24,60,11,737,728,1465,9,5.25,201752
14,20,138,11,187,72,3,36,0,447,567,1014,10,5.666666667,201752
15,1,198,18,127,95,191,50,0,679,665,1344,7,5.333333333,201752
15,2,147,7,203,279,54,35,18,743,876,1619,6,6,201752
15,3,186,27,212,296,23,49,2,795,991,1786,10,5.666666667,201752
15,4,250,12,238,355,32,68,18,973,1132,2105,4,6,201752
15,5,189,26,201,266,10,37,2,731,771,1502,8,5.666666667,201752
15,6,155,6,215,329,42,59,1,807,951,1758,7,6.5,201752
15,7,170,17,229,353,47,44,0,860,1098,1958,10,6,201752
15,8,83,12,102,187,15,25,4,428,463,891,4,6,201752
15,9,191,10,144,182,74,32,20,653,722,1375,9,5.75,201752
15,10,170,10,200,256,40,39,0,715,790,1505,9,6,201752
15,11,216,15,232,361,38,41,0,903,1052,1955,8,6,201752
15,12,177,11,383,427,21,53,0,1072,1380,2452,8,6,201752
15,13,120,12,137,213,69,49,0,600,671,1271,8,6,201752
15,14,78,6,76,191,19,22,0,392,451,843,4,6,201752
15,15,176,39,249,366,18,67,0,915,1013,1928,6,6,201752
15,16,203,18,275,496,12,64,4,1072,1268,2340,8,6,201752
15,17,150,17,199,241,8,51,4,670,851,1521,8,6,201752
15,18,244,25,247,367,27,76,1,987,1123,2110,7,5.666666667,201752
15,19,222,66,378,617,15,69,0,1367,1722,3089,14,6,201752
15,20,96,8,157,243,13,33,0,550,673,1223,6,6,201752
15,21,126,10,109,159,5,47,0,456,557,1013,6,5.5,201752
15,22,287,37,462,700,17,117,2,1622,1885,3507,14,6,201752
15,23,196,15,224,340,38,96,0,909,1041,1950,7,5.333333333,201752
15,24,130,14,174,236,18,29,0,601,737,1338,4,6,201752
15,25,258,26,290,317,13,58,0,962,909,1871,6,6,201752
15,26,136,5,191,171,37,56,0,596,841,1437,11,2.666666667,201752
15,27,207,21,274,454,9,73,6,1044,1153,2197,9,5.666666667,201752
15,28,262,15,392,309,36,80,0,1094,1256,2350,9,5.666666667,201752
15,29,263,24,256,554,13,73,0,1183,1280,2463,8,6,201752
15,30,262,28,362,317,31,54,1,1055,1276,2331,12,6,201752
15,31,170,31,168,345,11,53,0,778,863,1641,6,6,201752
15,32,165,10,218,320,34,62,0,809,977,1786,9,6,201752
15,33,202,11,282,328,32,52,0,907,1122,2029,7,6,201752
15,34,173,15,200,353,8,49,1,799,925,1724,8,6,201752
15,35,177,20,183,302,6,56,0,744,789,1533,9,5.666666667,201752
15,36,198,21,194,254,53,36,0,756,804,1560,9,5.5,201752
15,37,203,21,199,346,41,63,18,891,1074,1965,7,6,201752
15,38,219,18,234,339,8,59,0,877,950,1827,6,5.5,201752
15,39,158,28,239,346,14,47,7,839,829,1668,4,6,201752
15,40,289,18,237,358,78,87,8,1075,1160,2235,9,6,201752
15,41,279,25,457,513,28,54,29,1385,1862,3247,11,6,201752
16,1,222,42,290,240,17,57,0,868,622,1490,10,5.333333333,201752
16,2,153,16,121,244,18,59,0,611,594,1205,9,5.25,201752
16,3,166,24,153,274,17,28,0,662,593,1255,10,5.25,201752
16,4,199,26,174,158,35,91,0,683,637,1320,8,5.5,201752
16,5,279,25,209,250,38,87,13,901,760,1661,10,5.666666667,201752
16,6,211,34,140,205,52,37,0,679,713,1392,12,5.5,201752
16,7,203,19,144,154,37,80,0,637,641,1278,9,5.5,201752
16,8,249,41,440,474,18,103,4,1329,1369,2698,12,6,201752
16,9,201,25,226,252,10,62,0,776,843,1619,10,6,201752
16,10,118,21,236,237,5,48,0,665,880,1545,8,4.666666667,201752
16,11,222,29,180,136,114,70,1,752,795,1547,12,5.4,201752
16,12,149,19,195,149,22,33,0,567,634,1201,10,5.25,201752
17,1,183,23,317,372,25,55,0,975,1147,2122,12,3.5,201752
17,2,96,8,235,254,14,31,8,646,710,1356,9,4.666666667,201752
17,3,137,22,295,369,15,59,0,897,1071,1968,8,4.5,201752
17,4,177,14,336,282,3,56,0,868,898,1766,10,4.666666667,201752
17,5,88,13,111,157,6,19,0,394,412,806,5,4.5,201752
18,1,151,16,141,191,34,52,0,585,781,1366,9,5.4,201752
18,2,208,20,272,320,67,64,0,951,1145,2096,10,5.5,201752
18,3,156,12,280,170,5,46,0,669,919,1588,9,5.5,201752
19,1,204,11,324,279,16,62,12,908,1070,1978,9,6,201752
19,2,283,8,552,306,62,63,0,1274,1705,2979,10,6.5,201752
19,3,223,9,417,318,17,56,2,1042,1203,2245,8,6,201752
19,4,105,8,165,169,34,35,39,555,605,1160,5,6,201752
19,5,283,30,326,478,19,74,28,1238,1285,2523,8,6,201752
19,6,102,13,166,253,3,47,6,590,572,1162,5,6,201752
19,7,190,12,442,222,5,32,0,903,1001,1904,10,5.5,201752
19,8,39,4,86,86,2,10,0,227,251,478,7,6,201752
19,9,236,15,221,288,49,51,1,861,864,1725,9,5.25,201752
19,10,130,4,214,274,6,54,0,682,773,1455,7,2.333333333,201752
19,11,353,37,499,798,18,126,8,1839,2117,3956,13,6.333333333,201752
19,12,141,7,210,131,6,31,5,531,840,1371,8,5.666666667,201752
20,1,225,16,215,277,76,55,0,864,899,1763,7,5.5,201752
20,2,172,15,186,225,19,34,0,651,591,1242,6,5.333333333,201752
20,3,161,14,179,234,75,46,0,709,669,1378,6,5.333333333,201752
20,4,112,8,122,173,35,50,0,500,661,1161,6,5.333333333,201752
20,5,154,19,383,249,187,36,2,1030,1026,2056,11,5.25,201752
20,6,170,10,160,283,137,35,2,797,874,1671,8,5.25,201752
20,7,182,18,214,408,119,42,0,983,1304,2287,8,5.75,201752
20,8,508,25,547,822,38,134,65,2139,2116,4255,15,5,201752
20,9,233,12,195,219,79,67,10,815,743,1558,8,5.666666667,201752
20,10,237,20,232,370,14,54,0,927,1029,1956,9,5.25,201752
21,1,181,25,245,399,19,34,0,903,1108,2011,9,5.4,201752
21,2,236,21,195,243,86,42,4,827,905,1732,9,5.2,201752
21,3,226,6,286,194,67,77,14,870,1083,1953,8,5.5,201752
21,4,148,12,201,89,88,47,14,599,906,1505,6,5,201752
21,5,135,12,221,229,20,55,10,682,799,1481,8,5.666666667,201752
21,6,201,13,309,443,45,57,43,1111,1206,2317,6,7,201752
21,7,185,17,181,253,47,61,0,744,790,1534,9,5.666666667,201752
21,8,187,15,256,247,45,56,4,810,927,1737,10,5.2,201752
21,9,201,18,358,396,56,69,34,1132,1280,2412,9,6,201752
21,10,167,10,258,307,22,49,15,828,977,1805,7,6,201752
21,11,68,2,90,70,17,11,2,260,248,508,6,3.5,201752
21,12,364,23,649,681,57,106,28,1908,2026,3934,15,4.666666667,201752
21,13,162,15,170,236,23,81,0,687,928,1615,8,5.666666667,201752
21,14,203,14,283,230,70,72,2,874,960,1834,13,5.333333333,201752
21,15,214,11,301,288,20,57,1,892,978,1870,7,5.5,201752
22,1,195,36,201,310,55,34,0,831,1260,2091,11,5.2,201752
22,2,179,33,266,332,74,42,32,958,1118,2076,7,5.5,201752
22,3,227,24,526,491,18,63,3,1352,1521,2873,10,6,201752
22,4,185,31,462,447,27,69,0,1221,1363,2584,11,3.6,201752
22,5,165,20,373,212,25,36,1,832,900,1732,10,5.5,201752
23,1,238,6,946,368,42,36,0,1636,1701,3337,14,5.6,201752
23,2,182,26,351,318,15,38,1,931,1574,2505,10,4.2,201752
23,3,247,7,763,459,50,52,0,1578,1728,3306,11,5.5,201752
23,4,198,13,708,326,40,43,0,1328,1091,2419,10,5,201752
24,1,170,33,193,383,46,33,0,858,1068,1926,11,5.2,201752
24,2,100,16,138,159,14,34,0,461,570,1031,6,5.5,201752
24,3,151,53,222,599,149,36,0,1210,1471,2681,9,5.25,201752
24,4,189,33,304,240,68,64,116,1014,989,2003,5,5.5,201752
24,5,203,22,286,420,7,56,0,994,1183,2177,9,4.75,201752
24,6,224,33,373,481,17,75,0,1203,1486,2689,11,4.333333333,201752
24,7,277,33,359,549,126,36,0,1380,1396,2776,9,5.25,201752
25,1,129,5,215,216,22,37,0,624,728,1352,14,5.75,201752
25,2,224,30,288,438,26,68,0,1074,1145,2219,7,5.5,201752
25,3,200,22,208,365,32,35,6,868,1043,1911,9,5.6,201752
25,4,155,23,177,267,17,51,18,708,796,1504,8,5.333333333,201752
25,5,179,17,243,414,14,73,1,941,1187,2128,11,4.75,201752
25,6,226,18,296,293,37,69,0,939,959,1898,9,5.75,201752
25,7,186,13,208,353,7,65,0,832,1014,1846,7,6,201752
26,1,195,13,276,281,3,75,0,843,939,1782,9,5.5,201752
26,2,192,10,272,366,9,61,0,910,1092,2002,13,5.4,201752
26,3,226,19,334,494,7,127,0,1207,1683,2890,15,5.333333333,201752
26,4,146,17,144,241,15,76,0,639,664,1303,10,5.2,201752
26,5,79,5,88,127,4,38,0,341,426,767,3,5.5,201752
26,6,170,15,250,386,4,61,0,886,983,1869,10,5.333333333,201752
26,7,229,17,151,253,20,34,0,704,821,1525,10,5.5,201752
27,1,159,8,164,318,15,32,0,696,751,1447,9,5.5,201752
27,2,163,13,104,401,20,30,0,731,1281,2012,8,5.666666667,201752
27,3,139,3,93,349,11,38,0,633,776,1409,7,5.666666667,201752
27,4,217,17,280,616,17,60,7,1214,1287,2501,10,4,201752
27,5,114,6,86,298,0,26,0,530,679,1209,6,5.333333333,201752
27,6,173,16,207,496,1,57,0,950,1017,1967,9,5.333333333,201752
28,1,249,14,334,313,5,53,0,968,1236,2204,13,6,201752
28,2,228,18,356,243,16,53,74,988,1339,2327,14,6,201752
28,3,156,17,133,171,5,45,0,527,615,1142,7,5,201752
28,4,278,22,318,351,43,74,45,1131,1406,2537,16,6,201752
28,5,171,15,197,336,24,67,0,810,1093,1903,13,3.833333333,201752
28,6,145,35,152,569,146,34,17,1098,1343,2441,14,5.166666667,201752
28,7,269,23,396,416,56,71,0,1231,1338,2569,8,6,201752
28,8,170,17,215,275,43,67,0,787,942,1729,11,5.666666667,201752
28,9,143,11,186,151,22,29,36,578,645,1223,9,6,201752
29,1,241,38,273,286,56,36,1,931,1087,2018,10,5.5,201752
29,2,238,21,204,423,16,56,31,989,1321,2310,15,4.333333333,201752
29,3,117,21,118,241,13,30,0,540,609,1149,7,5.666666667,201752
30,1,134,20,141,210,40,38,14,597,812,1409,7,5.333333333,201752
30,2,135,27,138,91,54,27,246,718,959,1677,8,5.25,201752
30,3,163,9,208,198,103,33,38,752,823,1575,6,5.666666667,201752
30,4,110,6,206,193,32,42,0,589,722,1311,8,6,201752
30,5,171,21,186,347,41,65,1,832,936,1768,7,5.5,201752
30,6,162,11,200,247,28,45,0,693,819,1512,9,5.333333333,201752
30,7,210,27,199,271,103,65,35,910,1414,2324,12,5.25,201752
30,8,219,17,266,288,57,76,1,924,1117,2041,11,5.4,201752
30,9,210,14,230,155,67,72,107,855,900,1755,8,5.5,201752
30,10,170,18,283,280,27,68,20,866,1034,1900,9,4.666666667,201752
30,11,202,23,320,355,14,76,0,990,890,1880,6,5.5,201752
30,12,244,23,439,519,31,105,0,1361,1577,2938,11,6.25,201752
30,13,222,12,177,327,47,47,3,835,989,1824,10,5.4,201752
30,14,183,23,217,220,92,56,0,791,1074,1865,9,5.5,201752
30,15,241,9,206,241,46,63,68,874,996,1870,11,5.666666667,201752
30,16,187,14,245,296,46,79,31,898,958,1856,10,5.333333333,201752
30,17,203,30,183,302,42,61,1,822,846,1668,8,5.5,201752
30,18,159,8,125,223,13,52,35,615,781,1396,8,5.25,201752
30,19,144,21,148,217,52,58,13,653,881,1534,13,5.6,201752
30,20,189,17,207,356,96,53,0,918,1243,2161,11,5.4,201752
31,1,124,19,134,366,17,32,0,692,1123,1815,8,5.5,201752
31,2,97,13,132,20,166,26,0,454,623,1077,7,5.333333333,201752
31,3,377,41,737,540,91,102,0,1888,2164,4052,20,4.75,201752
31,4,117,7,232,241,31,49,0,677,709,1386,6,4,201752
31,5,194,20,123,193,29,40,0,599,674,1273,7,5.333333333,201752
32,1,153,31,139,184,24,32,14,577,742,1319,12,5.2,201752
32,2,219,39,196,181,59,38,1,733,1165,1898,13,5.142857143,201752
32,3,148,37,145,164,15,28,6,543,832,1375,15,4.666666667,201752
32,4,162,48,175,221,20,55,45,726,961,1687,12,4.5,201752
1,1,193,30,209,293,67,37,5,834,992,1826,13,5.5,201753
1,2,235,52,441,393,97,71,8,1297,1289,2586,12,4.8,201753
1,3,191,57,419,386,32,68,2,1155,1166,2321,13,4.8,201753
2,1,159,11,215,236,13,39,2,675,878,1553,11,6,201753
2,2,224,12,263,476,5,69,0,1049,1182,2231,9,4.333333333,201753
2,3,274,16,345,354,14,85,1,1089,1489,2578,11,4.4,201753
2,4,148,6,243,194,10,24,0,625,665,1290,13,5,201753
2,5,362,26,628,494,105,100,6,1721,2319,4040,16,5.666666667,201753
2,6,207,5,365,311,24,53,0,965,1152,2117,7,6,201753
2,7,269,15,404,334,19,63,9,1113,1393,2506,12,5.75,201753
2,8,241,12,477,380,11,43,0,1164,1371,2535,8,6,201753
3,1,141,9,223,241,19,75,3,711,917,1628,15,5,201753
3,2,157,4,337,180,14,24,0,716,943,1659,9,5.666666667,201753
4,1,187,19,292,525,72,40,0,1135,1269,2404,15,4.5,201753
4,2,191,22,327,396,64,54,1,1055,1119,2174,14,5.2,201753
5,1,201,14,279,266,36,66,0,862,1094,1956,9,5.666666667,201753
5,2,177,12,231,345,28,43,1,837,1291,2128,10,6,201753
5,3,167,23,191,373,37,62,0,853,1052,1905,9,5.75,201753
5,4,221,24,342,419,13,100,8,1127,1308,2435,11,4.75,201753
5,5,239,18,254,415,18,57,17,1018,1132,2150,8,6,201753
5,6,152,23,160,276,13,50,20,694,813,1507,7,5.5,201753
5,7,148,7,193,248,23,39,0,658,892,1550,10,3.666666667,201753
6,1,197,19,285,225,9,73,6,814,913,1727,14,4.285714286,201753
6,2,167,9,216,203,41,50,3,689,745,1434,9,5.666666667,201753
7,1,318,17,216,647,10,65,4,1277,1523,2800,9,5.25,201753
7,2,278,25,325,964,23,37,0,1652,1399,3051,9,5.25,201753
7,3,276,14,199,956,288,42,0,1775,987,2762,7,5.333333333,201753
7,4,177,22,170,560,13,72,96,1110,1042,2152,11,5.4,201753
7,5,351,21,191,658,26,61,88,1396,1606,3002,11,5.666666667,201753
7,6,290,30,344,486,40,77,29,1296,1773,3069,8,4,201753
7,7,267,37,315,1029,47,57,3,1755,1379,3134,8,5.5,201753
7,8,309,16,319,1278,75,75,0,2072,1374,3446,12,5.25,201753
7,9,245,25,491,576,33,75,22,1467,1605,3072,11,4.5,201753
7,10,240,11,322,576,170,61,0,1380,2069,3449,9,5.5,201753
7,11,211,5,128,246,55,33,0,678,828,1506,6,5.333333333,201753
7,12,251,10,284,736,5,40,0,1326,1370,2696,9,5.5,201753
7,13,154,14,167,458,14,25,0,832,1607,2439,9,4.75,201753
8,1,192,8,294,196,10,37,0,737,838,1575,4,6,201753
8,2,213,18,312,262,15,49,0,869,1111,1980,17,5.5,201753
8,3,209,18,277,336,16,53,1,910,1082,1992,5,6,201753
8,4,183,10,275,252,17,60,0,797,1002,1799,9,6,201753
8,5,188,19,199,254,25,54,0,739,761,1500,10,5.25,201753
8,6,177,33,267,329,28,92,4,930,1000,1930,7,4,201753
8,7,186,20,130,189,21,58,0,604,662,1266,8,5.25,201753
8,8,169,30,261,317,8,58,0,843,923,1766,12,3.5,201753
8,9,182,30,162,159,13,57,4,607,609,1216,10,5.2,201753
9,1,167,21,151,149,58,35,0,581,542,1123,6,7,201753
9,2,419,123,538,1081,60,137,5,2363,2738,5101,12,6,201753
9,3,225,56,353,509,51,83,15,1292,1319,2611,7,6,201753
9,4,311,19,295,567,40,68,2,1302,1372,2674,11,6,201753
9,5,197,22,288,372,31,68,4,982,1038,2020,7,6,201753
9,6,164,28,150,260,47,48,13,710,805,1515,7,6,201753
9,7,172,16,243,422,11,36,0,900,989,1889,9,6,201753
9,8,42,17,120,152,17,30,10,388,461,849,6,7,201753
9,9,214,14,209,325,36,54,8,860,818,1678,5,6,201753
9,10,155,13,357,377,27,72,5,1006,1209,2215,6,6,201753
9,11,219,21,320,491,73,78,4,1206,1511,2717,7,6,201753
9,12,198,86,448,631,27,95,7,1492,1450,2942,11,6,201753
9,13,176,16,274,360,61,62,25,974,1079,2053,4,6,201753
9,14,179,10,200,238,91,65,0,783,777,1560,5,6,201753
9,15,372,46,1007,1053,33,242,6,2759,2772,5531,11,4,201753
9,16,329,49,419,694,90,124,2,1707,1766,3473,15,6,201753
9,17,177,15,217,319,19,64,0,811,835,1646,6,6,201753
9,18,303,55,348,728,60,99,6,1599,1581,3180,12,6,201753
9,19,292,57,230,479,94,67,8,1227,1333,2560,5,6,201753
9,20,36,4,57,69,18,7,1,192,149,341,5,6,201753
9,21,159,8,148,226,43,40,29,653,726,1379,3,6,201753
9,22,236,10,223,332,122,76,45,1044,953,1997,5,6,201753
9,23,238,14,292,452,57,70,16,1139,1307,2446,7,7,201753
9,24,404,38,564,809,127,143,66,2151,2180,4331,13,6.5,201753
10,1,199,29,223,275,52,70,22,870,992,1862,12,4.666666667,201753
10,2,229,23,210,263,27,41,28,821,1036,1857,9,5.25,201753
10,3,200,30,141,225,21,46,19,682,864,1546,12,5.4,201753
10,4,224,20,313,387,22,71,1,1038,1074,2112,12,3.4,201753
11,1,210,59,258,467,26,44,14,1078,1274,2352,6,5.666666667,201753
11,2,232,35,197,266,40,68,12,850,930,1780,7,6,201753
11,3,130,23,199,297,15,48,0,712,894,1606,4,6,201753
11,4,153,42,140,217,10,39,0,601,665,1266,8,3.6,201753
11,5,243,40,268,406,16,90,1,1064,1272,2336,8,6,201753
11,6,189,33,250,288,38,50,8,856,927,1783,8,5.666666667,201753
11,7,252,32,273,318,20,56,0,951,926,1877,9,5.25,201753
11,8,234,31,213,339,28,56,0,901,990,1891,9,5.75,201753
11,9,237,49,258,393,6,70,3,1016,1146,2162,10,5.666666667,201753
11,10,299,47,236,346,29,91,50,1098,972,2070,11,5.6,201753
11,11,107,21,98,148,13,22,0,409,496,905,4,3,201753
11,12,232,46,301,354,10,44,1,988,1078,2066,7,6,201753
11,13,220,33,209,224,39,59,41,825,969,1794,9,5.5,201753
11,14,259,48,221,234,33,80,0,875,879,1754,8,5.5,201753
11,15,151,47,130,170,6,36,0,540,682,1222,6,6,201753
12,1,150,20,245,106,50,38,3,612,637,1249,10,4.6,201753
12,2,249,27,235,418,28,50,0,1007,997,2004,10,5.5,201753
12,3,215,35,286,492,26,47,1,1102,1477,2579,11,5.2,201753
12,4,224,20,298,447,28,40,12,1069,1293,2362,9,5.666666667,201753
12,5,308,24,246,315,3,60,13,969,678,1647,10,4.5,201753
12,6,204,16,143,379,35,34,5,816,683,1499,10,5.25,201753
12,7,241,18,322,380,12,56,17,1046,1066,2112,6,3.666666667,201753
12,8,296,24,484,457,22,36,0,1319,1336,2655,9,5.25,201753
12,9,171,25,223,401,7,33,4,864,1001,1865,9,5.666666667,201753
13,1,224,31,180,579,123,55,0,1192,1122,2314,9,5.333333333,201753
13,2,185,25,129,278,62,56,0,735,790,1525,6,5.333333333,201753
13,3,202,26,163,232,99,69,0,791,837,1628,12,5.25,201753
13,4,295,20,247,282,87,43,2,976,952,1928,9,5.666666667,201753
13,5,321,18,353,375,109,90,5,1271,1238,2509,9,5.75,201753
13,6,387,44,551,666,40,77,4,1769,1827,3596,13,4.5,201753
13,7,172,13,289,309,23,53,0,859,962,1821,9,5.5,201753
14,1,192,23,110,132,24,47,12,540,556,1096,6,5.5,201753
14,2,193,15,186,129,23,88,0,634,618,1252,6,5.666666667,201753
14,3,281,17,231,140,6,105,11,791,662,1453,11,5.4,201753
14,4,162,15,176,283,8,60,7,711,846,1557,12,6,201753
14,5,192,10,355,215,42,49,2,865,1049,1914,11,5.25,201753
14,6,221,16,346,241,10,56,0,890,1112,2002,11,6,201753
14,7,119,5,184,88,0,39,0,435,629,1064,6,6,201753
14,8,286,24,548,560,33,110,6,1567,1809,3376,13,4.333333333,201753
14,9,183,23,265,363,37,49,0,920,1133,2053,8,6,201753
14,10,201,41,325,277,12,78,0,934,1180,2114,7,6,201753
14,11,125,10,121,176,18,36,6,492,616,1108,4,6,201753
14,12,273,11,446,178,6,51,0,965,1166,2131,11,5.5,201753
14,13,155,9,213,179,6,40,0,602,719,1321,8,6,201753
14,14,141,7,217,266,4,45,4,684,1101,1785,7,6,201753
14,15,234,31,186,263,20,78,9,821,880,1701,10,5.6,201753
14,16,247,15,252,280,33,54,5,886,979,1865,5,6,201753
14,17,169,31,143,140,34,56,30,603,670,1273,9,5.25,201753
14,18,273,40,275,212,36,47,23,906,951,1857,10,5.4,201753
14,19,245,30,255,293,41,66,30,960,1195,2155,9,5.25,201753
14,20,134,13,178,94,4,27,2,452,492,944,10,5.666666667,201753
15,1,279,14,185,83,228,53,1,843,805,1648,7,5.333333333,201753
15,2,213,22,237,284,43,41,14,854,920,1774,6,6,201753
15,3,321,16,305,286,45,57,24,1054,869,1923,10,5.666666667,201753
15,4,294,19,258,405,31,45,22,1074,1138,2212,4,6,201753
15,5,226,25,175,329,6,39,0,800,869,1669,8,5.666666667,201753
15,6,214,6,244,384,64,64,2,978,1000,1978,7,6,201753
15,7,213,22,250,383,46,74,0,988,1059,2047,10,6,201753
15,8,128,10,153,214,9,21,1,536,547,1083,4,6,201753
15,9,250,10,100,260,126,37,34,817,863,1680,9,5.75,201753
15,10,201,9,223,294,43,37,0,807,883,1690,9,6,201753
15,11,267,20,249,408,28,60,0,1032,1070,2102,8,6,201753
15,12,330,14,501,507,22,43,0,1417,1480,2897,8,6,201753
15,13,152,11,129,247,65,33,0,637,810,1447,8,6,201753
15,14,93,12,87,181,19,24,0,416,435,851,4,6,201753
15,15,200,62,289,393,32,63,0,1039,1071,2110,6,6,201753
15,16,295,25,276,539,8,56,2,1201,1257,2458,8,6,201753
15,17,178,12,189,314,13,70,8,784,1020,1804,8,6,201753
15,18,295,29,325,396,33,76,3,1157,1105,2262,7,5.666666667,201753
15,19,323,56,407,722,20,113,0,1641,1784,3425,14,6,201753
15,20,127,14,190,317,21,33,0,702,728,1430,6,6,201753
15,21,143,6,92,209,7,41,0,498,536,1034,6,5.5,201753
15,22,398,61,443,731,17,122,2,1774,1876,3650,14,6,201753
15,23,248,18,237,392,28,85,0,1008,914,1922,7,5.333333333,201753
15,24,192,24,173,262,22,28,2,703,773,1476,4,6,201753
15,25,280,19,274,273,15,48,0,909,1105,2014,6,6,201753
15,26,182,2,229,192,41,60,0,706,947,1653,11,2.666666667,201753
15,27,330,21,325,513,8,88,4,1289,1283,2572,9,5.666666667,201753
15,28,335,22,492,337,43,81,1,1311,1348,2659,9,5.666666667,201753
15,29,311,23,295,599,8,81,1,1318,1410,2728,8,6,201753
15,30,256,27,274,381,54,49,4,1045,1259,2304,12,6,201753
15,31,256,44,144,368,13,50,0,875,922,1797,6,6,201753
15,32,235,9,227,404,40,42,0,957,1029,1986,9,6,201753
15,33,279,15,299,399,33,63,0,1088,1171,2259,7,6,201753
15,34,199,11,220,367,9,56,1,863,885,1748,8,6,201753
15,35,346,20,275,437,14,96,0,1188,1122,2310,9,5.666666667,201753
15,36,386,27,325,375,143,68,0,1324,1331,2655,9,5.5,201753
15,37,330,27,250,444,78,86,14,1229,1170,2399,7,6,201753
15,38,282,29,268,392,8,69,0,1048,1095,2143,6,5.5,201753
15,39,213,28,223,345,12,52,18,891,863,1754,4,6,201753
15,40,358,25,285,425,139,98,11,1341,1202,2543,9,6,201753
15,41,309,18,456,487,34,39,14,1357,1476,2833,11,6,201753
16,1,192,25,205,231,7,35,0,695,686,1381,10,5.333333333,201753
16,2,202,28,134,207,23,75,0,669,558,1227,9,5.25,201753
16,3,248,26,188,346,60,63,0,931,626,1557,10,5.25,201753
16,4,305,29,272,196,41,103,0,946,862,1808,8,5.5,201753
16,5,305,37,199,226,34,134,10,945,1058,2003,10,5.666666667,201753
16,6,225,37,173,244,75,61,0,815,875,1690,12,5.5,201753
16,7,296,43,176,220,59,118,0,912,939,1851,9,5.5,201753
16,8,272,38,522,501,24,110,4,1471,1616,3087,12,6,201753
16,9,232,31,211,253,12,77,2,818,1061,1879,10,6,201753
16,10,177,19,290,296,13,54,0,849,927,1776,8,4.666666667,201753
16,11,284,37,265,198,145,86,6,1021,946,1967,12,5.4,201753
16,12,301,29,252,168,57,47,0,854,789,1643,10,5.25,201753
17,1,256,34,372,492,34,90,1,1279,1337,2616,12,3.75,201753
17,2,160,13,242,345,8,52,6,826,906,1732,9,5.666666667,201753
17,3,274,24,396,488,29,56,0,1267,1546,2813,8,5.5,201753
17,4,251,26,356,464,16,66,0,1179,1288,2467,10,5.666666667,201753
17,5,101,15,138,181,20,30,0,485,516,1001,5,5.5,201753
18,1,186,21,107,195,29,45,0,583,573,1156,9,5.2,201753
18,2,251,34,363,391,74,79,0,1192,1234,2426,10,4.75,201753
18,3,175,16,254,201,7,38,0,691,1024,1715,9,5.5,201753
19,1,211,12,261,302,17,86,6,895,1050,1945,9,6,201753
19,2,284,12,509,301,50,53,0,1209,1652,2861,10,6,201753
19,3,252,17,436,326,19,61,0,1111,1560,2671,8,6,201753
19,4,113,9,160,166,23,47,43,561,592,1153,5,6,201753
19,5,295,33,328,504,18,60,34,1272,1459,2731,8,6,201753
19,6,115,8,205,246,3,55,9,641,631,1272,5,6,201753
19,7,142,8,351,161,6,38,1,707,856,1563,10,5.5,201753
19,8,50,6,60,54,0,15,0,185,341,526,7,6,201753
19,9,232,16,217,256,43,54,0,818,916,1734,9,5.25,201753
19,10,156,8,187,270,4,69,0,694,762,1456,8,2.666666667,201753
19,11,408,47,456,813,24,123,6,1877,2168,4045,13,6,201753
19,12,169,9,368,180,13,48,0,787,691,1478,8,5.666666667,201753
20,1,220,17,175,293,62,51,0,818,862,1680,7,5.5,201753
20,2,159,17,186,238,34,31,0,665,656,1321,6,5.333333333,201753
20,3,188,18,232,259,86,42,0,825,694,1519,6,5.333333333,201753
20,4,186,24,169,250,81,65,0,775,639,1414,6,5.333333333,201753
20,5,246,22,203,388,51,50,1,961,926,1887,11,5,201753
20,6,286,11,215,366,298,44,0,1220,1411,2631,8,5.25,201753
20,7,260,28,286,402,15,50,0,1041,1310,2351,8,5.75,201753
20,8,526,24,492,921,42,143,79,2227,2342,4569,15,4.333333333,201753
20,9,306,34,218,323,159,63,30,1133,863,1996,8,5.666666667,201753
20,10,199,8,137,420,13,57,1,835,643,1478,9,4.5,201753
21,1,267,26,315,521,34,46,1,1210,1245,2455,9,5.4,201753
21,2,167,21,190,183,40,41,2,644,835,1479,9,5.2,201753
21,3,313,17,327,209,95,82,34,1077,1083,2160,8,5.5,201753
21,4,208,10,242,104,108,78,4,754,579,1333,6,5,201753
21,5,244,16,300,255,33,75,23,946,927,1873,8,5.666666667,201753
21,6,271,19,306,446,42,71,50,1205,1211,2416,6,6,201753
21,7,364,21,213,345,77,97,0,1117,938,2055,9,5.666666667,201753
21,8,244,8,364,280,38,63,7,1004,1065,2069,10,5.2,201753
21,9,292,28,357,466,67,91,40,1341,1266,2607,9,6,201753
21,10,209,5,300,297,27,46,25,909,1002,1911,7,5.5,201753
21,11,106,1,103,67,9,13,0,299,262,561,6,3.5,201753
21,12,434,26,640,780,62,124,36,2102,2109,4211,15,4.333333333,201753
21,13,190,10,191,283,30,60,0,764,836,1600,8,5.666666667,201753
21,14,272,21,252,251,67,68,0,931,776,1707,13,5.333333333,201753
21,15,388,13,338,330,93,69,0,1231,1199,2430,7,5.5,201753
22,1,241,49,268,405,75,57,0,1095,1037,2132,11,5.2,201753
22,2,256,41,359,380,106,58,14,1214,1108,2322,7,5.5,201753
22,3,352,68,588,595,51,73,2,1729,1978,3707,10,5.666666667,201753
22,4,248,41,524,468,29,81,0,1391,1537,2928,13,4.2,201753
22,5,193,19,394,230,38,43,8,925,977,1902,10,5.5,201753
23,1,284,12,974,403,67,34,0,1774,2098,3872,14,5.6,201753
23,2,205,37,415,449,32,30,0,1168,1235,2403,10,4.2,201753
23,3,258,7,620,341,28,25,0,1279,1811,3090,11,6,201753
23,4,175,6,578,265,39,35,0,1098,1293,2391,10,4.5,201753
24,1,193,40,201,451,37,25,4,951,869,1820,11,5.2,201753
24,2,129,14,142,197,10,39,0,531,617,1148,6,5.5,201753
24,3,258,64,262,618,143,46,0,1391,1431,2822,9,5.25,201753
24,4,212,38,201,217,47,61,102,878,965,1843,5,5.5,201753
24,5,232,35,347,459,19,87,0,1179,1299,2478,10,4.75,201753
24,6,292,40,434,558,33,79,0,1436,1901,3337,11,4.333333333,201753
24,7,262,44,355,813,139,56,0,1669,1385,3054,9,5.25,201753
25,1,156,9,203,202,5,21,0,596,790,1386,14,5.75,201753
25,2,185,33,238,350,23,60,0,889,1158,2047,7,5.5,201753
25,3,166,15,205,350,27,40,0,803,1066,1869,9,5.6,201753
25,4,182,24,150,255,18,50,9,688,835,1523,8,5.333333333,201753
25,5,168,13,240,388,12,54,0,875,1194,2069,11,4.5,201753
25,6,216,18,294,265,45,75,0,913,1212,2125,9,5.75,201753
25,7,182,12,167,333,5,57,0,756,1061,1817,7,6,201753
26,1,178,8,190,203,7,63,0,649,739,1388,9,5.5,201753
26,2,147,8,264,285,5,58,0,767,1136,1903,13,5.4,201753
26,3,212,23,367,451,14,111,2,1180,1711,2891,15,4.333333333,201753
26,4,133,10,157,222,19,55,0,596,780,1376,10,5.2,201753
26,5,130,22,118,131,11,40,0,452,680,1132,3,5.5,201753
26,6,136,15,236,328,5,72,0,792,1044,1836,10,5.333333333,201753
26,7,133,19,138,251,16,33,0,590,809,1399,10,5.5,201753
27,1,205,21,180,451,27,46,2,932,964,1896,9,5.5,201753
27,2,221,34,194,599,23,39,1,1111,1049,2160,8,5.666666667,201753
27,3,202,13,101,411,3,38,0,768,908,1676,7,5.666666667,201753
27,4,223,25,243,616,7,41,6,1161,1553,2714,10,3.5,201753
27,5,174,7,118,372,8,33,0,712,589,1301,6,5.333333333,201753
27,6,229,18,230,565,13,51,0,1106,1027,2133,9,5.333333333,201753
28,1,204,11,295,270,6,44,0,830,1075,1905,13,6,201753
28,2,226,18,354,262,23,45,81,1009,1268,2277,14,5.75,201753
28,3,159,15,105,149,4,42,0,474,708,1182,7,4.333333333,201753
28,4,327,31,284,342,37,71,45,1137,1324,2461,16,6,201753
28,5,222,37,249,515,25,51,1,1100,1149,2249,13,3.833333333,201753
28,6,206,52,220,639,136,36,16,1305,1536,2841,14,5.166666667,201753
28,7,281,28,382,402,66,61,0,1220,1373,2593,8,6,201753
28,8,207,28,250,321,53,61,2,922,993,1915,11,5.666666667,201753
28,9,122,6,170,148,19,22,56,543,594,1137,9,6,201753
29,1,286,65,311,327,54,37,0,1080,1114,2194,10,5,201753
29,2,357,21,248,571,27,79,33,1336,1299,2635,15,4.166666667,201753
29,3,184,32,122,304,23,34,0,699,808,1507,7,5.333333333,201753
30,1,164,20,135,255,17,35,0,626,540,1166,7,5.333333333,201753
30,2,178,30,114,99,65,26,392,904,1036,1940,8,5.25,201753
30,3,208,54,266,243,113,65,50,999,1096,2095,6,5.666666667,201753
30,4,143,5,245,199,36,65,0,693,708,1401,8,6,201753
30,5,174,11,201,343,18,58,0,805,915,1720,7,5.5,201753
30,6,172,14,174,208,27,28,0,623,693,1316,9,5.333333333,201753
30,7,290,36,262,403,76,79,56,1202,818,2020,12,5.25,201753
30,8,272,27,340,340,72,85,1,1137,1079,2216,11,5.4,201753
30,9,277,20,224,168,58,51,81,879,857,1736,8,5.5,201753
30,10,206,13,307,342,37,67,24,996,958,1954,9,4.333333333,201753
30,11,179,13,329,363,8,59,0,951,1016,1967,6,5.5,201753
30,12,281,18,476,559,35,112,0,1481,1737,3218,11,6,201753
30,13,200,11,148,351,96,63,18,887,822,1709,10,5.4,201753
30,14,196,29,230,263,135,57,0,910,1124,2034,9,5.5,201753
30,15,282,16,218,273,51,69,106,1015,1221,2236,11,5.666666667,201753
30,16,216,14,200,342,49,79,44,944,1028,1972,10,5.333333333,201753
30,17,161,29,156,274,30,46,0,696,752,1448,8,5.5,201753
30,18,231,13,142,308,17,74,32,817,794,1611,8,5.25,201753
30,19,181,13,162,239,47,52,18,712,770,1482,13,5.6,201753
30,20,187,14,210,293,80,68,0,852,940,1792,11,5.4,201753
31,1,269,24,227,472,14,26,0,1032,917,1949,8,5.5,201753
31,2,132,10,168,37,185,33,0,565,629,1194,7,5.333333333,201753
31,3,364,48,684,573,94,97,0,1860,2135,3995,20,4.5,201753
31,4,106,5,250,240,29,55,0,685,760,1445,4,3,201753
31,5,203,28,150,340,24,36,0,781,821,1602,7,5.333333333,201753
32,1,209,41,181,208,25,50,16,730,818,1548,12,5.2,201753
32,2,243,48,210,171,58,42,6,778,676,1454,13,5.142857143,201753
32,3,188,58,170,270,25,49,5,765,816,1581,15,4.666666667,201753
32,4,235,91,227,263,33,77,72,998,1118,2116,13,4.333333333,201753
1,1,277,48,344,413,61,84,5,1232,565,1797,13,4.5,201801
1,2,400,75,845,661,141,126,13,2261,898,3159,12,4.2,201801
1,3,314,82,894,687,82,141,4,2204,906,3110,13,4.2,201801
2,1,296,20,523,553,17,87,0,1496,336,1832,11,5,201801
2,2,307,28,397,711,6,117,0,1566,877,2443,9,3.666666667,201801
2,3,319,29,509,472,23,99,0,1451,952,2403,11,3.6,201801
2,4,161,13,402,222,22,28,1,849,478,1327,13,5,201801
2,5,480,40,994,660,156,142,6,2478,1461,3939,14,6.666666667,201801
2,6,271,19,462,458,32,79,1,1322,790,2112,7,5,201801
2,7,354,26,623,565,49,87,7,1711,868,2579,12,4.75,201801
2,8,310,11,635,524,15,81,8,1584,973,2557,8,5,201801
3,1,135,14,343,349,19,87,10,957,497,1454,15,4.142857143,201801
3,2,159,10,492,268,10,31,0,970,496,1466,9,5,201801
4,1,226,23,357,654,80,50,1,1391,780,2171,15,3.833333333,201801
4,2,170,18,368,518,15,47,2,1138,774,1912,14,4.4,201801
5,1,237,18,348,379,28,88,0,1098,665,1763,9,5,201801
5,2,242,15,344,439,20,69,0,1129,285,1414,10,5,201801
5,3,177,12,253,364,41,76,20,943,422,1365,9,5,201801
5,4,326,35,731,633,14,176,9,1924,516,2440,11,4.25,201801
5,5,316,23,429,668,19,97,36,1588,630,2218,8,5,201801
5,6,207,16,344,367,13,55,27,1029,426,1455,7,4.5,201801
5,7,229,17,342,413,12,64,3,1080,424,1504,10,3,201801
6,1,233,27,520,413,12,85,12,1302,523,1825,14,3.714285714,201801
6,2,167,22,370,240,75,58,2,934,408,1342,9,4.666666667,201801
7,1,219,11,234,619,7,22,7,1119,663,1782,9,4.25,201801
7,2,235,9,175,777,20,33,1,1250,1594,2844,9,4.25,201801
7,3,263,5,175,371,413,34,0,1261,596,1857,7,4.333333333,201801
7,4,174,15,168,473,10,50,78,968,1146,2114,11,4.4,201801
7,5,383,8,202,770,23,66,81,1533,1099,2632,11,4.666666667,201801
7,6,312,27,348,699,36,88,38,1548,724,2272,8,3.5,201801
7,7,241,20,313,783,101,56,0,1514,738,2252,8,4.5,201801
7,8,286,18,372,986,35,45,0,1742,928,2670,12,4.25,201801
7,9,344,37,500,838,44,104,48,1915,1016,2931,11,3.75,201801
7,10,244,13,323,817,134,49,0,1580,1483,3063,9,4.5,201801
7,11,118,6,92,312,28,10,0,566,391,957,6,4.333333333,201801
7,12,315,9,325,938,16,40,0,1643,736,2379,9,4.5,201801
7,13,184,16,170,556,16,30,0,972,1011,1983,9,4.25,201801
8,1,277,10,452,235,3,47,0,1024,651,1675,4,5,201801
8,2,397,30,743,543,33,110,1,1857,764,2621,17,4.5,201801
8,3,368,35,544,550,22,78,6,1603,712,2315,5,5,201801
8,4,317,38,500,582,27,118,6,1588,450,2038,9,5,201801
8,5,317,31,374,333,50,105,0,1210,851,2061,10,4.25,201801
8,6,346,24,661,673,75,191,31,2001,727,2728,8,3.666666667,201801
8,7,259,35,284,304,17,96,0,995,511,1506,8,4.25,201801
8,8,318,55,579,623,8,143,1,1727,728,2455,10,3,201801
8,9,191,15,182,192,18,78,0,676,534,1210,10,4.2,201801
9,1,189,16,184,197,74,66,0,726,413,1139,6,6,201801
9,2,495,94,699,1198,70,158,11,2725,1417,4142,12,5,201801
9,3,232,34,440,616,57,108,17,1504,917,2421,7,5,201801
9,4,338,20,351,734,58,78,4,1583,902,2485,11,5,201801
9,5,238,16,354,439,83,89,14,1233,670,1903,7,5,201801
9,6,154,30,197,217,82,53,4,737,271,1008,7,5,201801
9,7,217,12,294,519,6,65,0,1113,659,1772,9,5,201801
9,8,90,31,171,230,22,52,22,618,194,812,5,5,201801
9,9,209,12,272,387,40,48,11,979,482,1461,5,5,201801
9,10,220,12,410,483,29,117,7,1278,550,1828,6,5,201801
9,11,336,25,423,629,55,106,16,1590,953,2543,7,5,201801
9,12,233,133,512,780,48,108,7,1821,874,2695,11,5,201801
9,13,237,27,314,472,84,60,42,1236,621,1857,4,5,201801
9,14,183,9,184,271,88,59,0,794,567,1361,5,5,201801
9,15,405,36,1049,1189,45,273,10,3007,1919,4926,10,2.75,201801
9,16,530,81,611,932,130,169,6,2459,1491,3950,15,6,201801
9,17,226,13,235,370,29,68,0,941,469,1410,6,5,201801
9,18,348,28,361,757,74,102,19,1689,1037,2726,12,5,201801
9,19,365,37,331,592,100,97,10,1532,921,2453,5,5,201801
9,20,57,20,59,89,20,18,1,264,78,342,5,5,201801
9,21,187,13,176,260,65,41,55,797,339,1136,3,5,201801
9,22,288,17,246,360,137,65,52,1165,651,1816,5,5,201801
9,23,271,24,356,655,78,90,10,1484,868,2352,7,6,201801
9,24,472,32,616,838,129,139,108,2334,1342,3676,13,5.5,201801
10,1,213,29,260,345,29,69,55,1000,566,1566,12,4.333333333,201801
10,2,322,21,389,383,47,86,22,1270,367,1637,9,4.5,201801
10,3,280,31,239,379,28,62,55,1074,404,1478,12,4.4,201801
10,4,346,50,575,635,26,84,8,1724,751,2475,14,3.25,201801
11,1,219,50,259,457,28,41,5,1059,755,1814,6,4.666666667,201801
11,2,245,21,233,348,18,50,22,937,611,1548,7,5,201801
11,3,232,31,313,350,17,48,12,1003,508,1511,4,5,201801
11,4,167,27,223,296,4,47,0,764,463,1227,8,3,201801
11,5,370,82,474,601,27,94,7,1655,783,2438,8,5.5,201801
11,6,253,37,355,423,49,77,13,1207,575,1782,8,4.666666667,201801
11,7,282,42,413,571,33,66,0,1407,669,2076,9,4.5,201801
11,8,280,20,293,477,29,40,0,1139,436,1575,9,4.75,201801
11,9,313,69,365,495,8,70,1,1321,775,2096,10,4.666666667,201801
11,10,254,51,267,373,37,74,68,1124,754,1878,11,4.6,201801
11,11,206,69,254,323,24,58,0,934,334,1268,4,5,201801
11,12,333,54,477,585,17,65,0,1531,576,2107,7,5.5,201801
11,13,191,38,211,236,31,40,66,813,503,1316,9,4.5,201801
11,14,175,30,189,289,20,41,0,744,703,1447,8,4.5,201801
11,15,185,31,197,318,6,34,0,771,437,1208,6,5,201801
12,1,214,28,279,146,92,37,10,806,488,1294,10,4,201801
12,2,300,42,316,527,35,53,0,1273,617,1890,10,4.5,201801
12,3,175,21,238,363,28,48,2,875,540,1415,11,4.2,201801
12,4,202,28,355,621,35,41,9,1291,605,1896,9,5,201801
12,5,189,17,330,292,2,23,31,884,455,1339,10,4.25,201801
12,6,182,28,139,484,28,7,6,874,444,1318,10,4.25,201801
12,7,215,17,246,498,19,39,37,1071,736,1807,6,3,201801
12,8,178,21,355,416,46,21,0,1037,692,1729,9,4.25,201801
12,9,162,17,262,471,10,21,8,951,436,1387,9,4.666666667,201801
13,1,216,21,152,339,194,37,0,959,696,1655,9,4.333333333,201801
13,2,224,26,135,358,83,54,0,880,474,1354,6,4.333333333,201801
13,3,231,10,141,296,113,48,1,840,544,1384,12,4.25,201801
13,4,248,19,284,379,56,69,7,1062,481,1543,9,4.666666667,201801
13,5,379,36,433,451,121,93,29,1542,785,2327,9,4.75,201801
13,6,462,54,802,893,38,135,11,2395,890,3285,11,3.75,201801
13,7,200,22,376,458,31,46,0,1133,408,1541,9,4.5,201801
14,1,207,24,147,148,17,87,17,647,369,1016,6,4.5,201801
14,2,256,17,245,196,29,73,0,816,401,1217,6,4.666666667,201801
14,3,346,20,349,177,4,121,4,1021,653,1674,11,4.4,201801
14,4,277,26,369,544,23,107,9,1355,636,1991,12,5,201801
14,5,215,15,467,240,41,41,15,1034,558,1592,11,4.5,201801
14,6,327,17,668,410,15,67,1,1505,477,1982,11,5,201801
14,7,99,6,199,66,0,18,0,388,319,707,6,5,201801
14,8,418,34,869,835,52,166,8,2382,1063,3445,12,3.5,201801
14,9,366,52,466,608,67,88,0,1647,654,2301,8,5,201801
14,10,253,26,498,388,15,88,1,1269,691,1960,7,5,201801
14,11,181,12,224,282,43,43,12,797,310,1107,4,5,201801
14,12,331,15,576,236,4,50,0,1212,714,1926,11,4.5,201801
14,13,238,16,346,231,26,63,0,920,368,1288,8,5,201801
14,14,237,25,387,470,12,86,12,1229,563,1792,7,6,201801
14,15,290,35,288,332,19,87,21,1072,531,1603,10,4.6,201801
14,16,316,17,332,301,43,58,8,1075,732,1807,5,5,201801
14,17,177,23,151,154,27,69,39,640,575,1215,9,4.25,201801
14,18,295,25,249,197,37,64,32,899,663,1562,10,4.4,201801
14,19,251,49,332,348,46,71,22,1119,665,1784,9,4.25,201801
14,20,191,12,268,163,13,60,2,709,391,1100,10,4.666666667,201801
15,1,216,17,145,67,205,33,0,683,392,1075,7,4.333333333,201801
15,2,335,16,320,425,48,72,29,1245,539,1784,6,5,201801
15,3,412,19,298,366,68,67,4,1234,430,1664,10,4.666666667,201801
15,4,335,29,307,485,50,83,40,1329,722,2051,4,5,201801
15,5,379,27,242,371,18,48,0,1085,500,1585,8,4.666666667,201801
15,6,312,12,413,559,92,87,7,1482,733,2215,7,5.5,201801
15,7,285,25,276,437,63,75,0,1161,399,1560,10,5,201801
15,8,164,8,156,240,11,43,3,625,346,971,4,5,201801
15,9,406,10,137,286,95,44,30,1008,426,1434,9,4.75,201801
15,10,281,19,283,469,77,76,0,1205,283,1488,9,5,201801
15,11,352,17,361,529,51,70,0,1380,706,2086,8,5,201801
15,12,514,18,578,723,30,61,0,1924,869,2793,8,5,201801
15,13,172,16,163,231,80,38,0,700,339,1039,8,5,201801
15,14,100,10,111,247,28,38,0,534,188,722,4,5,201801
15,15,264,50,317,510,24,88,0,1253,740,1993,6,5,201801
15,16,497,35,480,926,26,108,7,2079,849,2928,8,5,201801
15,17,204,25,217,450,11,56,46,1009,414,1423,8,5,201801
15,18,392,15,361,496,40,101,3,1408,530,1938,7,4.666666667,201801
15,19,443,88,614,1126,16,143,4,2434,908,3342,14,5,201801
15,20,156,13,242,430,27,58,0,926,343,1269,6,5,201801
15,21,159,2,112,204,9,42,0,528,287,815,6,4.5,201801
15,22,519,56,651,1068,41,173,7,2515,1157,3672,14,5,201801
15,23,371,14,256,440,51,88,0,1220,497,1717,7,4.333333333,201801
15,24,267,25,258,448,30,56,1,1085,570,1655,4,5,201801
15,25,281,25,268,341,11,44,0,970,670,1640,6,5,201801
15,26,212,7,231,241,43,71,0,805,329,1134,11,2.333333333,201801
15,27,404,23,369,695,8,85,15,1599,792,2391,9,4.666666667,201801
15,28,452,25,493,459,69,87,1,1586,625,2211,9,4.666666667,201801
15,29,419,36,413,780,16,103,0,1767,571,2338,8,5,201801
15,30,423,32,358,542,37,64,7,1463,787,2250,12,5,201801
15,31,321,44,225,514,15,62,0,1181,653,1834,6,5,201801
15,32,334,15,285,521,73,61,1,1290,559,1849,9,5,201801
15,33,419,15,363,549,35,67,0,1448,725,2173,7,5,201801
15,34,318,21,282,535,11,83,1,1251,859,2110,8,5,201801
15,35,399,25,265,445,26,90,0,1250,572,1822,9,4.666666667,201801
15,36,363,19,328,406,66,57,5,1244,536,1780,9,4.75,201801
15,37,388,44,400,596,98,87,43,1656,702,2358,7,5,201801
15,38,339,41,321,441,13,76,0,1231,628,1859,6,4.5,201801
15,39,329,30,284,473,39,67,24,1246,708,1954,4,5,201801
15,40,588,28,397,589,148,118,16,1884,793,2677,9,5,201801
15,41,562,38,763,791,67,94,35,2350,1035,3385,11,5,201801
16,1,193,23,245,266,10,37,0,774,755,1529,10,4.333333333,201801
16,2,135,18,148,188,13,56,0,558,478,1036,9,4.25,201801
16,3,259,22,211,321,41,63,0,917,641,1558,10,4.25,201801
16,4,241,28,263,173,30,92,0,827,604,1431,8,4.5,201801
16,5,262,37,207,293,26,100,17,942,688,1630,10,4.666666667,201801
16,6,260,32,163,323,64,49,0,891,587,1478,12,4.5,201801
16,7,307,38,193,276,50,94,0,958,577,1535,9,4.5,201801
16,8,312,41,566,646,22,119,4,1710,925,2635,12,5,201801
16,9,235,26,263,287,12,51,0,874,552,1426,10,5,201801
16,10,211,27,497,448,28,78,4,1293,550,1843,8,4,201801
16,11,288,27,234,224,163,70,1,1007,620,1627,12,4.4,201801
16,12,242,19,239,201,31,53,0,785,497,1282,10,4.25,201801
17,1,265,31,453,550,39,102,2,1442,658,2100,10,3.25,201801
17,2,258,17,389,499,23,55,19,1260,504,1764,9,5.333333333,201801
17,3,379,28,448,559,29,52,0,1495,381,1876,8,5,201801
17,4,370,30,460,567,22,77,0,1526,617,2143,10,5.333333333,201801
17,5,159,12,130,209,12,37,0,559,405,964,5,5,201801
18,1,209,26,209,234,62,52,0,792,496,1288,9,4.4,201801
18,2,298,39,590,544,113,101,0,1685,784,2469,8,4.5,201801
18,3,198,28,377,312,14,53,0,982,527,1509,9,4.75,201801
19,1,226,11,316,371,27,86,7,1044,615,1659,9,5,201801
19,2,340,16,711,374,85,87,1,1614,942,2556,10,5.5,201801
19,3,289,14,518,425,29,75,2,1352,763,2115,8,5,201801
19,4,113,12,182,177,47,40,47,618,360,978,5,5,201801
19,5,322,26,432,639,30,84,63,1596,813,2409,7,6,201801
19,6,109,10,252,240,4,50,11,676,345,1021,5,5,201801
19,7,184,6,429,244,7,43,0,913,658,1571,10,4.5,201801
19,8,58,3,80,86,2,12,0,241,160,401,7,5,201801
19,9,142,7,170,199,18,43,1,580,674,1254,9,4.25,201801
19,10,187,9,210,339,7,57,0,809,561,1370,7,2,201801
19,11,461,47,689,1064,31,171,24,2487,1230,3717,13,5.333333333,201801
19,12,191,5,479,255,8,52,4,994,380,1374,8,5,201801
20,1,227,17,251,323,76,55,0,949,551,1500,7,4.5,201801
20,2,138,15,103,177,17,21,0,471,283,754,6,4.333333333,201801
20,3,159,26,208,268,64,45,0,770,384,1154,6,4,201801
20,4,160,25,131,231,66,35,0,648,403,1051,6,4.333333333,201801
20,5,237,27,222,463,47,32,2,1030,440,1470,11,4,201801
20,6,253,17,213,335,191,55,3,1067,729,1796,8,4.25,201801
20,7,242,7,245,407,11,56,0,968,728,1696,8,4.75,201801
20,8,644,54,657,1124,66,180,122,2847,1554,4401,15,4,201801
20,9,256,26,205,318,83,63,23,974,414,1388,8,4.666666667,201801
20,10,233,14,195,399,15,48,0,904,763,1667,9,4.25,201801
21,1,260,17,290,480,17,40,0,1104,636,1740,9,4.4,201801
21,2,245,15,239,230,39,49,0,817,536,1353,9,4.2,201801
21,3,384,18,378,272,103,85,31,1271,762,2033,8,4.5,201801
21,4,247,3,199,136,130,67,64,846,274,1120,6,4.25,201801
21,5,355,15,453,389,45,91,13,1361,526,1887,8,4.666666667,201801
21,6,382,22,419,656,72,103,78,1732,1039,2771,6,6,201801
21,7,463,17,298,493,62,107,1,1441,755,2196,9,4.666666667,201801
21,8,265,12,272,290,58,46,11,954,646,1600,10,4.2,201801
21,9,443,34,620,640,110,124,89,2060,939,2999,9,5,201801
21,10,368,13,428,425,44,72,43,1393,654,2047,7,5,201801
21,11,114,3,163,124,37,21,2,464,173,637,6,3,201801
21,12,557,33,1013,1141,109,184,86,3123,1608,4731,15,4,201801
21,13,279,20,221,407,34,52,0,1013,478,1491,8,4.666666667,201801
21,14,317,19,318,336,80,65,0,1135,852,1987,13,4.333333333,201801
21,15,372,10,503,413,49,107,2,1456,714,2170,7,4.5,201801
22,1,258,62,273,482,77,28,0,1180,554,1734,11,4.2,201801
22,2,304,32,495,358,54,73,26,1342,718,2060,7,4.5,201801
22,3,432,79,963,904,52,137,8,2575,1152,3727,10,5,201801
22,4,339,65,832,736,66,106,6,2150,1128,3278,11,3.2,201801
22,5,217,27,607,396,59,63,20,1389,595,1984,10,4.5,201801
23,1,257,6,1046,472,31,40,1,1853,990,2843,14,4.6,201801
23,2,266,37,501,556,33,56,0,1449,753,2202,10,3.4,201801
23,3,291,18,914,581,39,32,1,1876,994,2870,11,5,201801
23,4,200,8,801,395,44,47,0,1495,942,2437,8,3.75,201801
24,1,255,57,245,497,57,59,9,1179,593,1772,11,4.2,201801
24,2,166,27,207,225,22,51,0,698,406,1104,6,4.5,201801
24,3,231,57,291,665,133,51,0,1428,985,2413,9,4.25,201801
24,4,178,34,260,198,59,46,88,863,602,1465,5,4.5,201801
24,5,405,34,690,774,17,131,0,2051,829,2880,10,4.25,201801
24,6,463,82,745,858,47,160,0,2355,1049,3404,11,3.666666667,201801
24,7,248,19,335,428,82,39,0,1151,1097,2248,9,4.25,201801
25,1,185,22,355,382,38,54,2,1038,476,1514,14,4.75,201801
25,2,240,30,446,468,9,82,0,1275,779,2054,7,4.5,201801
25,3,229,16,293,403,54,54,8,1057,558,1615,9,4.6,201801
25,4,205,24,166,409,13,56,15,888,575,1463,8,4.333333333,201801
25,5,281,21,456,686,30,103,0,1577,564,2141,9,3.75,201801
25,6,277,16,434,422,67,77,3,1296,650,1946,9,4.75,201801
25,7,269,12,448,585,6,105,0,1425,566,1991,7,5,201801
26,1,218,11,334,332,10,75,0,980,647,1627,9,4.5,201801
26,2,246,8,532,561,5,68,0,1420,566,1986,13,4.4,201801
26,3,306,35,671,814,25,227,1,2079,718,2797,15,4,201801
26,4,130,11,166,286,39,65,5,702,423,1125,10,4.2,201801
26,5,59,9,127,149,8,42,0,394,205,599,3,4.5,201801
26,6,170,10,419,507,5,70,0,1181,598,1779,10,4.333333333,201801
26,7,147,6,217,398,17,33,0,818,388,1206,10,4.5,201801
27,1,153,21,217,485,43,42,0,961,324,1285,9,4.5,201801
27,2,184,13,181,586,15,48,0,1027,466,1493,8,4.666666667,201801
27,3,209,12,184,582,14,43,0,1044,524,1568,7,4.666666667,201801
27,4,204,21,323,887,19,60,1,1515,748,2263,9,3,201801
27,5,183,3,117,459,7,18,0,787,307,1094,6,4.333333333,201801
27,6,211,14,284,743,9,48,0,1309,538,1847,9,4.333333333,201801
28,1,248,17,427,428,10,53,0,1183,645,1828,13,5,201801
28,2,250,19,503,346,36,46,122,1322,596,1918,14,5,201801
28,3,165,18,157,203,14,35,0,592,385,977,7,4.333333333,201801
28,4,311,23,468,486,37,59,82,1466,617,2083,16,5,201801
28,5,215,17,262,447,32,46,0,1019,444,1463,12,3,201801
28,6,172,23,163,399,105,34,19,915,764,1679,14,4.166666667,201801
28,7,273,29,478,604,71,79,0,1534,754,2288,8,5,201801
28,8,194,24,243,371,72,60,6,970,596,1566,11,4.666666667,201801
28,9,170,8,265,172,25,30,61,731,295,1026,9,4.666666667,201801
29,1,437,58,450,445,89,89,5,1573,675,2248,10,4.5,201801
29,2,504,40,428,913,65,101,66,2117,891,3008,13,3.5,201801
29,3,315,29,220,516,35,64,1,1180,422,1602,7,4.666666667,201801
30,1,111,7,135,138,17,20,38,466,310,776,7,4.333333333,201801
30,2,190,18,115,108,50,33,219,733,513,1246,8,4.25,201801
30,3,234,18,257,255,104,49,77,994,545,1539,6,4.666666667,201801
30,4,172,8,328,308,38,46,4,904,483,1387,8,5,201801
30,5,170,10,207,448,14,64,0,913,485,1398,7,4.5,201801
30,6,206,11,219,244,26,35,0,741,455,1196,9,4.333333333,201801
30,7,245,15,265,385,75,55,51,1091,730,1821,12,4.25,201801
30,8,278,10,402,357,43,84,0,1174,542,1716,11,4.4,201801
30,9,293,12,249,216,59,68,109,1006,577,1583,8,4.5,201801
30,10,271,20,508,499,36,108,42,1484,542,2026,9,4,201801
30,11,142,12,325,430,12,65,0,986,564,1550,6,4.5,201801
30,12,309,28,593,781,39,159,0,1909,900,2809,11,5.25,201801
30,13,304,13,236,416,71,65,5,1110,631,1741,10,4.4,201801
30,14,199,24,268,323,81,73,0,968,576,1544,9,4.5,201801
30,15,297,17,220,283,73,78,146,1114,639,1753,11,4.666666667,201801
30,16,251,13,291,475,65,90,66,1251,713,1964,10,4.333333333,201801
30,17,192,13,157,239,29,46,13,689,355,1044,8,4,201801
30,18,271,9,162,269,19,43,31,804,517,1321,8,4.25,201801
30,19,191,12,235,359,29,47,7,880,448,1328,13,4.6,201801
30,20,248,22,220,507,122,49,0,1168,629,1797,11,4.4,201801
31,1,297,21,325,563,28,52,0,1286,494,1780,8,4.5,201801
31,2,177,16,171,30,335,36,0,765,363,1128,7,4.333333333,201801
31,3,601,109,1167,1066,116,198,0,3257,1361,4618,21,4.25,201801
31,4,162,17,407,382,80,73,0,1121,523,1644,6,3.5,201801
31,5,284,44,224,383,27,37,0,999,395,1394,7,4.333333333,201801
32,1,264,38,223,249,29,58,49,910,456,1366,12,4.2,201801
32,2,237,42,226,212,55,54,10,836,488,1324,13,4.142857143,201801
32,3,217,42,293,293,23,66,5,939,467,1406,13,3.666666667,201801
32,4,234,63,313,366,30,95,51,1152,689,1841,12,3.666666667,201801
1,1,438,75,499,576,100,91,8,1787,784,2571,13,5.5,201802
1,2,481,88,1029,752,177,178,15,2720,1558,4278,12,5,201802
1,3,429,107,1067,758,83,165,3,2612,1486,4098,13,5,201802
2,1,372,21,677,751,35,124,4,1984,906,2890,11,6,201802
2,2,447,28,671,907,16,168,0,2237,905,3142,9,4.333333333,201802
2,3,456,17,710,538,31,125,0,1877,1046,2923,12,4.4,201802
2,4,248,18,477,254,38,49,0,1084,522,1606,13,6,201802
2,5,631,40,1191,841,192,205,7,3107,1825,4932,14,6.666666667,201802
2,6,306,20,559,537,50,77,0,1549,995,2544,7,6,201802
2,7,414,25,804,669,37,128,11,2088,775,2863,12,5.75,201802
2,8,371,22,729,575,16,100,1,1814,1143,2957,8,6,201802
3,1,285,23,540,473,21,114,11,1467,735,2202,15,5,201802
3,2,249,6,735,290,25,55,0,1360,728,2088,9,6,201802
4,1,468,50,663,990,96,89,1,2357,1315,3672,15,4.666666667,201802
4,2,394,17,659,744,30,92,0,1936,1138,3074,14,5.4,201802
5,1,415,40,649,547,47,137,0,1835,1055,2890,9,6,201802
5,2,400,37,632,693,76,107,3,1948,761,2709,10,6,201802
5,3,349,35,520,640,53,114,27,1738,882,2620,9,6,201802
5,4,567,66,937,855,31,234,32,2722,1504,4226,11,4.75,201802
5,5,471,40,625,742,40,85,36,2039,1191,3230,8,6,201802
5,6,393,41,605,646,23,89,90,1887,619,2506,11,5.5,201802
5,7,365,47,483,538,36,102,5,1576,787,2363,11,4,201802
6,1,311,37,625,452,11,106,15,1557,934,2491,15,4.571428571,201802
6,2,294,29,477,275,114,82,9,1280,683,1963,9,5.666666667,201802
7,1,370,23,326,925,18,43,11,1716,1129,2845,9,5.25,201802
7,2,521,35,299,2058,116,81,0,3110,1566,4676,9,5.25,201802
7,3,563,10,396,610,398,68,0,2045,1157,3202,7,5.333333333,201802
7,4,376,21,298,929,34,93,160,1911,1226,3137,11,5.4,201802
7,5,554,19,340,1267,28,87,96,2391,1098,3489,11,5.666666667,201802
7,6,462,38,533,1015,122,122,37,2329,1349,3678,8,4.25,201802
7,7,435,37,484,1008,88,94,0,2146,1979,4125,8,5.5,201802
7,8,444,35,533,1364,57,84,0,2517,1845,4362,12,5.25,201802
7,9,443,41,749,1107,57,137,32,2566,1490,4056,11,4.5,201802
7,10,386,26,512,1165,291,65,0,2445,1260,3705,9,5.5,201802
7,11,212,5,141,364,90,31,0,843,394,1237,6,5.333333333,201802
7,12,519,25,584,1283,9,69,0,2489,1128,3617,9,5.5,201802
7,13,252,19,254,791,8,65,0,1389,1409,2798,9,5.25,201802
8,1,350,13,563,287,43,46,1,1303,721,2024,4,6,201802
8,2,581,47,932,699,39,131,10,2439,1134,3573,17,5.5,201802
8,3,410,46,739,657,22,120,6,2000,896,2896,5,6,201802
8,4,385,32,716,634,52,159,16,1994,699,2693,9,6,201802
8,5,568,84,591,565,88,130,0,2026,462,2488,10,5.25,201802
8,6,398,48,826,764,77,170,28,2311,1123,3434,8,4.333333333,201802
8,7,358,30,373,434,17,107,1,1320,717,2037,8,5.25,201802
8,8,334,62,677,635,25,133,13,1879,880,2759,10,3.5,201802
8,9,388,38,340,316,34,128,0,1244,843,2087,10,5.2,201802
9,1,275,21,290,259,112,80,0,1037,619,1656,6,7,201802
9,2,699,124,1072,1570,99,229,1,3794,1908,5702,12,6,201802
9,3,385,59,659,727,82,150,43,2105,1207,3312,7,6,201802
9,4,529,42,636,971,79,123,8,2388,1394,3782,11,6,201802
9,5,342,19,483,604,93,94,4,1639,990,2629,7,6,201802
9,6,285,41,305,335,101,91,18,1176,564,1740,7,6,201802
9,7,279,24,427,684,6,97,2,1519,944,2463,9,6,201802
9,8,172,41,303,344,32,75,26,993,482,1475,6,7,201802
9,9,316,21,379,444,59,65,7,1291,828,2119,5,6,201802
9,10,255,29,536,569,43,119,5,1556,1046,2602,6,6,201802
9,11,494,42,811,848,82,160,15,2452,822,3274,7,6,201802
9,12,383,163,845,989,50,172,19,2621,1437,4058,11,6,201802
9,13,315,34,515,556,130,93,50,1693,1032,2725,4,6,201802
9,14,252,12,250,317,115,81,0,1027,564,1591,5,6,201802
9,15,462,53,1449,1464,35,327,10,3800,2718,6518,11,3.75,201802
9,16,610,96,885,1166,141,197,10,3105,1863,4968,15,7,201802
9,17,283,17,353,443,40,116,0,1252,843,2095,6,6,201802
9,18,392,53,564,836,62,136,12,2055,1410,3465,12,6,201802
9,19,466,53,465,704,145,114,16,1963,1179,3142,5,6,201802
9,20,69,6,129,152,30,35,8,429,109,538,5,6,201802
9,21,289,23,278,413,103,86,79,1271,617,1888,3,6,201802
9,22,392,20,349,416,150,92,75,1494,977,2471,5,6,201802
9,23,353,25,574,764,86,119,5,1926,1120,3046,7,7,201802
9,24,558,45,802,964,149,200,141,2859,1907,4766,12,6,201802
10,1,329,44,373,439,17,80,81,1363,895,2258,12,4.666666667,201802
10,2,452,40,465,530,65,107,27,1686,568,2254,9,5.5,201802
10,3,425,56,336,617,66,83,46,1629,772,2401,12,5.4,201802
10,4,477,63,784,759,48,113,3,2247,1254,3501,17,4,201802
11,1,469,91,382,570,40,67,22,1641,995,2636,6,5.666666667,201802
11,2,465,57,394,549,52,112,23,1652,827,2479,7,6,201802
11,3,307,47,353,399,33,85,19,1243,757,2000,4,6,201802
11,4,382,64,401,504,21,83,0,1455,725,2180,10,3.8,201802
11,5,647,85,568,782,41,142,3,2268,1304,3572,8,6.5,201802
11,6,388,46,468,436,74,95,26,1533,774,2307,8,5.666666667,201802
11,7,479,75,595,874,46,103,0,2172,917,3089,9,5.5,201802
11,8,523,68,515,662,61,103,0,1932,1059,2991,9,5.75,201802
11,9,625,113,559,710,25,113,7,2152,1178,3330,10,5.666666667,201802
11,10,567,99,489,660,50,143,98,2106,1112,3218,11,5.6,201802
11,11,394,84,327,406,27,65,0,1303,565,1868,4,6,201802
11,12,511,72,668,777,29,117,1,2175,1024,3199,7,6.5,201802
11,13,481,82,360,441,77,88,109,1638,802,2440,9,5.5,201802
11,14,510,68,396,525,43,87,2,1631,692,2323,8,5.5,201802
11,15,367,72,353,427,10,77,0,1306,553,1859,6,6,201802
12,1,292,36,496,334,53,59,13,1283,588,1871,10,4.8,201802
12,2,480,47,404,709,28,98,0,1766,948,2714,10,5.5,201802
12,3,395,75,503,850,81,86,3,1993,1101,3094,11,5.2,201802
12,4,383,36,683,907,84,89,26,2208,1159,3367,9,6,201802
12,5,368,32,444,389,3,62,12,1310,550,1860,10,5.25,201802
12,6,268,19,187,642,59,30,1,1206,424,1630,10,5.25,201802
12,7,456,34,520,693,38,79,36,1856,943,2799,8,4,201802
12,8,362,37,497,643,23,37,0,1599,905,2504,9,5,201802
12,9,392,41,491,743,31,47,20,1765,923,2688,9,5.666666667,201802
13,1,514,54,294,1016,190,103,0,2171,885,3056,9,5.333333333,201802
13,2,429,42,247,583,129,92,0,1522,926,2448,6,5.333333333,201802
13,3,455,40,343,500,158,128,0,1624,787,2411,12,5.25,201802
13,4,485,40,516,474,133,102,10,1760,668,2428,9,5.666666667,201802
13,5,668,51,715,725,205,194,36,2594,1204,3798,9,5.75,201802
13,6,795,98,1297,1105,88,175,11,3569,2001,5570,13,4.75,201802
13,7,465,36,580,688,59,82,2,1912,990,2902,9,5.5,201802
14,1,313,16,189,186,38,65,29,836,518,1354,6,5.5,201802
14,2,340,27,269,246,51,114,0,1047,536,1583,6,5.666666667,201802
14,3,495,29,430,193,16,180,6,1349,600,1949,11,5.4,201802
14,4,438,38,502,637,26,120,22,1783,885,2668,12,6,201802
14,5,369,36,671,365,63,89,16,1609,729,2338,11,5.5,201802
14,6,475,17,759,481,14,97,2,1845,1201,3046,11,6,201802
14,7,180,9,250,111,0,31,0,581,407,988,6,6,201802
14,8,653,61,1250,1018,46,222,3,3253,1459,4712,13,4.333333333,201802
14,9,524,56,582,605,62,108,0,1937,1044,2981,8,6,201802
14,10,404,36,632,446,17,107,0,1642,1046,2688,7,6,201802
14,11,281,12,274,375,43,74,6,1065,547,1612,4,6,201802
14,12,537,32,818,262,9,83,4,1745,597,2342,11,5.5,201802
14,13,420,24,406,330,27,93,0,1300,719,2019,8,6,201802
14,14,416,26,482,497,21,92,23,1557,912,2469,7,7,201802
14,15,478,73,433,484,43,148,25,1684,809,2493,10,5.6,201802
14,16,433,32,424,319,48,71,14,1341,928,2269,5,6,201802
14,17,357,50,291,251,35,103,79,1166,637,1803,9,5.25,201802
14,18,498,42,445,321,70,113,86,1575,834,2409,10,5.4,201802
14,19,379,59,453,461,45,88,49,1534,870,2404,9,5.25,201802
14,20,328,17,446,227,22,57,1,1098,384,1482,10,5.666666667,201802
15,1,368,30,251,169,336,51,0,1205,656,1861,7,5.333333333,201802
15,2,375,22,444,500,59,80,39,1519,948,2467,6,6,201802
15,3,526,32,413,528,111,105,18,1733,1128,2861,10,5.666666667,201802
15,4,370,34,457,592,45,109,29,1636,1051,2687,4,6,201802
15,5,490,35,419,490,18,82,1,1535,887,2422,8,5.666666667,201802
15,6,416,35,548,631,112,119,8,1869,976,2845,7,6.5,201802
15,7,325,22,464,573,75,122,0,1581,1041,2622,10,6,201802
15,8,167,15,245,337,13,42,5,824,483,1307,4,6,201802
15,9,491,23,211,400,170,62,39,1396,766,2162,9,5.75,201802
15,10,338,29,450,482,90,97,1,1487,1060,2547,7,7,201802
15,11,467,26,444,665,82,90,0,1774,1022,2796,8,6,201802
15,12,596,27,887,807,43,99,1,2460,1389,3849,8,6,201802
15,13,222,19,190,261,118,58,0,868,667,1535,8,6,201802
15,14,147,17,163,292,29,53,0,701,469,1170,4,6,201802
15,15,330,69,386,597,37,104,0,1523,981,2504,6,6,201802
15,16,648,42,718,1119,37,144,15,2723,1429,4152,8,6,201802
15,17,322,39,335,568,28,91,35,1418,731,2149,8,6,201802
15,18,533,48,529,644,59,167,10,1990,1309,3299,7,5.666666667,201802
15,19,598,138,828,1261,28,201,2,3056,1466,4522,14,6,201802
15,20,212,29,322,517,27,85,0,1192,821,2013,6,6,201802
15,21,298,18,202,322,30,80,11,961,505,1466,6,5.5,201802
15,22,639,60,879,1263,38,189,4,3072,2102,5174,14,6,201802
15,23,508,39,396,628,62,173,0,1806,1169,2975,7,5.333333333,201802
15,24,329,36,428,520,39,66,5,1423,775,2198,4,6,201802
15,25,377,41,408,408,16,69,1,1320,832,2152,6,6,201802
15,26,239,8,364,274,52,70,2,1009,620,1629,11,2.666666667,201802
15,27,500,36,599,812,14,183,14,2158,1081,3239,9,5.666666667,201802
15,28,546,28,820,581,78,125,1,2179,1249,3428,9,5.666666667,201802
15,29,563,50,569,1011,15,149,0,2357,1576,3933,8,6,201802
15,30,657,61,777,716,76,115,16,2418,937,3355,10,9.5,201802
15,31,368,61,329,567,21,96,0,1442,849,2291,6,6,201802
15,32,409,30,566,717,80,111,0,1913,932,2845,9,6,201802
15,33,455,28,479,666,48,93,0,1769,959,2728,7,6,201802
15,34,358,29,403,675,18,132,0,1615,908,2523,8,6,201802
15,35,551,38,396,637,30,145,0,1797,1026,2823,9,5.666666667,201802
15,36,586,46,578,583,154,89,1,2037,991,3028,9,5.5,201802
15,37,474,53,520,710,120,148,28,2053,1304,3357,7,6,201802
15,38,514,48,486,679,20,110,0,1857,787,2644,6,5.5,201802
15,39,364,47,428,505,47,87,27,1505,987,2492,4,6,201802
15,40,724,50,614,851,250,221,19,2729,1022,3751,9,6,201802
15,41,662,42,1058,897,84,129,57,2929,1639,4568,11,6,201802
16,1,216,22,355,311,11,69,0,984,657,1641,10,5.333333333,201802
16,2,224,57,228,287,28,59,0,883,539,1422,9,5.25,201802
16,3,466,52,350,597,64,68,0,1597,828,2425,10,5.25,201802
16,4,402,30,350,318,59,102,0,1261,735,1996,8,5.5,201802
16,5,382,61,379,386,67,134,27,1436,888,2324,10,5.666666667,201802
16,6,347,54,336,454,96,79,1,1367,749,2116,12,5.5,201802
16,7,344,35,283,310,76,78,0,1126,734,1860,9,5.5,201802
16,8,513,61,884,720,30,146,8,2362,1464,3826,12,6,201802
16,9,404,38,376,423,20,112,0,1373,733,2106,10,6,201802
16,10,370,44,639,629,16,112,3,1813,888,2701,8,4.666666667,201802
16,11,444,34,394,278,180,111,3,1444,862,2306,12,5.4,201802
16,12,303,37,326,273,37,69,0,1045,574,1619,10,5.25,201802
17,1,449,63,677,779,34,128,0,2130,901,3031,12,4.5,201802
17,2,331,21,555,609,36,74,35,1661,975,2636,9,6.333333333,201802
17,3,510,43,653,743,32,98,0,2079,841,2920,8,6,201802
17,4,518,33,620,675,33,100,1,1980,1250,3230,10,6.333333333,201802
17,5,215,20,239,290,34,46,0,844,619,1463,5,6,201802
18,1,371,48,297,391,44,83,0,1234,687,1921,9,5.4,201802
18,2,439,54,748,643,105,111,1,2101,1311,3412,10,5.5,201802
18,3,390,33,593,404,18,76,0,1514,807,2321,9,5.75,201802
19,1,490,31,644,628,37,185,37,2052,817,2869,9,6,201802
19,2,598,33,1074,524,115,124,0,2468,1152,3620,10,6.5,201802
19,3,599,23,936,633,37,112,2,2342,921,3263,8,6,201802
19,4,286,29,347,257,50,72,113,1154,536,1690,5,6,201802
19,5,754,61,854,1068,54,189,86,3066,1368,4434,7,7,201802
19,6,192,10,407,437,8,67,4,1125,630,1755,5,6,201802
19,7,529,14,882,449,13,58,0,1945,778,2723,10,5.5,201802
19,8,171,10,235,199,4,36,0,655,201,856,7,6,201802
19,9,381,37,453,468,75,111,0,1525,931,2456,9,5.25,201802
19,10,316,19,418,546,13,135,0,1447,657,2104,8,2.666666667,201802
19,11,947,95,1123,1537,47,290,17,4056,1966,6022,13,6.333333333,201802
19,12,409,19,830,431,23,100,14,1826,620,2446,8,6,201802
20,1,497,30,455,564,112,98,0,1756,917,2673,7,5.5,201802
20,2,297,35,276,361,31,40,0,1040,594,1634,6,5.333333333,201802
20,3,307,20,341,432,145,60,0,1305,586,1891,6,5.333333333,201802
20,4,197,28,206,427,130,70,1,1059,470,1529,6,5.333333333,201802
20,5,365,30,322,519,51,55,3,1345,844,2189,11,5.25,201802
20,6,282,8,296,475,293,64,0,1418,904,2322,8,5.25,201802
20,7,358,31,407,595,15,56,0,1462,990,2452,8,5.5,201802
20,8,934,61,965,1552,70,238,122,3942,2331,6273,15,5,201802
20,9,447,34,329,401,123,90,64,1488,986,2474,8,5.666666667,201802
20,10,433,32,337,724,46,62,0,1634,1138,2772,9,5.25,201802
21,1,495,34,453,796,24,67,0,1869,826,2695,9,5.4,201802
21,2,556,60,381,392,147,88,0,1624,841,2465,9,5.2,201802
21,3,556,36,510,352,122,131,34,1741,674,2415,8,5.5,201802
21,4,298,16,250,174,163,128,41,1070,561,1631,6,5.25,201802
21,5,572,39,599,529,50,144,11,1944,996,2940,8,5.666666667,201802
21,6,424,45,583,752,59,146,119,2128,1289,3417,6,7,201802
21,7,625,13,356,510,91,110,1,1706,681,2387,9,5.666666667,201802
21,8,414,27,428,393,74,101,5,1442,739,2181,10,5.2,201802
21,9,507,42,787,695,127,154,103,2415,1431,3846,9,6,201802
21,10,366,11,470,483,21,78,56,1485,1093,2578,7,6,201802
21,11,144,6,284,211,44,42,4,735,236,971,6,4.5,201802
21,12,727,50,1350,1350,99,241,107,3924,2361,6285,14,4.333333333,201802
21,13,447,19,340,409,55,64,0,1334,708,2042,8,5.666666667,201802
21,14,595,22,486,436,108,109,7,1763,967,2730,13,5.333333333,201802
21,15,577,25,630,489,57,132,3,1913,1034,2947,7,5.5,201802
22,1,506,79,495,699,109,64,0,1952,1049,3001,11,5.2,201802
22,2,424,55,629,425,68,79,23,1703,872,2575,7,5.5,201802
22,3,645,82,1394,1008,48,150,20,3347,1784,5131,10,6,201802
22,4,501,72,1070,872,64,155,2,2736,1368,4104,13,4,201802
22,5,404,51,837,487,61,110,12,1962,722,2684,10,5.5,201802
23,1,371,15,1674,567,57,69,0,2753,1244,3997,14,5.6,201802
23,2,376,33,769,667,37,92,0,1974,1362,3336,10,4.2,201802
23,3,543,9,1372,665,57,64,1,2711,1348,4059,11,6,201802
23,4,332,10,1098,508,73,79,0,2100,1115,3215,10,5,201802
24,1,368,85,377,649,91,50,9,1629,770,2399,11,5.2,201802
24,2,306,34,361,319,30,68,0,1118,566,1684,6,5.5,201802
24,3,369,90,458,779,191,72,1,1960,1100,3060,9,5.25,201802
24,4,274,63,372,266,83,87,176,1321,838,2159,5,5.5,201802
24,5,564,55,828,932,18,183,0,2580,1242,3822,10,5,201802
24,6,739,98,937,1010,37,177,0,2998,1351,4349,11,4.333333333,201802
24,7,503,54,685,955,151,66,0,2414,1165,3579,9,5.25,201802
25,1,297,35,402,521,26,71,5,1357,642,1999,14,5.75,201802
25,2,415,44,643,628,29,131,0,1890,1036,2926,7,5.5,201802
25,3,331,19,458,697,97,67,8,1677,821,2498,9,5.6,201802
25,4,336,42,337,591,28,63,45,1442,674,2116,8,5.333333333,201802
25,5,397,32,660,827,45,163,1,2125,1179,3304,9,4.5,201802
25,6,456,32,711,511,90,111,8,1919,839,2758,9,5.75,201802
25,7,385,31,668,707,10,150,0,1951,934,2885,7,6,201802
26,1,358,35,507,462,12,118,0,1492,715,2207,9,5.5,201802
26,2,464,28,809,803,8,140,0,2252,801,3053,13,5.4,201802
26,3,520,34,954,1108,48,285,2,2951,1618,4569,15,4.666666667,201802
26,4,299,21,393,501,38,132,9,1393,641,2034,10,5.2,201802
26,5,119,6,175,196,20,64,0,580,291,871,3,5.5,201802
26,6,330,25,637,745,13,125,0,1875,843,2718,10,5.333333333,201802
26,7,286,25,320,551,27,86,0,1295,722,2017,10,5.5,201802
27,1,392,35,401,840,56,75,0,1799,715,2514,9,5.5,201802
27,2,497,36,398,969,26,65,0,1991,780,2771,8,5.666666667,201802
27,3,515,28,354,925,28,75,0,1925,844,2769,7,5.666666667,201802
27,4,409,30,604,1191,19,77,8,2338,1385,3723,10,3.75,201802
27,5,349,13,301,702,14,48,1,1428,645,2073,6,5.333333333,201802
27,6,405,41,552,997,7,95,0,2097,1007,3104,9,5.333333333,201802
28,1,510,39,911,761,40,90,0,2351,866,3217,13,6,201802
28,2,514,44,926,554,66,106,273,2483,1108,3591,14,6,201802
28,3,347,28,393,385,20,84,0,1257,433,1690,7,5.333333333,201802
28,4,725,62,934,825,128,184,170,3028,1051,4079,16,6,201802
28,5,415,52,608,769,49,120,0,2013,864,2877,12,3.833333333,201802
28,6,365,55,543,1018,240,85,71,2377,1006,3383,14,5.166666667,201802
28,7,502,51,905,858,128,141,0,2585,1077,3662,8,6,201802
28,8,326,47,470,554,70,98,13,1578,758,2336,11,5.666666667,201802
28,9,351,21,583,321,33,65,160,1534,537,2071,9,6,201802
29,1,558,91,596,609,140,89,3,2086,1098,3184,10,5.5,201802
29,2,718,57,516,1013,79,151,101,2635,1040,3675,15,4.333333333,201802
29,3,382,62,288,564,47,102,0,1445,596,2041,7,5.666666667,201802
30,1,270,30,238,361,52,59,115,1125,655,1780,7,5.333333333,201802
30,2,376,35,228,181,94,57,650,1621,797,2418,8,5.25,201802
30,3,387,26,426,313,211,79,159,1601,736,2337,6,5.666666667,201802
30,4,280,22,576,362,64,113,5,1422,562,1984,8,6,201802
30,5,335,37,368,659,13,98,0,1510,381,1891,7,5.5,201802
30,6,357,24,360,414,47,63,0,1265,497,1762,9,5.333333333,201802
30,7,631,44,545,537,141,131,75,2104,1034,3138,12,5.25,201802
30,8,438,32,642,592,105,123,1,1933,1051,2984,11,5.4,201802
30,9,376,23,359,271,103,125,168,1425,813,2238,8,5.5,201802
30,10,422,30,714,586,47,143,67,2009,1153,3162,9,4.666666667,201802
30,11,330,19,681,700,31,134,0,1895,950,2845,6,5.5,201802
30,12,495,37,1004,1008,48,215,0,2807,1481,4288,11,6.25,201802
30,13,436,26,293,629,108,78,23,1593,758,2351,10,5.4,201802
30,14,379,38,571,484,167,104,0,1743,842,2585,9,5.5,201802
30,15,416,21,388,329,87,133,167,1541,780,2321,11,5.666666667,201802
30,16,417,24,486,618,112,155,132,1944,1039,2983,10,5.333333333,201802
30,17,330,32,286,482,45,81,18,1274,829,2103,8,5.5,201802
30,18,373,28,252,451,26,92,59,1281,742,2023,8,5.25,201802
30,19,375,25,523,551,132,90,4,1700,591,2291,13,5.6,201802
30,20,371,36,423,558,177,108,0,1673,931,2604,11,5.4,201802
31,1,491,39,421,698,28,78,0,1755,818,2573,8,5.5,201802
31,2,233,19,248,63,347,53,0,963,530,1493,7,5.333333333,201802
31,3,783,129,1559,1174,174,250,0,4069,1914,5983,20,4.75,201802
31,4,197,18,561,498,65,108,0,1447,750,2197,6,4,201802
31,5,378,54,238,537,31,68,0,1306,448,1754,7,5.333333333,201802
32,1,437,76,396,401,68,91,68,1537,624,2161,12,5.2,201802
32,2,457,102,418,501,166,90,25,1759,906,2665,13,5.142857143,201802
32,3,409,89,462,526,44,83,5,1618,625,2243,15,4.666666667,201802
32,4,450,100,538,494,75,121,72,1850,884,2734,12,4.5,201802
1,1,399,65,515,532,143,76,8,1738,1243,2981,13,5.5,201803
1,2,525,90,1075,679,180,181,39,2769,2361,5130,12,5,201803
1,3,406,106,1155,704,86,190,3,2650,2338,4988,13,5,201803
2,1,447,33,737,896,38,156,1,2308,1800,4108,11,6,201803
2,2,456,39,613,854,19,187,0,2168,1814,3982,9,4.333333333,201803
2,3,456,36,726,621,34,133,0,2006,1458,3464,11,4.4,201803
2,4,341,29,679,310,34,75,1,1469,815,2284,13,6,201803
2,5,737,59,1431,874,208,240,14,3563,2758,6321,14,6.666666667,201803
2,6,416,18,667,529,49,130,0,1809,1582,3391,7,6,201803
2,7,562,41,857,737,51,164,15,2427,1527,3954,12,5.75,201803
2,8,417,28,810,598,34,113,1,2001,1784,3785,8,6,201803
3,1,266,28,585,526,33,126,6,1570,1143,2713,15,5,201803
3,2,263,9,762,323,19,51,0,1427,1196,2623,9,6,201803
4,1,483,27,714,890,105,117,1,2337,1715,4052,13,4.5,201803
4,2,350,41,781,774,41,101,0,2088,1350,3438,14,5.4,201803
5,1,391,39,681,631,77,163,0,1982,1363,3345,9,6,201803
5,2,358,34,607,704,45,99,19,1866,1267,3133,10,6,201803
5,3,274,39,427,605,59,141,28,1573,1310,2883,9,6,201803
5,4,341,41,832,637,18,211,23,2103,2258,4361,11,4.75,201803
5,5,389,36,666,740,46,99,85,2061,1715,3776,8,6,201803
5,6,354,34,676,566,35,82,104,1851,1059,2910,7,5.5,201803
5,7,280,23,402,409,13,62,6,1195,1161,2356,10,3.666666667,201803
6,1,350,41,689,441,15,118,11,1665,1348,3013,15,4.571428571,201803
6,2,306,27,478,262,101,78,11,1263,1004,2267,9,5.666666667,201803
7,1,529,28,440,946,26,73,34,2076,1560,3636,9,5.25,201803
7,2,683,41,450,2678,112,139,1,4104,1189,5293,9,5.25,201803
7,3,520,13,417,472,308,76,0,1806,900,2706,7,5.333333333,201803
7,4,378,43,356,862,25,100,177,1941,1233,3174,11,5.4,201803
7,5,629,24,352,1243,54,97,66,2465,1723,4188,11,5.666666667,201803
7,6,436,28,561,708,63,118,19,1933,1409,3342,8,4.25,201803
7,7,357,43,413,1071,65,79,0,2028,2029,4057,8,5.5,201803
7,8,453,30,458,1454,47,93,0,2535,2089,4624,12,5.25,201803
7,9,409,52,758,1135,62,109,18,2543,2083,4626,11,4.75,201803
7,10,405,17,630,1029,307,70,0,2458,1809,4267,9,5.5,201803
7,11,353,20,117,447,81,35,0,1053,886,1939,6,5.333333333,201803
7,12,505,25,607,1360,8,80,0,2585,2272,4857,9,5.5,201803
7,13,281,22,485,802,4,39,0,1633,1195,2828,9,5.25,201803
8,1,298,12,557,316,26,56,0,1265,1164,2429,4,6,201803
8,2,477,40,902,570,44,136,20,2189,1925,4114,17,5.5,201803
8,3,413,58,684,607,30,134,19,1945,1868,3813,5,6,201803
8,4,373,35,754,562,44,192,16,1976,1900,3876,9,6,201803
8,5,474,47,638,530,64,131,0,1884,766,2650,10,5.25,201803
8,6,334,55,842,710,86,217,10,2254,2064,4318,7,4,201803
8,7,363,36,421,460,12,118,0,1410,1016,2426,8,5.25,201803
8,8,275,69,732,677,15,172,11,1951,2017,3968,12,4,201803
8,9,300,39,339,318,40,115,10,1161,765,1926,10,4.8,201803
9,1,299,22,294,282,114,61,1,1073,834,1907,6,7,201803
9,2,839,228,1140,1637,125,275,15,4259,2394,6653,12,6,201803
9,3,416,77,706,737,105,161,48,2250,1724,3974,7,6,201803
9,4,538,46,700,911,93,156,17,2461,2036,4497,11,6,201803
9,5,378,26,539,551,92,144,0,1730,1352,3082,7,6,201803
9,6,288,53,334,323,76,103,15,1192,686,1878,7,6,201803
9,7,261,25,508,617,8,95,0,1514,1254,2768,9,6,201803
9,8,200,27,573,435,23,127,35,1420,721,2141,6,7,201803
9,9,349,16,411,471,67,85,8,1407,1125,2532,5,6,201803
9,10,277,38,644,581,40,153,0,1733,1391,3124,6,6,201803
9,11,481,49,917,848,110,189,17,2611,917,3528,7,6,201803
9,12,333,84,1042,992,50,229,32,2762,1944,4706,11,6,201803
9,13,319,44,561,564,107,118,68,1781,1387,3168,4,6,201803
9,14,240,15,282,317,95,98,0,1047,995,2042,5,6,201803
9,15,545,65,1699,1455,38,411,7,4220,3265,7485,11,3.75,201803
9,16,654,116,920,1117,150,241,9,3207,2576,5783,15,7,201803
9,17,297,24,412,413,23,129,0,1298,1032,2330,6,6,201803
9,18,428,64,650,846,91,188,9,2276,1988,4264,12,6,201803
9,19,470,69,484,654,146,108,4,1935,1771,3706,5,6,201803
9,20,109,21,187,175,22,29,6,549,317,866,5,6,201803
9,21,331,22,318,404,124,95,60,1354,978,2332,3,6,201803
9,22,368,18,407,422,165,96,49,1525,1340,2865,5,6,201803
9,23,382,33,703,799,113,149,8,2187,1743,3930,7,7,201803
9,24,702,59,907,1035,177,258,131,3269,2647,5916,13,6.5,201803
10,1,282,54,436,411,39,74,75,1371,1123,2494,12,4.666666667,201803
10,2,403,64,469,594,49,108,29,1716,1342,3058,8,4.25,201803
10,3,378,70,337,528,41,97,75,1526,925,2451,12,5.4,201803
10,4,461,97,829,842,22,135,7,2393,1940,4333,17,4,201803
11,1,543,103,364,469,62,68,33,1642,1045,2687,6,5.666666667,201803
11,2,435,61,393,524,47,102,33,1595,1278,2873,7,6,201803
11,3,299,30,332,406,20,84,20,1191,1116,2307,4,6,201803
11,4,588,89,465,554,12,76,0,1784,1078,2862,10,3.8,201803
11,5,615,118,569,671,45,137,7,2162,1881,4043,8,6.5,201803
11,6,429,47,524,373,71,100,23,1567,1298,2865,8,5.666666667,201803
11,7,545,44,597,786,67,100,0,2139,1506,3645,9,5.5,201803
11,8,555,64,451,671,76,78,0,1895,1503,3398,9,5.75,201803
11,9,667,120,580,607,37,124,24,2159,1689,3848,10,5.666666667,201803
11,10,516,90,451,623,47,105,83,1915,1662,3577,11,5.6,201803
11,11,366,85,356,399,25,62,0,1293,924,2217,4,6,201803
11,12,545,61,685,673,26,106,0,2096,1361,3457,7,6.5,201803
11,13,489,65,376,335,84,72,112,1533,1037,2570,9,5.5,201803
11,14,504,87,463,544,53,96,1,1748,1067,2815,8,5.5,201803
11,15,404,97,344,412,8,83,0,1348,946,2294,6,6,201803
12,1,340,37,488,250,141,48,4,1308,927,2235,10,5,201803
12,2,406,44,478,627,38,87,0,1680,1492,3172,10,5.5,201803
12,3,426,59,492,637,38,82,1,1735,1164,2899,11,5.2,201803
12,4,450,51,760,907,72,101,14,2355,1760,4115,9,6,201803
12,5,398,40,482,387,1,51,10,1369,988,2357,10,5.25,201803
12,6,285,28,284,525,85,25,18,1250,1045,2295,10,5.25,201803
12,7,523,40,600,664,19,85,27,1958,1348,3306,8,4,201803
12,8,475,38,739,588,17,56,0,1913,1162,3075,9,5.25,201803
12,9,345,29,479,703,40,60,11,1667,1227,2894,9,5.666666667,201803
13,1,374,49,314,949,208,76,0,1970,1620,3590,9,5.333333333,201803
13,2,346,45,278,498,150,115,0,1432,737,2169,6,5.333333333,201803
13,3,379,36,297,366,205,105,0,1388,953,2341,12,5.25,201803
13,4,487,32,490,501,93,106,13,1722,1396,3118,9,5.666666667,201803
13,5,694,66,724,716,247,201,72,2720,1902,4622,9,5.75,201803
13,6,819,114,1364,1114,84,214,12,3721,2984,6705,13,4.75,201803
13,7,429,49,720,721,63,105,1,2088,1415,3503,9,5.5,201803
14,1,361,34,234,144,28,77,34,912,641,1553,6,5.5,201803
14,2,420,22,323,206,33,92,1,1097,842,1939,6,5.666666667,201803
14,3,436,23,347,235,14,117,12,1184,929,2113,11,5.4,201803
14,4,436,32,614,674,30,125,21,1932,1457,3389,12,6,201803
14,5,359,39,796,415,67,95,8,1779,1272,3051,11,5.5,201803
14,6,432,25,812,468,11,108,1,1857,1700,3557,11,6,201803
14,7,246,13,298,129,0,34,0,720,415,1135,6,6,201803
14,8,610,52,1357,1049,22,273,4,3367,2596,5963,13,4.333333333,201803
14,9,488,59,621,613,67,121,0,1969,1729,3698,8,6,201803
14,10,378,60,637,443,24,162,3,1707,1390,3097,7,6,201803
14,11,246,14,317,364,39,95,15,1090,845,1935,4,6,201803
14,12,563,32,895,266,18,103,0,1877,1461,3338,11,5.5,201803
14,13,448,28,479,297,22,75,0,1349,1035,2384,8,6,201803
14,14,302,28,480,449,28,120,16,1423,1293,2716,7,7,201803
14,15,534,86,462,484,34,124,26,1750,1131,2881,10,5.6,201803
14,16,399,29,466,351,36,117,10,1408,1208,2616,5,6,201803
14,17,312,46,267,205,39,90,63,1022,728,1750,9,5.25,201803
14,18,452,71,507,368,63,107,77,1645,889,2534,10,5.2,201803
14,19,484,71,561,507,69,93,42,1827,1337,3164,9,5.25,201803
14,20,336,36,511,222,19,63,6,1193,751,1944,10,5.666666667,201803
15,1,611,29,345,195,450,84,0,1714,1076,2790,7,5.333333333,201803
15,2,391,27,465,448,53,96,27,1507,1377,2884,6,6,201803
15,3,651,27,472,493,106,117,19,1885,1193,3078,10,5.666666667,201803
15,4,467,28,506,517,49,126,38,1731,1452,3183,4,6,201803
15,5,607,53,480,552,22,100,0,1814,1243,3057,8,5.666666667,201803
15,6,392,28,584,626,113,141,4,1888,1688,3576,7,6.5,201803
15,7,344,31,490,558,62,111,0,1596,1554,3150,10,6,201803
15,8,179,14,225,313,23,45,11,810,741,1551,4,6,201803
15,9,566,25,250,442,179,72,31,1565,1017,2582,9,5.75,201803
15,10,354,22,463,500,83,84,0,1506,1451,2957,9,7,201803
15,11,491,31,537,648,89,135,0,1931,1616,3547,8,6,201803
15,12,648,31,1055,891,44,138,0,2807,2084,4891,8,6,201803
15,13,208,17,226,292,85,57,1,886,828,1714,8,6,201803
15,14,165,15,177,225,28,56,0,666,612,1278,4,6,201803
15,15,325,105,421,529,31,113,0,1524,1356,2880,6,6,201803
15,16,768,63,927,1196,48,201,12,3215,2166,5381,8,6,201803
15,17,358,39,410,551,17,91,61,1527,863,2390,8,6,201803
15,18,557,42,583,603,43,196,6,2030,1477,3507,7,5.666666667,201803
15,19,563,108,945,1233,20,211,2,3082,2500,5582,14,6,201803
15,20,230,25,411,496,31,74,0,1267,989,2256,6,6,201803
15,21,288,25,213,322,16,91,17,972,620,1592,6,5.5,201803
15,22,692,105,965,1201,44,252,6,3265,2670,5935,14,6,201803
15,23,502,33,452,594,52,163,0,1796,1285,3081,7,5.333333333,201803
15,24,380,41,395,463,52,100,8,1439,1175,2614,4,6,201803
15,25,423,26,423,412,24,75,0,1383,1155,2538,6,6,201803
15,26,403,14,369,364,51,119,0,1320,880,2200,10,2.666666667,201803
15,27,613,40,632,804,14,208,42,2353,1655,4008,9,5.666666667,201803
15,28,611,36,810,578,62,174,1,2272,1844,4116,9,5.666666667,201803
15,29,705,64,641,988,15,187,0,2600,2092,4692,8,6,201803
15,30,692,58,869,749,90,144,18,2620,1636,4256,12,7.5,201803
15,31,418,90,347,541,28,89,0,1513,1301,2814,6,6,201803
15,32,478,33,704,664,65,103,7,2054,1489,3543,9,6,201803
15,33,516,25,596,670,52,116,0,1975,1414,3389,7,6,201803
15,34,409,24,456,618,23,124,1,1655,1332,2987,8,6,201803
15,35,643,45,429,618,23,177,0,1935,1364,3299,9,5.666666667,201803
15,36,658,54,656,687,305,103,0,2463,1260,3723,9,5.5,201803
15,37,523,45,553,656,115,173,34,2099,1434,3533,7,6,201803
15,38,483,56,507,583,13,103,0,1745,1441,3186,6,5.5,201803
15,39,422,42,504,484,34,82,15,1583,1274,2857,4,6,201803
15,40,919,65,736,824,243,279,21,3087,2200,5287,9,6,201803
15,41,749,70,1177,1036,114,137,56,3339,2515,5854,11,6,201803
16,1,307,49,444,352,10,86,0,1248,949,2197,10,5.333333333,201803
16,2,253,40,254,372,26,56,0,1001,741,1742,9,5.25,201803
16,3,464,50,339,552,78,89,0,1572,961,2533,10,5.25,201803
16,4,381,51,433,313,45,122,0,1345,893,2238,8,5.5,201803
16,5,370,67,315,376,57,128,31,1344,972,2316,10,5.666666667,201803
16,6,379,59,308,427,142,91,0,1406,858,2264,12,5.5,201803
16,7,399,63,324,355,90,109,0,1340,932,2272,9,5.5,201803
16,8,482,52,956,730,33,161,13,2427,2018,4445,12,6,201803
16,9,473,37,432,436,28,146,0,1552,951,2503,10,6,201803
16,10,390,38,788,651,24,138,4,2033,1396,3429,8,4.666666667,201803
16,11,387,56,398,275,225,115,7,1463,1034,2497,12,5.4,201803
16,12,389,69,463,310,91,91,9,1422,814,2236,10,5.25,201803
17,1,394,61,731,663,50,146,0,2045,1426,3471,11,4,201803
17,2,374,18,575,553,22,105,37,1684,1137,2821,9,6.333333333,201803
17,3,665,56,700,747,30,107,0,2305,2022,4327,8,6,201803
17,4,506,40,756,784,31,113,1,2231,1544,3775,10,6.333333333,201803
17,5,222,20,247,316,21,54,2,882,599,1481,5,6,201803
18,1,363,40,305,371,64,69,0,1212,725,1937,9,5.4,201803
18,2,435,53,828,677,116,125,0,2234,1816,4050,10,5.5,201803
18,3,325,34,591,446,25,62,0,1483,853,2336,9,5.75,201803
19,1,344,32,548,555,23,174,23,1699,1268,2967,9,7,201803
19,2,540,20,1057,449,120,151,1,2338,1824,4162,10,7,201803
19,3,517,30,888,540,50,141,0,2166,1528,3694,8,6,201803
19,4,231,14,296,239,43,67,80,970,768,1738,5,6,201803
19,5,605,27,709,809,36,152,48,2386,2029,4415,7,7,201803
19,6,160,11,352,366,17,98,3,1007,744,1751,5,7,201803
19,7,358,27,769,341,9,88,1,1593,1078,2671,10,5.5,201803
19,8,123,7,209,167,3,28,0,537,98,635,7,6,201803
19,9,398,42,514,528,77,93,4,1656,942,2598,9,5.25,201803
19,10,450,18,413,444,16,115,0,1456,973,2429,7,3,201803
19,11,793,91,1057,1220,28,265,11,3465,3034,6499,13,6.333333333,201803
19,12,338,15,764,324,23,92,16,1572,1013,2585,8,6,201803
20,1,388,30,400,451,101,90,0,1460,1074,2534,7,5.5,201803
20,2,309,33,223,442,65,45,0,1117,740,1857,6,5.333333333,201803
20,3,207,22,309,452,143,60,0,1193,925,2118,6,5.333333333,201803
20,4,208,24,173,332,100,73,1,911,615,1526,6,5.333333333,201803
20,5,338,27,326,531,40,67,0,1329,1295,2624,11,5.25,201803
20,6,357,22,337,664,313,51,4,1748,1167,2915,8,5.25,201803
20,7,442,35,417,614,25,67,0,1600,1242,2842,8,5.75,201803
20,8,1038,83,1075,1469,51,245,182,4143,3278,7421,15,4.666666667,201803
20,9,481,37,353,415,150,81,75,1592,1050,2642,8,5.666666667,201803
20,10,325,23,262,504,21,67,0,1202,1011,2213,9,5.25,201803
21,1,603,32,461,816,25,97,0,2034,1498,3532,9,5.4,201803
21,2,415,16,329,277,94,58,0,1189,872,2061,9,5.2,201803
21,3,659,29,601,308,157,116,39,1909,1088,2997,8,5.5,201803
21,4,355,9,296,136,131,83,64,1074,1133,2207,6,5.25,201803
21,5,606,27,655,544,63,174,47,2116,1559,3675,8,5.666666667,201803
21,6,573,38,561,704,72,150,133,2231,1749,3980,6,7,201803
21,7,673,13,460,454,81,124,0,1805,1363,3168,9,5.666666667,201803
21,8,509,14,535,456,65,109,12,1700,1120,2820,10,5.2,201803
21,9,550,50,805,698,99,165,125,2492,1950,4442,9,6,201803
21,10,482,25,497,503,65,108,39,1719,1354,3073,7,6,201803
21,11,167,7,338,207,30,49,9,807,457,1264,6,4,201803
21,12,874,42,1473,1418,133,278,88,4306,3279,7585,15,4.666666667,201803
21,13,526,14,382,426,47,108,0,1503,1015,2518,8,5.666666667,201803
21,14,671,40,544,477,121,98,2,1953,1153,3106,13,5.333333333,201803
21,15,690,24,676,462,72,123,0,2047,1626,3673,7,5.5,201803
22,1,480,121,486,775,121,79,0,2062,1154,3216,11,6,201803
22,2,388,55,624,549,92,96,25,1829,1660,3489,7,5.5,201803
22,3,589,92,1427,971,61,188,39,3367,2934,6301,10,6,201803
22,4,489,73,1185,781,60,152,1,2741,2140,4881,13,4,201803
22,5,318,58,1019,438,78,98,14,2023,1497,3520,10,5.5,201803
23,1,444,12,1722,556,66,99,0,2899,2481,5380,14,5.6,201803
23,2,352,32,724,702,50,74,0,1934,1430,3364,10,4.2,201803
23,3,481,17,1288,641,55,61,2,2545,2152,4697,11,6,201803
23,4,391,18,1390,608,76,84,1,2568,1833,4401,10,4.75,201803
24,1,312,95,350,728,70,56,7,1618,1321,2939,11,5.2,201803
24,2,252,44,261,282,31,61,0,931,724,1655,6,5.5,201803
24,3,505,113,562,1032,222,95,0,2529,1745,4274,9,5.25,201803
24,4,391,52,378,317,108,92,209,1547,1110,2657,5,5.5,201803
24,5,488,38,894,860,26,190,0,2496,1935,4431,10,5,201803
24,6,613,75,879,910,55,176,0,2708,2572,5280,11,4.333333333,201803
24,7,480,64,558,1150,237,81,0,2570,1696,4266,9,5.25,201803
25,1,348,32,486,481,34,102,16,1499,1004,2503,14,5.75,201803
25,2,462,62,625,679,26,161,0,2015,1463,3478,7,5.5,201803
25,3,421,35,546,721,79,90,14,1906,1309,3215,9,5.6,201803
25,4,404,34,355,647,19,98,16,1573,921,2494,8,5.333333333,201803
25,5,462,30,765,887,44,166,0,2354,1622,3976,11,4.75,201803
25,6,449,31,761,545,119,155,2,2062,1466,3528,9,5.75,201803
25,7,467,50,691,809,16,170,0,2203,1494,3697,7,6,201803
26,1,396,20,545,545,46,116,0,1668,1160,2828,9,5.5,201803
26,2,429,18,918,727,6,177,0,2275,1534,3809,13,5.4,201803
26,3,526,43,1073,998,40,327,21,3028,2425,5453,15,4.666666667,201803
26,4,286,37,404,478,44,135,0,1384,778,2162,10,5.2,201803
26,5,196,25,250,237,17,74,0,799,573,1372,3,5.5,201803
26,6,277,30,674,642,24,141,0,1788,1368,3156,10,5.333333333,201803
26,7,266,38,357,543,40,101,2,1347,828,2175,10,5.5,201803
27,1,403,42,405,934,62,70,0,1916,1406,3322,9,5.5,201803
27,2,441,29,376,1033,27,67,0,1973,1440,3413,8,5.666666667,201803
27,3,546,45,410,1061,16,68,1,2147,1429,3576,7,5.666666667,201803
27,4,477,36,592,1261,30,103,6,2505,1987,4492,10,3.5,201803
27,5,324,12,240,744,30,66,1,1417,1185,2602,6,5.333333333,201803
27,6,484,62,732,933,59,90,0,2360,1574,3934,9,5.333333333,201803
28,1,327,44,748,632,24,112,0,1887,1533,3420,13,6,201803
28,2,395,30,914,503,47,112,267,2268,1663,3931,14,6,201803
28,3,233,19,292,272,11,50,0,877,603,1480,7,5.333333333,201803
28,4,472,40,719,625,59,137,104,2156,1817,3973,16,6,201803
28,5,339,60,541,692,44,111,0,1787,1542,3329,13,4,201803
28,6,345,78,482,996,225,83,82,2291,1433,3724,14,5.166666667,201803
28,7,367,52,875,706,99,133,0,2232,2029,4261,8,6,201803
28,8,243,23,387,431,84,100,20,1288,1125,2413,11,5.666666667,201803
28,9,240,11,480,241,28,46,122,1168,919,2087,9,6,201803
29,1,569,71,551,574,130,77,3,1975,1636,3611,10,5.5,201803
29,2,646,56,535,917,60,172,81,2467,2196,4663,15,4.333333333,201803
29,3,357,55,286,557,48,86,0,1389,1131,2520,7,5.666666667,201803
30,1,280,30,260,357,32,74,86,1119,580,1699,7,5.333333333,201803
30,2,474,50,266,185,105,62,526,1668,792,2460,8,5.25,201803
30,3,451,29,468,339,224,110,115,1736,1247,2983,6,5.666666667,201803
30,4,339,22,602,370,58,115,7,1513,1066,2579,8,6,201803
30,5,298,36,371,578,31,114,0,1428,1293,2721,7,5.5,201803
30,6,371,24,386,409,35,78,1,1304,718,2022,9,5.333333333,201803
30,7,360,33,399,364,171,103,38,1468,1410,2878,12,5.25,201803
30,8,512,36,677,519,108,151,9,2012,1449,3461,11,5.2,201803
30,9,477,29,355,237,95,120,159,1472,1139,2611,8,5.5,201803
30,10,439,49,812,613,73,173,64,2223,1537,3760,9,4.666666667,201803
30,11,402,31,587,642,25,116,0,1803,1391,3194,6,5.5,201803
30,12,549,45,1130,1089,54,269,1,3137,2299,5436,11,6.25,201803
30,13,550,23,378,693,151,107,19,1921,1021,2942,10,5.4,201803
30,14,437,59,564,524,238,147,1,1970,1157,3127,9,5.5,201803
30,15,534,22,354,382,67,133,137,1629,1231,2860,11,5.666666667,201803
30,16,458,27,470,693,122,163,135,2068,1430,3498,10,5.333333333,201803
30,17,339,42,302,398,83,90,47,1301,814,2115,8,5.5,201803
30,18,408,25,268,440,20,101,47,1309,764,2073,8,5.25,201803
30,19,399,26,467,518,84,81,1,1576,1025,2601,13,5.6,201803
30,20,451,40,396,670,181,132,1,1871,1137,3008,11,5.4,201803
31,1,411,42,460,717,21,77,0,1728,1419,3147,8,5.5,201803
31,2,302,35,330,96,380,83,0,1226,713,1939,7,5.333333333,201803
31,3,974,123,1628,1192,202,276,0,4395,3170,7565,20,4.75,201803
31,4,227,18,584,531,78,105,0,1543,1253,2796,6,4,201803
31,5,448,37,285,426,16,70,0,1282,827,2109,7,5.333333333,201803
32,1,372,86,336,386,61,100,42,1383,861,2244,12,5.2,201803
32,2,287,90,259,311,85,79,39,1150,879,2029,13,5.142857143,201803
32,3,383,130,458,521,42,97,27,1658,1148,2806,15,4.666666667,201803
32,4,450,144,539,568,50,116,78,1945,1158,3103,13,4.666666667,201803
1,1,490,108,677,713,142,141,21,2292,1959,4251,13,6.5,201804
1,2,582,135,1385,914,237,270,51,3574,2455,6029,12,5.4,201804
1,3,469,121,1547,963,132,286,3,3521,2453,5974,13,5.4,201804
2,1,502,42,959,1069,44,249,5,2870,2125,4995,11,6,201804
2,2,470,35,674,893,12,222,1,2307,2163,4470,9,4.333333333,201804
2,3,649,49,1037,818,54,226,2,2835,2080,4915,12,4.6,201804
2,4,450,21,1016,414,49,111,2,2063,1296,3359,13,6,201804
2,5,804,66,1522,930,221,349,25,3917,3203,7120,14,6.666666667,201804
2,6,481,26,819,636,39,167,1,2169,1598,3767,7,6,201804
2,7,609,39,1141,796,65,246,15,2911,2732,5643,12,5.75,201804
2,8,466,24,913,679,24,138,6,2250,1920,4170,8,6,201804
3,1,374,36,846,568,48,237,12,2121,1531,3652,15,5.571428571,201804
3,2,285,7,893,313,17,82,0,1597,1331,2928,9,6.333333333,201804
4,1,493,66,850,1021,114,164,1,2709,2020,4729,15,4.666666667,201804
4,2,512,51,984,1003,66,151,0,2767,1848,4615,14,5.4,201804
5,1,515,35,1046,879,48,250,0,2773,1529,4302,9,6.333333333,201804
5,2,412,68,918,1050,71,128,20,2667,1362,4029,10,7,201804
5,3,439,47,779,882,97,232,86,2562,1348,3910,9,6.25,201804
5,4,557,86,1498,1149,42,443,35,3810,2419,6229,11,5.5,201804
5,5,566,64,930,1022,60,213,116,2971,2006,4977,8,7,201804
5,6,526,66,952,846,44,189,223,2846,2110,4956,11,6,201804
5,7,436,54,664,702,20,133,13,2022,1379,3401,11,4,201804
6,1,386,52,985,556,18,181,15,2193,1525,3718,15,5,201804
6,2,326,34,558,290,118,105,29,1460,1185,2645,9,6.333333333,201804
7,1,461,33,589,1197,31,70,24,2405,1617,4022,9,5.5,201804
7,2,675,26,300,2332,109,104,0,3546,1690,5236,9,5.5,201804
7,3,460,21,476,662,379,93,0,2091,1185,3276,7,5.333333333,201804
7,4,481,38,591,1122,28,130,187,2577,1200,3777,11,6.4,201804
7,5,797,34,447,1739,75,128,124,3344,2218,5562,11,6.666666667,201804
7,6,605,37,696,735,50,158,14,2295,1842,4137,8,4.25,201804
7,7,560,39,601,1169,78,125,0,2572,2217,4789,8,6.5,201804
7,8,592,32,584,1225,66,124,0,2623,2245,4868,12,5.5,201804
7,9,552,58,973,1327,49,198,24,3181,2485,5666,11,5.5,201804
7,10,423,21,611,1656,293,85,0,3089,1699,4788,9,6,201804
7,11,373,12,204,402,77,55,0,1123,941,2064,6,5.333333333,201804
7,12,726,20,782,1241,22,104,24,2919,2011,4930,9,6.5,201804
7,13,411,36,512,1294,42,99,0,2394,886,3280,9,6,201804
8,1,350,17,637,342,43,79,1,1469,1222,2691,4,7,201804
8,2,671,70,1371,867,62,220,16,3277,2265,5542,17,6,201804
8,3,487,60,901,739,42,200,17,2446,2038,4484,5,7,201804
8,4,426,52,982,721,53,288,37,2559,1966,4525,9,7,201804
8,5,486,49,730,621,87,179,0,2152,1126,3278,10,5.5,201804
8,6,471,59,1111,900,145,286,26,2998,2172,5170,8,5,201804
8,7,526,81,638,676,41,169,0,2131,1070,3201,8,5.5,201804
8,8,416,71,946,876,33,243,21,2606,1861,4467,10,3.5,201804
8,9,485,40,600,476,65,187,89,1942,909,2851,10,5,201804
9,1,381,28,355,294,141,128,7,1334,972,2306,6,7,201804
9,2,958,176,1444,1691,145,363,13,4790,3537,8327,12,6,201804
9,3,408,71,802,773,111,220,26,2411,2041,4452,7,6,201804
9,4,758,57,853,1132,139,236,17,3192,2247,5439,11,6,201804
9,5,369,29,539,532,96,200,1,1766,1525,3291,7,6,201804
9,6,289,48,340,289,94,141,26,1227,1413,2640,7,6,201804
9,7,298,34,606,627,8,126,0,1699,1431,3130,9,6,201804
9,8,246,28,773,555,59,220,52,1933,976,2909,6,7,201804
9,9,409,30,444,472,85,124,11,1575,1286,2861,5,6,201804
9,10,287,24,724,500,51,236,0,1822,1475,3297,6,6,201804
9,11,553,64,1032,865,113,235,19,2881,2325,5206,7,6,201804
9,12,443,70,1287,994,57,342,30,3223,2751,5974,11,6,201804
9,13,421,39,594,540,113,166,66,1939,1645,3584,4,6,201804
9,14,300,19,319,299,131,129,19,1216,1012,2228,5,6,201804
9,15,549,51,1988,1451,66,520,6,4631,3475,8106,11,3.75,201804
9,16,683,118,1053,1066,158,333,15,3426,2949,6375,15,7,201804
9,17,331,19,505,423,30,157,3,1468,1271,2739,6,6,201804
9,18,494,54,747,878,102,274,15,2564,1972,4536,12,6,201804
9,19,545,75,543,635,173,142,6,2119,1851,3970,5,6,201804
9,20,150,16,285,211,38,63,12,775,403,1178,5,6,201804
9,21,392,29,356,426,93,126,35,1457,1166,2623,3,6,201804
9,22,498,25,415,432,166,144,52,1732,1442,3174,5,6,201804
9,23,461,52,897,912,122,220,1,2665,1769,4434,7,7,201804
9,24,777,63,1154,1064,178,373,133,3742,2736,6478,12,6,201804
10,1,366,38,412,430,31,99,81,1457,1283,2740,12,5,201804
10,2,535,63,590,704,76,164,95,2227,1856,4083,9,5.75,201804
10,3,472,82,469,663,69,130,77,1962,1322,3284,12,5.8,201804
10,4,523,80,967,1058,41,187,1,2857,2197,5054,17,4,201804
11,1,608,103,492,508,50,93,21,1875,759,2634,6,6.333333333,201804
11,2,601,67,525,549,71,135,37,1985,1476,3461,7,7,201804
11,3,317,56,387,374,25,108,7,1274,1159,2433,4,7,201804
11,4,399,74,457,528,14,106,0,1578,1180,2758,10,4.2,201804
11,5,630,126,686,816,25,230,20,2533,2105,4638,8,7,201804
11,6,443,86,623,526,72,144,25,1919,1362,3281,8,6.333333333,201804
11,7,618,82,666,1018,69,112,0,2565,2187,4752,9,6,201804
11,8,627,110,624,784,85,130,0,2360,1598,3958,9,6.5,201804
11,9,665,124,639,715,27,171,28,2369,1958,4327,10,6.333333333,201804
11,10,556,110,534,746,35,140,87,2208,1587,3795,11,6.2,201804
11,11,405,129,421,477,29,107,0,1568,1191,2759,4,7,201804
11,12,551,92,836,855,22,138,0,2494,1604,4098,7,7,201804
11,13,505,92,360,429,72,98,148,1704,1214,2918,9,6,201804
11,14,523,76,467,537,43,112,17,1775,1353,3128,8,6,201804
11,15,492,98,457,509,9,113,1,1679,1215,2894,9,7,201804
12,1,561,70,691,381,119,109,16,1947,1245,3192,10,5.2,201804
12,2,676,93,616,759,44,125,1,2314,1684,3998,10,5.5,201804
12,3,496,73,719,804,80,115,0,2287,1603,3890,11,5.2,201804
12,4,516,67,1008,1168,117,156,29,3061,1844,4905,9,6,201804
12,5,405,32,679,487,0,62,8,1673,1214,2887,10,5.25,201804
12,6,281,35,266,653,112,33,22,1402,1317,2719,10,5.25,201804
12,7,643,65,904,919,48,137,29,2745,1730,4475,8,4.333333333,201804
12,8,504,32,854,748,20,44,0,2202,1714,3916,9,5.25,201804
12,9,499,49,621,956,56,93,28,2302,1011,3313,9,5.666666667,201804
13,1,560,63,344,977,190,103,0,2237,1587,3824,9,5.666666667,201804
13,2,498,53,281,623,168,147,0,1770,1212,2982,6,5.666666667,201804
13,3,493,48,403,509,262,171,0,1886,1281,3167,12,5.5,201804
13,4,664,56,743,687,135,184,35,2504,1379,3883,9,6.333333333,201804
13,5,742,66,1025,885,226,259,56,3259,2401,5660,9,6.5,201804
13,6,907,135,1738,1386,97,336,26,4625,3006,7631,13,5,201804
13,7,497,67,917,850,94,218,0,2643,1709,4352,9,6,201804
14,1,413,28,287,162,38,85,35,1048,699,1747,6,5.5,201804
14,2,413,32,350,203,53,142,1,1194,990,2184,6,5.666666667,201804
14,3,646,26,508,214,13,220,0,1627,1238,2865,11,5.4,201804
14,4,498,39,809,826,28,236,18,2454,1738,4192,12,6,201804
14,5,408,34,911,466,68,131,9,2027,1433,3460,11,5.5,201804
14,6,528,30,1033,527,24,170,3,2315,1602,3917,11,6,201804
14,7,305,16,319,166,1,83,0,890,384,1274,6,6,201804
14,8,726,62,1585,1135,40,392,10,3950,3246,7196,13,4.333333333,201804
14,9,528,54,715,666,80,170,4,2217,1710,3927,8,6,201804
14,10,437,52,853,461,23,204,1,2031,1507,3538,7,6,201804
14,11,326,24,414,460,46,121,26,1417,958,2375,4,6,201804
14,12,616,41,1014,306,14,149,3,2143,1679,3822,11,5.5,201804
14,13,449,42,546,372,38,125,0,1572,1047,2619,8,6,201804
14,14,436,42,604,592,24,178,43,1919,1387,3306,7,7,201804
14,15,537,65,495,511,31,173,34,1846,1357,3203,10,5.6,201804
14,16,458,29,498,315,35,120,9,1464,1261,2725,5,6,201804
14,17,355,49,294,238,49,110,60,1155,746,1901,9,5.25,201804
14,18,515,49,543,436,93,109,67,1812,1335,3147,10,5.4,201804
14,19,521,82,674,591,76,123,42,2109,1242,3351,9,5.25,201804
14,20,388,22,563,279,18,94,5,1369,916,2285,10,5.666666667,201804
15,1,662,40,468,168,442,104,0,1884,880,2764,7,5.666666667,201804
15,2,435,31,657,521,51,167,36,1898,1482,3380,6,6.5,201804
15,3,1019,32,649,455,172,194,10,2531,1448,3979,10,5.666666667,201804
15,4,561,23,513,473,45,168,23,1806,1736,3542,4,7,201804
15,5,765,58,673,613,15,176,1,2301,1236,3537,8,6,201804
15,6,595,40,797,890,151,224,7,2704,1802,4506,7,7,201804
15,7,420,21,519,616,72,149,0,1797,1562,3359,10,7,201804
15,8,258,25,350,397,25,91,10,1156,759,1915,4,7,201804
15,9,842,25,336,377,276,115,28,1999,1388,3387,9,6,201804
15,10,503,25,554,504,119,150,0,1855,1481,3336,9,8,201804
15,11,599,38,593,655,84,153,0,2122,1803,3925,8,7,201804
15,12,958,47,1288,979,42,190,0,3504,2489,5993,8,6.333333333,201804
15,13,267,26,287,310,103,115,0,1108,865,1973,8,7,201804
15,14,242,27,237,256,44,97,1,904,635,1539,4,7,201804
15,15,409,70,517,641,38,182,0,1857,1495,3352,6,7,201804
15,16,858,107,1147,1519,25,293,11,3960,2326,6286,8,6.5,201804
15,17,481,43,515,666,24,162,54,1945,1452,3397,8,7,201804
15,18,758,41,654,655,44,302,8,2462,1750,4212,7,6,201804
15,19,703,172,1109,1197,26,271,2,3480,2705,6185,14,6.5,201804
15,20,335,35,453,481,25,124,1,1454,1133,2587,6,7,201804
15,21,401,22,304,455,25,125,8,1340,724,2064,6,6,201804
15,22,860,102,1190,1236,58,363,3,3812,2898,6710,14,6.5,201804
15,23,596,30,505,540,71,207,0,1949,1932,3881,7,5.666666667,201804
15,24,452,66,590,604,51,110,14,1887,1364,3251,4,7,201804
15,25,600,70,583,499,24,76,52,1904,1356,3260,6,7,201804
15,26,406,19,484,294,82,157,1,1443,1228,2671,11,3,201804
15,27,732,57,790,851,22,305,35,2792,1986,4778,9,6,201804
15,28,741,40,999,622,84,237,0,2723,2192,4915,9,6,201804
15,29,765,55,771,1080,18,228,0,2917,2177,5094,8,7,201804
15,30,804,56,1100,784,88,170,7,3009,2310,5319,12,7.5,201804
15,31,542,106,412,678,26,143,0,1907,1379,3286,6,7,201804
15,32,633,40,972,820,86,175,2,2728,1835,4563,9,7,201804
15,33,696,30,697,662,47,165,0,2297,1919,4216,7,6.5,201804
15,34,485,25,491,583,26,190,0,1800,1509,3309,8,7,201804
15,35,973,43,555,630,32,275,0,2508,1868,4376,9,6,201804
15,36,827,45,792,635,216,133,3,2651,1779,4430,9,5.75,201804
15,37,630,64,711,715,126,211,37,2494,1960,4454,7,6.5,201804
15,38,676,63,587,572,19,172,0,2089,1668,3757,6,6,201804
15,39,477,49,589,545,42,149,14,1865,1452,3317,4,7,201804
15,40,1240,87,934,962,279,396,17,3915,2664,6579,9,6.333333333,201804
15,41,911,84,1425,1218,117,237,88,4080,2621,6701,11,6.25,201804
16,1,439,57,626,547,30,112,0,1811,1327,3138,10,5.666666667,201804
16,2,260,44,317,400,36,88,0,1145,670,1815,9,5.5,201804
16,3,580,58,466,652,107,98,0,1961,1277,3238,10,5.5,201804
16,4,448,46,564,375,61,164,0,1658,1263,2921,8,6,201804
16,5,388,68,430,404,50,136,43,1519,1292,2811,10,6.333333333,201804
16,6,566,80,470,568,129,123,1,1937,1246,3183,12,6,201804
16,7,557,59,513,441,106,147,1,1824,1172,2996,9,6,201804
16,8,599,75,996,829,24,197,16,2736,2256,4992,12,7,201804
16,9,563,60,561,521,39,172,0,1916,1357,3273,10,7,201804
16,10,493,49,947,737,31,201,7,2465,1661,4126,8,5,201804
16,11,558,67,587,367,307,158,32,2076,1414,3490,12,5.8,201804
16,12,514,64,602,301,123,100,8,1712,974,2686,10,5.5,201804
17,1,487,45,822,664,52,199,1,2270,1900,4170,12,4.25,201804
17,2,448,30,724,702,39,131,50,2124,1500,3624,9,6.333333333,201804
17,3,776,51,868,856,43,166,0,2760,1414,4174,8,6,201804
17,4,687,43,884,861,50,153,4,2682,1881,4563,10,6.666666667,201804
17,5,326,25,309,356,37,70,1,1124,825,1949,5,6,201804
18,1,408,54,310,464,82,101,5,1424,1250,2674,9,5.4,201804
18,2,578,89,1145,891,155,212,0,3070,2008,5078,10,5.5,201804
18,3,326,36,785,486,30,101,0,1764,1237,3001,9,6,201804
19,1,593,51,938,748,23,370,50,2773,979,3752,9,7,201804
19,2,665,41,1253,573,127,189,2,2850,1563,4413,10,7,201804
19,3,699,29,1194,665,73,218,0,2878,989,3867,8,6,201804
19,4,261,31,419,293,69,138,120,1331,631,1962,5,6,201804
19,5,1019,80,1175,1065,56,340,125,3860,2691,6551,8,7,201804
19,6,234,24,531,494,16,206,0,1505,718,2223,5,7,201804
19,7,505,21,1461,384,14,149,0,2534,1463,3997,10,5.5,201804
19,8,211,17,436,341,6,104,0,1115,396,1511,7,6,201804
19,9,516,43,642,585,71,111,1,1969,518,2487,9,5.25,201804
19,10,354,22,666,551,13,178,9,1793,656,2449,7,2.666666667,201804
19,11,1092,129,1545,1792,53,516,11,5138,2165,7303,13,7,201804
19,12,502,34,1248,371,23,146,25,2349,1504,3853,8,5.333333333,201804
20,1,545,49,562,584,173,159,0,2072,1175,3247,7,6,201804
20,2,253,38,307,373,54,62,0,1087,673,1760,6,5.666666667,201804
20,3,285,29,462,482,144,84,1,1487,1697,3184,6,5.666666667,201804
20,4,352,49,270,534,107,104,72,1488,874,2362,6,5.666666667,201804
20,5,395,36,415,638,68,97,3,1652,1508,3160,11,5.5,201804
20,6,418,28,436,665,297,86,5,1935,1362,3297,8,5.5,201804
20,7,602,43,691,859,18,113,0,2326,1315,3641,8,6.5,201804
20,8,1272,81,1337,1838,73,384,245,5230,3743,8973,15,5.333333333,201804
20,9,636,40,484,459,178,149,96,2042,1539,3581,8,6.333333333,201804
20,10,413,21,382,647,40,82,0,1585,1323,2908,9,5.5,201804
21,1,713,44,729,947,41,119,1,2594,1658,4252,9,5.8,201804
21,2,602,34,561,359,90,161,0,1807,1191,2998,9,5.4,201804
21,3,1020,34,795,391,170,212,54,2676,1471,4147,8,6,201804
21,4,417,18,335,172,149,112,49,1252,984,2236,6,5.5,201804
21,5,861,43,884,697,57,263,36,2841,1586,4427,8,6.333333333,201804
21,6,733,46,711,818,90,211,145,2754,2029,4783,6,7,201804
21,7,1051,26,622,631,117,195,3,2645,2064,4709,9,6.333333333,201804
21,8,559,18,678,560,88,117,22,2042,1103,3145,10,5.4,201804
21,9,840,46,1207,864,126,302,107,3492,2200,5692,9,7,201804
21,10,625,22,736,575,55,189,51,2253,1269,3522,7,6,201804
21,11,250,14,351,279,45,82,20,1041,663,1704,6,4.5,201804
21,12,1263,56,2012,1756,144,476,96,5803,3687,9490,15,5,201804
21,13,717,22,470,538,43,198,4,1992,1181,3173,8,6.333333333,201804
21,14,780,39,630,546,120,182,10,2307,1430,3737,13,5.666666667,201804
21,15,935,27,865,580,56,227,1,2691,2005,4696,7,6,201804
22,1,600,114,671,986,148,109,0,2628,2274,4902,11,7,201804
22,2,594,71,941,585,85,111,37,2424,1838,4262,7,6,201804
22,3,724,125,1763,1213,66,293,15,4199,3218,7417,10,7,201804
22,4,666,104,1495,957,78,233,16,3549,2660,6209,13,4.6,201804
22,5,433,66,1247,583,99,141,22,2591,1876,4467,10,6,201804
23,1,492,19,2284,736,93,118,0,3742,3090,6832,14,6.2,201804
23,2,486,52,941,799,64,116,0,2458,1958,4416,10,4.4,201804
23,3,645,17,1849,870,63,109,1,3554,2349,5903,11,7,201804
23,4,451,24,1650,758,67,115,1,3066,2021,5087,10,5.5,201804
24,1,419,81,450,694,80,76,6,1806,1234,3040,11,5.4,201804
24,2,321,41,345,346,46,73,1,1173,952,2125,6,6,201804
24,3,416,121,611,1107,368,79,3,2705,2142,4847,9,5.5,201804
24,4,413,81,490,334,138,158,244,1858,1094,2952,5,6,201804
24,5,587,93,1057,1063,22,267,0,3089,2342,5431,10,5.5,201804
24,6,672,120,1190,1033,76,255,0,3346,2641,5987,11,5,201804
24,7,569,79,718,901,206,93,0,2566,1986,4552,9,5.5,201804
25,1,430,41,727,668,64,166,28,2124,1428,3552,14,6.5,201804
25,2,504,52,803,805,51,178,0,2393,1595,3988,7,6,201804
25,3,575,37,681,886,104,144,61,2488,1537,4025,9,6.2,201804
25,4,526,58,440,727,16,120,7,1894,1368,3262,8,5.666666667,201804
25,5,566,42,1021,1165,46,269,0,3109,2167,5276,11,5,201804
25,6,518,41,910,697,109,196,14,2485,1898,4383,9,6.5,201804
25,7,531,35,906,953,26,245,0,2696,1855,4551,7,7,201804
26,1,371,22,708,596,39,185,0,1921,1216,3137,9,5.5,201804
26,2,498,34,1105,996,15,258,0,2906,2218,5124,13,5.4,201804
26,3,589,41,1405,1125,30,435,22,3647,2613,6260,15,5,201804
26,4,364,44,545,517,62,189,1,1722,1255,2977,10,5.2,201804
26,5,146,19,282,251,13,102,0,813,638,1451,3,5.5,201804
26,6,323,25,728,679,6,178,0,1939,1789,3728,10,5.333333333,201804
26,7,346,27,466,584,47,111,1,1582,1119,2701,10,5.5,201804
27,1,489,40,555,1083,58,98,0,2323,1427,3750,9,6,201804
27,2,700,40,519,1161,21,114,0,2555,1847,4402,8,6.333333333,201804
27,3,626,41,497,1204,30,115,0,2513,1651,4164,7,6.333333333,201804
27,4,697,41,856,1594,32,175,14,3409,2281,5690,10,3.5,201804
27,5,420,18,329,844,21,70,10,1712,1413,3125,6,5.666666667,201804
27,6,446,48,804,1297,23,164,0,2782,2011,4793,9,5.666666667,201804
28,1,595,78,1330,1245,46,223,0,3517,1970,5487,13,7,201804
28,2,650,67,1363,750,76,221,423,3550,2296,5846,14,6.5,201804
28,3,389,28,479,410,19,106,2,1433,922,2355,7,6.333333333,201804
28,4,792,96,1242,1051,135,301,240,3857,1874,5731,16,6,201804
28,5,475,64,850,889,36,195,0,2509,1728,4237,12,4.166666667,201804
28,6,427,120,628,1235,324,103,153,2990,1675,4665,14,5.333333333,201804
28,7,610,79,1227,922,147,234,0,3219,2326,5545,8,7,201804
28,8,365,52,589,478,94,177,5,1760,1426,3186,11,6.333333333,201804
28,9,408,31,739,342,52,105,228,1905,1376,3281,9,7,201804
29,1,642,111,723,656,140,146,0,2418,1969,4387,10,5.5,201804
29,2,790,65,707,1097,81,266,117,3123,2702,5825,15,4.333333333,201804
29,3,476,76,419,746,61,146,0,1924,1481,3405,7,5.666666667,201804
30,1,369,39,418,410,65,103,103,1507,932,2439,7,5.333333333,201804
30,2,650,34,371,196,100,89,546,1986,1161,3147,8,5.25,201804
30,3,607,25,584,381,183,161,180,2121,1466,3587,6,5.666666667,201804
30,4,376,28,705,430,83,182,15,1819,1414,3233,8,6,201804
30,5,477,42,507,757,36,188,0,2007,1394,3401,7,5.5,201804
30,6,557,22,422,434,44,104,1,1584,884,2468,9,5.333333333,201804
30,7,453,59,471,525,59,153,55,1775,1680,3455,12,5.25,201804
30,8,606,47,867,671,130,201,18,2540,1434,3974,11,5.4,201804
30,9,567,27,409,317,111,177,214,1822,1336,3158,8,5.5,201804
30,10,615,34,1183,804,79,311,113,3139,1828,4967,9,4.666666667,201804
30,11,394,32,781,729,21,152,0,2109,1443,3552,6,5.5,201804
30,12,754,55,1393,1271,73,338,0,3884,2878,6762,11,6.25,201804
30,13,785,47,589,1003,201,199,27,2851,1819,4670,10,5.4,201804
30,14,556,70,801,628,259,218,0,2532,1594,4126,9,5.5,201804
30,15,734,19,397,387,104,200,193,2034,1579,3613,11,5.666666667,201804
30,16,747,28,744,779,169,238,198,2903,1767,4670,10,5.333333333,201804
30,17,437,52,357,448,58,121,56,1529,983,2512,8,5.5,201804
30,18,494,24,284,500,27,113,55,1497,1144,2641,8,5.25,201804
30,19,442,33,657,666,239,124,13,2174,1489,3663,13,5.6,201804
30,20,573,32,456,888,203,134,0,2286,1665,3951,11,5.4,201804
31,1,516,35,653,634,17,88,0,1943,1681,3624,8,5.5,201804
31,2,281,43,434,110,436,116,0,1420,666,2086,7,5.333333333,201804
31,3,1200,163,2353,1493,267,413,0,5889,3643,9532,20,4.75,201804
31,4,380,20,837,535,71,212,0,2055,1325,3380,6,4,201804
31,5,507,40,352,459,30,110,0,1498,1089,2587,7,5.333333333,201804
32,1,548,87,445,429,86,133,61,1789,1597,3386,12,5.4,201804
32,2,412,118,380,340,139,90,40,1519,1388,2907,13,5.285714286,201804
32,3,494,138,580,651,54,145,22,2084,1442,3526,15,5,201804
32,4,527,128,619,602,62,163,73,2174,1630,3804,13,4.666666667,201804
1,1,479,80,715,856,112,163,0,2405,1433,3838,13,5.5,201805
1,2,560,108,1159,909,152,273,35,3196,1585,4781,12,5,201805
1,3,488,107,1268,775,61,293,0,2992,2283,5275,13,5,201805
2,1,524,34,821,807,46,267,11,2510,1799,4309,11,6,201805
2,2,477,23,654,800,4,258,0,2216,1147,3363,9,5,201805
2,3,649,51,862,649,36,228,0,2475,1142,3617,12,4.4,201805
2,4,454,27,877,395,40,135,6,1934,994,2928,13,6,201805
2,5,743,34,1187,816,124,312,3,3219,2099,5318,14,6.333333333,201805
2,6,488,18,720,552,28,156,0,1962,1683,3645,7,6,201805
2,7,612,38,978,684,48,187,11,2558,2097,4655,12,5.75,201805
2,8,444,16,761,670,24,120,6,2041,1841,3882,8,6,201805
3,1,444,31,876,599,39,262,7,2258,1265,3523,15,5.285714286,201805
3,2,322,16,864,338,23,82,0,1645,1072,2717,9,5.666666667,201805
4,1,592,41,924,912,83,205,1,2758,2174,4932,15,4.5,201805
4,2,474,40,950,686,31,149,0,2330,1403,3733,14,5.2,201805
5,1,367,41,784,532,39,201,0,1964,1009,2973,9,5.666666667,201805
5,2,430,61,821,855,59,177,11,2414,1409,3823,10,5.2,201805
5,3,393,60,699,654,69,275,89,2239,969,3208,9,5.5,201805
5,4,525,53,1036,827,23,343,19,2826,1549,4375,11,4.75,201805
5,5,475,46,776,578,49,228,63,2215,1522,3737,8,6,201805
5,6,510,67,834,620,38,204,127,2400,1318,3718,11,5.5,201805
5,7,456,31,596,550,18,149,9,1809,1021,2830,10,3.666666667,201805
6,1,453,36,990,450,16,264,9,2218,1292,3510,15,4.428571429,201805
6,2,355,37,493,320,82,103,20,1410,1032,2442,9,5.666666667,201805
7,1,396,20,386,866,14,96,26,1804,1538,3342,9,5.25,201805
7,2,527,24,357,1620,50,74,1,2653,1643,4296,9,5.25,201805
7,3,361,10,319,527,254,70,0,1541,1166,2707,7,5.333333333,201805
7,4,376,32,493,837,7,132,81,1958,1302,3260,11,5.4,201805
7,5,600,19,400,1267,36,140,35,2497,2229,4726,11,5.666666667,201805
7,6,514,17,656,507,31,165,7,1897,1222,3119,8,4,201805
7,7,531,28,556,545,53,119,0,1832,1533,3365,8,5.5,201805
7,8,617,16,527,771,24,124,1,2080,2565,4645,12,5.25,201805
7,9,609,45,965,557,24,207,1,2408,2102,4510,11,5,201805
7,10,385,28,552,1357,166,94,1,2583,1897,4480,9,5.5,201805
7,11,227,6,136,349,31,37,0,786,892,1678,6,5.333333333,201805
7,12,627,18,690,614,4,114,0,2067,1150,3217,9,5.5,201805
7,13,445,42,515,1231,20,103,0,2356,1497,3853,9,5.25,201805
8,1,227,11,537,343,28,67,0,1213,1053,2266,4,6,201805
8,2,514,49,1140,718,47,201,7,2676,2334,5010,17,5.5,201805
8,3,374,35,675,561,23,125,3,1796,1738,3534,5,6,201805
8,4,324,42,797,578,30,244,17,2032,1413,3445,9,6,201805
8,5,405,64,596,505,78,189,0,1837,1963,3800,10,5.25,201805
8,6,346,47,980,651,79,312,10,2425,1162,3587,8,5,201805
8,7,347,35,469,573,30,156,1,1611,587,2198,8,5.25,201805
8,8,324,55,868,799,15,266,9,2336,2026,4362,12,4,201805
8,9,453,32,656,364,42,215,5,1767,360,2127,10,5.2,201805
9,1,307,18,260,207,67,89,2,950,654,1604,6,10,201805
9,2,802,181,1130,840,88,326,6,3373,3634,7007,12,6,201805
9,3,387,65,602,392,42,233,20,1741,2275,4016,7,6,201805
9,4,647,44,760,891,70,213,9,2634,2412,5046,11,6,201805
9,5,393,29,513,258,68,171,1,1433,1563,2996,7,6,201805
9,6,329,34,323,272,69,122,10,1159,913,2072,7,6,201805
9,7,370,14,569,418,11,152,3,1537,1451,2988,9,6,201805
9,8,291,35,657,275,40,237,19,1554,904,2458,6,10,201805
9,9,382,21,395,223,43,110,3,1177,769,1946,5,6,201805
9,10,279,42,620,227,24,248,1,1441,1519,2960,6,6,201805
9,11,505,22,809,496,76,217,15,2140,2952,5092,7,6,201805
9,12,452,80,1160,694,36,377,15,2814,2578,5392,11,6,201805
9,13,381,34,545,309,53,139,18,1479,822,2301,4,6,201805
9,14,338,5,366,283,72,149,11,1224,905,2129,5,6,201805
9,15,636,47,1577,840,31,588,3,3722,2577,6299,11,3.75,201805
9,16,682,98,740,536,103,283,4,2446,1962,4408,15,6,201805
9,17,366,16,503,240,21,217,2,1365,1210,2575,6,6,201805
9,18,538,54,770,519,68,246,14,2209,1540,3749,12,6,201805
9,19,640,65,470,483,93,162,1,1914,1712,3626,5,6,201805
9,20,184,31,366,190,35,73,9,888,349,1237,5,6,201805
9,21,371,23,274,333,43,120,28,1192,1081,2273,3,6,201805
9,22,438,19,401,240,133,124,33,1388,1221,2609,5,6,201805
9,23,474,41,704,625,66,220,0,2130,1337,3467,7,10,201805
9,24,778,57,893,596,93,322,60,2799,2680,5479,13,7.5,201805
10,1,254,31,375,469,37,84,36,1286,1234,2520,12,4.5,201805
10,2,430,44,441,586,62,138,30,1731,1468,3199,9,5.5,201805
10,3,435,81,417,785,44,149,53,1964,1847,3811,12,5.4,201805
10,4,553,53,870,917,34,185,3,2615,2168,4783,17,4.5,201805
11,1,496,50,307,424,7,76,4,1364,732,2096,6,5.666666667,201805
11,2,561,56,498,473,52,123,22,1785,1379,3164,7,6,201805
11,3,305,28,274,273,22,120,11,1033,1050,2083,4,6,201805
11,4,366,51,356,627,17,132,0,1549,1305,2854,10,4.2,201805
11,5,629,82,504,624,26,182,20,2067,1522,3589,8,6.5,201805
11,6,410,38,482,438,30,158,15,1571,1059,2630,8,5.666666667,201805
11,7,621,65,605,893,37,116,0,2337,1843,4180,9,5.5,201805
11,8,577,49,553,778,57,150,1,2165,1776,3941,9,5.75,201805
11,9,538,94,558,628,17,154,15,2004,1858,3862,10,5.666666667,201805
11,10,543,84,488,732,39,156,35,2077,1711,3788,11,5.6,201805
11,11,387,75,308,246,12,90,0,1118,304,1422,4,6,201805
11,12,584,59,708,703,13,161,0,2228,1388,3616,7,6,201805
11,13,568,82,362,411,52,96,80,1651,1555,3206,9,5.5,201805
11,14,487,41,428,554,29,117,8,1664,1368,3032,8,5.5,201805
11,15,482,60,343,468,3,128,0,1484,1118,2602,9,6,201805
12,1,342,34,464,314,54,86,12,1306,1213,2519,10,5,201805
12,2,574,68,658,559,16,173,0,2048,1663,3711,10,5.5,201805
12,3,371,83,743,816,42,111,0,2166,2003,4169,11,5.2,201805
12,4,525,47,956,806,63,177,28,2602,1768,4370,9,6,201805
12,5,577,24,584,568,1,58,19,1831,1362,3193,10,5.25,201805
12,6,238,25,421,652,69,36,20,1461,1060,2521,10,5.25,201805
12,7,678,44,742,722,8,128,23,2345,1927,4272,8,5,201805
12,8,405,28,606,608,8,50,0,1705,1755,3460,9,5.25,201805
12,9,581,48,631,943,52,125,47,2427,1372,3799,9,5.666666667,201805
13,1,873,28,344,788,100,118,0,2251,1638,3889,9,5.333333333,201805
13,2,595,25,264,383,73,136,0,1476,1099,2575,6,5.333333333,201805
13,3,764,84,443,574,195,210,1,2271,1819,4090,12,5.25,201805
13,4,739,50,608,559,105,189,10,2260,739,2999,9,5.666666667,201805
13,5,838,51,679,756,156,247,18,2745,2470,5215,9,5.75,201805
13,6,816,104,1309,962,81,354,4,3630,1456,5086,13,4.75,201805
13,7,501,46,867,698,52,206,0,2370,1528,3898,9,5.5,201805
14,1,384,18,290,135,17,101,3,948,728,1676,6,5.5,201805
14,2,422,21,323,195,29,142,3,1135,743,1878,6,4.666666667,201805
14,3,447,19,382,232,8,180,1,1269,1212,2481,11,5.4,201805
14,4,492,32,658,586,27,229,19,2043,1482,3525,12,6,201805
14,5,413,29,1000,531,48,155,6,2182,1350,3532,11,5.5,201805
14,6,537,25,743,396,15,147,0,1863,860,2723,11,6,201805
14,7,310,10,289,171,0,77,0,857,483,1340,6,6,201805
14,8,733,53,1279,792,22,463,6,3348,1953,5301,13,4.5,201805
14,9,513,50,626,630,53,193,0,2065,766,2831,8,6,201805
14,10,451,34,779,426,23,251,8,1972,899,2871,7,6,201805
14,11,315,21,309,322,33,96,26,1122,905,2027,4,6,201805
14,12,496,24,711,268,17,154,0,1670,1469,3139,11,5.5,201805
14,13,529,19,559,224,14,148,0,1493,352,1845,8,4.5,201805
14,14,364,35,412,332,12,136,18,1309,1103,2412,7,6,201805
14,15,540,61,444,415,26,166,19,1671,1078,2749,10,5.6,201805
14,16,524,26,431,239,32,100,4,1356,1057,2413,5,6,201805
14,17,356,48,319,311,37,127,39,1237,862,2099,9,5.25,201805
14,18,496,49,488,414,43,119,44,1653,1484,3137,10,5.4,201805
14,19,451,63,520,611,62,135,20,1862,1557,3419,9,5.25,201805
14,20,401,19,478,303,12,132,9,1354,1139,2493,10,5.666666667,201805
15,1,406,28,352,251,302,111,0,1450,1157,2607,7,5.333333333,201805
15,2,417,14,534,477,35,154,20,1651,1221,2872,6,6,201805
15,3,898,28,565,507,147,208,1,2354,1302,3656,10,5.666666667,201805
15,4,494,21,425,354,25,165,3,1487,1459,2946,4,6,201805
15,5,685,58,593,455,13,204,1,2009,841,2850,8,5.666666667,201805
15,6,516,21,678,602,68,199,2,2086,1882,3968,7,6,201805
15,7,398,23,486,533,52,149,0,1641,1456,3097,10,6,201805
15,8,245,25,290,334,15,96,7,1012,849,1861,4,6,201805
15,9,796,24,339,444,159,123,11,1896,1397,3293,9,5.75,201805
15,10,360,21,438,335,37,122,0,1313,1081,2394,9,8,201805
15,11,482,21,448,482,38,137,0,1608,1804,3412,8,6,201805
15,12,712,19,1152,611,38,147,0,2679,2371,5050,8,6,201805
15,13,304,12,269,293,88,129,0,1095,779,1874,8,6,201805
15,14,227,13,188,262,23,84,0,797,579,1376,4,6,201805
15,15,357,67,402,514,18,154,0,1512,1435,2947,6,6,201805
15,16,676,53,1016,1158,10,256,5,3174,2589,5763,8,6,201805
15,17,403,29,457,463,27,171,31,1581,1140,2721,8,6,201805
15,18,738,34,600,446,28,271,1,2118,1627,3745,7,5.666666667,201805
15,19,586,115,806,964,12,281,0,2764,2807,5571,14,6,201805
15,20,326,20,482,422,16,98,1,1365,1249,2614,6,6,201805
15,21,293,12,327,361,13,135,0,1141,1062,2203,6,5.5,201805
15,22,678,75,857,940,39,332,8,2929,3045,5974,14,6,201805
15,23,620,23,442,539,43,217,0,1884,1298,3182,7,5.333333333,201805
15,24,445,49,462,424,31,144,2,1557,1277,2834,4,6,201805
15,25,492,39,415,357,10,98,2,1413,1147,2560,6,6,201805
15,26,388,12,349,319,42,145,0,1255,1202,2457,11,3,201805
15,27,688,35,658,507,19,275,16,2198,1738,3936,9,5.666666667,201805
15,28,672,37,851,586,58,207,0,2411,1251,3662,9,5.666666667,201805
15,29,650,28,658,662,12,209,0,2219,1116,3335,8,6,201805
15,30,736,57,1000,554,48,159,8,2562,2612,5174,12,8,201805
15,31,455,81,379,451,17,131,0,1514,1363,2877,6,6,201805
15,32,560,25,860,523,38,146,2,2154,1966,4120,9,6,201805
15,33,573,14,678,482,32,201,0,1980,1313,3293,7,6,201805
15,34,488,21,451,549,13,209,0,1731,1164,2895,8,6,201805
15,35,745,26,460,588,16,252,0,2087,1822,3909,9,5.666666667,201805
15,36,615,23,619,559,102,150,1,2069,2001,4070,9,5.5,201805
15,37,547,37,522,611,64,212,13,2006,1610,3616,7,6,201805
15,38,589,40,422,607,20,183,0,1861,1604,3465,6,5.5,201805
15,39,404,35,456,372,20,109,4,1400,1453,2853,4,6,201805
15,40,1034,48,732,733,106,388,4,3045,2837,5882,9,6,201805
15,41,766,43,1203,898,66,203,43,3222,2923,6145,11,6,201805
16,1,379,44,531,371,22,120,0,1467,935,2402,10,5.333333333,201805
16,2,295,40,353,421,28,79,0,1216,945,2161,9,5.25,201805
16,3,473,37,410,553,80,97,0,1650,1546,3196,10,5.25,201805
16,4,472,25,387,413,53,129,0,1479,1097,2576,8,5.5,201805
16,5,414,51,355,422,33,137,27,1439,1167,2606,10,5.666666667,201805
16,6,460,65,463,519,74,82,0,1663,1572,3235,12,5.5,201805
16,7,413,49,344,437,61,114,0,1418,1140,2558,9,5.5,201805
16,8,567,45,843,703,13,179,8,2358,2028,4386,12,6,201805
16,9,507,33,436,429,28,154,1,1588,1077,2665,10,6,201805
16,10,483,35,901,568,20,215,7,2229,1858,4087,8,5.333333333,201805
16,11,598,52,563,348,251,160,25,1997,1338,3335,12,5.4,201805
16,12,448,29,424,335,48,110,11,1405,1285,2690,10,5.25,201805
17,1,520,37,691,517,23,216,0,2004,1665,3669,12,4,201805
17,2,467,24,793,443,28,158,21,1934,1143,3077,9,5.666666667,201805
17,3,707,40,580,747,19,150,0,2243,897,3140,8,5.5,201805
17,4,655,36,848,722,41,172,6,2480,1614,4094,10,5.666666667,201805
17,5,256,22,311,377,21,84,0,1071,636,1707,5,5.5,201805
18,1,396,35,356,475,36,120,6,1424,1166,2590,9,5.4,201805
18,2,573,84,1005,749,122,232,0,2765,1546,4311,10,5,201805
18,3,376,34,772,489,26,119,0,1816,1466,3282,9,5.5,201805
19,1,602,39,738,513,25,352,22,2291,816,3107,9,6,201805
19,2,726,32,1083,500,68,219,2,2630,1629,4259,10,6,201805
19,3,737,32,962,493,32,227,0,2483,1403,3886,8,6,201805
19,4,331,13,371,209,44,169,31,1168,848,2016,5,6,201805
19,5,846,56,797,589,25,294,60,2667,1489,4156,8,6,201805
19,6,245,11,520,323,14,244,0,1357,518,1875,5,6,201805
19,7,486,23,1203,383,8,171,0,2274,2131,4405,10,5.5,201805
19,8,264,19,538,289,6,129,0,1245,788,2033,7,6,201805
19,9,496,30,668,563,50,144,1,1952,1253,3205,9,5.25,201805
19,10,393,18,477,300,5,183,0,1376,1203,2579,8,2.666666667,201805
19,11,969,80,1152,962,22,429,6,3620,2675,6295,13,6,201805
19,12,518,27,1054,287,18,189,15,2108,838,2946,8,5.666666667,201805
20,1,469,30,399,446,86,118,0,1548,981,2529,7,5.5,201805
20,2,401,25,454,393,28,78,0,1379,821,2200,6,5.333333333,201805
20,3,314,19,421,672,96,90,0,1612,598,2210,6,5.333333333,201805
20,4,202,25,273,347,266,72,42,1227,475,1702,6,5.333333333,201805
20,5,453,43,508,555,79,122,2,1762,871,2633,11,5.25,201805
20,6,340,21,347,675,260,75,0,1718,1213,2931,8,5.25,201805
20,7,495,48,622,624,16,114,0,1919,1691,3610,8,5.75,201805
20,8,1129,50,1172,905,50,348,114,3768,2743,6511,15,4.666666667,201805
20,9,477,22,421,400,69,117,44,1550,960,2510,8,5.666666667,201805
20,10,410,12,339,698,8,70,0,1537,1153,2690,9,5.25,201805
21,1,566,25,607,654,29,107,0,1988,1425,3413,9,5.4,201805
21,2,472,28,474,344,111,118,1,1548,1082,2630,9,5.2,201805
21,3,721,23,704,317,98,200,27,2090,907,2997,8,5.5,201805
21,4,410,17,298,260,80,162,33,1260,951,2211,6,5.25,201805
21,5,624,38,841,541,45,296,16,2401,1403,3804,8,5.666666667,201805
21,6,584,30,559,502,42,208,56,1981,1430,3411,6,7,201805
21,7,862,35,523,503,86,217,0,2226,1296,3522,9,5.666666667,201805
21,8,636,18,699,531,70,180,12,2146,1034,3180,10,5.2,201805
21,9,581,47,915,641,64,280,28,2556,1026,3582,9,6,201805
21,10,511,12,589,446,35,198,33,1824,574,2398,7,6,201805
21,11,256,13,442,279,44,112,20,1166,398,1564,6,4.5,201805
21,12,944,45,1449,1055,61,379,34,3967,2744,6711,14,4.333333333,201805
21,13,644,13,499,385,26,163,2,1732,811,2543,8,5.666666667,201805
21,14,596,25,543,414,76,184,12,1850,1326,3176,13,5.333333333,201805
21,15,739,27,748,545,30,179,0,2268,1571,3839,7,5.5,201805
22,1,435,104,492,909,81,105,0,2126,1647,3773,11,5.2,201805
22,2,452,35,681,488,73,111,21,1861,1613,3474,7,5.5,201805
22,3,619,71,1481,876,42,261,17,3367,3090,6457,10,5.666666667,201805
22,4,563,75,1283,964,50,301,14,3250,2634,5884,11,3.8,201805
22,5,369,47,1075,611,61,197,16,2376,1819,4195,10,5.5,201805
23,1,400,16,2206,602,73,115,0,3412,1855,5267,14,5.2,201805
23,2,395,48,853,887,23,149,0,2355,1984,4339,11,4.6,201805
23,3,548,13,1539,724,35,113,1,2973,2259,5232,11,6,201805
23,4,306,12,1225,372,54,107,0,2076,2154,4230,10,5,201805
24,1,475,92,582,861,112,109,7,2238,1784,4022,11,5.2,201805
24,2,322,42,365,358,32,92,1,1212,853,2065,6,5.5,201805
24,3,380,89,536,894,186,91,2,2178,1871,4049,9,5.25,201805
24,4,333,60,410,418,83,138,123,1565,670,2235,5,5.5,201805
24,5,594,75,923,938,15,307,0,2852,1707,4559,9,4.5,201805
24,6,666,88,859,895,38,246,0,2792,1945,4737,11,4.666666667,201805
24,7,535,47,610,717,141,96,0,2146,1997,4143,9,5.25,201805
25,1,542,35,804,632,80,199,5,2297,1475,3772,14,5.75,201805
25,2,520,45,589,603,25,155,0,1937,605,2542,7,5.5,201805
25,3,472,19,503,655,63,124,10,1846,1836,3682,9,5.6,201805
25,4,515,38,362,614,33,142,0,1704,1649,3353,8,5.333333333,201805
25,5,514,26,981,656,20,255,0,2452,1369,3821,11,4.5,201805
25,6,536,30,722,505,74,173,5,2045,1673,3718,9,5.75,201805
25,7,492,29,700,694,14,205,0,2134,1930,4064,7,6,201805
26,1,390,22,737,618,20,183,0,1970,1215,3185,9,5.5,201805
26,2,454,36,1105,1030,14,339,0,2978,1895,4873,13,5.4,201805
26,3,548,38,1144,765,19,486,15,3015,1954,4969,15,4.666666667,201805
26,4,376,44,531,382,43,252,0,1628,838,2466,10,5.2,201805
26,5,157,13,292,231,10,90,0,793,555,1348,3,5.5,201805
26,6,330,23,650,615,5,211,0,1834,1617,3451,10,5.333333333,201805
26,7,458,23,525,547,55,142,1,1751,925,2676,10,5.5,201805
27,1,456,30,504,869,97,102,0,2058,1429,3487,9,5.5,201805
27,2,554,30,487,887,13,126,0,2097,1580,3677,8,5.666666667,201805
27,3,508,31,411,857,29,99,0,1935,1699,3634,7,5.666666667,201805
27,4,495,25,676,1195,8,150,2,2551,2517,5068,10,3.75,201805
27,5,321,7,328,688,8,87,11,1450,907,2357,6,5.333333333,201805
27,6,360,31,645,1062,18,150,0,2266,2083,4349,9,5.333333333,201805
28,1,558,64,1278,817,45,262,0,3024,1372,4396,13,6,201805
28,2,593,48,1023,532,36,198,209,2639,1875,4514,14,6,201805
28,3,412,25,373,293,8,118,0,1229,655,1884,7,5.333333333,201805
28,4,868,74,1212,870,92,324,146,3586,633,4219,16,6,201805
28,5,537,39,790,652,46,206,4,2274,1157,3431,13,4.166666667,201805
28,6,426,87,674,944,208,123,95,2557,2053,4610,14,5.166666667,201805
28,7,570,56,1176,663,98,294,0,2857,646,3503,8,6,201805
28,8,425,50,647,342,82,212,7,1765,421,2186,9,6,201805
28,9,416,28,805,404,32,124,140,1949,834,2783,11,5.75,201805
29,1,587,91,629,715,109,156,0,2287,1796,4083,10,5.5,201805
29,2,838,66,758,1020,59,330,56,3127,1207,4334,15,4.333333333,201805
29,3,468,72,360,619,44,176,0,1739,1161,2900,7,5.666666667,201805
30,1,362,27,362,441,32,103,83,1410,983,2393,7,5.333333333,201805
30,2,420,29,271,170,49,86,433,1458,1401,2859,8,5.25,201805
30,3,463,14,465,270,113,150,68,1543,1218,2761,6,5.666666667,201805
30,4,339,18,576,388,69,177,4,1571,984,2555,8,6,201805
30,5,458,22,459,605,24,216,0,1784,1416,3200,7,5.5,201805
30,6,490,14,426,471,28,115,0,1544,1480,3024,9,5.333333333,201805
30,7,668,60,597,614,108,181,59,2287,1470,3757,12,5.25,201805
30,8,489,33,774,572,88,259,13,2228,1275,3503,11,5.4,201805
30,9,514,26,426,285,76,195,106,1628,1080,2708,8,5,201805
30,10,623,23,931,592,36,331,57,2593,1696,4289,9,5.333333333,201805
30,11,344,21,753,477,14,173,1,1783,1671,3454,6,5.5,201805
30,12,750,52,1336,1090,35,410,1,3674,1955,5629,11,6,201805
30,13,639,35,519,868,136,189,40,2426,1800,4226,10,5.4,201805
30,14,503,40,604,613,135,190,0,2085,1430,3515,9,5.5,201805
30,15,768,25,410,391,83,241,125,2043,1208,3251,11,5.666666667,201805
30,16,685,21,737,742,98,360,134,2777,1776,4553,10,5.333333333,201805
30,17,506,40,443,533,57,157,39,1775,1250,3025,8,5.5,201805
30,18,471,17,300,513,31,155,37,1524,1221,2745,8,5.25,201805
30,19,531,27,614,651,64,198,26,2111,1618,3729,13,5.6,201805
30,20,525,33,495,655,145,174,0,2027,1619,3646,11,5.4,201805
31,1,545,20,604,489,16,125,0,1799,1081,2880,8,5.5,201805
31,2,301,21,469,128,305,141,0,1365,408,1773,7,5.333333333,201805
31,3,1103,131,2031,1229,116,470,0,5080,2833,7913,21,5,201805
31,4,295,15,730,283,44,243,0,1610,937,2547,6,4,201805
31,5,363,28,335,491,23,104,0,1344,835,2179,7,5.333333333,201805
32,1,357,58,355,399,47,119,39,1374,992,2366,12,5.2,201805
32,2,523,97,514,350,120,146,14,1764,1336,3100,13,5.142857143,201805
32,3,561,178,642,785,43,195,31,2435,956,3391,15,4.833333333,201805
32,4,568,122,630,554,44,234,72,2224,1233,3457,13,4.5,201805
1,1,0,0,0,294,0,0,0,294,1747,2041,13,4.5,201807
1,2,0,0,0,458,0,0,0,458,3313,3771,12,4,201807
1,3,0,0,0,540,0,0,0,540,3054,3594,13,4,201807
2,1,0,0,0,424,0,0,0,424,2372,2796,11,5,201807
2,2,0,0,0,633,0,0,0,633,1768,2401,9,3.666666667,201807
2,3,0,0,0,523,0,0,0,523,2097,2620,13,4.25,201807
2,4,0,0,0,332,0,0,0,332,2262,2594,13,5,201807
2,5,0,0,0,890,0,0,0,890,3669,4559,14,5.333333333,201807
2,6,0,0,0,482,0,0,0,482,1899,2381,7,5,201807
2,7,0,0,0,599,0,0,0,599,2416,3015,12,4.75,201807
2,8,0,0,0,757,0,0,0,757,1862,2619,8,5,201807
3,1,0,0,0,534,0,0,0,534,1609,2143,15,4.142857143,201807
3,2,0,0,0,436,0,0,0,436,1445,1881,9,4.666666667,201807
4,1,0,0,0,512,0,0,0,512,2262,2774,15,3.666666667,201807
4,2,0,0,0,679,0,0,0,679,1700,2379,14,4.2,201807
5,1,0,0,0,306,0,0,0,306,1447,1753,9,4.666666667,201807
5,2,0,0,0,356,0,0,0,356,1627,1983,10,4.2,201807
5,3,0,0,0,385,0,0,0,385,1832,2217,9,4.5,201807
5,4,0,0,0,469,0,0,0,469,1977,2446,11,3.75,201807
5,5,0,0,0,481,0,0,0,481,1644,2125,8,5,201807
5,6,0,0,0,253,0,0,0,253,1985,2238,11,4.5,201807
5,7,0,0,0,187,0,0,0,187,1322,1509,10,3,201807
6,1,0,0,0,308,0,0,0,308,1725,2033,14,3.571428571,201807
6,2,0,0,0,265,0,0,0,265,1215,1480,9,4.666666667,201807
7,1,0,0,0,551,0,0,0,551,1376,1927,9,4.25,201807
7,2,0,0,0,903,0,0,0,903,2128,3031,9,4.25,201807
7,3,0,0,0,309,0,0,0,309,1962,2271,7,4.333333333,201807
7,4,0,0,0,509,0,0,0,509,790,1299,11,4.4,201807
7,5,0,0,0,570,0,0,0,570,2112,2682,11,5,201807
7,6,0,0,0,706,0,0,0,706,1770,2476,8,3.25,201807
7,7,0,0,0,1144,0,0,0,1144,1146,2290,8,4.5,201807
7,8,0,0,0,711,0,0,0,711,2602,3313,12,4.25,201807
7,9,0,0,0,979,0,0,0,979,2612,3591,11,4.25,201807
7,10,0,0,0,1232,0,0,0,1232,1822,3054,9,4.5,201807
7,11,0,0,0,130,0,0,0,130,703,833,6,4.333333333,201807
7,12,0,0,0,764,0,0,0,764,1837,2601,9,4.5,201807
7,13,0,0,0,193,0,0,0,193,1453,1646,9,4.5,201807
8,1,0,0,0,192,0,0,0,192,1237,1429,4,5,201807
8,2,0,0,0,346,0,0,0,346,2413,2759,17,4.5,201807
8,3,0,0,0,321,0,0,0,321,1863,2184,5,5,201807
8,4,0,0,0,314,0,0,0,314,2302,2616,9,5,201807
8,5,0,0,0,254,0,0,0,254,1652,1906,10,4.25,201807
8,6,0,0,0,527,0,0,0,527,2897,3424,7,3.333333333,201807
8,7,0,0,0,287,0,0,0,287,1383,1670,8,4.25,201807
8,8,0,0,0,359,0,0,0,359,2156,2515,12,3.5,201807
8,9,0,0,0,114,0,0,0,114,1165,1279,10,4.2,201807
9,1,0,0,0,327,0,0,0,327,1117,1444,6,6,201807
9,2,0,0,0,1546,0,0,0,1546,3545,5091,12,5,201807
9,3,0,0,0,771,0,0,0,771,1714,2485,7,5,201807
9,4,0,0,0,619,0,0,0,619,2607,3226,11,5,201807
9,5,0,0,0,575,0,0,0,575,1404,1979,7,5,201807
9,6,0,0,0,341,0,0,0,341,1054,1395,7,5,201807
9,7,0,0,0,597,0,0,0,597,1329,1926,9,5,201807
9,8,0,0,0,476,0,0,0,476,1437,1913,6,6,201807
9,9,0,0,0,462,0,0,0,462,1112,1574,5,5,201807
9,10,0,0,0,641,0,0,0,641,1303,1944,6,5,201807
9,11,0,0,0,819,0,0,0,819,2463,3282,7,5,201807
9,12,0,0,0,958,0,0,0,958,2337,3295,11,5,201807
9,13,0,0,0,605,0,0,0,605,1508,2113,4,5,201807
9,14,0,0,0,414,0,0,0,414,1049,1463,5,5,201807
9,15,0,0,0,1701,0,0,0,1701,3926,5627,11,3.5,201807
9,16,0,0,0,1173,0,0,0,1173,1835,3008,15,5,201807
9,17,0,0,0,654,0,0,0,654,1042,1696,6,5,201807
9,18,0,0,0,986,0,0,0,986,1696,2682,12,5,201807
9,19,0,0,0,725,0,0,0,725,1660,2385,5,5,201807
9,20,0,0,0,104,0,0,0,104,680,784,5,5,201807
9,21,0,0,0,366,0,0,0,366,1078,1444,3,5,201807
9,22,0,0,0,512,0,0,0,512,1436,1948,5,5,201807
9,23,0,0,0,699,0,0,0,699,2050,2749,7,6,201807
9,24,0,0,0,1509,0,0,0,1509,2842,4351,13,5.5,201807
10,1,0,0,0,319,0,0,0,319,1300,1619,12,4.333333333,201807
10,2,0,0,0,392,0,0,0,392,1609,2001,9,4.5,201807
10,3,0,0,0,364,0,0,0,364,1242,1606,12,4.4,201807
10,4,0,0,0,520,0,0,0,520,2104,2624,17,3.5,201807
11,1,0,0,0,498,0,0,0,498,1453,1951,6,4.666666667,201807
11,2,0,0,0,357,0,0,0,357,1332,1689,7,5,201807
11,3,0,0,0,347,0,0,0,347,1014,1361,4,5,201807
11,4,0,0,0,363,0,0,0,363,1473,1836,10,3.2,201807
11,5,0,0,0,567,0,0,0,567,1753,2320,8,5.5,201807
11,6,0,0,0,357,0,0,0,357,1226,1583,8,4.666666667,201807
11,7,0,0,0,666,0,0,0,666,2030,2696,9,4.5,201807
11,8,0,0,0,425,0,0,0,425,1747,2172,9,4.75,201807
11,9,0,0,0,471,0,0,0,471,1937,2408,10,4.666666667,201807
11,10,0,0,0,629,0,0,0,629,1821,2450,11,4.6,201807
11,11,0,0,0,309,0,0,0,309,818,1127,4,5,201807
11,12,0,0,0,559,0,0,0,559,1998,2557,7,5,201807
11,13,0,0,0,431,0,0,0,431,1523,1954,9,4.5,201807
11,14,0,0,0,348,0,0,0,348,1407,1755,8,4.5,201807
11,15,0,0,0,296,0,0,0,296,1321,1617,9,5,201807
12,1,0,0,0,237,0,0,0,237,1347,1584,10,3.8,201807
12,2,0,0,0,651,0,0,0,651,1505,2156,10,4.5,201807
12,3,0,0,0,614,0,0,0,614,1431,2045,11,4.2,201807
12,4,0,0,0,805,0,0,0,805,2669,3474,9,5,201807
12,5,0,0,0,456,0,0,0,456,1216,1672,10,4.25,201807
12,6,0,0,0,557,0,0,0,557,1022,1579,10,4.25,201807
12,7,0,0,0,476,0,0,0,476,2099,2575,8,3.666666667,201807
12,8,0,0,0,771,0,0,0,771,1181,1952,9,4.25,201807
12,9,0,0,0,598,0,0,0,598,1813,2411,9,4.666666667,201807
13,1,0,0,0,199,0,0,0,199,1997,2196,9,4.333333333,201807
13,2,0,0,0,349,0,0,0,349,901,1250,6,4.333333333,201807
13,3,0,0,0,364,0,0,0,364,1483,1847,12,4.25,201807
13,4,0,0,0,405,0,0,0,405,1746,2151,9,4.666666667,201807
13,5,0,0,0,551,0,0,0,551,2617,3168,9,4.75,201807
13,6,0,0,0,934,0,0,0,934,3131,4065,13,3.75,201807
13,7,0,0,0,446,0,0,0,446,2219,2665,9,4.5,201807
14,1,0,0,0,193,0,0,0,193,744,937,6,4.25,201807
14,2,0,0,0,297,0,0,0,297,1069,1366,6,4.666666667,201807
14,3,0,0,0,167,0,0,0,167,1330,1497,11,4.4,201807
14,4,0,0,0,485,0,0,0,485,2121,2606,12,5,201807
14,5,0,0,0,387,0,0,0,387,1979,2366,11,4.5,201807
14,6,0,0,0,463,0,0,0,463,1117,1580,11,5,201807
14,7,0,0,0,294,0,0,0,294,695,989,6,5,201807
14,8,0,0,0,884,0,0,0,884,2257,3141,13,3.666666667,201807
14,9,0,0,0,551,0,0,0,551,1857,2408,8,5,201807
14,10,0,0,0,553,0,0,0,553,1465,2018,7,5,201807
14,11,0,0,0,320,0,0,0,320,1215,1535,4,5,201807
14,12,0,0,0,363,0,0,0,363,1832,2195,11,4.5,201807
14,13,0,0,0,375,0,0,0,375,1491,1866,8,5,201807
14,14,0,0,0,384,0,0,0,384,1292,1676,7,5,201807
14,15,0,0,0,405,0,0,0,405,1401,1806,10,4.6,201807
14,16,0,0,0,395,0,0,0,395,1352,1747,5,5,201807
14,17,0,0,0,200,0,0,0,200,1049,1249,9,4.25,201807
14,18,0,0,0,272,0,0,0,272,1412,1684,10,4.4,201807
14,19,0,0,0,496,0,0,0,496,1826,2322,9,4.25,201807
14,20,0,0,0,160,0,0,0,160,1190,1350,10,4.666666667,201807
15,1,0,0,0,268,0,0,0,268,1522,1790,7,4.333333333,201807
15,2,0,0,0,518,0,0,0,518,1394,1912,6,5,201807
15,3,0,0,0,504,0,0,0,504,1085,1589,10,4.666666667,201807
15,4,0,0,0,683,0,0,0,683,1496,2179,4,5,201807
15,5,0,0,0,406,0,0,0,406,1516,1922,8,4.666666667,201807
15,6,0,0,0,594,0,0,0,594,1999,2593,7,5.5,201807
15,7,0,0,0,555,0,0,0,555,1552,2107,10,5,201807
15,8,0,0,0,258,0,0,0,258,870,1128,4,5,201807
15,9,0,0,0,328,0,0,0,328,1265,1593,9,4.5,201807
15,10,0,0,0,485,0,0,0,485,1622,2107,9,6,201807
15,11,0,0,0,581,0,0,0,581,1618,2199,8,5,201807
15,12,0,0,0,727,0,0,0,727,2748,3475,8,5,201807
15,13,0,0,0,382,0,0,0,382,767,1149,8,5,201807
15,14,0,0,0,313,0,0,0,313,502,815,4,5,201807
15,15,0,0,0,506,0,0,0,506,1424,1930,6,5,201807
15,16,0,0,0,690,0,0,0,690,2730,3420,8,5,201807
15,17,0,0,0,402,0,0,0,402,719,1121,8,5,201807
15,18,0,0,0,600,0,0,0,600,1603,2203,7,4.666666667,201807
15,19,0,0,0,816,0,0,0,816,3006,3822,13,5,201807
15,20,0,0,0,391,0,0,0,391,1125,1516,6,5,201807
15,21,0,0,0,263,0,0,0,263,946,1209,6,4.5,201807
15,22,0,0,0,946,0,0,0,946,2666,3612,14,5,201807
15,23,0,0,0,438,0,0,0,438,1531,1969,7,4.333333333,201807
15,24,0,0,0,354,0,0,0,354,1554,1908,4,5,201807
15,25,0,0,0,561,0,0,0,561,1491,2052,6,5,201807
15,26,0,0,0,385,0,0,0,385,943,1328,11,2.333333333,201807
15,27,0,0,0,754,0,0,0,754,2294,3048,9,4.666666667,201807
15,28,0,0,0,600,0,0,0,600,2572,3172,9,4.666666667,201807
15,29,0,0,0,754,0,0,0,754,1701,2455,8,5,201807
15,30,0,0,0,551,0,0,0,551,2091,2642,12,6,201807
15,31,0,0,0,505,0,0,0,505,1369,1874,6,5,201807
15,32,0,0,0,528,0,0,0,528,1962,2490,9,5,201807
15,33,0,0,0,605,0,0,0,605,921,1526,7,5,201807
15,34,0,0,0,544,0,0,0,544,1335,1879,8,5,201807
15,35,0,0,0,543,0,0,0,543,1910,2453,9,4.666666667,201807
15,36,0,0,0,422,0,0,0,422,2243,2665,9,4.5,201807
15,37,0,0,0,677,0,0,0,677,1843,2520,7,5,201807
15,38,0,0,0,495,0,0,0,495,1558,2053,6,4.5,201807
15,39,0,0,0,470,0,0,0,470,1499,1969,4,5,201807
15,40,0,0,0,642,0,0,0,642,2751,3393,9,5,201807
15,41,0,0,0,846,0,0,0,846,3322,4168,11,5,201807
16,1,0,0,0,172,0,0,0,172,986,1158,10,4.333333333,201807
16,2,0,0,0,293,0,0,0,293,995,1288,9,4.25,201807
16,3,0,0,0,430,0,0,0,430,2000,2430,10,4.25,201807
16,4,0,0,0,283,0,0,0,283,1269,1552,8,4.5,201807
16,5,0,0,0,377,0,0,0,377,1220,1597,10,4.666666667,201807
16,6,0,0,0,285,0,0,0,285,1231,1516,12,4.5,201807
16,7,0,0,0,322,0,0,0,322,1504,1826,9,4.5,201807
16,8,0,0,0,599,0,0,0,599,2347,2946,12,5,201807
16,9,0,0,0,339,0,0,0,339,1596,1935,10,5,201807
16,10,0,0,0,425,0,0,0,425,1829,2254,8,4,201807
16,11,0,0,0,258,0,0,0,258,1524,1782,12,4.4,201807
16,12,0,0,0,287,0,0,0,287,1797,2084,10,4.25,201807
17,1,0,0,0,675,0,0,0,675,2098,2773,12,3,201807
17,2,0,0,0,424,0,0,0,424,2030,2454,9,4.666666667,201807
17,3,0,0,0,759,0,0,0,759,2241,3000,8,4.5,201807
17,4,0,0,0,483,0,0,0,483,1762,2245,10,4.666666667,201807
17,5,0,0,0,308,0,0,0,308,852,1160,5,4.5,201807
18,1,0,0,0,213,0,0,0,213,903,1116,9,4.2,201807
18,2,0,0,0,504,0,0,0,504,3160,3664,10,4,201807
18,3,0,0,0,297,0,0,0,297,1292,1589,9,4.5,201807
19,1,0,0,0,402,0,0,0,402,1907,2309,9,5,201807
19,2,0,0,0,584,0,0,0,584,2497,3081,10,5,201807
19,3,0,0,0,504,0,0,0,504,2170,2674,8,5,201807
19,4,0,0,0,243,0,0,0,243,961,1204,5,5,201807
19,5,0,0,0,690,0,0,0,690,2477,3167,8,5,201807
19,6,0,0,0,307,0,0,0,307,814,1121,5,5,201807
19,7,0,0,0,252,0,0,0,252,1457,1709,10,4.25,201807
19,8,0,0,0,75,0,0,0,75,661,736,7,5,201807
19,9,0,0,0,326,0,0,0,326,1013,1339,9,4.25,201807
19,10,0,0,0,461,0,0,0,461,1312,1773,7,2.666666667,201807
19,11,0,0,0,899,0,0,0,899,3618,4517,13,5,201807
19,12,0,0,0,249,0,0,0,249,1047,1296,8,4.666666667,201807
20,1,0,0,0,385,0,0,0,385,1079,1464,7,4.5,201807
20,2,0,0,0,235,0,0,0,235,1015,1250,6,4.333333333,201807
20,3,0,0,0,419,0,0,0,419,896,1315,6,4.333333333,201807
20,4,0,0,0,244,0,0,0,244,840,1084,6,4.333333333,201807
20,5,0,0,0,458,0,0,0,458,1745,2203,11,4.25,201807
20,6,0,0,0,634,0,0,0,634,985,1619,8,4.25,201807
20,7,0,0,0,469,0,0,0,469,1916,2385,8,4.75,201807
20,8,0,0,0,999,0,0,0,999,4031,5030,15,4,201807
20,9,0,0,0,293,0,0,0,293,1437,1730,8,4.666666667,201807
20,10,0,0,0,513,0,0,0,513,1015,1528,9,4.25,201807
21,1,0,0,0,387,0,0,0,387,1882,2269,9,4.4,201807
21,2,0,0,0,209,0,0,0,209,1208,1417,9,4.2,201807
21,3,0,0,0,211,0,0,0,211,1145,1356,8,4.5,201807
21,4,0,0,0,227,0,0,0,227,733,960,6,4.25,201807
21,5,0,0,0,531,0,0,0,531,2140,2671,8,4.666666667,201807
21,6,0,0,0,506,0,0,0,506,2299,2805,6,6,201807
21,7,0,0,0,223,0,0,0,223,1948,2171,9,4.666666667,201807
21,8,0,0,0,288,0,0,0,288,945,1233,10,4.2,201807
21,9,0,0,0,532,0,0,0,532,2502,3034,9,5,201807
21,10,0,0,0,480,0,0,0,480,1184,1664,7,5,201807
21,11,0,0,0,82,0,0,0,82,776,858,6,3.5,201807
21,12,0,0,0,1003,0,0,0,1003,4967,5970,15,4,201807
21,13,0,0,0,388,0,0,0,388,1712,2100,8,4.666666667,201807
21,14,0,0,0,196,0,0,0,196,1519,1715,13,4.333333333,201807
21,15,0,0,0,452,0,0,0,452,1523,1975,7,4.5,201807
22,1,0,0,0,483,0,0,0,483,1642,2125,11,4.2,201807
22,2,0,0,0,460,0,0,0,460,1742,2202,7,4.5,201807
22,3,0,0,0,859,0,0,0,859,3231,4090,10,4.666666667,201807
22,4,0,0,0,679,0,0,0,679,2865,3544,12,3.2,201807
22,5,0,0,0,337,0,0,0,337,2057,2394,10,4.5,201807
23,1,0,0,0,820,0,0,0,820,3128,3948,14,4.6,201807
23,2,0,0,0,474,0,0,0,474,1514,1988,10,3.4,201807
23,3,0,0,0,430,0,0,0,430,2955,3385,11,5,201807
23,4,0,0,0,518,0,0,0,518,2489,3007,10,4,201807
24,1,0,0,0,200,0,0,0,200,1450,1650,11,4.2,201807
24,2,0,0,0,305,0,0,0,305,726,1031,6,4.5,201807
24,3,0,0,0,603,0,0,0,603,1961,2564,9,4.25,201807
24,4,0,0,0,458,0,0,0,458,1287,1745,5,4.5,201807
24,5,0,0,0,563,0,0,0,563,2259,2822,10,4,201807
24,6,0,0,0,696,0,0,0,696,2234,2930,11,3.666666667,201807
24,7,0,0,0,232,0,0,0,232,2366,2598,9,4.25,201807
25,1,0,0,0,355,0,0,0,355,1484,1839,14,4.75,201807
25,2,0,0,0,492,0,0,0,492,2504,2996,7,4.5,201807
25,3,0,0,0,444,0,0,0,444,2041,2485,9,4.6,201807
25,4,0,0,0,374,0,0,0,374,1243,1617,8,4.333333333,201807
25,5,0,0,0,640,0,0,0,640,2540,3180,11,3.75,201807
25,6,0,0,0,332,0,0,0,332,2000,2332,9,4.75,201807
25,7,0,0,0,527,0,0,0,527,1995,2522,7,5,201807
26,1,0,0,0,376,0,0,0,376,1705,2081,9,4.5,201807
26,2,0,0,0,530,0,0,0,530,1975,2505,13,4.4,201807
26,3,0,0,0,859,0,0,0,859,2736,3595,15,3.666666667,201807
26,4,0,0,0,319,0,0,0,319,1116,1435,10,4.2,201807
26,5,0,0,0,261,0,0,0,261,454,715,3,4.5,201807
26,6,0,0,0,550,0,0,0,550,1489,2039,10,4.333333333,201807
26,7,0,0,0,519,0,0,0,519,1364,1883,10,4.5,201807
27,1,0,0,0,591,0,0,0,591,1819,2410,9,4.5,201807
27,2,0,0,0,971,0,0,0,971,1765,2736,8,4.666666667,201807
27,3,0,0,0,521,0,0,0,521,1995,2516,7,4.666666667,201807
27,4,0,0,0,844,0,0,0,844,2327,3171,10,2.75,201807
27,5,0,0,0,579,0,0,0,579,866,1445,6,4.333333333,201807
27,6,0,0,0,648,0,0,0,648,2228,2876,9,4.333333333,201807
28,1,0,0,0,340,0,0,0,340,2482,2822,13,5,201807
28,2,0,0,0,376,0,0,0,376,2571,2947,14,5,201807
28,3,0,0,0,226,0,0,0,226,889,1115,7,4.333333333,201807
28,4,0,0,0,418,0,0,0,418,2439,2857,16,5,201807
28,5,0,0,0,353,0,0,0,353,1367,1720,12,3.166666667,201807
28,6,0,0,0,269,0,0,0,269,2321,2590,14,4.166666667,201807
28,7,0,0,0,526,0,0,0,526,2565,3091,8,5,201807
28,8,0,0,0,372,0,0,0,372,1055,1427,9,5,201807
28,9,0,0,0,227,0,0,0,227,1688,1915,11,4.75,201807
29,1,0,0,0,578,0,0,0,578,2209,2787,10,4.5,201807
29,2,0,0,0,557,0,0,0,557,2371,2928,14,3.5,201807
29,3,0,0,0,371,0,0,0,371,1401,1772,7,4.666666667,201807
30,1,0,0,0,255,0,0,0,255,712,967,7,4.333333333,201807
30,2,0,0,0,103,0,0,0,103,1423,1526,8,4.25,201807
30,3,0,0,0,221,0,0,0,221,1838,2059,6,4.666666667,201807
30,4,0,0,0,277,0,0,0,277,1396,1673,8,5,201807
30,5,0,0,0,356,0,0,0,356,1498,1854,7,4.5,201807
30,6,0,0,0,305,0,0,0,305,979,1284,9,4.333333333,201807
30,7,0,0,0,247,0,0,0,247,1425,1672,12,4.25,201807
30,8,0,0,0,323,0,0,0,323,1628,1951,11,4.4,201807
30,9,0,0,0,231,0,0,0,231,1480,1711,8,4.5,201807
30,10,0,0,0,417,0,0,0,417,2453,2870,9,3.666666667,201807
30,11,0,0,0,531,0,0,0,531,1920,2451,6,4.5,201807
30,12,0,0,0,618,0,0,0,618,2836,3454,11,5,201807
30,13,0,0,0,345,0,0,0,345,1931,2276,10,4.4,201807
30,14,0,0,0,384,0,0,0,384,1532,1916,9,4.5,201807
30,15,0,0,0,382,0,0,0,382,1687,2069,11,4.666666667,201807
30,16,0,0,0,289,0,0,0,289,1983,2272,10,4.333333333,201807
30,17,0,0,0,592,0,0,0,592,1081,1673,8,4.5,201807
30,18,0,0,0,171,0,0,0,171,1062,1233,8,4.25,201807
30,19,0,0,0,305,0,0,0,305,1174,1479,13,4.6,201807
30,20,0,0,0,627,0,0,0,627,1699,2326,11,4.4,201807
31,1,0,0,0,511,0,0,0,511,1196,1707,8,4.5,201807
31,2,0,0,0,271,0,0,0,271,1057,1328,7,4.333333333,201807
31,3,0,0,0,1014,0,0,0,1014,3386,4400,20,4,201807
31,4,0,0,0,445,0,0,0,445,1313,1758,6,3.5,201807
31,5,0,0,0,314,0,0,0,314,715,1029,7,4.333333333,201807
32,1,0,0,0,233,0,0,0,233,1270,1503,12,4.2,201807
32,2,0,0,0,174,0,0,0,174,1277,1451,13,4.142857143,201807
32,3,0,0,0,326,0,0,0,326,1459,1785,15,3.833333333,201807
32,4,0,0,0,418,0,0,0,418,1772,2190,13,3.666666667,201807
1,1,0,0,0,342,0,0,0,342,1833,2175,13,5.5,201808
1,2,0,0,0,528,0,0,0,528,2901,3429,12,4.8,201808
1,3,0,0,0,675,0,0,0,675,2129,2804,13,4.8,201808
2,1,0,0,0,428,0,0,0,428,1787,2215,11,6,201808
2,2,0,0,0,674,0,0,0,674,2503,3177,9,5,201808
2,3,0,0,0,528,0,0,0,528,2207,2735,14,5.75,201808
2,4,0,0,0,353,0,0,0,353,1506,1859,13,6,201808
2,5,0,0,0,941,0,0,0,941,2970,3911,14,6.333333333,201808
2,6,0,0,0,536,0,0,0,536,1437,1973,7,6,201808
2,7,0,0,0,687,0,0,0,687,2253,2940,12,5.75,201808
2,8,0,0,0,765,0,0,0,765,1598,2363,8,6,201808
3,1,0,0,0,564,0,0,0,564,1612,2176,15,5.142857143,201808
3,2,0,0,0,529,0,0,0,529,1437,1966,9,5.666666667,201808
4,1,0,0,0,584,0,0,0,584,1929,2513,15,3.666666667,201808
4,2,0,0,0,760,0,0,0,760,1911,2671,14,4.2,201808
5,1,0,0,0,447,0,0,0,447,2385,2832,9,5.666666667,201808
5,2,0,0,0,442,0,0,0,442,1689,2131,10,5.2,201808
5,3,0,0,0,406,0,0,0,406,2021,2427,9,5.5,201808
5,4,0,0,0,583,0,0,0,583,2441,3024,11,4.5,201808
5,5,0,0,0,541,0,0,0,541,2338,2879,8,6,201808
5,6,0,0,0,325,0,0,0,325,1896,2221,11,5.5,201808
5,7,0,0,0,309,0,0,0,309,1403,1712,10,3.666666667,201808
6,1,0,0,0,407,0,0,0,407,1574,1981,14,4.285714286,201808
6,2,0,0,0,289,0,0,0,289,1291,1580,9,5.666666667,201808
7,1,0,0,0,594,0,0,0,594,1843,2437,9,5.25,201808
7,2,0,0,0,1163,0,0,0,1163,2535,3698,9,5.25,201808
7,3,0,0,0,362,0,0,0,362,1776,2138,7,5.333333333,201808
7,4,0,0,0,483,0,0,0,483,2706,3189,11,5.4,201808
7,5,0,0,0,698,0,0,0,698,2504,3202,11,5.666666667,201808
7,6,0,0,0,742,0,0,0,742,2478,3220,8,4,201808
7,7,0,0,0,973,0,0,0,973,1868,2841,8,5.5,201808
7,8,0,0,0,828,0,0,0,828,3517,4345,12,5.25,201808
7,9,0,0,0,934,0,0,0,934,2386,3320,11,5,201808
7,10,0,0,0,1140,0,0,0,1140,2203,3343,9,5.5,201808
7,11,0,0,0,258,0,0,0,258,623,881,6,5.333333333,201808
7,12,0,0,0,790,0,0,0,790,2458,3248,9,5.5,201808
7,13,0,0,0,520,0,0,0,520,1593,2113,9,5.25,201808
8,1,0,0,0,237,0,0,0,237,943,1180,4,6,201808
8,2,0,0,0,335,0,0,0,335,1676,2011,17,5.5,201808
8,3,0,0,0,332,0,0,0,332,1319,1651,5,6,201808
8,4,0,0,0,279,0,0,0,279,1609,1888,9,6,201808
8,5,0,0,0,244,0,0,0,244,2041,2285,10,5.25,201808
8,6,0,0,0,605,0,0,0,605,2072,2677,8,4.333333333,201808
8,7,0,0,0,329,0,0,0,329,2096,2425,8,5.25,201808
8,8,0,0,0,427,0,0,0,427,1460,1887,10,3.5,201808
8,9,0,0,0,111,0,0,0,111,1102,1213,10,5.2,201808
9,1,0,0,0,340,0,0,0,340,996,1336,6,7,201808
9,2,0,0,0,1607,0,0,0,1607,4169,5776,12,6,201808
9,3,0,0,0,853,0,0,0,853,1591,2444,7,6,201808
9,4,0,0,0,814,0,0,0,814,1817,2631,11,6,201808
9,5,0,0,0,671,0,0,0,671,1155,1826,7,6,201808
9,6,0,0,0,409,0,0,0,409,957,1366,7,6,201808
9,7,0,0,0,647,0,0,0,647,1139,1786,9,6,201808
9,8,0,0,0,494,0,0,0,494,1307,1801,6,7,201808
9,9,0,0,0,512,0,0,0,512,1537,2049,5,6,201808
9,10,0,0,0,798,0,0,0,798,1150,1948,6,6,201808
9,11,0,0,0,1030,0,0,0,1030,1857,2887,7,6,201808
9,12,0,0,0,944,0,0,0,944,2125,3069,11,6,201808
9,13,0,0,0,699,0,0,0,699,1722,2421,4,6,201808
9,14,0,0,0,520,0,0,0,520,947,1467,5,6,201808
9,15,0,0,0,2030,0,0,0,2030,3722,5752,11,3.75,201808
9,16,0,0,0,1271,0,0,0,1271,2830,4101,15,6,201808
9,17,0,0,0,708,0,0,0,708,1198,1906,6,6,201808
9,18,0,0,0,1046,0,0,0,1046,2411,3457,12,6,201808
9,19,0,0,0,877,0,0,0,877,1628,2505,5,6,201808
9,20,0,0,0,95,0,0,0,95,528,623,5,6,201808
9,21,0,0,0,353,0,0,0,353,1013,1366,3,6,201808
9,22,0,0,0,553,0,0,0,553,1220,1773,5,6,201808
9,23,0,0,0,876,0,0,0,876,2275,3151,7,7,201808
9,24,0,0,0,1580,0,0,0,1580,2692,4272,13,6.5,201808
10,1,0,0,0,465,0,0,0,465,922,1387,12,4.666666667,201808
10,2,0,0,0,418,0,0,0,418,1696,2114,9,5.25,201808
10,3,0,0,0,383,0,0,0,383,1156,1539,12,5.4,201808
10,4,0,0,0,645,0,0,0,645,1934,2579,17,3.75,201808
11,1,0,0,0,684,0,0,0,684,2246,2930,6,5.666666667,201808
11,2,0,0,0,403,0,0,0,403,1222,1625,7,6,201808
11,3,0,0,0,425,0,0,0,425,918,1343,3,6,201808
11,4,0,0,0,406,0,0,0,406,1241,1647,10,3.8,201808
11,5,0,0,0,740,0,0,0,740,2062,2802,8,6.5,201808
11,6,0,0,0,434,0,0,0,434,1289,1723,8,5.666666667,201808
11,7,0,0,0,652,0,0,0,652,1782,2434,9,5.5,201808
11,8,0,0,0,528,0,0,0,528,1549,2077,9,5.75,201808
11,9,0,0,0,615,0,0,0,615,1686,2301,10,5.666666667,201808
11,10,0,0,0,546,0,0,0,546,1601,2147,11,5.6,201808
11,11,0,0,0,375,0,0,0,375,1197,1572,4,6,201808
11,12,0,0,0,701,0,0,0,701,2539,3240,7,6,201808
11,13,0,0,0,427,0,0,0,427,1461,1888,9,5.5,201808
11,14,0,0,0,449,0,0,0,449,1585,2034,8,5.5,201808
11,15,0,0,0,383,0,0,0,383,1113,1496,9,6,201808
12,1,0,0,0,324,0,0,0,324,1077,1401,10,5.2,201808
12,2,0,0,0,609,0,0,0,609,1781,2390,10,5.5,201808
12,3,0,0,0,675,0,0,0,675,2150,2825,11,5.2,201808
12,4,0,0,0,737,0,0,0,737,2130,2867,9,6,201808
12,5,0,0,0,526,0,0,0,526,1249,1775,10,5.25,201808
12,6,0,0,0,584,0,0,0,584,1494,2078,10,5.25,201808
12,7,0,0,0,593,0,0,0,593,2027,2620,8,4.666666667,201808
12,8,0,0,0,702,0,0,0,702,1805,2507,9,5.25,201808
12,9,0,0,0,641,0,0,0,641,1600,2241,9,5.333333333,201808
13,1,0,0,0,193,0,0,0,193,2027,2220,9,5.333333333,201808
13,2,0,0,0,372,0,0,0,372,1959,2331,6,5.333333333,201808
13,3,0,0,0,532,0,0,0,532,1807,2339,12,5.25,201808
13,4,0,0,0,513,0,0,0,513,2381,2894,9,5.666666667,201808
13,5,0,0,0,651,0,0,0,651,2250,2901,9,5.75,201808
13,6,0,0,0,1072,0,0,0,1072,4827,5899,13,4.5,201808
13,7,0,0,0,686,0,0,0,686,1865,2551,9,5.5,201808
14,1,0,0,0,188,0,0,0,188,898,1086,6,5.5,201808
14,2,0,0,0,248,0,0,0,248,1256,1504,5,5.666666667,201808
14,3,0,0,0,197,0,0,0,197,1477,1674,8,5.4,201808
14,4,0,0,0,573,0,0,0,573,1735,2308,11,6,201808
14,5,0,0,0,435,0,0,0,435,1649,2084,9,5.5,201808
14,6,0,0,0,629,0,0,0,629,2275,2904,11,6,201808
14,7,0,0,0,278,0,0,0,278,1034,1312,6,6,201808
14,8,0,0,0,1051,0,0,0,1051,3728,4779,13,4.333333333,201808
14,9,0,0,0,621,0,0,0,621,2221,2842,8,6,201808
14,10,0,0,0,623,0,0,0,623,1626,2249,7,5,201808
14,11,0,0,0,301,0,0,0,301,897,1198,4,6,201808
14,12,0,0,0,384,0,0,0,384,1904,2288,9,5.5,201808
14,13,0,0,0,408,0,0,0,408,1748,2156,6,6,201808
14,14,0,0,0,492,0,0,0,492,1603,2095,7,6,201808
14,15,0,0,0,512,0,0,0,512,1976,2488,10,5.6,201808
14,16,0,0,0,568,0,0,0,568,1245,1813,5,6,201808
14,17,0,0,0,220,0,0,0,220,1496,1716,7,5.25,201808
14,18,0,0,0,359,0,0,0,359,1729,2088,9,5.4,201808
14,19,0,0,0,579,0,0,0,579,2101,2680,8,5.25,201808
14,20,0,0,0,189,0,0,0,189,1381,1570,10,5.666666667,201808
15,1,0,0,0,222,0,0,0,222,1920,2142,7,5.333333333,201808
15,2,0,0,0,536,0,0,0,536,1585,2121,6,6,201808
15,3,0,0,0,694,0,0,0,694,2001,2695,10,5.666666667,201808
15,4,0,0,0,707,0,0,0,707,1394,2101,4,6,201808
15,5,0,0,0,430,0,0,0,430,2392,2822,8,5.666666667,201808
15,6,0,0,0,682,0,0,0,682,1612,2294,7,6.5,201808
15,7,0,0,0,646,0,0,0,646,1360,2006,10,6,201808
15,8,0,0,0,279,0,0,0,279,770,1049,4,6,201808
15,9,0,0,0,357,0,0,0,357,1758,2115,9,5.75,201808
15,10,0,0,0,396,0,0,0,396,1170,1566,9,7,201808
15,11,0,0,0,709,0,0,0,709,1436,2145,8,6,201808
15,12,0,0,0,779,0,0,0,779,2354,3133,8,6,201808
15,13,0,0,0,535,0,0,0,535,949,1484,8,6,201808
15,14,0,0,0,382,0,0,0,382,824,1206,4,6,201808
15,15,0,0,0,636,0,0,0,636,1331,1967,6,6,201808
15,16,0,0,0,840,0,0,0,840,2760,3600,8,6,201808
15,17,0,0,0,382,0,0,0,382,863,1245,8,6,201808
15,18,0,0,0,780,0,0,0,780,2043,2823,7,5.666666667,201808
15,19,0,0,0,1166,0,0,0,1166,2684,3850,13,6,201808
15,20,0,0,0,410,0,0,0,410,1070,1480,6,6,201808
15,21,0,0,0,257,0,0,0,257,1064,1321,6,5.5,201808
15,22,0,0,0,1177,0,0,0,1177,2507,3684,14,6,201808
15,23,0,0,0,607,0,0,0,607,1985,2592,7,5.333333333,201808
15,24,0,0,0,430,0,0,0,430,1140,1570,4,6,201808
15,25,0,0,0,587,0,0,0,587,1304,1891,6,6,201808
15,26,0,0,0,442,0,0,0,442,1166,1608,11,2.666666667,201808
15,27,0,0,0,887,0,0,0,887,2280,3167,9,5.666666667,201808
15,28,0,0,0,551,0,0,0,551,2252,2803,9,5.666666667,201808
15,29,0,0,0,816,0,0,0,816,3060,3876,8,6,201808
15,30,0,0,0,553,0,0,0,553,2305,2858,12,7,201808
15,31,0,0,0,608,0,0,0,608,1400,2008,6,6,201808
15,32,0,0,0,522,0,0,0,522,1552,2074,9,6,201808
15,33,0,0,0,535,0,0,0,535,1694,2229,7,6,201808
15,34,0,0,0,682,0,0,0,682,1794,2476,8,6,201808
15,35,0,0,0,685,0,0,0,685,2214,2899,9,5.666666667,201808
15,36,0,0,0,544,0,0,0,544,2309,2853,9,5.5,201808
15,37,0,0,0,729,0,0,0,729,1892,2621,7,6,201808
15,38,0,0,0,544,0,0,0,544,1540,2084,6,5.5,201808
15,39,0,0,0,450,0,0,0,450,1279,1729,4,6,201808
15,40,0,0,0,694,0,0,0,694,2566,3260,9,6,201808
15,41,0,0,0,926,0,0,0,926,2811,3737,11,6,201808
16,1,0,0,0,231,0,0,0,231,1425,1656,7,5.333333333,201808
16,2,0,0,0,331,0,0,0,331,1102,1433,9,5.25,201808
16,3,0,0,0,390,0,0,0,390,1416,1806,10,5.25,201808
16,4,0,0,0,354,0,0,0,354,1448,1802,8,5.5,201808
16,5,0,0,0,395,0,0,0,395,1264,1659,10,5.666666667,201808
16,6,0,0,0,300,0,0,0,300,1596,1896,12,5.5,201808
16,7,0,0,0,335,0,0,0,335,1441,1776,9,5.5,201808
16,8,0,0,0,715,0,0,0,715,1781,2496,12,6,201808
16,9,0,0,0,408,0,0,0,408,1429,1837,7,6,201808
16,10,0,0,0,446,0,0,0,446,1834,2280,8,6,201808
16,11,0,0,0,286,0,0,0,286,1977,2263,10,5.4,201808
16,12,0,0,0,303,0,0,0,303,971,1274,10,5.25,201808
17,1,0,0,0,768,0,0,0,768,1953,2721,11,3.5,201808
17,2,0,0,0,509,0,0,0,509,1655,2164,8,5.666666667,201808
17,3,0,0,0,784,0,0,0,784,3528,4312,8,5.5,201808
17,4,0,0,0,540,0,0,0,540,2002,2542,10,5.666666667,201808
17,5,0,0,0,253,0,0,0,253,898,1151,5,5.5,201808
18,1,0,0,0,269,0,0,0,269,1359,1628,9,5.2,201808
18,2,0,0,0,527,0,0,0,527,1984,2511,10,4.75,201808
18,3,0,0,0,304,0,0,0,304,1479,1783,9,5.5,201808
19,1,0,0,0,485,0,0,0,485,2480,2965,9,6,201808
19,2,0,0,0,653,0,0,0,653,2177,2830,10,6,201808
19,3,0,0,0,515,0,0,0,515,2661,3176,8,6,201808
19,4,0,0,0,295,0,0,0,295,869,1164,5,6,201808
19,5,0,0,0,750,0,0,0,750,2810,3560,8,6,201808
19,6,0,0,0,330,0,0,0,330,1253,1583,5,6,201808
19,7,0,0,0,261,0,0,0,261,1659,1920,10,5.5,201808
19,8,0,0,0,102,0,0,0,102,814,916,7,6,201808
19,9,0,0,0,437,0,0,0,437,1667,2104,9,5.25,201808
19,10,0,0,0,496,0,0,0,496,1284,1780,8,3.333333333,201808
19,11,0,0,0,1031,0,0,0,1031,3229,4260,13,6,201808
19,12,0,0,0,291,0,0,0,291,1374,1665,8,5.666666667,201808
20,1,0,0,0,428,0,0,0,428,1902,2330,7,5.5,201808
20,2,0,0,0,119,0,0,0,119,869,988,6,5.333333333,201808
20,3,0,0,0,672,0,0,0,672,1050,1722,6,5.333333333,201808
20,4,0,0,0,234,0,0,0,234,1489,1723,6,5.333333333,201808
20,5,0,0,0,449,0,0,0,449,2320,2769,11,5.25,201808
20,6,0,0,0,618,0,0,0,618,1999,2617,8,5.25,201808
20,7,0,0,0,476,0,0,0,476,1956,2432,7,5.75,201808
20,8,0,0,0,1138,0,0,0,1138,3197,4335,15,4.333333333,201808
20,9,0,0,0,400,0,0,0,400,1435,1835,8,5.666666667,201808
20,10,0,0,0,399,0,0,0,399,1076,1475,9,5.25,201808
21,1,0,0,0,513,0,0,0,513,1801,2314,9,5.4,201808
21,2,0,0,0,180,0,0,0,180,1348,1528,9,5.2,201808
21,3,0,0,0,331,0,0,0,331,1643,1974,8,5.5,201808
21,4,0,0,0,223,0,0,0,223,748,971,6,5.25,201808
21,5,0,0,0,449,0,0,0,449,1722,2171,8,5.666666667,201808
21,6,0,0,0,630,0,0,0,630,1784,2414,6,7,201808
21,7,0,0,0,226,0,0,0,226,2030,2256,9,5.666666667,201808
21,8,0,0,0,476,0,0,0,476,1241,1717,10,5.2,201808
21,9,0,0,0,582,0,0,0,582,2641,3223,9,6,201808
21,10,0,0,0,561,0,0,0,561,1715,2276,7,6,201808
21,11,0,0,0,108,0,0,0,108,1153,1261,6,3.5,201808
21,12,0,0,0,1345,0,0,0,1345,3493,4838,14,4.333333333,201808
21,13,0,0,0,377,0,0,0,377,1894,2271,8,5.666666667,201808
21,14,0,0,0,228,0,0,0,228,1752,1980,13,5.333333333,201808
21,15,0,0,0,450,0,0,0,450,1695,2145,7,5.5,201808
22,1,0,0,0,501,0,0,0,501,2259,2760,11,5.2,201808
22,2,0,0,0,494,0,0,0,494,1396,1890,7,5.5,201808
22,3,0,0,0,972,0,0,0,972,2910,3882,10,5.666666667,201808
22,4,0,0,0,937,0,0,0,937,2328,3265,12,3.8,201808
22,5,0,0,0,418,0,0,0,418,2080,2498,10,5.5,201808
23,1,0,0,0,820,0,0,0,820,3098,3918,14,5.6,201808
23,2,0,0,0,526,0,0,0,526,1373,1899,11,4.4,201808
23,3,0,0,0,464,0,0,0,464,2381,2845,11,6,201808
23,4,0,0,0,506,0,0,0,506,1607,2113,10,4.5,201808
24,1,0,0,0,230,0,0,0,230,1983,2213,11,5.2,201808
24,2,0,0,0,369,0,0,0,369,1161,1530,6,5.5,201808
24,3,0,0,0,782,0,0,0,782,2591,3373,9,5.25,201808
24,4,0,0,0,481,0,0,0,481,1589,2070,5,5.5,201808
24,5,0,0,0,631,0,0,0,631,2572,3203,9,4.5,201808
24,6,0,0,0,840,0,0,0,840,2702,3542,11,4.333333333,201808
24,7,0,0,0,218,0,0,0,218,2833,3051,9,5.25,201808
25,1,0,0,0,414,0,0,0,414,1692,2106,14,5.75,201808
25,2,0,0,0,546,0,0,0,546,2279,2825,7,5.5,201808
25,3,0,0,0,498,0,0,0,498,1577,2075,9,5.6,201808
25,4,0,0,0,452,0,0,0,452,1219,1671,8,5.333333333,201808
25,5,0,0,0,593,0,0,0,593,2036,2629,9,4.25,201808
25,6,0,0,0,363,0,0,0,363,1695,2058,9,5.75,201808
25,7,0,0,0,519,0,0,0,519,1700,2219,7,6,201808
26,1,0,0,0,394,0,0,0,394,1345,1739,9,5.5,201808
26,2,0,0,0,549,0,0,0,549,1755,2304,13,5.4,201808
26,3,0,0,0,942,0,0,0,942,2485,3427,15,4.666666667,201808
26,4,0,0,0,369,0,0,0,369,1426,1795,10,5.2,201808
26,5,0,0,0,217,0,0,0,217,477,694,3,5.5,201808
26,6,0,0,0,627,0,0,0,627,1544,2171,10,5.333333333,201808
26,7,0,0,0,506,0,0,0,506,1690,2196,10,5.5,201808
27,1,0,0,0,906,0,0,0,906,2009,2915,9,5.5,201808
27,2,0,0,0,810,0,0,0,810,2185,2995,8,5.666666667,201808
27,3,0,0,0,590,0,0,0,590,1828,2418,7,5.666666667,201808
27,4,0,0,0,1018,0,0,0,1018,2071,3089,10,3.5,201808
27,5,0,0,0,664,0,0,0,664,1176,1840,6,5.333333333,201808
27,6,0,0,0,903,0,0,0,903,2085,2988,9,5.333333333,201808
28,1,0,0,0,342,0,0,0,342,2520,2862,13,6,201808
28,2,0,0,0,376,0,0,0,376,2112,2488,13,6,201808
28,3,0,0,0,237,0,0,0,237,1224,1461,7,5.333333333,201808
28,4,0,0,0,477,0,0,0,477,3839,4316,16,6,201808
28,5,0,0,0,363,0,0,0,363,2182,2545,12,4.166666667,201808
28,6,0,0,0,214,0,0,0,214,3580,3794,13,5.166666667,201808
28,7,0,0,0,523,0,0,0,523,3032,3555,6,6,201808
28,8,0,0,0,383,0,0,0,383,1357,1740,9,6,201808
28,9,0,0,0,235,0,0,0,235,1766,2001,11,5.75,201808
29,1,0,0,0,542,0,0,0,542,1937,2479,10,5.5,201808
29,2,0,0,0,590,0,0,0,590,3155,3745,15,4.333333333,201808
29,3,0,0,0,397,0,0,0,397,1369,1766,7,5.666666667,201808
30,1,0,0,0,302,0,0,0,302,1126,1428,7,5.333333333,201808
30,2,0,0,0,87,0,0,0,87,1910,1997,8,5.25,201808
30,3,0,0,0,211,0,0,0,211,1687,1898,6,5.666666667,201808
30,4,0,0,0,271,0,0,0,271,1370,1641,8,6,201808
30,5,0,0,0,432,0,0,0,432,1846,2278,7,5.5,201808
30,6,0,0,0,357,0,0,0,357,1267,1624,9,5.333333333,201808
30,7,0,0,0,257,0,0,0,257,2436,2693,12,5.25,201808
30,8,0,0,0,417,0,0,0,417,2323,2740,11,5.4,201808
30,9,0,0,0,310,0,0,0,310,1814,2124,8,5.5,201808
30,10,0,0,0,480,0,0,0,480,2061,2541,9,4.333333333,201808
30,11,0,0,0,563,0,0,0,563,1800,2363,6,5.5,201808
30,12,0,0,0,648,0,0,0,648,3310,3958,11,6,201808
30,13,0,0,0,370,0,0,0,370,2286,2656,10,5.4,201808
30,14,0,0,0,488,0,0,0,488,1873,2361,9,5.5,201808
30,15,0,0,0,470,0,0,0,470,2111,2581,11,5.666666667,201808
30,16,0,0,0,383,0,0,0,383,2822,3205,10,5.333333333,201808
30,17,0,0,0,489,0,0,0,489,1287,1776,8,5.5,201808
30,18,0,0,0,234,0,0,0,234,1463,1697,8,5.25,201808
30,19,0,0,0,276,0,0,0,276,2017,2293,13,5.6,201808
30,20,0,0,0,553,0,0,0,553,2156,2709,11,5.4,201808
31,1,0,0,0,637,0,0,0,637,1382,2019,8,5.5,201808
31,2,0,0,0,179,0,0,0,179,1081,1260,7,5.333333333,201808
31,3,0,0,0,1160,0,0,0,1160,5033,6193,20,4.75,201808
31,4,0,0,0,408,0,0,0,408,1428,1836,6,4,201808
31,5,0,0,0,381,0,0,0,381,1182,1563,7,5.333333333,201808
32,1,0,0,0,309,0,0,0,309,1686,1995,12,5.2,201808
32,2,0,0,0,215,0,0,0,215,1815,2030,13,5.142857143,201808
32,3,0,0,0,370,0,0,0,370,2124,2494,15,4.666666667,201808
32,4,0,0,0,568,0,0,0,568,1930,2498,13,4.5,201808
1,1,0,0,0,429,0,0,0,429,1316,1745,13,5.5,201809
1,2,0,0,0,691,0,0,0,691,1427,2118,12,4.8,201809
1,3,0,0,0,772,0,0,0,772,1365,2137,13,6,201809
2,1,0,0,0,428,0,0,0,428,1050,1478,11,6,201809
2,2,0,0,0,761,0,0,0,761,1370,2131,9,6.5,201809
2,3,0,0,0,671,0,0,0,671,1791,2462,14,5.25,201809
2,4,0,0,0,402,0,0,0,402,754,1156,13,6,201809
2,5,0,0,0,1146,0,0,0,1146,1703,2849,14,6.333333333,201809
2,6,0,0,0,587,0,0,0,587,884,1471,7,6,201809
2,7,0,0,0,627,0,0,0,627,1385,2012,12,5.75,201809
2,8,0,0,0,822,0,0,0,822,1120,1942,8,6,201809
3,1,0,0,0,508,0,0,0,508,1111,1619,15,5.833333333,201809
3,2,0,0,0,570,0,0,0,570,775,1345,9,5.666666667,201809
4,1,0,0,0,733,0,0,0,733,1291,2024,12,5.2,201809
4,2,0,0,0,825,0,0,0,825,2292,3117,14,5.2,201809
5,1,0,0,0,445,0,0,0,445,1625,2070,9,5.666666667,201809
5,2,0,0,0,450,0,0,0,450,1358,1808,10,5.2,201809
5,3,0,0,0,347,0,0,0,347,1016,1363,9,5.5,201809
5,4,0,0,0,630,0,0,0,630,1642,2272,11,6,201809
5,5,0,0,0,584,0,0,0,584,1228,1812,8,6,201809
5,6,0,0,0,277,0,0,0,277,1517,1794,11,5.5,201809
5,7,0,0,0,318,0,0,0,318,1158,1476,10,3.666666667,201809
6,1,0,0,0,471,0,0,0,471,951,1422,12,4.833333333,201809
6,2,0,0,0,376,0,0,0,376,956,1332,9,5.666666667,201809
7,1,0,0,0,490,0,0,0,490,2190,2680,9,5.25,201809
7,2,0,0,0,839,0,0,0,839,3867,4706,9,5.25,201809
7,3,0,0,0,344,0,0,0,344,2561,2905,7,5.333333333,201809
7,4,0,0,0,541,0,0,0,541,2340,2881,11,5.4,201809
7,5,0,0,0,927,0,0,0,927,1833,2760,11,6,201809
7,6,0,0,0,801,0,0,0,801,1701,2502,8,4,201809
7,7,0,0,0,915,0,0,0,915,2626,3541,8,5.5,201809
7,8,0,0,0,639,0,0,0,639,1840,2479,12,5.25,201809
7,9,0,0,0,1002,0,0,0,1002,1580,2582,11,6,201809
7,10,0,0,0,891,0,0,0,891,2139,3030,9,5.5,201809
7,11,0,0,0,175,0,0,0,175,639,814,6,5.333333333,201809
7,12,0,0,0,843,0,0,0,843,2149,2992,9,5.5,201809
7,13,0,0,0,272,0,0,0,272,2481,2753,9,5.25,201809
8,1,0,0,0,321,0,0,0,321,490,811,4,6,201809
8,2,0,0,0,380,0,0,0,380,1153,1533,18,5.75,201809
8,3,0,0,0,402,0,0,0,402,737,1139,5,6,201809
8,4,0,0,0,330,0,0,0,330,933,1263,9,6,201809
8,5,0,0,0,296,0,0,0,296,1098,1394,10,5.25,201809
8,6,0,0,0,628,0,0,0,628,1125,1753,8,4.333333333,201809
8,7,0,0,0,351,0,0,0,351,1240,1591,8,5.25,201809
8,8,0,0,0,493,0,0,0,493,885,1378,12,8,201809
8,9,0,0,0,108,0,0,0,108,1155,1263,10,5.2,201809
9,1,0,0,0,417,0,0,0,417,692,1109,6,7,201809
9,2,0,0,0,2104,0,0,0,2104,2950,5054,12,6,201809
9,3,0,0,0,1038,0,0,0,1038,1084,2122,7,6,201809
9,4,0,0,0,925,0,0,0,925,1268,2193,11,6,201809
9,5,0,0,0,806,0,0,0,806,915,1721,7,6,201809
9,6,0,0,0,563,0,0,0,563,646,1209,7,6,201809
9,7,0,0,0,756,0,0,0,756,883,1639,9,6,201809
9,8,0,0,0,631,0,0,0,631,870,1501,6,7,201809
9,9,0,0,0,632,0,0,0,632,955,1587,5,6,201809
9,10,0,0,0,912,0,0,0,912,1048,1960,6,6,201809
9,11,0,0,0,1269,0,0,0,1269,1554,2823,7,6,201809
9,12,0,0,0,1261,0,0,0,1261,1509,2770,11,6,201809
9,13,0,0,0,863,0,0,0,863,1113,1976,4,6,201809
9,14,0,0,0,604,0,0,0,604,720,1324,5,6,201809
9,15,0,0,0,2404,0,0,0,2404,2802,5206,11,4.666666667,201809
9,16,0,0,0,1538,0,0,0,1538,2094,3632,15,6,201809
9,17,0,0,0,853,0,0,0,853,985,1838,6,6,201809
9,18,0,0,0,1185,0,0,0,1185,1574,2759,12,6,201809
9,19,0,0,0,1025,0,0,0,1025,1134,2159,5,6,201809
9,20,0,0,0,111,0,0,0,111,321,432,5,6,201809
9,21,0,0,0,454,0,0,0,454,703,1157,3,6,201809
9,22,0,0,0,641,0,0,0,641,879,1520,5,6,201809
9,23,0,0,0,1019,0,0,0,1019,1324,2343,7,7,201809
9,24,0,0,0,1964,0,0,0,1964,2268,4232,13,6.5,201809
10,1,0,0,0,317,0,0,0,317,917,1234,12,4.666666667,201809
10,2,0,0,0,487,0,0,0,487,939,1426,9,5.25,201809
10,3,0,0,0,357,0,0,0,357,865,1222,12,5.4,201809
10,4,0,0,0,649,0,0,0,649,1177,1826,14,5,201809
11,1,0,0,0,940,0,0,0,940,1315,2255,6,5.666666667,201809
11,2,0,0,0,419,0,0,0,419,1099,1518,7,6,201809
11,3,0,0,0,505,0,0,0,505,699,1204,3,7,201809
11,4,0,0,0,399,0,0,0,399,700,1099,10,4.75,201809
11,5,0,0,0,780,0,0,0,780,1363,2143,7,6.5,201809
11,6,0,0,0,528,0,0,0,528,1426,1954,7,5.666666667,201809
11,7,0,0,0,693,0,0,0,693,1474,2167,9,5.5,201809
11,8,0,0,0,629,0,0,0,629,1105,1734,9,5.75,201809
11,9,0,0,0,741,0,0,0,741,981,1722,10,5.666666667,201809
11,10,0,0,0,647,0,0,0,647,1186,1833,10,5.6,201809
11,11,0,0,0,418,0,0,0,418,819,1237,4,6,201809
11,12,0,0,0,847,0,0,0,847,1356,2203,7,6,201809
11,13,0,0,0,338,0,0,0,338,727,1065,8,5.5,201809
11,14,0,0,0,504,0,0,0,504,924,1428,8,5.5,201809
11,15,0,0,0,493,0,0,0,493,799,1292,9,6,201809
12,1,0,0,0,425,0,0,0,425,1093,1518,10,5.2,201809
12,2,0,0,0,551,0,0,0,551,1037,1588,10,5.5,201809
12,3,0,0,0,751,0,0,0,751,1322,2073,11,5.2,201809
12,4,0,0,0,845,0,0,0,845,1402,2247,9,6,201809
12,5,0,0,0,271,0,0,0,271,1053,1324,10,5.25,201809
12,6,0,0,0,547,0,0,0,547,1379,1926,10,5.25,201809
12,7,0,0,0,580,0,0,0,580,1221,1801,8,6,201809
12,8,0,0,0,625,0,0,0,625,1368,1993,9,5.25,201809
12,9,0,0,0,683,0,0,0,683,1983,2666,9,5.666666667,201809
13,1,0,0,0,240,0,0,0,240,1324,1564,9,5.333333333,201809
13,2,0,0,0,349,0,0,0,349,1202,1551,6,5.333333333,201809
13,3,0,0,0,611,0,0,0,611,1124,1735,12,5.25,201809
13,4,0,0,0,566,0,0,0,566,1923,2489,9,5.666666667,201809
13,5,0,0,0,819,0,0,0,819,1475,2294,9,5.75,201809
13,6,0,0,0,1260,0,0,0,1260,2735,3995,11,5.666666667,201809
13,7,0,0,0,714,0,0,0,714,1382,2096,9,5.5,201809
14,1,0,0,0,162,0,0,0,162,735,897,6,5.5,201809
14,2,0,0,0,306,0,0,0,306,550,856,5,5.666666667,201809
14,3,0,0,0,192,0,0,0,192,746,938,8,5.4,201809
14,4,0,0,0,626,0,0,0,626,1030,1656,11,6,201809
14,5,0,0,0,424,0,0,0,424,819,1243,9,5.5,201809
14,6,0,0,0,737,0,0,0,737,1583,2320,11,6,201809
14,7,0,0,0,310,0,0,0,310,760,1070,6,6,201809
14,8,0,0,0,1211,0,0,0,1211,2443,3654,11,4.8,201809
14,9,0,0,0,724,0,0,0,724,1469,2193,8,6,201809
14,10,0,0,0,771,0,0,0,771,1443,2214,7,6,201809
14,11,0,0,0,343,0,0,0,343,505,848,4,6,201809
14,12,0,0,0,367,0,0,0,367,789,1156,9,5.5,201809
14,13,0,0,0,489,0,0,0,489,921,1410,6,6,201809
14,14,0,0,0,557,0,0,0,557,1113,1670,7,6,201809
14,15,0,0,0,466,0,0,0,466,1333,1799,10,5.6,201809
14,16,0,0,0,632,0,0,0,632,779,1411,5,6,201809
14,17,0,0,0,226,0,0,0,226,638,864,7,5.25,201809
14,18,0,0,0,370,0,0,0,370,1216,1586,9,5.4,201809
14,19,0,0,0,532,0,0,0,532,922,1454,8,5.25,201809
14,20,0,0,0,211,0,0,0,211,654,865,10,5.666666667,201809
15,1,0,0,0,295,0,0,0,295,925,1220,7,5.333333333,201809
15,2,0,0,0,671,0,0,0,671,927,1598,6,6,201809
15,3,0,0,0,698,0,0,0,698,2223,2921,10,5.666666667,201809
15,4,0,0,0,772,0,0,0,772,938,1710,4,6,201809
15,5,0,0,0,476,0,0,0,476,1261,1737,8,5.666666667,201809
15,6,0,0,0,780,0,0,0,780,1074,1854,7,6.5,201809
15,7,0,0,0,798,0,0,0,798,954,1752,10,6,201809
15,8,0,0,0,356,0,0,0,356,490,846,4,6,201809
15,9,0,0,0,396,0,0,0,396,985,1381,9,5.75,201809
15,10,0,0,0,491,0,0,0,491,759,1250,9,7,201809
15,11,0,0,0,738,0,0,0,738,954,1692,8,6,201809
15,12,0,0,0,908,0,0,0,908,1526,2434,8,6,201809
15,13,0,0,0,582,0,0,0,582,542,1124,8,6,201809
15,14,0,0,0,455,0,0,0,455,562,1017,4,6,201809
15,15,0,0,0,744,0,0,0,744,886,1630,6,6,201809
15,16,0,0,0,889,0,0,0,889,1894,2783,8,6,201809
15,17,0,0,0,521,0,0,0,521,1625,2146,8,6,201809
15,18,0,0,0,785,0,0,0,785,1442,2227,7,5.666666667,201809
15,19,0,0,0,1329,0,0,0,1329,1802,3131,13,6,201809
15,20,0,0,0,483,0,0,0,483,726,1209,6,6,201809
15,21,0,0,0,382,0,0,0,382,698,1080,6,5.5,201809
15,22,0,0,0,1339,0,0,0,1339,1880,3219,14,6,201809
15,23,0,0,0,634,0,0,0,634,1005,1639,7,5.333333333,201809
15,24,0,0,0,489,0,0,0,489,702,1191,4,6,201809
15,25,0,0,0,736,0,0,0,736,987,1723,6,6,201809
15,26,0,0,0,518,0,0,0,518,837,1355,8,3,201809
15,27,0,0,0,1068,0,0,0,1068,1485,2553,9,5.666666667,201809
15,28,0,0,0,599,0,0,0,599,1171,1770,9,5.666666667,201809
15,29,0,0,0,892,0,0,0,892,1890,2782,8,6,201809
15,30,0,0,0,660,0,0,0,660,1276,1936,12,7,201809
15,31,0,0,0,663,0,0,0,663,926,1589,6,6,201809
15,32,0,0,0,597,0,0,0,597,1048,1645,9,6,201809
15,33,0,0,0,673,0,0,0,673,1992,2665,7,6,201809
15,34,0,0,0,796,0,0,0,796,1051,1847,8,6,201809
15,35,0,0,0,680,0,0,0,680,1084,1764,9,5.666666667,201809
15,36,0,0,0,457,0,0,0,457,1052,1509,9,5.5,201809
15,37,0,0,0,861,0,0,0,861,1340,2201,7,6,201809
15,38,0,0,0,663,0,0,0,663,1328,1991,6,5.5,201809
15,39,0,0,0,514,0,0,0,514,776,1290,4,6,201809
15,40,0,0,0,718,0,0,0,718,1589,2307,9,6,201809
15,41,0,0,0,998,0,0,0,998,1709,2707,11,6,201809
16,1,0,0,0,238,0,0,0,238,856,1094,7,5.333333333,201809
16,2,0,0,0,386,0,0,0,386,805,1191,9,5.25,201809
16,3,0,0,0,383,0,0,0,383,960,1343,10,5.25,201809
16,4,0,0,0,302,0,0,0,302,898,1200,8,5.5,201809
16,5,0,0,0,501,0,0,0,501,900,1401,10,5.666666667,201809
16,6,0,0,0,355,0,0,0,355,827,1182,12,5.5,201809
16,7,0,0,0,356,0,0,0,356,659,1015,9,5.5,201809
16,8,0,0,0,843,0,0,0,843,1257,2100,12,6,201809
16,9,0,0,0,412,0,0,0,412,924,1336,9,6,201809
16,10,0,0,0,529,0,0,0,529,950,1479,7,6.5,201809
16,11,0,0,0,351,0,0,0,351,899,1250,10,5.4,201809
16,12,0,0,0,324,0,0,0,324,752,1076,10,5.25,201809
17,1,0,0,0,918,0,0,0,918,1372,2290,9,4.333333333,201809
17,2,0,0,0,540,0,0,0,540,1006,1546,8,5.666666667,201809
17,3,0,0,0,926,0,0,0,926,1571,2497,8,5.5,201809
17,4,0,0,0,576,0,0,0,576,1896,2472,10,5.666666667,201809
17,5,0,0,0,348,0,0,0,348,773,1121,5,5.5,201809
18,1,0,0,0,281,0,0,0,281,908,1189,9,5.2,201809
18,2,0,0,0,663,0,0,0,663,1155,1818,8,6,201809
18,3,0,0,0,346,0,0,0,346,987,1333,9,5.5,201809
19,1,0,0,0,685,0,0,0,685,1301,1986,9,6,201809
19,2,0,0,0,855,0,0,0,855,1409,2264,9,6,201809
19,3,0,0,0,651,0,0,0,651,1419,2070,7,6,201809
19,4,0,0,0,342,0,0,0,342,631,973,5,6,201809
19,5,0,0,0,835,0,0,0,835,1637,2472,8,5.5,201809
19,6,0,0,0,477,0,0,0,477,1069,1546,5,6,201809
19,7,0,0,0,329,0,0,0,329,1578,1907,10,5.5,201809
19,8,0,0,0,116,0,0,0,116,433,549,7,6,201809
19,9,0,0,0,407,0,0,0,407,1433,1840,9,5.25,201809
19,10,0,0,0,599,0,0,0,599,918,1517,8,4,201809
19,11,0,0,0,1152,0,0,0,1152,2240,3392,13,6,201809
19,12,0,0,0,333,0,0,0,333,1962,2295,8,5.666666667,201809
20,1,0,0,0,418,0,0,0,418,1399,1817,7,5.5,201809
20,2,0,0,0,224,0,0,0,224,903,1127,6,5.333333333,201809
20,3,0,0,0,549,0,0,0,549,1230,1779,6,5.333333333,201809
20,4,0,0,0,344,0,0,0,344,1109,1453,6,5.333333333,201809
20,5,0,0,0,438,0,0,0,438,1776,2214,11,5.25,201809
20,6,0,0,0,511,0,0,0,511,1609,2120,8,5.25,201809
20,7,0,0,0,372,0,0,0,372,1433,1805,7,5.75,201809
20,8,0,0,0,1249,0,0,0,1249,2631,3880,13,6,201809
20,9,0,0,0,358,0,0,0,358,1596,1954,8,5.666666667,201809
20,10,0,0,0,485,0,0,0,485,1703,2188,9,5.25,201809
21,1,0,0,0,530,0,0,0,530,1193,1723,9,5.4,201809
21,2,0,0,0,223,0,0,0,223,883,1106,9,5.2,201809
21,3,0,0,0,385,0,0,0,385,1827,2212,8,5.5,201809
21,4,0,0,0,238,0,0,0,238,959,1197,6,5.25,201809
21,5,0,0,0,541,0,0,0,541,1394,1935,8,5.666666667,201809
21,6,0,0,0,833,0,0,0,833,1132,1965,6,7,201809
21,7,0,0,0,284,0,0,0,284,1034,1318,9,5.666666667,201809
21,8,0,0,0,507,0,0,0,507,1639,2146,10,5.2,201809
21,9,0,0,0,811,0,0,0,811,1690,2501,9,6,201809
21,10,0,0,0,679,0,0,0,679,1751,2430,7,6,201809
21,11,0,0,0,153,0,0,0,153,510,663,4,6,201809
21,12,0,0,0,1571,0,0,0,1571,2270,3841,14,4.333333333,201809
21,13,0,0,0,569,0,0,0,569,1156,1725,8,5.666666667,201809
21,14,0,0,0,315,0,0,0,315,1281,1596,13,5.333333333,201809
21,15,0,0,0,606,0,0,0,606,1397,2003,7,5.5,201809
22,1,0,0,0,517,0,0,0,517,1428,1945,11,5.2,201809
22,2,0,0,0,527,0,0,0,527,1057,1584,7,5.5,201809
22,3,0,0,0,1182,0,0,0,1182,1770,2952,9,5.666666667,201809
22,4,0,0,0,1033,0,0,0,1033,1518,2551,10,4.5,201809
22,5,0,0,0,413,0,0,0,413,956,1369,10,5.5,201809
23,1,0,0,0,966,0,0,0,966,1741,2707,14,5.6,201809
23,2,0,0,0,657,0,0,0,657,1591,2248,7,4.2,201809
23,3,0,0,0,600,0,0,0,600,1322,1922,11,6,201809
23,4,0,0,0,562,0,0,0,562,1324,1886,8,5.666666667,201809
24,1,0,0,0,264,0,0,0,264,845,1109,11,5.2,201809
24,2,0,0,0,322,0,0,0,322,676,998,6,5.5,201809
24,3,0,0,0,604,0,0,0,604,1350,1954,9,5.25,201809
24,4,0,0,0,519,0,0,0,519,1529,2048,5,5.5,201809
24,5,0,0,0,753,0,0,0,753,1472,2225,9,4.5,201809
24,6,0,0,0,976,0,0,0,976,1876,2852,9,6,201809
24,7,0,0,0,256,0,0,0,256,1022,1278,9,5.25,201809
25,1,0,0,0,396,0,0,0,396,947,1343,14,5.75,201809
25,2,0,0,0,591,0,0,0,591,1084,1675,7,5.5,201809
25,3,0,0,0,498,0,0,0,498,975,1473,9,5.6,201809
25,4,0,0,0,425,0,0,0,425,936,1361,8,5.333333333,201809
25,5,0,0,0,675,0,0,0,675,1412,2087,9,5.666666667,201809
25,6,0,0,0,503,0,0,0,503,1112,1615,9,5.75,201809
25,7,0,0,0,566,0,0,0,566,1070,1636,7,6,201809
26,1,0,0,0,441,0,0,0,441,1312,1753,9,5.5,201809
26,2,0,0,0,626,0,0,0,626,1624,2250,12,5.4,201809
26,3,0,0,0,1144,0,0,0,1144,1641,2785,15,6.5,201809
26,4,0,0,0,428,0,0,0,428,1114,1542,9,5.2,201809
26,5,0,0,0,358,0,0,0,358,554,912,3,5.5,201809
26,6,0,0,0,759,0,0,0,759,1021,1780,10,5.333333333,201809
26,7,0,0,0,505,0,0,0,505,994,1499,10,5.5,201809
27,1,0,0,0,788,0,0,0,788,1483,2271,9,5.5,201809
27,2,0,0,0,832,0,0,0,832,1609,2441,8,5.666666667,201809
27,3,0,0,0,677,0,0,0,677,1131,1808,7,5.666666667,201809
27,4,0,0,0,1287,0,0,0,1287,1429,2716,10,4.333333333,201809
27,5,0,0,0,458,0,0,0,458,1161,1619,6,5.333333333,201809
27,6,0,0,0,826,0,0,0,826,1318,2144,9,5.333333333,201809
28,1,0,0,0,535,0,0,0,535,1188,1723,13,6,201809
28,2,0,0,0,520,0,0,0,520,1241,1761,13,6,201809
28,3,0,0,0,217,0,0,0,217,867,1084,7,5.333333333,201809
28,4,0,0,0,546,0,0,0,546,2660,3206,16,6,201809
28,5,0,0,0,402,0,0,0,402,1842,2244,11,4.6,201809
28,6,0,0,0,229,0,0,0,229,963,1192,13,5.166666667,201809
28,7,0,0,0,597,0,0,0,597,1711,2308,6,6,201809
28,8,0,0,0,500,0,0,0,500,1422,1922,9,6,201809
28,9,0,0,0,260,0,0,0,260,754,1014,11,5.75,201809
29,1,0,0,0,579,0,0,0,579,1374,1953,10,5.5,201809
29,2,0,0,0,665,0,0,0,665,1750,2415,15,5.2,201809
29,3,0,0,0,462,0,0,0,462,943,1405,7,5.666666667,201809
30,1,0,0,0,377,0,0,0,377,1137,1514,7,5.333333333,201809
30,2,0,0,0,118,0,0,0,118,745,863,8,5.25,201809
30,3,0,0,0,245,0,0,0,245,667,912,6,5.666666667,201809
30,4,0,0,0,357,0,0,0,357,781,1138,8,6,201809
30,5,0,0,0,430,0,0,0,430,882,1312,7,5.5,201809
30,6,0,0,0,336,0,0,0,336,915,1251,9,5.333333333,201809
30,7,0,0,0,290,0,0,0,290,939,1229,12,5.25,201809
30,8,0,0,0,496,0,0,0,496,1636,2132,11,5.4,201809
30,9,0,0,0,297,0,0,0,297,721,1018,8,5.5,201809
30,10,0,0,0,605,0,0,0,605,1311,1916,9,6.5,201809
30,11,0,0,0,602,0,0,0,602,975,1577,6,5.5,201809
30,12,0,0,0,871,0,0,0,871,1920,2791,11,6,201809
30,13,0,0,0,307,0,0,0,307,1217,1524,10,5.4,201809
30,14,0,0,0,319,0,0,0,319,1650,1969,9,5.5,201809
30,15,0,0,0,543,0,0,0,543,1013,1556,11,5.666666667,201809
30,16,0,0,0,462,0,0,0,462,1002,1464,10,5.333333333,201809
30,17,0,0,0,490,0,0,0,490,1248,1738,8,5.5,201809
30,18,0,0,0,363,0,0,0,363,886,1249,8,5.25,201809
30,19,0,0,0,299,0,0,0,299,1146,1445,13,5.6,201809
30,20,0,0,0,477,0,0,0,477,1081,1558,11,5.4,201809
31,1,0,0,0,560,0,0,0,560,1323,1883,8,5.5,201809
31,2,0,0,0,159,0,0,0,159,1114,1273,7,5.333333333,201809
31,3,0,0,0,1545,0,0,0,1545,3492,5037,20,4.75,201809
31,4,0,0,0,543,0,0,0,543,962,1505,6,8,201809
31,5,0,0,0,355,0,0,0,355,1328,1683,7,5.333333333,201809
32,1,0,0,0,378,0,0,0,378,775,1153,12,5.2,201809
32,2,0,0,0,205,0,0,0,205,700,905,13,5.142857143,201809
32,3,0,0,0,443,0,0,0,443,1462,1905,13,5.4,201809
32,4,0,0,0,488,0,0,0,488,1505,1993,13,4.5,201809
1,1,0,0,0,385,0,0,0,385,786,1171,13,5.5,201810
1,2,0,0,0,846,0,0,0,846,997,1843,10,5.2,201810
1,3,0,0,0,932,0,0,0,932,1025,1957,10,5.75,201810
2,1,0,0,0,478,0,0,0,478,728,1206,11,6,201810
2,2,0,0,0,762,0,0,0,762,1086,1848,8,8,201810
2,3,0,0,0,825,0,0,0,825,1096,1921,13,4.75,201810
2,4,0,0,0,400,0,0,0,400,596,996,13,6,201810
2,5,0,0,0,1250,0,0,0,1250,1356,2606,14,6.666666667,201810
2,6,0,0,0,642,0,0,0,642,666,1308,7,6,201810
2,7,0,0,0,641,0,0,0,641,1151,1792,12,5.75,201810
2,8,0,0,0,866,0,0,0,866,948,1814,8,6,201810
3,1,0,0,0,593,0,0,0,593,895,1488,13,6,201810
3,2,0,0,0,497,0,0,0,497,682,1179,9,5.666666667,201810
4,1,0,0,0,867,0,0,0,867,1217,2084,12,5.2,201810
4,2,0,0,0,649,0,0,0,649,1521,2170,14,5.2,201810
5,1,0,0,0,485,0,0,0,485,989,1474,9,5.666666667,201810
5,2,0,0,0,376,0,0,0,376,1593,1969,10,5.2,201810
5,3,0,0,0,425,0,0,0,425,688,1113,9,5.5,201810
5,4,0,0,0,876,0,0,0,876,1406,2282,10,6.333333333,201810
5,5,0,0,0,658,0,0,0,658,934,1592,8,6,201810
5,6,0,0,0,409,0,0,0,409,822,1231,11,5.5,201810
5,7,0,0,0,471,0,0,0,471,650,1121,11,4.666666667,201810
6,1,0,0,0,469,0,0,0,469,748,1217,11,4.833333333,201810
6,2,0,0,0,370,0,0,0,370,511,881,9,5.666666667,201810
7,1,0,0,0,435,0,0,0,435,1232,1667,9,5.25,201810
7,2,0,0,0,504,0,0,0,504,3278,3782,9,5.25,201810
7,3,0,0,0,353,0,0,0,353,1869,2222,7,5.333333333,201810
7,4,0,0,0,425,0,0,0,425,1464,1889,11,5.4,201810
7,5,0,0,0,749,0,0,0,749,1051,1800,11,5.666666667,201810
7,6,0,0,0,710,0,0,0,710,1141,1851,8,4,201810
7,7,0,0,0,729,0,0,0,729,1468,2197,8,5.5,201810
7,8,0,0,0,547,0,0,0,547,1376,1923,12,5.25,201810
7,9,0,0,0,1060,0,0,0,1060,1264,2324,10,6,201810
7,10,0,0,0,664,0,0,0,664,1950,2614,9,5.5,201810
7,11,0,0,0,119,0,0,0,119,728,847,6,5.333333333,201810
7,12,0,0,0,690,0,0,0,690,1276,1966,9,5.5,201810
7,13,0,0,0,200,0,0,0,200,1984,2184,9,5.25,201810
8,1,0,0,0,301,0,0,0,301,376,677,4,6,201810
8,2,0,0,0,339,0,0,0,339,1055,1394,17,5.5,201810
8,3,0,0,0,433,0,0,0,433,532,965,5,6,201810
8,4,0,0,0,478,0,0,0,478,562,1040,9,6,201810
8,5,0,0,0,313,0,0,0,313,971,1284,10,5.25,201810
8,6,0,0,0,754,0,0,0,754,843,1597,7,4,201810
8,7,0,0,0,278,0,0,0,278,509,787,8,4.5,201810
8,8,0,0,0,549,0,0,0,549,673,1222,10,7,201810
8,9,0,0,0,109,0,0,0,109,979,1088,10,4,201810
9,1,0,0,0,433,0,0,0,433,444,877,6,8,201810
9,2,0,0,0,1978,0,0,0,1978,2378,4356,12,6,201810
9,3,0,0,0,1167,0,0,0,1167,1040,2207,7,6,201810
9,4,0,0,0,945,0,0,0,945,1120,2065,11,6,201810
9,5,0,0,0,803,0,0,0,803,817,1620,7,6,201810
9,6,0,0,0,623,0,0,0,623,630,1253,7,6,201810
9,7,0,0,0,758,0,0,0,758,802,1560,9,6,201810
9,8,0,0,0,658,0,0,0,658,748,1406,6,8,201810
9,9,0,0,0,633,0,0,0,633,728,1361,5,6,201810
9,10,0,0,0,965,0,0,0,965,941,1906,6,6,201810
9,11,0,0,0,1189,0,0,0,1189,1357,2546,7,6,201810
9,12,0,0,0,1515,0,0,0,1515,1527,3042,11,6,201810
9,13,0,0,0,893,0,0,0,893,927,1820,4,6,201810
9,14,0,0,0,582,0,0,0,582,662,1244,5,6,201810
9,15,0,0,0,2539,0,0,0,2539,2399,4938,10,6,201810
9,16,0,0,0,1656,0,0,0,1656,1982,3638,15,6,201810
9,17,0,0,0,849,0,0,0,849,870,1719,6,6,201810
9,18,0,0,0,1335,0,0,0,1335,1311,2646,12,6,201810
9,19,0,0,0,967,0,0,0,967,1071,2038,5,6,201810
9,20,0,0,0,139,0,0,0,139,214,353,5,6,201810
9,21,0,0,0,438,0,0,0,438,542,980,3,6,201810
9,22,0,0,0,678,0,0,0,678,687,1365,5,6,201810
9,23,0,0,0,1212,0,0,0,1212,1166,2378,7,8,201810
9,24,0,0,0,2094,0,0,0,2094,1899,3993,13,6.5,201810
10,1,0,0,0,416,0,0,0,416,614,1030,12,4.666666667,201810
10,2,0,0,0,511,0,0,0,511,660,1171,9,5.25,201810
10,3,0,0,0,407,0,0,0,407,903,1310,12,5.4,201810
10,4,0,0,0,874,0,0,0,874,1016,1890,13,5.333333333,201810
11,1,0,0,0,705,0,0,0,705,1080,1785,6,5.666666667,201810
11,2,0,0,0,460,0,0,0,460,661,1121,7,6,201810
11,3,0,0,0,474,0,0,0,474,655,1129,3,6,201810
11,4,0,0,0,498,0,0,0,498,581,1079,8,4.5,201810
11,5,0,0,0,1011,0,0,0,1011,944,1955,7,6.5,201810
11,6,0,0,0,558,0,0,0,558,793,1351,7,5.666666667,201810
11,7,0,0,0,644,0,0,0,644,1010,1654,9,5.5,201810
11,8,0,0,0,695,0,0,0,695,827,1522,9,5.75,201810
11,9,0,0,0,787,0,0,0,787,811,1598,10,5.666666667,201810
11,10,0,0,0,582,0,0,0,582,784,1366,10,5.6,201810
11,11,0,0,0,405,0,0,0,405,976,1381,4,6,201810
11,12,0,0,0,900,0,0,0,900,1023,1923,7,6,201810
11,13,0,0,0,443,0,0,0,443,702,1145,8,5.5,201810
11,14,0,0,0,498,0,0,0,498,637,1135,8,5.5,201810
11,15,0,0,0,452,0,0,0,452,581,1033,9,6,201810
12,1,0,0,0,381,0,0,0,381,633,1014,10,4.8,201810
12,2,0,0,0,549,0,0,0,549,904,1453,10,5.5,201810
12,3,0,0,0,446,0,0,0,446,952,1398,11,5.2,201810
12,4,0,0,0,890,0,0,0,890,1085,1975,9,6,201810
12,5,0,0,0,192,0,0,0,192,821,1013,10,5.25,201810
12,6,0,0,0,387,0,0,0,387,1140,1527,10,5.25,201810
12,7,0,0,0,603,0,0,0,603,835,1438,7,6.5,201810
12,8,0,0,0,410,0,0,0,410,1148,1558,9,5.25,201810
12,9,0,0,0,601,0,0,0,601,1052,1653,9,5.666666667,201810
13,1,0,0,0,210,0,0,0,210,526,736,9,5.333333333,201810
13,2,0,0,0,303,0,0,0,303,657,960,6,5.333333333,201810
13,3,0,0,0,400,0,0,0,400,723,1123,12,5.25,201810
13,4,0,0,0,573,0,0,0,573,919,1492,9,5,201810
13,5,0,0,0,766,0,0,0,766,936,1702,9,5.75,201810
13,6,0,0,0,1205,0,0,0,1205,1690,2895,11,5.666666667,201810
13,7,0,0,0,729,0,0,0,729,1005,1734,9,5.5,201810
14,1,0,0,0,144,0,0,0,144,328,472,6,5.5,201810
14,2,0,0,0,290,0,0,0,290,407,697,5,5.666666667,201810
14,3,0,0,0,217,0,0,0,217,342,559,8,5.4,201810
14,4,0,0,0,770,0,0,0,770,749,1519,11,6,201810
14,5,0,0,0,498,0,0,0,498,767,1265,9,5.5,201810
14,6,0,0,0,859,0,0,0,859,984,1843,11,6,201810
14,7,0,0,0,308,0,0,0,308,387,695,6,6,201810
14,8,0,0,0,1446,0,0,0,1446,1590,3036,11,5.4,201810
14,9,0,0,0,790,0,0,0,790,994,1784,8,6,201810
14,10,0,0,0,816,0,0,0,816,991,1807,7,6,201810
14,11,0,0,0,335,0,0,0,335,448,783,4,6,201810
14,12,0,0,0,366,0,0,0,366,550,916,9,5.5,201810
14,13,0,0,0,458,0,0,0,458,645,1103,6,6,201810
14,14,0,0,0,640,0,0,0,640,644,1284,7,6,201810
14,15,0,0,0,433,0,0,0,433,603,1036,10,5.6,201810
14,16,0,0,0,657,0,0,0,657,816,1473,5,6,201810
14,17,0,0,0,214,0,0,0,214,412,626,7,5.25,201810
14,18,0,0,0,362,0,0,0,362,628,990,9,5.4,201810
14,19,0,0,0,529,0,0,0,529,800,1329,8,5.25,201810
14,20,0,0,0,189,0,0,0,189,293,482,10,5.666666667,201810
15,1,0,0,0,299,0,0,0,299,490,789,7,5.333333333,201810
15,2,0,0,0,661,0,0,0,661,777,1438,6,6,201810
15,3,0,0,0,710,0,0,0,710,1461,2171,10,5.666666667,201810
15,4,0,0,0,838,0,0,0,838,861,1699,4,6,201810
15,5,0,0,0,579,0,0,0,579,750,1329,8,5.666666667,201810
15,6,0,0,0,861,0,0,0,861,931,1792,7,6,201810
15,7,0,0,0,835,0,0,0,835,852,1687,10,6,201810
15,8,0,0,0,389,0,0,0,389,445,834,4,6,201810
15,9,0,0,0,414,0,0,0,414,704,1118,9,5.75,201810
15,10,0,0,0,556,0,0,0,556,600,1156,9,8,201810
15,11,0,0,0,841,0,0,0,841,863,1704,8,6,201810
15,12,0,0,0,944,0,0,0,944,1169,2113,8,6,201810
15,13,0,0,0,577,0,0,0,577,663,1240,8,6,201810
15,14,0,0,0,437,0,0,0,437,481,918,4,6,201810
15,15,0,0,0,746,0,0,0,746,772,1518,6,6,201810
15,16,0,0,0,955,0,0,0,955,1384,2339,8,6,201810
15,17,0,0,0,544,0,0,0,544,1064,1608,8,6,201810
15,18,0,0,0,905,0,0,0,905,1114,2019,7,5.666666667,201810
15,19,0,0,0,1378,0,0,0,1378,1533,2911,13,6,201810
15,20,0,0,0,585,0,0,0,585,558,1143,6,6,201810
15,21,0,0,0,327,0,0,0,327,442,769,6,5.5,201810
15,22,0,0,0,1460,0,0,0,1460,1509,2969,14,6,201810
15,23,0,0,0,609,0,0,0,609,766,1375,7,5.333333333,201810
15,24,0,0,0,531,0,0,0,531,626,1157,4,6,201810
15,25,0,0,0,754,0,0,0,754,802,1556,6,6,201810
15,26,0,0,0,590,0,0,0,590,592,1182,8,3,201810
15,27,0,0,0,1121,0,0,0,1121,1297,2418,9,5.666666667,201810
15,28,0,0,0,625,0,0,0,625,892,1517,9,5.666666667,201810
15,29,0,0,0,973,0,0,0,973,1244,2217,8,6,201810
15,30,0,0,0,752,0,0,0,752,876,1628,12,7.5,201810
15,31,0,0,0,736,0,0,0,736,767,1503,6,6,201810
15,32,0,0,0,695,0,0,0,695,780,1475,9,6,201810
15,33,0,0,0,727,0,0,0,727,1224,1951,7,6,201810
15,34,0,0,0,862,0,0,0,862,895,1757,8,6,201810
15,35,0,0,0,729,0,0,0,729,994,1723,9,5.666666667,201810
15,36,0,0,0,446,0,0,0,446,948,1394,9,5.5,201810
15,37,0,0,0,881,0,0,0,881,1109,1990,7,6,201810
15,38,0,0,0,683,0,0,0,683,798,1481,6,5.5,201810
15,39,0,0,0,515,0,0,0,515,660,1175,4,6,201810
15,40,0,0,0,820,0,0,0,820,1183,2003,9,6,201810
15,41,0,0,0,1197,0,0,0,1197,1348,2545,11,6,201810
16,1,0,0,0,193,0,0,0,193,490,683,7,5.333333333,201810
16,2,0,0,0,319,0,0,0,319,436,755,9,5.25,201810
16,3,0,0,0,347,0,0,0,347,490,837,10,5.25,201810
16,4,0,0,0,292,0,0,0,292,509,801,8,5.5,201810
16,5,0,0,0,404,0,0,0,404,448,852,10,5.666666667,201810
16,6,0,0,0,377,0,0,0,377,582,959,12,5.5,201810
16,7,0,0,0,354,0,0,0,354,493,847,9,5.5,201810
16,8,0,0,0,963,0,0,0,963,979,1942,12,6,201810
16,9,0,0,0,462,0,0,0,462,615,1077,9,6,201810
16,10,0,0,0,556,0,0,0,556,665,1221,7,6.5,201810
16,11,0,0,0,349,0,0,0,349,562,911,10,5.4,201810
16,12,0,0,0,347,0,0,0,347,638,985,10,5.25,201810
17,1,0,0,0,1018,0,0,0,1018,1132,2150,10,5.666666667,201810
17,2,0,0,0,545,0,0,0,545,686,1231,8,5.666666667,201810
17,3,0,0,0,838,0,0,0,838,1397,2235,8,5.5,201810
17,4,0,0,0,582,0,0,0,582,854,1436,10,5.666666667,201810
17,5,0,0,0,373,0,0,0,373,468,841,5,5.5,201810
18,1,0,0,0,209,0,0,0,209,448,657,9,5.2,201810
18,2,0,0,0,723,0,0,0,723,856,1579,8,6,201810
18,3,0,0,0,303,0,0,0,303,690,993,9,5.5,201810
19,1,0,0,0,759,0,0,0,759,890,1649,9,6,201810
19,2,0,0,0,958,0,0,0,958,1172,2130,9,6,201810
19,3,0,0,0,811,0,0,0,811,953,1764,7,6,201810
19,4,0,0,0,411,0,0,0,411,460,871,5,6,201810
19,5,0,0,0,1019,0,0,0,1019,1281,2300,8,6,201810
19,6,0,0,0,515,0,0,0,515,659,1174,5,6,201810
19,7,0,0,0,266,0,0,0,266,1012,1278,10,5.5,201810
19,8,0,0,0,163,0,0,0,163,304,467,7,6,201810
19,9,0,0,0,277,0,0,0,277,1285,1562,9,5.25,201810
19,10,0,0,0,658,0,0,0,658,801,1459,6,3.5,201810
19,11,0,0,0,1469,0,0,0,1469,1582,3051,13,6,201810
19,12,0,0,0,395,0,0,0,395,1676,2071,8,5.666666667,201810
20,1,0,0,0,386,0,0,0,386,701,1087,7,5.5,201810
20,2,0,0,0,143,0,0,0,143,1450,1593,6,5.333333333,201810
20,3,0,0,0,303,0,0,0,303,1228,1531,6,5.333333333,201810
20,4,0,0,0,206,0,0,0,206,737,943,6,5.333333333,201810
20,5,0,0,0,416,0,0,0,416,754,1170,11,5.25,201810
20,6,0,0,0,336,0,0,0,336,1175,1511,8,5.25,201810
20,7,0,0,0,394,0,0,0,394,692,1086,7,5.75,201810
20,8,0,0,0,1491,0,0,0,1491,1828,3319,13,6,201810
20,9,0,0,0,387,0,0,0,387,955,1342,8,5.666666667,201810
20,10,0,0,0,562,0,0,0,562,1048,1610,9,5.25,201810
21,1,0,0,0,460,0,0,0,460,942,1402,9,5.4,201810
21,2,0,0,0,209,0,0,0,209,476,685,9,5.2,201810
21,3,0,0,0,393,0,0,0,393,1635,2028,8,5.5,201810
21,4,0,0,0,189,0,0,0,189,491,680,6,5.25,201810
21,5,0,0,0,676,0,0,0,676,1116,1792,8,5.666666667,201810
21,6,0,0,0,1005,0,0,0,1005,989,1994,6,7,201810
21,7,0,0,0,339,0,0,0,339,686,1025,9,5.666666667,201810
21,8,0,0,0,382,0,0,0,382,1276,1658,10,5.2,201810
21,9,0,0,0,1008,0,0,0,1008,1078,2086,9,6,201810
21,10,0,0,0,757,0,0,0,757,1241,1998,7,6,201810
21,11,0,0,0,219,0,0,0,219,304,523,4,6,201810
21,12,0,0,0,1960,0,0,0,1960,1983,3943,15,4.666666667,201810
21,13,0,0,0,644,0,0,0,644,773,1417,8,5.666666667,201810
21,14,0,0,0,257,0,0,0,257,927,1184,13,5.333333333,201810
21,15,0,0,0,645,0,0,0,645,1029,1674,7,5.5,201810
22,1,0,0,0,387,0,0,0,387,899,1286,11,5.2,201810
22,2,0,0,0,551,0,0,0,551,956,1507,7,5.5,201810
22,3,0,0,0,1210,0,0,0,1210,1345,2555,9,5.666666667,201810
22,4,0,0,0,1117,0,0,0,1117,1393,2510,12,5.25,201810
22,5,0,0,0,454,0,0,0,454,776,1230,10,5.5,201810
23,1,0,0,0,797,0,0,0,797,1449,2246,14,5.6,201810
23,2,0,0,0,589,0,0,0,589,1387,1976,8,4.2,201810
23,3,0,0,0,765,0,0,0,765,800,1565,11,6,201810
23,4,0,0,0,595,0,0,0,595,826,1421,8,5.666666667,201810
24,1,0,0,0,252,0,0,0,252,643,895,11,5.2,201810
24,2,0,0,0,335,0,0,0,335,551,886,6,5.5,201810
24,3,0,0,0,531,0,0,0,531,825,1356,9,5.25,201810
24,4,0,0,0,413,0,0,0,413,1058,1471,5,5.5,201810
24,5,0,0,0,817,0,0,0,817,1098,1915,9,4.5,201810
24,6,0,0,0,1073,0,0,0,1073,1227,2300,9,6,201810
24,7,0,0,0,211,0,0,0,211,531,742,9,5.25,201810
25,1,0,0,0,440,0,0,0,440,734,1174,14,5.75,201810
25,2,0,0,0,614,0,0,0,614,745,1359,7,5.5,201810
25,3,0,0,0,489,0,0,0,489,734,1223,9,5.6,201810
25,4,0,0,0,394,0,0,0,394,796,1190,8,5.333333333,201810
25,5,0,0,0,825,0,0,0,825,1042,1867,9,5.666666667,201810
25,6,0,0,0,540,0,0,0,540,728,1268,9,5.75,201810
25,7,0,0,0,699,0,0,0,699,813,1512,7,6,201810
26,1,0,0,0,496,0,0,0,496,759,1255,9,5.5,201810
26,2,0,0,0,639,0,0,0,639,1344,1983,12,5.4,201810
26,3,0,0,0,1307,0,0,0,1307,1405,2712,14,7,201810
26,4,0,0,0,419,0,0,0,419,770,1189,9,5.2,201810
26,5,0,0,0,268,0,0,0,268,681,949,3,5.5,201810
26,6,0,0,0,719,0,0,0,719,823,1542,10,5.333333333,201810
26,7,0,0,0,572,0,0,0,572,733,1305,10,5.5,201810
27,1,0,0,0,607,0,0,0,607,1097,1704,9,5.5,201810
27,2,0,0,0,807,0,0,0,807,1063,1870,8,5.666666667,201810
27,3,0,0,0,625,0,0,0,625,891,1516,7,5.666666667,201810
27,4,0,0,0,1191,0,0,0,1191,1576,2767,8,4.333333333,201810
27,5,0,0,0,385,0,0,0,385,1348,1733,6,5.333333333,201810
27,6,0,0,0,474,0,0,0,474,1076,1550,9,5.333333333,201810
28,1,0,0,0,624,0,0,0,624,724,1348,13,6,201810
28,2,0,0,0,566,0,0,0,566,715,1281,13,6,201810
28,3,0,0,0,193,0,0,0,193,686,879,7,5.333333333,201810
28,4,0,0,0,629,0,0,0,629,1173,1802,16,6,201810
28,5,0,0,0,442,0,0,0,442,638,1080,10,4.6,201810
28,6,0,0,0,154,0,0,0,154,529,683,13,5.166666667,201810
28,7,0,0,0,685,0,0,0,685,1001,1686,6,6,201810
28,8,0,0,0,555,0,0,0,555,901,1456,9,6,201810
28,9,0,0,0,254,0,0,0,254,444,698,11,5.75,201810
29,1,0,0,0,544,0,0,0,544,845,1389,7,5.5,201810
29,2,0,0,0,839,0,0,0,839,1036,1875,12,5,201810
29,3,0,0,0,461,0,0,0,461,656,1117,5,5.666666667,201810
30,1,0,0,0,204,0,0,0,204,690,894,7,5.333333333,201810
30,2,0,0,0,111,0,0,0,111,460,571,8,5.25,201810
30,3,0,0,0,280,0,0,0,280,462,742,6,5.666666667,201810
30,4,0,0,0,432,0,0,0,432,566,998,8,6,201810
30,5,0,0,0,462,0,0,0,462,556,1018,7,5.5,201810
30,6,0,0,0,336,0,0,0,336,710,1046,9,5.333333333,201810
30,7,0,0,0,277,0,0,0,277,471,748,12,5.25,201810
30,8,0,0,0,434,0,0,0,434,909,1343,11,5.4,201810
30,9,0,0,0,342,0,0,0,342,512,854,8,5.5,201810
30,10,0,0,0,689,0,0,0,689,855,1544,8,7,201810
30,11,0,0,0,599,0,0,0,599,574,1173,6,5.5,201810
30,12,0,0,0,1047,0,0,0,1047,1274,2321,11,6,201810
30,13,0,0,0,248,0,0,0,248,679,927,10,5.4,201810
30,14,0,0,0,348,0,0,0,348,692,1040,9,5.5,201810
30,15,0,0,0,588,0,0,0,588,741,1329,11,5.666666667,201810
30,16,0,0,0,542,0,0,0,542,646,1188,10,5.333333333,201810
30,17,0,0,0,417,0,0,0,417,1118,1535,8,5.5,201810
30,18,0,0,0,196,0,0,0,196,496,692,8,5.25,201810
30,19,0,0,0,232,0,0,0,232,571,803,13,5.6,201810
30,20,0,0,0,473,0,0,0,473,938,1411,11,5.4,201810
31,1,0,0,0,511,0,0,0,511,943,1454,8,5.5,201810
31,2,0,0,0,160,0,0,0,160,873,1033,7,5.333333333,201810
31,3,0,0,0,1643,0,0,0,1643,2336,3979,20,4.75,201810
31,4,0,0,0,671,0,0,0,671,814,1485,4,7,201810
31,5,0,0,0,239,0,0,0,239,1259,1498,7,5.333333333,201810
32,1,0,0,0,328,0,0,0,328,525,853,12,5.2,201810
32,2,0,0,0,166,0,0,0,166,364,530,13,5.142857143,201810
32,3,0,0,0,366,0,0,0,366,778,1144,13,5.4,201810
32,4,0,0,0,441,0,0,0,441,766,1207,13,4.5,201810
1,1,0,0,0,132,0,0,0,132,626,758,13,5.5,201812
1,2,0,0,0,384,0,0,0,384,903,1287,10,4.8,201812
1,3,0,0,0,429,0,0,0,429,1141,1570,10,5.75,201812
2,1,0,0,0,174,0,0,0,174,680,854,11,6,201812
2,2,0,0,0,224,0,0,0,224,1044,1268,8,6.5,201812
2,3,0,0,0,300,0,0,0,300,1026,1326,12,4.5,201812
2,4,0,0,0,143,0,0,0,143,466,609,13,6,201812
2,5,0,0,0,549,0,0,0,549,1519,2068,14,6.333333333,201812
2,6,0,0,0,261,0,0,0,261,796,1057,7,6,201812
2,7,0,0,0,231,0,0,0,231,882,1113,12,5.75,201812
2,8,0,0,0,558,0,0,0,558,1001,1559,8,6,201812
3,1,0,0,0,261,0,0,0,261,789,1050,13,5.833333333,201812
3,2,0,0,0,190,0,0,0,190,647,837,9,5.666666667,201812
4,1,0,0,0,312,0,0,0,312,952,1264,12,5.2,201812
4,2,0,0,0,92,0,0,0,92,957,1049,14,5.2,201812
5,1,0,0,0,174,0,0,0,174,755,929,9,5.666666667,201812
5,2,0,0,0,49,0,0,0,49,904,953,10,5.2,201812
5,3,0,0,0,153,0,0,0,153,1059,1212,9,5.5,201812
5,4,0,0,0,306,0,0,0,306,1083,1389,10,6,201812
5,5,0,0,0,244,0,0,0,244,925,1169,8,6,201812
5,6,0,0,0,121,0,0,0,121,437,558,11,5.5,201812
5,7,0,0,0,172,0,0,0,172,515,687,10,3.666666667,201812
6,1,0,0,0,237,0,0,0,237,694,931,12,5,201812
6,2,0,0,0,132,0,0,0,132,629,761,9,5.666666667,201812
7,1,0,0,0,48,0,0,0,48,838,886,9,5.25,201812
7,2,0,0,0,59,0,0,0,59,1924,1983,9,5.25,201812
7,3,0,0,0,101,0,0,0,101,1050,1151,7,5.333333333,201812
7,4,0,0,0,64,0,0,0,64,854,918,11,5.4,201812
7,5,0,0,0,251,0,0,0,251,1152,1403,11,5.666666667,201812
7,6,0,0,0,272,0,0,0,272,1203,1475,8,4,201812
7,7,0,0,0,106,0,0,0,106,1356,1462,8,5.5,201812
7,8,0,0,0,186,0,0,0,186,870,1056,10,4,201812
7,9,0,0,0,336,0,0,0,336,1352,1688,10,6,201812
7,10,0,0,0,13,0,0,0,13,1598,1611,9,5.5,201812
7,11,0,0,0,0,0,0,0,0,427,427,6,5.333333333,201812
7,12,0,0,0,280,0,0,0,280,1180,1460,9,5.5,201812
7,13,0,0,0,22,0,0,0,22,905,927,9,5.25,201812
8,1,0,0,0,211,0,0,0,211,425,636,4,6,201812
8,2,0,0,0,205,0,0,0,205,619,824,17,5.5,201812
8,3,0,0,0,290,0,0,0,290,656,946,5,6,201812
8,4,0,0,0,259,0,0,0,259,460,719,9,6,201812
8,5,0,0,0,130,0,0,0,130,415,545,10,5.25,201812
8,6,0,0,0,371,0,0,0,371,882,1253,7,4,201812
8,7,0,0,0,63,0,0,0,63,710,773,8,5.25,201812
8,8,0,0,0,310,0,0,0,310,681,991,11,8,201812
8,9,0,0,0,49,0,0,0,49,627,676,10,5.2,201812
9,1,0,0,0,189,0,0,0,189,589,778,6,7,201812
9,2,0,0,0,902,0,0,0,902,2487,3389,12,6,201812
9,3,0,0,0,632,0,0,0,632,1265,1897,7,6,201812
9,4,0,0,0,504,0,0,0,504,1291,1795,11,6,201812
9,5,0,0,0,368,0,0,0,368,935,1303,7,6,201812
9,6,0,0,0,308,0,0,0,308,670,978,7,6,201812
9,7,0,0,0,395,0,0,0,395,897,1292,9,6,201812
9,8,0,0,0,253,0,0,0,253,821,1074,6,7,201812
9,9,0,0,0,313,0,0,0,313,809,1122,5,6,201812
9,10,0,0,0,462,0,0,0,462,1085,1547,6,6,201812
9,11,0,0,0,855,0,0,0,855,1477,2332,7,6,201812
9,12,0,0,0,629,0,0,0,629,1696,2325,11,6,201812
9,13,0,0,0,482,0,0,0,482,1000,1482,4,6,201812
9,14,0,0,0,284,0,0,0,284,783,1067,5,6,201812
9,15,0,0,0,1090,0,0,0,1090,2737,3827,10,4.666666667,201812
9,16,0,0,0,796,0,0,0,796,2011,2807,15,6,201812
9,17,0,0,0,228,0,0,0,228,936,1164,6,6,201812
9,18,0,0,0,575,0,0,0,575,1419,1994,12,6,201812
9,19,0,0,0,479,0,0,0,479,1415,1894,5,6,201812
9,20,0,0,0,64,0,0,0,64,234,298,5,6,201812
9,21,0,0,0,176,0,0,0,176,566,742,3,6,201812
9,22,0,0,0,344,0,0,0,344,767,1111,5,6,201812
9,23,0,0,0,555,0,0,0,555,1175,1730,7,7,201812
9,24,0,0,0,991,0,0,0,991,2238,3229,13,6.5,201812
10,1,0,0,0,171,0,0,0,171,612,783,12,4.666666667,201812
10,2,0,0,0,264,0,0,0,264,639,903,9,5.25,201812
10,3,0,0,0,122,0,0,0,122,999,1121,12,5.4,201812
10,4,0,0,0,487,0,0,0,487,970,1457,13,4.666666667,201812
11,1,0,0,0,242,0,0,0,242,999,1241,6,5.666666667,201812
11,2,0,0,0,227,0,0,0,227,579,806,7,6,201812
11,3,0,0,0,248,0,0,0,248,558,806,3,6,201812
11,4,0,0,0,171,0,0,0,171,567,738,8,4.5,201812
11,5,0,0,0,500,0,0,0,500,1092,1592,7,6.5,201812
11,6,0,0,0,251,0,0,0,251,684,935,7,5.666666667,201812
11,7,0,0,0,179,0,0,0,179,878,1057,9,5.5,201812
11,8,0,0,0,389,0,0,0,389,902,1291,9,5.75,201812
11,9,0,0,0,451,0,0,0,451,884,1335,10,5.666666667,201812
11,10,0,0,0,151,0,0,0,151,791,942,11,5.6,201812
11,11,0,0,0,123,0,0,0,123,584,707,4,6,201812
11,12,0,0,0,397,0,0,0,397,999,1396,7,6,201812
11,13,0,0,0,131,0,0,0,131,456,587,9,5.5,201812
11,14,0,0,0,228,0,0,0,228,573,801,8,5.5,201812
11,15,0,0,0,254,0,0,0,254,677,931,9,6,201812
12,1,0,0,0,97,0,0,0,97,669,766,10,5,201812
12,2,0,0,0,251,0,0,0,251,768,1019,10,5.5,201812
12,3,0,0,0,116,0,0,0,116,878,994,11,5.2,201812
12,4,0,0,0,503,0,0,0,503,1152,1655,9,6,201812
12,5,0,0,0,41,0,0,0,41,866,907,10,5.25,201812
12,6,0,0,0,107,0,0,0,107,897,1004,10,5.25,201812
12,7,0,0,0,307,0,0,0,307,846,1153,7,6,201812
12,8,0,0,0,62,0,0,0,62,1070,1132,9,5.25,201812
12,9,0,0,0,401,0,0,0,401,1126,1527,9,5.666666667,201812
13,1,0,0,0,88,0,0,0,88,449,537,9,5.333333333,201812
13,2,0,0,0,32,0,0,0,32,472,504,6,5.333333333,201812
13,3,0,0,0,111,0,0,0,111,703,814,12,5.25,201812
13,4,0,0,0,237,0,0,0,237,1014,1251,9,5.666666667,201812
13,5,0,0,0,122,0,0,0,122,989,1111,9,5.75,201812
13,6,0,0,0,318,0,0,0,318,1671,1989,11,5.666666667,201812
13,7,0,0,0,275,0,0,0,275,1022,1297,9,5.5,201812
14,1,0,0,0,5,0,0,0,5,385,390,6,5.5,201812
14,2,0,0,0,99,0,0,0,99,371,470,5,5.666666667,201812
14,3,0,0,0,54,0,0,0,54,335,389,8,5.4,201812
14,4,0,0,0,310,0,0,0,310,933,1243,11,6,201812
14,5,0,0,0,246,0,0,0,246,818,1064,9,5.5,201812
14,6,0,0,0,385,0,0,0,385,863,1248,11,6,201812
14,7,0,0,0,147,0,0,0,147,388,535,6,6,201812
14,8,0,0,0,582,0,0,0,582,1667,2249,10,4.8,201812
14,9,0,0,0,388,0,0,0,388,1012,1400,8,6,201812
14,10,0,0,0,374,0,0,0,374,1031,1405,7,6,201812
14,11,0,0,0,138,0,0,0,138,428,566,4,6,201812
14,12,0,0,0,189,0,0,0,189,517,706,9,5.5,201812
14,13,0,0,0,83,0,0,0,83,651,734,6,6,201812
14,14,0,0,0,277,0,0,0,277,739,1016,7,6,201812
14,15,0,0,0,196,0,0,0,196,625,821,10,5.6,201812
14,16,0,0,0,346,0,0,0,346,694,1040,5,6,201812
14,17,0,0,0,44,0,0,0,44,327,371,7,5.25,201812
14,18,0,0,0,119,0,0,0,119,580,699,9,5.4,201812
14,19,0,0,0,155,0,0,0,155,727,882,8,5.25,201812
14,20,0,0,0,26,0,0,0,26,360,386,10,5.666666667,201812
15,1,0,0,0,89,0,0,0,89,433,522,7,5.333333333,201812
15,2,0,0,0,251,0,0,0,251,823,1074,6,6,201812
15,3,0,0,0,313,0,0,0,313,882,1195,10,5.666666667,201812
15,4,0,0,0,436,0,0,0,436,930,1366,4,6,201812
15,5,0,0,0,163,0,0,0,163,845,1008,8,5.666666667,201812
15,6,0,0,0,368,0,0,0,368,955,1323,7,6.5,201812
15,7,0,0,0,461,0,0,0,461,989,1450,10,6,201812
15,8,0,0,0,172,0,0,0,172,417,589,4,6,201812
15,9,0,0,0,147,0,0,0,147,567,714,9,5.75,201812
15,10,0,0,0,270,0,0,0,270,647,917,9,7,201812
15,11,0,0,0,356,0,0,0,356,1036,1392,8,6,201812
15,12,0,0,0,445,0,0,0,445,1189,1634,8,6,201812
15,13,0,0,0,302,0,0,0,302,734,1036,8,6,201812
15,14,0,0,0,211,0,0,0,211,534,745,4,6,201812
15,15,0,0,0,381,0,0,0,381,904,1285,6,6,201812
15,16,0,0,0,398,0,0,0,398,1296,1694,8,6,201812
15,17,0,0,0,273,0,0,0,273,968,1241,8,6,201812
15,18,0,0,0,371,0,0,0,371,1108,1479,7,5.666666667,201812
15,19,0,0,0,698,0,0,0,698,1560,2258,13,6,201812
15,20,0,0,0,243,0,0,0,243,728,971,6,6,201812
15,21,0,0,0,103,0,0,0,103,437,540,6,5.5,201812
15,22,0,0,0,691,0,0,0,691,1674,2365,14,6,201812
15,23,0,0,0,254,0,0,0,254,846,1100,7,5.333333333,201812
15,24,0,0,0,269,0,0,0,269,636,905,4,6,201812
15,25,0,0,0,423,0,0,0,423,860,1283,6,6,201812
15,26,0,0,0,228,0,0,0,228,612,840,9,3.5,201812
15,27,0,0,0,472,0,0,0,472,1361,1833,9,5.666666667,201812
15,28,0,0,0,341,0,0,0,341,860,1201,9,5.666666667,201812
15,29,0,0,0,477,0,0,0,477,1197,1674,8,6,201812
15,30,0,0,0,311,0,0,0,311,889,1200,12,7,201812
15,31,0,0,0,343,0,0,0,343,826,1169,6,6,201812
15,32,0,0,0,396,0,0,0,396,846,1242,9,6,201812
15,33,0,0,0,382,0,0,0,382,927,1309,7,6,201812
15,34,0,0,0,364,0,0,0,364,1022,1386,8,6,201812
15,35,0,0,0,308,0,0,0,308,943,1251,9,5.666666667,201812
15,36,0,0,0,180,0,0,0,180,675,855,9,5.5,201812
15,37,0,0,0,403,0,0,0,403,1070,1473,7,6,201812
15,38,0,0,0,371,0,0,0,371,829,1200,6,5.5,201812
15,39,0,0,0,168,0,0,0,168,648,816,4,6,201812
15,40,0,0,0,376,0,0,0,376,1054,1430,9,6,201812
15,41,0,0,0,520,0,0,0,520,1503,2023,11,6,201812
16,1,0,0,0,83,0,0,0,83,459,542,7,5.333333333,201812
16,2,0,0,0,71,0,0,0,71,481,552,9,5.25,201812
16,3,0,0,0,163,0,0,0,163,551,714,10,5.25,201812
16,4,0,0,0,135,0,0,0,135,406,541,8,5.5,201812
16,5,0,0,0,208,0,0,0,208,639,847,10,5.666666667,201812
16,6,0,0,0,155,0,0,0,155,536,691,12,5.5,201812
16,7,0,0,0,185,0,0,0,185,454,639,9,5.5,201812
16,8,0,0,0,471,0,0,0,471,1090,1561,12,6,201812
16,9,0,0,0,230,0,0,0,230,591,821,9,6,201812
16,10,0,0,0,254,0,0,0,254,691,945,7,6.5,201812
16,11,0,0,0,129,0,0,0,129,610,739,10,5.4,201812
16,12,0,0,0,90,0,0,0,90,595,685,10,5.25,201812
17,1,0,0,0,482,0,0,0,482,1162,1644,9,4.333333333,201812
17,2,0,0,0,314,0,0,0,314,718,1032,8,5.666666667,201812
17,3,0,0,0,391,0,0,0,391,1241,1632,8,5.5,201812
17,4,0,0,0,316,0,0,0,316,766,1082,10,5.666666667,201812
17,5,0,0,0,138,0,0,0,138,501,639,5,5.5,201812
18,1,0,0,0,72,0,0,0,72,427,499,9,5.2,201812
18,2,0,0,0,424,0,0,0,424,1049,1473,8,6,201812
18,3,0,0,0,124,0,0,0,124,485,609,9,5.5,201812
19,1,0,0,0,320,0,0,0,320,948,1268,9,6,201812
19,2,0,0,0,438,0,0,0,438,1130,1568,9,6,201812
19,3,0,0,0,302,0,0,0,302,839,1141,7,6,201812
19,4,0,0,0,176,0,0,0,176,463,639,5,6,201812
19,5,0,0,0,319,0,0,0,319,1228,1547,8,6,201812
19,6,0,0,0,184,0,0,0,184,609,793,5,6,201812
19,7,0,0,0,131,0,0,0,131,700,831,10,5.5,201812
19,8,0,0,0,74,0,0,0,74,268,342,7,6,201812
19,9,0,0,0,59,0,0,0,59,857,916,9,5.25,201812
19,10,0,0,0,280,0,0,0,280,778,1058,5,3,201812
19,11,0,0,0,551,0,0,0,551,1866,2417,13,6,201812
19,12,0,0,0,148,0,0,0,148,1230,1378,8,5.666666667,201812
20,1,0,0,0,155,0,0,0,155,680,835,7,5.5,201812
20,2,0,0,0,31,0,0,0,31,382,413,6,5.333333333,201812
20,3,0,0,0,52,0,0,0,52,700,752,6,5.333333333,201812
20,4,0,0,0,19,0,0,0,19,619,638,6,5.333333333,201812
20,5,0,0,0,116,0,0,0,116,821,937,11,5.25,201812
20,6,0,0,0,52,0,0,0,52,1082,1134,8,5.25,201812
20,7,0,0,0,139,0,0,0,139,651,790,7,5.75,201812
20,8,0,0,0,764,0,0,0,764,1698,2462,14,6.5,201812
20,9,0,0,0,184,0,0,0,184,631,815,8,5.666666667,201812
20,10,0,0,0,103,0,0,0,103,620,723,9,5.25,201812
21,1,0,0,0,172,0,0,0,172,903,1075,9,5.4,201812
21,2,0,0,0,49,0,0,0,49,576,625,9,5.2,201812
21,3,0,0,0,186,0,0,0,186,1360,1546,8,5.5,201812
21,4,0,0,0,41,0,0,0,41,414,455,6,5.25,201812
21,5,0,0,0,255,0,0,0,255,1163,1418,8,5.666666667,201812
21,6,0,0,0,404,0,0,0,404,1154,1558,6,7,201812
21,7,0,0,0,99,0,0,0,99,652,751,9,5.666666667,201812
21,8,0,0,0,59,0,0,0,59,1130,1189,10,5.2,201812
21,9,0,0,0,385,0,0,0,385,1384,1769,9,6,201812
21,10,0,0,0,345,0,0,0,345,1068,1413,7,6,201812
21,11,0,0,0,105,0,0,0,105,311,416,4,6,201812
21,12,0,0,0,783,0,0,0,783,2214,2997,14,4.333333333,201812
21,13,0,0,0,275,0,0,0,275,1039,1314,8,5.666666667,201812
21,14,0,0,0,110,0,0,0,110,735,845,13,5.333333333,201812
21,15,0,0,0,275,0,0,0,275,1273,1548,7,5.5,201812
22,1,0,0,0,116,0,0,0,116,728,844,11,5.2,201812
22,2,0,0,0,289,0,0,0,289,676,965,7,5.5,201812
22,3,0,0,0,497,0,0,0,497,1408,1905,9,5.666666667,201812
22,4,0,0,0,573,0,0,0,573,1327,1900,11,4.75,201812
22,5,0,0,0,165,0,0,0,165,714,879,10,5.5,201812
23,1,0,0,0,269,0,0,0,269,1442,1711,14,5.6,201812
23,2,0,0,0,144,0,0,0,144,893,1037,8,4.2,201812
23,3,0,0,0,423,0,0,0,423,909,1332,11,6,201812
23,4,0,0,0,340,0,0,0,340,940,1280,8,5.666666667,201812
24,1,0,0,0,79,0,0,0,79,414,493,11,5.2,201812
24,2,0,0,0,191,0,0,0,191,420,611,6,5.5,201812
24,3,0,0,0,79,0,0,0,79,881,960,9,5.25,201812
24,4,0,0,0,59,0,0,0,59,725,784,5,5.5,201812
24,5,0,0,0,332,0,0,0,332,1141,1473,9,4.5,201812
24,6,0,0,0,597,0,0,0,597,1272,1869,9,6,201812
24,7,0,0,0,16,0,0,0,16,388,404,9,5.25,201812
25,1,0,0,0,232,0,0,0,232,627,859,14,5.75,201812
25,2,0,0,0,353,0,0,0,353,761,1114,7,5.5,201812
25,3,0,0,0,160,0,0,0,160,710,870,9,5.6,201812
25,4,0,0,0,146,0,0,0,146,807,953,8,5.333333333,201812
25,5,0,0,0,460,0,0,0,460,1010,1470,9,5.666666667,201812
25,6,0,0,0,287,0,0,0,287,779,1066,9,5.75,201812
25,7,0,0,0,399,0,0,0,399,868,1267,7,6,201812
26,1,0,0,0,260,0,0,0,260,612,872,9,5.5,201812
26,2,0,0,0,364,0,0,0,364,949,1313,12,5.4,201812
26,3,0,0,0,675,0,0,0,675,1568,2243,14,6.5,201812
26,4,0,0,0,130,0,0,0,130,697,827,9,5.2,201812
26,5,0,0,0,100,0,0,0,100,422,522,3,5.5,201812
26,6,0,0,0,400,0,0,0,400,862,1262,10,5.333333333,201812
26,7,0,0,0,221,0,0,0,221,697,918,10,5.5,201812
27,1,0,0,0,188,0,0,0,188,1228,1416,9,5.5,201812
27,2,0,0,0,306,0,0,0,306,1100,1406,8,5.666666667,201812
27,3,0,0,0,269,0,0,0,269,870,1139,7,5.666666667,201812
27,4,0,0,0,745,0,0,0,745,1515,2260,8,4,201812
27,5,0,0,0,71,0,0,0,71,629,700,6,5.333333333,201812
27,6,0,0,0,382,0,0,0,382,1119,1501,9,5.333333333,201812
28,1,0,0,0,311,0,0,0,311,823,1134,13,6,201812
28,2,0,0,0,306,0,0,0,306,950,1256,13,6,201812
28,3,0,0,0,63,0,0,0,63,542,605,7,5,201812
28,4,0,0,0,173,0,0,0,173,1029,1202,16,6,201812
28,5,0,0,0,214,0,0,0,214,754,968,10,4.4,201812
28,6,0,0,0,24,0,0,0,24,347,371,13,5.166666667,201812
28,7,0,0,0,404,0,0,0,404,846,1250,6,6,201812
28,8,0,0,0,216,0,0,0,216,720,936,9,6,201812
28,9,0,0,0,108,0,0,0,108,482,590,11,5.75,201812
29,1,0,0,0,149,0,0,0,149,789,938,7,5.5,201812
29,2,0,0,0,405,0,0,0,405,1051,1456,12,5,201812
29,3,0,0,0,198,0,0,0,198,628,826,5,5.666666667,201812
30,1,0,0,0,51,0,0,0,51,596,647,7,5.333333333,201812
30,2,0,0,0,39,0,0,0,39,416,455,8,5.25,201812
30,3,0,0,0,173,0,0,0,173,405,578,6,5.666666667,201812
30,4,0,0,0,228,0,0,0,228,527,755,8,6,201812
30,5,0,0,0,195,0,0,0,195,662,857,7,5.5,201812
30,6,0,0,0,55,0,0,0,55,848,903,9,5.333333333,201812
30,7,0,0,0,154,0,0,0,154,479,633,12,5.25,201812
30,8,0,0,0,158,0,0,0,158,801,959,11,5.4,201812
30,9,0,0,0,166,0,0,0,166,480,646,8,5.5,201812
30,10,0,0,0,372,0,0,0,372,868,1240,8,6.5,201812
30,11,0,0,0,288,0,0,0,288,584,872,6,5.5,201812
30,12,0,0,0,504,0,0,0,504,1268,1772,11,6,201812
30,13,0,0,0,103,0,0,0,103,557,660,10,5.4,201812
30,14,0,0,0,149,0,0,0,149,514,663,9,5.5,201812
30,15,0,0,0,317,0,0,0,317,818,1135,11,5.666666667,201812
30,16,0,0,0,249,0,0,0,249,720,969,10,5.333333333,201812
30,17,0,0,0,113,0,0,0,113,750,863,8,5.5,201812
30,18,0,0,0,31,0,0,0,31,457,488,8,5.25,201812
30,19,0,0,0,60,0,0,0,60,439,499,13,5.6,201812
30,20,0,0,0,159,0,0,0,159,500,659,11,5.4,201812
31,1,0,0,0,142,0,0,0,142,667,809,8,5.5,201812
31,2,0,0,0,52,0,0,0,52,333,385,7,5.333333333,201812
31,3,0,0,0,714,0,0,0,714,2328,3042,20,4.75,201812
31,4,0,0,0,245,0,0,0,245,731,976,4,7,201812
31,5,0,0,0,85,0,0,0,85,598,683,7,5.333333333,201812
32,1,0,0,0,75,0,0,0,75,526,601,12,5.2,201812
32,2,0,0,0,47,0,0,0,47,304,351,13,5.142857143,201812
32,3,0,0,0,85,0,0,0,85,645,730,13,5.4,201812
32,4,0,0,0,202,0,0,0,202,905,1107,12,4.333333333,201812
1,1,0,0,0,130,0,0,0,130,390,520,13,5.5,201813
1,2,0,0,0,494,0,0,0,494,700,1194,9,4.6,201813
1,3,0,0,0,463,0,0,0,463,835,1298,10,5.75,201813
2,1,0,0,0,223,0,0,0,223,443,666,11,6,201813
2,2,0,0,0,323,0,0,0,323,616,939,8,6.5,201813
2,3,0,0,0,317,0,0,0,317,630,947,12,4.5,201813
2,4,0,0,0,125,0,0,0,125,250,375,13,6,201813
2,5,0,0,0,603,0,0,0,603,922,1525,14,6.333333333,201813
2,6,0,0,0,359,0,0,0,359,461,820,7,6,201813
2,7,0,0,0,282,0,0,0,282,479,761,12,5.75,201813
2,8,0,0,0,598,0,0,0,598,695,1293,8,6,201813
3,1,0,0,0,314,0,0,0,314,493,807,13,5.833333333,201813
3,2,0,0,0,303,0,0,0,303,369,672,9,5.666666667,201813
4,1,0,0,0,336,0,0,0,336,737,1073,12,5.2,201813
4,2,0,0,0,183,0,0,0,183,425,608,14,5.2,201813
5,1,0,0,0,201,0,0,0,201,528,729,9,5.666666667,201813
5,2,0,0,0,52,0,0,0,52,562,614,10,5.2,201813
5,3,0,0,0,209,0,0,0,209,580,789,9,5.5,201813
5,4,0,0,0,413,0,0,0,413,625,1038,10,6,201813
5,5,0,0,0,295,0,0,0,295,628,923,8,6,201813
5,6,0,0,0,117,0,0,0,117,478,595,11,5.5,201813
5,7,0,0,0,214,0,0,0,214,443,657,10,3.666666667,201813
6,1,0,0,0,234,0,0,0,234,494,728,11,4.833333333,201813
6,2,0,0,0,163,0,0,0,163,328,491,9,5.666666667,201813
7,1,0,0,0,71,0,0,0,71,864,935,9,5.25,201813
7,2,0,0,0,51,0,0,0,51,1559,1610,9,5.25,201813
7,3,0,0,0,149,0,0,0,149,679,828,7,5.333333333,201813
7,4,0,0,0,67,0,0,0,67,984,1051,11,5.4,201813
7,5,0,0,0,226,0,0,0,226,740,966,11,5.666666667,201813
7,6,0,0,0,307,0,0,0,307,741,1048,8,4,201813
7,7,0,0,0,213,0,0,0,213,1131,1344,8,5.5,201813
7,8,0,0,0,223,0,0,0,223,445,668,10,4,201813
7,9,0,0,0,429,0,0,0,429,578,1007,10,6,201813
7,10,0,0,0,35,0,0,0,35,1485,1520,9,5.5,201813
7,11,0,0,0,11,0,0,0,11,745,756,6,5.333333333,201813
7,12,0,0,0,362,0,0,0,362,860,1222,9,5.5,201813
7,13,0,0,0,26,0,0,0,26,379,405,9,5.25,201813
8,1,0,0,0,232,0,0,0,232,291,523,4,6,201813
8,2,0,0,0,272,0,0,0,272,392,664,18,5.75,201813
8,3,0,0,0,335,0,0,0,335,435,770,5,6,201813
8,4,0,0,0,329,0,0,0,329,582,911,9,6,201813
8,5,0,0,0,146,0,0,0,146,351,497,10,5.25,201813
8,6,0,0,0,419,0,0,0,419,657,1076,8,4.333333333,201813
8,7,0,0,0,90,0,0,0,90,418,508,8,5.25,201813
8,8,0,0,0,364,0,0,0,364,436,800,10,6,201813
8,9,0,0,0,62,0,0,0,62,407,469,10,5.2,201813
9,1,0,0,0,229,0,0,0,229,334,563,6,7,201813
9,2,0,0,0,1083,0,0,0,1083,1228,2311,12,6,201813
9,3,0,0,0,707,0,0,0,707,1073,1780,7,6,201813
9,4,0,0,0,533,0,0,0,533,676,1209,11,6,201813
9,5,0,0,0,414,0,0,0,414,713,1127,7,6,201813
9,6,0,0,0,319,0,0,0,319,449,768,7,6,201813
9,7,0,0,0,410,0,0,0,410,552,962,9,6,201813
9,8,0,0,0,293,0,0,0,293,454,747,6,7,201813
9,9,0,0,0,330,0,0,0,330,458,788,5,6,201813
9,10,0,0,0,479,0,0,0,479,817,1296,6,6,201813
9,11,0,0,0,781,0,0,0,781,844,1625,7,6,201813
9,12,0,0,0,740,0,0,0,740,1380,2120,11,6,201813
9,13,0,0,0,443,0,0,0,443,659,1102,4,6,201813
9,14,0,0,0,321,0,0,0,321,641,962,5,6,201813
9,15,0,0,0,1179,0,0,0,1179,1906,3085,11,4.666666667,201813
9,16,0,0,0,846,0,0,0,846,1283,2129,15,6,201813
9,17,0,0,0,381,0,0,0,381,684,1065,6,6,201813
9,18,0,0,0,673,0,0,0,673,956,1629,12,6,201813
9,19,0,0,0,495,0,0,0,495,890,1385,5,6,201813
9,20,0,0,0,75,0,0,0,75,144,219,5,6,201813
9,21,0,0,0,225,0,0,0,225,366,591,3,6,201813
9,22,0,0,0,342,0,0,0,342,655,997,5,6,201813
9,23,0,0,0,655,0,0,0,655,867,1522,7,7,201813
9,24,0,0,0,1037,0,0,0,1037,1496,2533,13,6.5,201813
10,1,0,0,0,178,0,0,0,178,579,757,12,4.666666667,201813
10,2,0,0,0,264,0,0,0,264,660,924,9,5.25,201813
10,3,0,0,0,145,0,0,0,145,486,631,12,5.4,201813
10,4,0,0,0,529,0,0,0,529,739,1268,12,4.333333333,201813
11,1,0,0,0,201,0,0,0,201,741,942,6,5.666666667,201813
11,2,0,0,0,224,0,0,0,224,430,654,7,6,201813
11,3,0,0,0,336,0,0,0,336,431,767,3,6,201813
11,4,0,0,0,199,0,0,0,199,563,762,8,4.5,201813
11,5,0,0,0,532,0,0,0,532,742,1274,7,6.5,201813
11,6,0,0,0,319,0,0,0,319,627,946,7,5.666666667,201813
11,7,0,0,0,220,0,0,0,220,628,848,9,5.5,201813
11,8,0,0,0,384,0,0,0,384,658,1042,9,5.75,201813
11,9,0,0,0,423,0,0,0,423,788,1211,10,5.666666667,201813
11,10,0,0,0,219,0,0,0,219,624,843,11,5.6,201813
11,11,0,0,0,278,0,0,0,278,715,993,4,6,201813
11,12,0,0,0,420,0,0,0,420,894,1314,7,6,201813
11,13,0,0,0,164,0,0,0,164,309,473,8,5.5,201813
11,14,0,0,0,219,0,0,0,219,510,729,8,5.5,201813
11,15,0,0,0,262,0,0,0,262,375,637,9,6,201813
12,1,0,0,0,94,0,0,0,94,353,447,10,4.6,201813
12,2,0,0,0,331,0,0,0,331,603,934,10,5.5,201813
12,3,0,0,0,162,0,0,0,162,767,929,11,5.2,201813
12,4,0,0,0,545,0,0,0,545,769,1314,9,6,201813
12,5,0,0,0,34,0,0,0,34,628,662,10,5.25,201813
12,6,0,0,0,72,0,0,0,72,970,1042,10,5.25,201813
12,7,0,0,0,338,0,0,0,338,623,961,7,6,201813
12,8,0,0,0,66,0,0,0,66,765,831,9,5.25,201813
12,9,0,0,0,433,0,0,0,433,658,1091,9,5.666666667,201813
13,1,0,0,0,107,0,0,0,107,258,365,9,5.333333333,201813
13,2,0,0,0,73,0,0,0,73,369,442,6,5.333333333,201813
13,3,0,0,0,89,0,0,0,89,551,640,12,5.25,201813
13,4,0,0,0,260,0,0,0,260,539,799,9,5.666666667,201813
13,5,0,0,0,219,0,0,0,219,571,790,7,4.5,201813
13,6,0,0,0,445,0,0,0,445,875,1320,10,4.333333333,201813
13,7,0,0,0,291,0,0,0,291,569,860,9,5.5,201813
14,1,0,0,0,15,0,0,0,15,319,334,6,5.5,201813
14,2,0,0,0,119,0,0,0,119,344,463,5,5.666666667,201813
14,3,0,0,0,55,0,0,0,55,261,316,8,5.4,201813
14,4,0,0,0,372,0,0,0,372,516,888,11,6,201813
14,5,0,0,0,260,0,0,0,260,511,771,9,5.5,201813
14,6,0,0,0,426,0,0,0,426,591,1017,11,6,201813
14,7,0,0,0,166,0,0,0,166,226,392,6,6,201813
14,8,0,0,0,603,0,0,0,603,1081,1684,10,4.8,201813
14,9,0,0,0,474,0,0,0,474,539,1013,8,6,201813
14,10,0,0,0,458,0,0,0,458,724,1182,7,6,201813
14,11,0,0,0,147,0,0,0,147,295,442,4,6,201813
14,12,0,0,0,216,0,0,0,216,301,517,9,5.5,201813
14,13,0,0,0,218,0,0,0,218,338,556,6,6,201813
14,14,0,0,0,305,0,0,0,305,566,871,7,6,201813
14,15,0,0,0,201,0,0,0,201,406,607,10,5.6,201813
14,16,0,0,0,397,0,0,0,397,504,901,5,6,201813
14,17,0,0,0,41,0,0,0,41,275,316,7,5.25,201813
14,18,0,0,0,123,0,0,0,123,441,564,9,5.4,201813
14,19,0,0,0,170,0,0,0,170,550,720,8,5.25,201813
14,20,0,0,0,32,0,0,0,32,150,182,10,5.666666667,201813
15,1,0,0,0,96,0,0,0,96,339,435,7,5.333333333,201813
15,2,0,0,0,340,0,0,0,340,490,830,6,6,201813
15,3,0,0,0,363,0,0,0,363,770,1133,10,5.666666667,201813
15,4,0,0,0,482,0,0,0,482,639,1121,4,6,201813
15,5,0,0,0,224,0,0,0,224,478,702,8,5.666666667,201813
15,6,0,0,0,435,0,0,0,435,660,1095,7,6.5,201813
15,7,0,0,0,474,0,0,0,474,622,1096,10,6,201813
15,8,0,0,0,207,0,0,0,207,329,536,4,6,201813
15,9,0,0,0,123,0,0,0,123,470,593,9,5.75,201813
15,10,0,0,0,318,0,0,0,318,557,875,9,7,201813
15,11,0,0,0,471,0,0,0,471,734,1205,8,6,201813
15,12,0,0,0,515,0,0,0,515,867,1382,8,6,201813
15,13,0,0,0,393,0,0,0,393,502,895,8,6,201813
15,14,0,0,0,287,0,0,0,287,369,656,4,6,201813
15,15,0,0,0,461,0,0,0,461,554,1015,6,6,201813
15,16,0,0,0,550,0,0,0,550,907,1457,8,6,201813
15,17,0,0,0,319,0,0,0,319,687,1006,8,6,201813
15,18,0,0,0,374,0,0,0,374,789,1163,7,5.666666667,201813
15,19,0,0,0,656,0,0,0,656,1114,1770,13,6,201813
15,20,0,0,0,236,0,0,0,236,533,769,6,6,201813
15,21,0,0,0,114,0,0,0,114,305,419,6,5.5,201813
15,22,0,0,0,784,0,0,0,784,1128,1912,14,6,201813
15,23,0,0,0,280,0,0,0,280,587,867,7,5.333333333,201813
15,24,0,0,0,299,0,0,0,299,405,704,4,6,201813
15,25,0,0,0,469,0,0,0,469,665,1134,6,6,201813
15,26,0,0,0,287,0,0,0,287,636,923,8,3,201813
15,27,0,0,0,522,0,0,0,522,1035,1557,9,5.666666667,201813
15,28,0,0,0,405,0,0,0,405,567,972,9,5.666666667,201813
15,29,0,0,0,519,0,0,0,519,831,1350,8,6,201813
15,30,0,0,0,386,0,0,0,386,824,1210,12,7,201813
15,31,0,0,0,391,0,0,0,391,559,950,6,6,201813
15,32,0,0,0,419,0,0,0,419,744,1163,9,6,201813
15,33,0,0,0,425,0,0,0,425,586,1011,7,6,201813
15,34,0,0,0,428,0,0,0,428,573,1001,8,6,201813
15,35,0,0,0,315,0,0,0,315,640,955,9,5.666666667,201813
15,36,0,0,0,204,0,0,0,204,498,702,9,5.5,201813
15,37,0,0,0,460,0,0,0,460,763,1223,7,6,201813
15,38,0,0,0,399,0,0,0,399,613,1012,6,5.5,201813
15,39,0,0,0,204,0,0,0,204,433,637,4,6,201813
15,40,0,0,0,401,0,0,0,401,723,1124,9,6,201813
15,41,0,0,0,623,0,0,0,623,1073,1696,11,6,201813
16,1,0,0,0,86,0,0,0,86,405,491,7,5.333333333,201813
16,2,0,0,0,69,0,0,0,69,379,448,9,5.25,201813
16,3,0,0,0,176,0,0,0,176,403,579,10,5.25,201813
16,4,0,0,0,149,0,0,0,149,297,446,8,5.5,201813
16,5,0,0,0,219,0,0,0,219,540,759,10,5.666666667,201813
16,6,0,0,0,153,0,0,0,153,388,541,12,5.5,201813
16,7,0,0,0,167,0,0,0,167,345,512,9,5.5,201813
16,8,0,0,0,584,0,0,0,584,807,1391,12,6,201813
16,9,0,0,0,240,0,0,0,240,417,657,9,6,201813
16,10,0,0,0,305,0,0,0,305,558,863,7,6.5,201813
16,11,0,0,0,126,0,0,0,126,379,505,10,5.4,201813
16,12,0,0,0,135,0,0,0,135,322,457,10,5,201813
17,1,0,0,0,592,0,0,0,592,901,1493,9,4.333333333,201813
17,2,0,0,0,323,0,0,0,323,466,789,8,5.666666667,201813
17,3,0,0,0,437,0,0,0,437,807,1244,8,5.5,201813
17,4,0,0,0,329,0,0,0,329,722,1051,10,5.666666667,201813
17,5,0,0,0,138,0,0,0,138,328,466,5,5.5,201813
18,1,0,0,0,104,0,0,0,104,314,418,9,5.2,201813
18,2,0,0,0,490,0,0,0,490,775,1265,8,6,201813
18,3,0,0,0,129,0,0,0,129,414,543,9,5.5,201813
19,1,0,0,0,340,0,0,0,340,639,979,9,6,201813
19,2,0,0,0,497,0,0,0,497,696,1193,9,6,201813
19,3,0,0,0,374,0,0,0,374,735,1109,7,6,201813
19,4,0,0,0,219,0,0,0,219,324,543,5,6,201813
19,5,0,0,0,532,0,0,0,532,651,1183,8,6,201813
19,6,0,0,0,222,0,0,0,222,421,643,5,6,201813
19,7,0,0,0,155,0,0,0,155,345,500,10,5.5,201813
19,8,0,0,0,76,0,0,0,76,165,241,7,6,201813
19,9,0,0,0,84,0,0,0,84,609,693,9,5.25,201813
19,10,0,0,0,308,0,0,0,308,497,805,6,3.5,201813
19,11,0,0,0,661,0,0,0,661,1257,1918,13,6,201813
19,12,0,0,0,193,0,0,0,193,561,754,8,5.666666667,201813
20,1,0,0,0,195,0,0,0,195,348,543,7,5.5,201813
20,2,0,0,0,45,0,0,0,45,426,471,6,5.333333333,201813
20,3,0,0,0,60,0,0,0,60,623,683,6,5.333333333,201813
20,4,0,0,0,24,0,0,0,24,386,410,6,5.333333333,201813
20,5,0,0,0,115,0,0,0,115,495,610,11,5.25,201813
20,6,0,0,0,72,0,0,0,72,742,814,8,5.25,201813
20,7,0,0,0,184,0,0,0,184,449,633,7,5.75,201813
20,8,0,0,0,788,0,0,0,788,1294,2082,13,6,201813
20,9,0,0,0,187,0,0,0,187,487,674,8,5.333333333,201813
20,10,0,0,0,155,0,0,0,155,635,790,9,5.25,201813
21,1,0,0,0,181,0,0,0,181,573,754,9,5.4,201813
21,2,0,0,0,67,0,0,0,67,336,403,9,5.2,201813
21,3,0,0,0,226,0,0,0,226,466,692,8,5.5,201813
21,4,0,0,0,77,0,0,0,77,360,437,6,5.25,201813
21,5,0,0,0,282,0,0,0,282,573,855,8,5.666666667,201813
21,6,0,0,0,470,0,0,0,470,770,1240,6,7,201813
21,7,0,0,0,138,0,0,0,138,501,639,9,5.666666667,201813
21,8,0,0,0,88,0,0,0,88,513,601,10,5.2,201813
21,9,0,0,0,451,0,0,0,451,777,1228,9,6,201813
21,10,0,0,0,354,0,0,0,354,619,973,7,6,201813
21,11,0,0,0,110,0,0,0,110,203,313,5,7,201813
21,12,0,0,0,909,0,0,0,909,1576,2485,14,4.333333333,201813
21,13,0,0,0,262,0,0,0,262,548,810,8,5.666666667,201813
21,14,0,0,0,145,0,0,0,145,402,547,13,5.333333333,201813
21,15,0,0,0,344,0,0,0,344,552,896,7,5.5,201813
22,1,0,0,0,143,0,0,0,143,593,736,11,5.2,201813
22,2,0,0,0,307,0,0,0,307,464,771,7,5.5,201813
22,3,0,0,0,435,0,0,0,435,1041,1476,9,5.666666667,201813
22,4,0,0,0,609,0,0,0,609,891,1500,10,4.5,201813
22,5,0,0,0,218,0,0,0,218,491,709,10,5.5,201813
23,1,0,0,0,391,0,0,0,391,928,1319,14,5.6,201813
23,2,0,0,0,179,0,0,0,179,653,832,8,4.2,201813
23,3,0,0,0,453,0,0,0,453,584,1037,11,5,201813
23,4,0,0,0,302,0,0,0,302,569,871,8,5.666666667,201813
24,1,0,0,0,87,0,0,0,87,367,454,11,5.2,201813
24,2,0,0,0,159,0,0,0,159,383,542,6,5.5,201813
24,3,0,0,0,93,0,0,0,93,589,682,9,5.25,201813
24,4,0,0,0,85,0,0,0,85,416,501,5,5.5,201813
24,5,0,0,0,362,0,0,0,362,744,1106,9,4.5,201813
24,6,0,0,0,542,0,0,0,542,759,1301,9,5,201813
24,7,0,0,0,4,0,0,0,4,264,268,9,5.25,201813
25,1,0,0,0,241,0,0,0,241,458,699,14,5.75,201813
25,2,0,0,0,408,0,0,0,408,619,1027,7,5.5,201813
25,3,0,0,0,205,0,0,0,205,485,690,9,5.6,201813
25,4,0,0,0,153,0,0,0,153,443,596,8,5.333333333,201813
25,5,0,0,0,469,0,0,0,469,990,1459,9,5.666666667,201813
25,6,0,0,0,356,0,0,0,356,589,945,9,5.75,201813
25,7,0,0,0,457,0,0,0,457,574,1031,7,6,201813
26,1,0,0,0,255,0,0,0,255,433,688,9,5.5,201813
26,2,0,0,0,411,0,0,0,411,622,1033,12,5.4,201813
26,3,0,0,0,686,0,0,0,686,1254,1940,14,6.5,201813
26,4,0,0,0,133,0,0,0,133,504,637,9,5.2,201813
26,5,0,0,0,104,0,0,0,104,361,465,3,5.5,201813
26,6,0,0,0,417,0,0,0,417,813,1230,10,5.333333333,201813
26,7,0,0,0,272,0,0,0,272,466,738,10,5.5,201813
27,1,0,0,0,222,0,0,0,222,643,865,9,5.5,201813
27,2,0,0,0,269,0,0,0,269,705,974,8,5.666666667,201813
27,3,0,0,0,279,0,0,0,279,574,853,7,5.666666667,201813
27,4,0,0,0,752,0,0,0,752,1129,1881,8,4,201813
27,5,0,0,0,105,0,0,0,105,410,515,6,5.333333333,201813
27,6,0,0,0,373,0,0,0,373,652,1025,9,5.333333333,201813
28,1,0,0,0,357,0,0,0,357,636,993,13,6,201813
28,2,0,0,0,322,0,0,0,322,607,929,13,6,201813
28,3,0,0,0,80,0,0,0,80,198,278,7,5.333333333,201813
28,4,0,0,0,263,0,0,0,263,603,866,15,6,201813
28,5,0,0,0,237,0,0,0,237,413,650,10,4.4,201813
28,6,0,0,0,71,0,0,0,71,215,286,13,5.166666667,201813
28,7,0,0,0,398,0,0,0,398,599,997,6,6,201813
28,8,0,0,0,221,0,0,0,221,456,677,9,6,201813
28,9,0,0,0,156,0,0,0,156,307,463,11,5.75,201813
29,1,0,0,0,213,0,0,0,213,552,765,7,5.5,201813
29,2,0,0,0,525,0,0,0,525,825,1350,11,4.8,201813
29,3,0,0,0,237,0,0,0,237,581,818,5,5.666666667,201813
30,1,0,0,0,56,0,0,0,56,311,367,7,5.333333333,201813
30,2,0,0,0,48,0,0,0,48,189,237,8,5.25,201813
30,3,0,0,0,192,0,0,0,192,302,494,6,5.666666667,201813
30,4,0,0,0,251,0,0,0,251,378,629,8,6,201813
30,5,0,0,0,240,0,0,0,240,378,618,7,5.5,201813
30,6,0,0,0,63,0,0,0,63,319,382,9,5.333333333,201813
30,7,0,0,0,164,0,0,0,164,291,455,12,5.25,201813
30,8,0,0,0,157,0,0,0,157,547,704,11,5.4,201813
30,9,0,0,0,166,0,0,0,166,324,490,8,5.5,201813
30,10,0,0,0,401,0,0,0,401,697,1098,8,6.5,201813
30,11,0,0,0,264,0,0,0,264,626,890,6,5.5,201813
30,12,0,0,0,534,0,0,0,534,787,1321,11,6,201813
30,13,0,0,0,140,0,0,0,140,357,497,10,5.4,201813
30,14,0,0,0,150,0,0,0,150,398,548,9,5.5,201813
30,15,0,0,0,349,0,0,0,349,539,888,11,5.666666667,201813
30,16,0,0,0,313,0,0,0,313,445,758,10,5.333333333,201813
30,17,0,0,0,168,0,0,0,168,559,727,8,5.5,201813
30,18,0,0,0,42,0,0,0,42,347,389,8,5.25,201813
30,19,0,0,0,96,0,0,0,96,319,415,13,5.6,201813
30,20,0,0,0,170,0,0,0,170,624,794,11,5.4,201813
31,1,0,0,0,154,0,0,0,154,590,744,8,5.5,201813
31,2,0,0,0,61,0,0,0,61,237,298,7,5.333333333,201813
31,3,0,0,0,824,0,0,0,824,1250,2074,20,4.75,201813
31,4,0,0,0,321,0,0,0,321,470,791,5,8,201813
31,5,0,0,0,93,0,0,0,93,535,628,7,5.333333333,201813
32,1,0,0,0,84,0,0,0,84,323,407,12,5.2,201813
32,2,0,0,0,47,0,0,0,47,276,323,13,5.142857143,201813
32,3,0,0,0,171,0,0,0,171,568,739,13,5.4,201813
32,4,0,0,0,172,0,0,0,172,576,748,12,4.333333333,201813
1,1,0,0,0,138,0,0,0,138,219,357,13,4.5,201814
1,2,0,0,0,432,0,0,0,432,483,915,8,3,201814
1,3,0,0,0,434,0,0,0,434,523,957,10,4.75,201814
2,1,0,0,0,225,0,0,0,225,302,527,11,5,201814
2,2,0,0,0,356,0,0,0,356,504,860,8,5.5,201814
2,3,0,0,0,311,0,0,0,311,505,816,12,3.75,201814
2,4,0,0,0,143,0,0,0,143,167,310,13,5,201814
2,5,0,0,0,554,0,0,0,554,669,1223,14,5.333333333,201814
2,6,0,0,0,346,0,0,0,346,317,663,7,5,201814
2,7,0,0,0,310,0,0,0,310,445,755,12,4.75,201814
2,8,0,0,0,496,0,0,0,496,589,1085,8,5,201814
3,1,0,0,0,290,0,0,0,290,426,716,13,4.833333333,201814
3,2,0,0,0,238,0,0,0,238,359,597,9,4.666666667,201814
4,1,0,0,0,349,0,0,0,349,488,837,12,4,201814
4,2,0,0,0,191,0,0,0,191,794,985,14,4.2,201814
5,1,0,0,0,189,0,0,0,189,166,355,9,4.666666667,201814
5,2,0,0,0,53,0,0,0,53,587,640,10,4.2,201814
5,3,0,0,0,205,0,0,0,205,360,565,9,4.5,201814
5,4,0,0,0,388,0,0,0,388,642,1030,9,4.666666667,201814
5,5,0,0,0,264,0,0,0,264,399,663,8,5,201814
5,6,0,0,0,128,0,0,0,128,340,468,11,4.5,201814
5,7,0,0,0,195,0,0,0,195,379,574,10,3,201814
6,1,0,0,0,252,0,0,0,252,340,592,11,4,201814
6,2,0,0,0,171,0,0,0,171,248,419,9,4.666666667,201814
7,1,0,0,0,18,0,0,0,18,369,387,9,4.5,201814
7,2,0,0,0,47,0,0,0,47,1600,1647,9,4.25,201814
7,3,0,0,0,118,0,0,0,118,334,452,7,5,201814
7,4,0,0,0,70,0,0,0,70,398,468,11,4.4,201814
7,5,0,0,0,203,0,0,0,203,421,624,11,4.666666667,201814
7,6,0,0,0,248,0,0,0,248,487,735,8,3.25,201814
7,7,0,0,0,286,0,0,0,286,581,867,8,4.5,201814
7,8,0,0,0,166,0,0,0,166,340,506,10,3.25,201814
7,9,0,0,0,391,0,0,0,391,654,1045,11,6.333333333,201814
7,10,0,0,0,65,0,0,0,65,788,853,9,4.5,201814
7,11,0,0,0,4,0,0,0,4,58,62,4,3,201814
7,12,0,0,0,367,0,0,0,367,507,874,9,4.5,201814
7,13,0,0,0,32,0,0,0,32,395,427,9,4.25,201814
8,1,0,0,0,267,0,0,0,267,212,479,4,5,201814
8,2,0,0,0,223,0,0,0,223,217,440,18,4.75,201814
8,3,0,0,0,333,0,0,0,333,379,712,5,5,201814
8,4,0,0,0,265,0,0,0,265,391,656,9,5,201814
8,5,0,0,0,126,0,0,0,126,227,353,10,4.25,201814
8,6,0,0,0,412,0,0,0,412,498,910,7,3.333333333,201814
8,7,0,0,0,100,0,0,0,100,248,348,8,4.25,201814
8,8,0,0,0,347,0,0,0,347,405,752,10,5,201814
8,9,0,0,0,50,0,0,0,50,249,299,10,4.2,201814
9,1,0,0,0,223,0,0,0,223,231,454,6,6,201814
9,2,0,0,0,958,0,0,0,958,967,1925,12,5,201814
9,3,0,0,0,637,0,0,0,637,714,1351,7,5,201814
9,4,0,0,0,380,0,0,0,380,674,1054,11,5,201814
9,5,0,0,0,352,0,0,0,352,509,861,7,5,201814
9,6,0,0,0,262,0,0,0,262,351,613,7,5,201814
9,7,0,0,0,375,0,0,0,375,483,858,9,5,201814
9,8,0,0,0,251,0,0,0,251,344,595,6,6,201814
9,9,0,0,0,339,0,0,0,339,411,750,5,5,201814
9,10,0,0,0,442,0,0,0,442,711,1153,6,5,201814
9,11,0,0,0,773,0,0,0,773,916,1689,7,5,201814
9,12,0,0,0,661,0,0,0,661,1002,1663,11,5,201814
9,13,0,0,0,416,0,0,0,416,603,1019,4,5,201814
9,14,0,0,0,327,0,0,0,327,433,760,5,5,201814
9,15,0,0,0,1083,0,0,0,1083,1411,2494,9,3.666666667,201814
9,16,0,0,0,789,0,0,0,789,862,1651,15,5,201814
9,17,0,0,0,344,0,0,0,344,479,823,6,5,201814
9,18,0,0,0,578,0,0,0,578,804,1382,12,5,201814
9,19,0,0,0,512,0,0,0,512,560,1072,5,5,201814
9,20,0,0,0,50,0,0,0,50,127,177,5,5,201814
9,21,0,0,0,182,0,0,0,182,286,468,3,5,201814
9,22,0,0,0,314,0,0,0,314,386,700,5,5,201814
9,23,0,0,0,582,0,0,0,582,723,1305,7,6,201814
9,24,0,0,0,830,0,0,0,830,1212,2042,12,5,201814
10,1,0,0,0,153,0,0,0,153,362,515,12,4,201814
10,2,0,0,0,240,0,0,0,240,438,678,9,4.25,201814
10,3,0,0,0,119,0,0,0,119,331,450,12,4.4,201814
10,4,0,0,0,495,0,0,0,495,677,1172,13,4,201814
11,1,0,0,0,172,0,0,0,172,340,512,6,4.666666667,201814
11,2,0,0,0,220,0,0,0,220,264,484,7,5,201814
11,3,0,0,0,264,0,0,0,264,335,599,3,5,201814
11,4,0,0,0,182,0,0,0,182,277,459,7,3.5,201814
11,5,0,0,0,516,0,0,0,516,685,1201,7,5.5,201814
11,6,0,0,0,252,0,0,0,252,437,689,7,4.666666667,201814
11,7,0,0,0,209,0,0,0,209,354,563,9,4.5,201814
11,8,0,0,0,346,0,0,0,346,449,795,9,4.75,201814
11,9,0,0,0,392,0,0,0,392,574,966,10,4.666666667,201814
11,10,0,0,0,205,0,0,0,205,316,521,11,4.6,201814
11,11,0,0,0,225,0,0,0,225,476,701,4,5,201814
11,12,0,0,0,375,0,0,0,375,663,1038,7,5,201814
11,13,0,0,0,161,0,0,0,161,366,527,8,4.5,201814
11,14,0,0,0,179,0,0,0,179,304,483,8,4.5,201814
11,15,0,0,0,237,0,0,0,237,297,534,9,5,201814
12,1,0,0,0,99,0,0,0,99,205,304,10,4.2,201814
12,2,0,0,0,271,0,0,0,271,495,766,10,4.5,201814
12,3,0,0,0,151,0,0,0,151,341,492,11,4.2,201814
12,4,0,0,0,484,0,0,0,484,654,1138,9,5,201814
12,5,0,0,0,28,0,0,0,28,671,699,10,4.25,201814
12,6,0,0,0,60,0,0,0,60,317,377,10,4.25,201814
12,7,0,0,0,322,0,0,0,322,383,705,7,5,201814
12,8,0,0,0,51,0,0,0,51,396,447,9,4.25,201814
12,9,0,0,0,397,0,0,0,397,528,925,9,4.666666667,201814
13,1,0,0,0,91,0,0,0,91,163,254,9,4.333333333,201814
13,2,0,0,0,89,0,0,0,89,196,285,6,4.333333333,201814
13,3,0,0,0,120,0,0,0,120,252,372,12,4.25,201814
13,4,0,0,0,211,0,0,0,211,379,590,9,4.666666667,201814
13,5,0,0,0,256,0,0,0,256,333,589,9,4.75,201814
13,6,0,0,0,452,0,0,0,452,697,1149,11,4.666666667,201814
13,7,0,0,0,272,0,0,0,272,455,727,9,4.5,201814
14,1,0,0,0,22,0,0,0,22,110,132,6,4.5,201814
14,2,0,0,0,112,0,0,0,112,176,288,5,4.666666667,201814
14,3,0,0,0,63,0,0,0,63,162,225,8,4.4,201814
14,4,0,0,0,320,0,0,0,320,420,740,11,5,201814
14,5,0,0,0,227,0,0,0,227,385,612,9,4.5,201814
14,6,0,0,0,366,0,0,0,366,479,845,11,5,201814
14,7,0,0,0,169,0,0,0,169,208,377,6,5,201814
14,8,0,0,0,630,0,0,0,630,784,1414,10,4,201814
14,9,0,0,0,378,0,0,0,378,437,815,8,5,201814
14,10,0,0,0,417,0,0,0,417,549,966,7,5,201814
14,11,0,0,0,103,0,0,0,103,206,309,4,5,201814
14,12,0,0,0,231,0,0,0,231,287,518,9,4.5,201814
14,13,0,0,0,188,0,0,0,188,196,384,6,5,201814
14,14,0,0,0,303,0,0,0,303,334,637,7,5,201814
14,15,0,0,0,165,0,0,0,165,406,571,10,4.6,201814
14,16,0,0,0,329,0,0,0,329,527,856,5,5,201814
14,17,0,0,0,54,0,0,0,54,149,203,7,4.25,201814
14,18,0,0,0,153,0,0,0,153,223,376,9,4.4,201814
14,19,0,0,0,165,0,0,0,165,304,469,8,4.25,201814
14,20,0,0,0,50,0,0,0,50,82,132,10,4.666666667,201814
15,1,0,0,0,66,0,0,0,66,165,231,7,4.333333333,201814
15,2,0,0,0,328,0,0,0,328,357,685,6,5,201814
15,3,0,0,0,358,0,0,0,358,425,783,10,4.666666667,201814
15,4,0,0,0,397,0,0,0,397,526,923,4,5,201814
15,5,0,0,0,219,0,0,0,219,287,506,8,4.666666667,201814
15,6,0,0,0,345,0,0,0,345,541,886,7,5.5,201814
15,7,0,0,0,408,0,0,0,408,468,876,10,5,201814
15,8,0,0,0,189,0,0,0,189,261,450,4,5,201814
15,9,0,0,0,97,0,0,0,97,292,389,9,4.75,201814
15,10,0,0,0,278,0,0,0,278,373,651,9,6,201814
15,11,0,0,0,417,0,0,0,417,517,934,8,5,201814
15,12,0,0,0,480,0,0,0,480,620,1100,8,5,201814
15,13,0,0,0,320,0,0,0,320,345,665,8,5,201814
15,14,0,0,0,223,0,0,0,223,323,546,4,5,201814
15,15,0,0,0,379,0,0,0,379,496,875,6,5,201814
15,16,0,0,0,499,0,0,0,499,562,1061,8,5,201814
15,17,0,0,0,278,0,0,0,278,427,705,8,5,201814
15,18,0,0,0,355,0,0,0,355,574,929,7,4.666666667,201814
15,19,0,0,0,687,0,0,0,687,898,1585,13,5,201814
15,20,0,0,0,228,0,0,0,228,336,564,6,5,201814
15,21,0,0,0,82,0,0,0,82,205,287,6,4.5,201814
15,22,0,0,0,713,0,0,0,713,925,1638,14,5,201814
15,23,0,0,0,267,0,0,0,267,378,645,7,4.333333333,201814
15,24,0,0,0,273,0,0,0,273,366,639,4,5,201814
15,25,0,0,0,454,0,0,0,454,556,1010,6,5,201814
15,26,0,0,0,287,0,0,0,287,376,663,8,2.5,201814
15,27,0,0,0,479,0,0,0,479,666,1145,9,4.666666667,201814
15,28,0,0,0,357,0,0,0,357,456,813,9,4.666666667,201814
15,29,0,0,0,516,0,0,0,516,663,1179,8,5,201814
15,30,0,0,0,357,0,0,0,357,456,813,12,6,201814
15,31,0,0,0,371,0,0,0,371,437,808,6,5,201814
15,32,0,0,0,356,0,0,0,356,520,876,9,5,201814
15,33,0,0,0,365,0,0,0,365,440,805,7,5,201814
15,34,0,0,0,423,0,0,0,423,489,912,8,5,201814
15,35,0,0,0,246,0,0,0,246,526,772,9,4.666666667,201814
15,36,0,0,0,162,0,0,0,162,349,511,9,4.5,201814
15,37,0,0,0,394,0,0,0,394,487,881,7,5,201814
15,38,0,0,0,357,0,0,0,357,375,732,6,4.5,201814
15,39,0,0,0,197,0,0,0,197,295,492,4,5,201814
15,40,0,0,0,332,0,0,0,332,575,907,9,5,201814
15,41,0,0,0,571,0,0,0,571,747,1318,11,5,201814
16,1,0,0,0,96,0,0,0,96,168,264,7,4.333333333,201814
16,2,0,0,0,60,0,0,0,60,191,251,9,4.25,201814
16,3,0,0,0,165,0,0,0,165,225,390,10,4.25,201814
16,4,0,0,0,131,0,0,0,131,289,420,8,4.5,201814
16,5,0,0,0,193,0,0,0,193,342,535,10,4.666666667,201814
16,6,0,0,0,112,0,0,0,112,252,364,12,4.5,201814
16,7,0,0,0,155,0,0,0,155,250,405,9,4.5,201814
16,8,0,0,0,478,0,0,0,478,648,1126,12,5,201814
16,9,0,0,0,207,0,0,0,207,303,510,9,5,201814
16,10,0,0,0,257,0,0,0,257,446,703,7,5.5,201814
16,11,0,0,0,130,0,0,0,130,240,370,10,4.4,201814
16,12,0,0,0,130,0,0,0,130,250,380,10,4.25,201814
17,1,0,0,0,503,0,0,0,503,615,1118,9,3.666666667,201814
17,2,0,0,0,282,0,0,0,282,462,744,8,4.666666667,201814
17,3,0,0,0,373,0,0,0,373,541,914,8,4.5,201814
17,4,0,0,0,343,0,0,0,343,442,785,10,4.666666667,201814
17,5,0,0,0,110,0,0,0,110,199,309,5,4.5,201814
18,1,0,0,0,77,0,0,0,77,199,276,9,4.2,201814
18,2,0,0,0,404,0,0,0,404,550,954,8,5,201814
18,3,0,0,0,155,0,0,0,155,257,412,9,4.5,201814
19,1,0,0,0,314,0,0,0,314,437,751,9,5,201814
19,2,0,0,0,432,0,0,0,432,599,1031,9,5,201814
19,3,0,0,0,296,0,0,0,296,485,781,7,5,201814
19,4,0,0,0,197,0,0,0,197,237,434,5,5,201814
19,5,0,0,0,432,0,0,0,432,494,926,8,5,201814
19,6,0,0,0,199,0,0,0,199,344,543,5,5,201814
19,7,0,0,0,108,0,0,0,108,290,398,10,4.5,201814
19,8,0,0,0,72,0,0,0,72,114,186,7,5,201814
19,9,0,0,0,61,0,0,0,61,311,372,9,4.25,201814
19,10,0,0,0,284,0,0,0,284,387,671,6,3,201814
19,11,0,0,0,535,0,0,0,535,817,1352,13,5,201814
19,12,0,0,0,189,0,0,0,189,288,477,8,4.666666667,201814
20,1,0,0,0,204,0,0,0,204,259,463,7,4.5,201814
20,2,0,0,0,27,0,0,0,27,216,243,6,4.333333333,201814
20,3,0,0,0,72,0,0,0,72,372,444,6,4.333333333,201814
20,4,0,0,0,23,0,0,0,23,246,269,6,4.333333333,201814
20,5,0,0,0,133,0,0,0,133,432,565,11,4.25,201814
20,6,0,0,0,34,0,0,0,34,513,547,8,4.25,201814
20,7,0,0,0,149,0,0,0,149,266,415,7,4.75,201814
20,8,0,0,0,715,0,0,0,715,963,1678,13,5,201814
20,9,0,0,0,176,0,0,0,176,313,489,8,4.666666667,201814
20,10,0,0,0,83,0,0,0,83,228,311,9,4.25,201814
21,1,0,0,0,150,0,0,0,150,539,689,9,4.4,201814
21,2,0,0,0,74,0,0,0,74,293,367,9,4.2,201814
21,3,0,0,0,184,0,0,0,184,418,602,8,4.5,201814
21,4,0,0,0,47,0,0,0,47,238,285,6,4.25,201814
21,5,0,0,0,202,0,0,0,202,481,683,8,4.666666667,201814
21,6,0,0,0,468,0,0,0,468,554,1022,6,6,201814
21,7,0,0,0,151,0,0,0,151,254,405,9,4.666666667,201814
21,8,0,0,0,81,0,0,0,81,480,561,9,4.2,201814
21,9,0,0,0,466,0,0,0,466,528,994,9,5,201814
21,10,0,0,0,325,0,0,0,325,572,897,7,5,201814
21,11,0,0,0,91,0,0,0,91,144,235,4,5,201814
21,12,0,0,0,862,0,0,0,862,1197,2059,14,3.666666667,201814
21,13,0,0,0,214,0,0,0,214,321,535,8,4.666666667,201814
21,14,0,0,0,140,0,0,0,140,268,408,12,4.333333333,201814
21,15,0,0,0,302,0,0,0,302,429,731,7,4.5,201814
22,1,0,0,0,131,0,0,0,131,336,467,11,4.2,201814
22,2,0,0,0,273,0,0,0,273,533,806,7,4.5,201814
22,3,0,0,0,469,0,0,0,469,679,1148,9,4.666666667,201814
22,4,0,0,0,590,0,0,0,590,712,1302,10,3.75,201814
22,5,0,0,0,196,0,0,0,196,312,508,10,4.5,201814
23,1,0,0,0,357,0,0,0,357,609,966,14,4.6,201814
23,2,0,0,0,175,0,0,0,175,587,762,8,3.4,201814
23,3,0,0,0,470,0,0,0,470,528,998,11,5,201814
23,4,0,0,0,316,0,0,0,316,499,815,8,4.666666667,201814
24,1,0,0,0,83,0,0,0,83,209,292,11,4.2,201814
24,2,0,0,0,139,0,0,0,139,236,375,6,4.5,201814
24,3,0,0,0,91,0,0,0,91,433,524,9,4.25,201814
24,4,0,0,0,108,0,0,0,108,202,310,5,4,201814
24,5,0,0,0,314,0,0,0,314,535,849,9,3.75,201814
24,6,0,0,0,596,0,0,0,596,803,1399,9,5,201814
24,7,0,0,0,18,0,0,0,18,100,118,9,4.25,201814
25,1,0,0,0,224,0,0,0,224,332,556,14,4.75,201814
25,2,0,0,0,336,0,0,0,336,468,804,7,4.5,201814
25,3,0,0,0,175,0,0,0,175,312,487,9,4.6,201814
25,4,0,0,0,157,0,0,0,157,188,345,8,4.333333333,201814
25,5,0,0,0,402,0,0,0,402,594,996,9,4.666666667,201814
25,6,0,0,0,323,0,0,0,323,421,744,9,4.75,201814
25,7,0,0,0,392,0,0,0,392,498,890,7,5,201814
26,1,0,0,0,211,0,0,0,211,399,610,9,4.5,201814
26,2,0,0,0,321,0,0,0,321,546,867,12,4.4,201814
26,3,0,0,0,638,0,0,0,638,967,1605,14,5.5,201814
26,4,0,0,0,113,0,0,0,113,282,395,9,4.2,201814
26,5,0,0,0,112,0,0,0,112,336,448,3,4.5,201814
26,6,0,0,0,401,0,0,0,401,495,896,10,4.333333333,201814
26,7,0,0,0,203,0,0,0,203,407,610,10,4.5,201814
27,1,0,0,0,206,0,0,0,206,316,522,9,4.5,201814
27,2,0,0,0,300,0,0,0,300,441,741,8,4.666666667,201814
27,3,0,0,0,289,0,0,0,289,406,695,7,4.666666667,201814
27,4,0,0,0,620,0,0,0,620,785,1405,8,3.333333333,201814
27,5,0,0,0,70,0,0,0,70,264,334,6,4.333333333,201814
27,6,0,0,0,313,0,0,0,313,463,776,9,4.333333333,201814
28,1,0,0,0,298,0,0,0,298,443,741,13,5,201814
28,2,0,0,0,321,0,0,0,321,389,710,13,5,201814
28,3,0,0,0,66,0,0,0,66,179,245,7,4.333333333,201814
28,4,0,0,0,236,0,0,0,236,405,641,15,5,201814
28,5,0,0,0,228,0,0,0,228,335,563,10,3.6,201814
28,6,0,0,0,87,0,0,0,87,151,238,13,4.166666667,201814
28,7,0,0,0,327,0,0,0,327,517,844,6,5,201814
28,8,0,0,0,207,0,0,0,207,350,557,9,5,201814
28,9,0,0,0,130,0,0,0,130,192,322,11,4.75,201814
29,1,0,0,0,178,0,0,0,178,297,475,7,4.5,201814
29,2,0,0,0,453,0,0,0,453,585,1038,11,4,201814
29,3,0,0,0,188,0,0,0,188,345,533,5,4.666666667,201814
30,1,0,0,0,52,0,0,0,52,121,173,7,4.333333333,201814
30,2,0,0,0,67,0,0,0,67,118,185,8,4.25,201814
30,3,0,0,0,210,0,0,0,210,180,390,6,4.666666667,201814
30,4,0,0,0,230,0,0,0,230,309,539,8,5,201814
30,5,0,0,0,182,0,0,0,182,330,512,7,4.5,201814
30,6,0,0,0,54,0,0,0,54,141,195,9,4.333333333,201814
30,7,0,0,0,181,0,0,0,181,236,417,12,4.25,201814
30,8,0,0,0,183,0,0,0,183,294,477,11,4.4,201814
30,9,0,0,0,182,0,0,0,182,250,432,8,4.5,201814
30,10,0,0,0,361,0,0,0,361,558,919,8,5.5,201814
30,11,0,0,0,330,0,0,0,330,474,804,6,4.5,201814
30,12,0,0,0,480,0,0,0,480,644,1124,11,5,201814
30,13,0,0,0,121,0,0,0,121,243,364,10,4.4,201814
30,14,0,0,0,160,0,0,0,160,332,492,9,4.5,201814
30,15,0,0,0,339,0,0,0,339,410,749,11,4.666666667,201814
30,16,0,0,0,246,0,0,0,246,415,661,10,4.333333333,201814
30,17,0,0,0,166,0,0,0,166,323,489,8,4.5,201814
30,18,0,0,0,41,0,0,0,41,178,219,8,4.25,201814
30,19,0,0,0,90,0,0,0,90,201,291,13,4.6,201814
30,20,0,0,0,163,0,0,0,163,340,503,11,4.4,201814
31,1,0,0,0,143,0,0,0,143,618,761,8,4.5,201814
31,2,0,0,0,49,0,0,0,49,283,332,6,4.333333333,201814
31,3,0,0,0,765,0,0,0,765,950,1715,20,4,201814
31,4,0,0,0,275,0,0,0,275,340,615,3,6,201814
31,5,0,0,0,80,0,0,0,80,378,458,5,4.333333333,201814
32,1,0,0,0,88,0,0,0,88,206,294,12,4.2,201814
32,2,0,0,0,26,0,0,0,26,155,181,13,4.142857143,201814
32,3,0,0,0,154,0,0,0,154,319,473,13,4.4,201814
32,4,0,0,0,179,0,0,0,179,315,494,12,3.5,201814
1,1,0,0,0,106,0,0,0,106,189,295,13,3.5,201815
1,2,0,0,0,340,0,0,0,340,433,773,8,2.4,201815
1,3,0,0,0,360,0,0,0,360,361,721,10,3.75,201815
2,1,0,0,0,171,0,0,0,171,252,423,11,4,201815
2,2,0,0,0,286,0,0,0,286,383,669,8,4.5,201815
2,3,0,0,0,225,0,0,0,225,325,550,12,3,201815
2,4,0,0,0,115,0,0,0,115,127,242,13,4,201815
2,5,0,0,0,434,0,0,0,434,548,982,14,4.333333333,201815
2,6,0,0,0,255,0,0,0,255,310,565,7,4,201815
2,7,0,0,0,164,0,0,0,164,371,535,12,3.75,201815
2,8,0,0,0,394,0,0,0,394,387,781,8,4,201815
3,1,0,0,0,157,0,0,0,157,214,371,13,3.833333333,201815
3,2,0,0,0,109,0,0,0,109,173,282,9,3.666666667,201815
4,1,0,0,0,245,0,0,0,245,368,613,14,3.4,201815
4,2,0,0,0,115,0,0,0,115,382,497,14,3.2,201815
5,1,0,0,0,162,0,0,0,162,164,326,9,3.666666667,201815
5,2,0,0,0,48,0,0,0,48,359,407,10,3.2,201815
5,3,0,0,0,154,0,0,0,154,278,432,9,3.5,201815
5,4,0,0,0,237,0,0,0,237,386,623,9,3.666666667,201815
5,5,0,0,0,251,0,0,0,251,290,541,8,4,201815
5,6,0,0,0,99,0,0,0,99,260,359,11,3.5,201815
5,7,0,0,0,122,0,0,0,122,195,317,10,2.333333333,201815
6,1,0,0,0,202,0,0,0,202,275,477,11,3.166666667,201815
6,2,0,0,0,120,0,0,0,120,167,287,9,3.666666667,201815
7,1,0,0,0,8,0,0,0,8,147,155,9,4,201815
7,2,0,0,0,49,0,0,0,49,587,636,9,3.25,201815
7,3,0,0,0,62,0,0,0,62,310,372,7,3,201815
7,4,0,0,0,53,0,0,0,53,217,270,11,3.4,201815
7,5,0,0,0,159,0,0,0,159,223,382,11,3.666666667,201815
7,6,0,0,0,187,0,0,0,187,423,610,8,2.5,201815
7,7,0,0,0,133,0,0,0,133,322,455,8,3.5,201815
7,8,0,0,0,106,0,0,0,106,218,324,10,2.5,201815
7,9,0,0,0,302,0,0,0,302,386,688,9,3.666666667,201815
7,10,0,0,0,56,0,0,0,56,812,868,9,4,201815
7,11,0,0,0,3,0,0,0,3,216,219,6,3.333333333,201815
7,12,0,0,0,244,0,0,0,244,278,522,9,3.5,201815
7,13,0,0,0,10,0,0,0,10,186,196,9,3.5,201815
8,1,0,0,0,196,0,0,0,196,244,440,4,4,201815
8,2,0,0,0,154,0,0,0,154,395,549,17,3.5,201815
8,3,0,0,0,280,0,0,0,280,239,519,5,4,201815
8,4,0,0,0,214,0,0,0,214,216,430,9,4,201815
8,5,0,0,0,94,0,0,0,94,258,352,10,3.25,201815
8,6,0,0,0,321,0,0,0,321,272,593,8,3,201815
8,7,0,0,0,75,0,0,0,75,264,339,8,3.25,201815
8,8,0,0,0,235,0,0,0,235,291,526,10,4,201815
8,9,0,0,0,50,0,0,0,50,228,278,10,3.2,201815
9,1,0,0,0,175,0,0,0,175,212,387,6,5,201815
9,2,0,0,0,745,0,0,0,745,721,1466,12,4,201815
9,3,0,0,0,501,0,0,0,501,409,910,7,4,201815
9,4,0,0,0,311,0,0,0,311,443,754,11,4,201815
9,5,0,0,0,312,0,0,0,312,411,723,7,4,201815
9,6,0,0,0,240,0,0,0,240,280,520,7,4,201815
9,7,0,0,0,305,0,0,0,305,358,663,9,4,201815
9,8,0,0,0,209,0,0,0,209,254,463,6,5,201815
9,9,0,0,0,237,0,0,0,237,275,512,5,4,201815
9,10,0,0,0,354,0,0,0,354,474,828,6,4,201815
9,11,0,0,0,611,0,0,0,611,585,1196,7,4,201815
9,12,0,0,0,444,0,0,0,444,722,1166,11,4,201815
9,13,0,0,0,326,0,0,0,326,357,683,4,4,201815
9,14,0,0,0,258,0,0,0,258,243,501,5,4,201815
9,15,0,0,0,914,0,0,0,914,1032,1946,10,3,201815
9,16,0,0,0,640,0,0,0,640,781,1421,15,4,201815
9,17,0,0,0,265,0,0,0,265,354,619,6,4,201815
9,18,0,0,0,453,0,0,0,453,525,978,12,4,201815
9,19,0,0,0,368,0,0,0,368,520,888,5,4,201815
9,20,0,0,0,47,0,0,0,47,77,124,5,4,201815
9,21,0,0,0,148,0,0,0,148,198,346,3,4,201815
9,22,0,0,0,231,0,0,0,231,219,450,5,4,201815
9,23,0,0,0,446,0,0,0,446,561,1007,7,5,201815
9,24,0,0,0,734,0,0,0,734,834,1568,12,4,201815
10,1,0,0,0,127,0,0,0,127,252,379,12,3.333333333,201815
10,2,0,0,0,188,0,0,0,188,202,390,9,3.25,201815
10,3,0,0,0,83,0,0,0,83,258,341,12,3.4,201815
10,4,0,0,0,344,0,0,0,344,369,713,13,3.333333333,201815
11,1,0,0,0,147,0,0,0,147,209,356,6,3.666666667,201815
11,2,0,0,0,169,0,0,0,169,183,352,7,4,201815
11,3,0,0,0,219,0,0,0,219,205,424,3,4,201815
11,4,0,0,0,132,0,0,0,132,192,324,7,2.75,201815
11,5,0,0,0,331,0,0,0,331,353,684,7,4.5,201815
11,6,0,0,0,206,0,0,0,206,227,433,7,3.666666667,201815
11,7,0,0,0,136,0,0,0,136,212,348,7,2.75,201815
11,8,0,0,0,256,0,0,0,256,331,587,9,3.75,201815
11,9,0,0,0,275,0,0,0,275,390,665,10,3.666666667,201815
11,10,0,0,0,160,0,0,0,160,236,396,10,3.6,201815
11,11,0,0,0,156,0,0,0,156,203,359,5,4,201815
11,12,0,0,0,295,0,0,0,295,291,586,7,4,201815
11,13,0,0,0,105,0,0,0,105,139,244,8,3.5,201815
11,14,0,0,0,140,0,0,0,140,182,322,8,3.5,201815
11,15,0,0,0,159,0,0,0,159,182,341,9,4,201815
12,1,0,0,0,80,0,0,0,80,112,192,10,3.2,201815
12,2,0,0,0,191,0,0,0,191,322,513,10,3.5,201815
12,3,0,0,0,81,0,0,0,81,195,276,11,3.2,201815
12,4,0,0,0,310,0,0,0,310,422,732,9,4,201815
12,5,0,0,0,38,0,0,0,38,322,360,10,3.25,201815
12,6,0,0,0,43,0,0,0,43,240,283,10,3.25,201815
12,7,0,0,0,178,0,0,0,178,265,443,7,4,201815
12,8,0,0,0,41,0,0,0,41,203,244,9,3.25,201815
12,9,0,0,0,250,0,0,0,250,365,615,9,3.666666667,201815
13,1,0,0,0,64,0,0,0,64,161,225,9,3.333333333,201815
13,2,0,0,0,53,0,0,0,53,130,183,6,3.333333333,201815
13,3,0,0,0,104,0,0,0,104,158,262,12,3.25,201815
13,4,0,0,0,169,0,0,0,169,289,458,9,3.666666667,201815
13,5,0,0,0,235,0,0,0,235,266,501,9,3.75,201815
13,6,0,0,0,399,0,0,0,399,451,850,11,3.666666667,201815
13,7,0,0,0,203,0,0,0,203,292,495,9,3.5,201815
14,1,0,0,0,21,0,0,0,21,75,96,6,3.5,201815
14,2,0,0,0,75,0,0,0,75,123,198,5,3.666666667,201815
14,3,0,0,0,47,0,0,0,47,83,130,8,3.4,201815
14,4,0,0,0,221,0,0,0,221,326,547,11,4,201815
14,5,0,0,0,147,0,0,0,147,230,377,9,3.5,201815
14,6,0,0,0,279,0,0,0,279,319,598,11,4,201815
14,7,0,0,0,96,0,0,0,96,121,217,6,4,201815
14,8,0,0,0,437,0,0,0,437,521,958,10,3.2,201815
14,9,0,0,0,289,0,0,0,289,348,637,8,4,201815
14,10,0,0,0,304,0,0,0,304,344,648,7,4,201815
14,11,0,0,0,82,0,0,0,82,130,212,4,4,201815
14,12,0,0,0,159,0,0,0,159,207,366,9,3.5,201815
14,13,0,0,0,167,0,0,0,167,113,280,6,4,201815
14,14,0,0,0,186,0,0,0,186,278,464,7,4,201815
14,15,0,0,0,128,0,0,0,128,252,380,10,3.6,201815
14,16,0,0,0,236,0,0,0,236,314,550,5,4,201815
14,17,0,0,0,30,0,0,0,30,84,114,7,3.25,201815
14,18,0,0,0,91,0,0,0,91,198,289,9,3.4,201815
14,19,0,0,0,119,0,0,0,119,159,278,8,3.25,201815
14,20,0,0,0,25,0,0,0,25,61,86,10,3.666666667,201815
15,1,0,0,0,66,0,0,0,66,135,201,7,3.333333333,201815
15,2,0,0,0,251,0,0,0,251,307,558,6,4,201815
15,3,0,0,0,251,0,0,0,251,313,564,10,3.666666667,201815
15,4,0,0,0,286,0,0,0,286,380,666,4,4,201815
15,5,0,0,0,190,0,0,0,190,263,453,8,3.666666667,201815
15,6,0,0,0,269,0,0,0,269,286,555,7,4.5,201815
15,7,0,0,0,242,0,0,0,242,324,566,10,4,201815
15,8,0,0,0,140,0,0,0,140,185,325,4,4,201815
15,9,0,0,0,109,0,0,0,109,247,356,9,3.75,201815
15,10,0,0,0,225,0,0,0,225,273,498,9,5,201815
15,11,0,0,0,359,0,0,0,359,416,775,8,4,201815
15,12,0,0,0,383,0,0,0,383,473,856,8,4,201815
15,13,0,0,0,297,0,0,0,297,243,540,8,4,201815
15,14,0,0,0,178,0,0,0,178,228,406,4,4,201815
15,15,0,0,0,255,0,0,0,255,370,625,6,4,201815
15,16,0,0,0,378,0,0,0,378,452,830,8,4,201815
15,17,0,0,0,224,0,0,0,224,378,602,8,4,201815
15,18,0,0,0,297,0,0,0,297,362,659,7,3.666666667,201815
15,19,0,0,0,479,0,0,0,479,632,1111,13,4,201815
15,20,0,0,0,198,0,0,0,198,255,453,6,4,201815
15,21,0,0,0,97,0,0,0,97,117,214,6,3.5,201815
15,22,0,0,0,509,0,0,0,509,742,1251,14,4,201815
15,23,0,0,0,178,0,0,0,178,256,434,7,3.333333333,201815
15,24,0,0,0,210,0,0,0,210,226,436,4,4,201815
15,25,0,0,0,327,0,0,0,327,318,645,6,4,201815
15,26,0,0,0,200,0,0,0,200,269,469,8,2,201815
15,27,0,0,0,399,0,0,0,399,381,780,9,3.666666667,201815
15,28,0,0,0,248,0,0,0,248,288,536,9,3.666666667,201815
15,29,0,0,0,383,0,0,0,383,506,889,8,4,201815
15,30,0,0,0,276,0,0,0,276,380,656,11,4.5,201815
15,31,0,0,0,282,0,0,0,282,304,586,6,4,201815
15,32,0,0,0,264,0,0,0,264,368,632,9,4,201815
15,33,0,0,0,303,0,0,0,303,316,619,7,4,201815
15,34,0,0,0,324,0,0,0,324,357,681,8,4,201815
15,35,0,0,0,225,0,0,0,225,245,470,9,3.666666667,201815
15,36,0,0,0,135,0,0,0,135,239,374,9,3.5,201815
15,37,0,0,0,318,0,0,0,318,348,666,7,4,201815
15,38,0,0,0,286,0,0,0,286,318,604,6,3.5,201815
15,39,0,0,0,163,0,0,0,163,237,400,4,4,201815
15,40,0,0,0,261,0,0,0,261,398,659,9,4,201815
15,41,0,0,0,434,0,0,0,434,579,1013,11,4,201815
16,1,0,0,0,85,0,0,0,85,125,210,7,3.333333333,201815
16,2,0,0,0,42,0,0,0,42,77,119,9,3.25,201815
16,3,0,0,0,129,0,0,0,129,203,332,10,3.25,201815
16,4,0,0,0,98,0,0,0,98,127,225,8,3.5,201815
16,5,0,0,0,138,0,0,0,138,181,319,10,3.666666667,201815
16,6,0,0,0,98,0,0,0,98,157,255,12,3.5,201815
16,7,0,0,0,96,0,0,0,96,148,244,9,3.5,201815
16,8,0,0,0,352,0,0,0,352,443,795,12,4,201815
16,9,0,0,0,166,0,0,0,166,165,331,9,4,201815
16,10,0,0,0,186,0,0,0,186,292,478,7,4.5,201815
16,11,0,0,0,124,0,0,0,124,158,282,10,3.4,201815
16,12,0,0,0,89,0,0,0,89,139,228,10,3.25,201815
17,1,0,0,0,385,0,0,0,385,463,848,9,3,201815
17,2,0,0,0,215,0,0,0,215,278,493,8,3.666666667,201815
17,3,0,0,0,296,0,0,0,296,334,630,8,3.5,201815
17,4,0,0,0,258,0,0,0,258,408,666,10,3.666666667,201815
17,5,0,0,0,89,0,0,0,89,186,275,5,3.5,201815
18,1,0,0,0,64,0,0,0,64,117,181,9,3.2,201815
18,2,0,0,0,243,0,0,0,243,365,608,9,4.333333333,201815
18,3,0,0,0,89,0,0,0,89,145,234,9,3.5,201815
19,1,0,0,0,216,0,0,0,216,284,500,9,4,201815
19,2,0,0,0,257,0,0,0,257,332,589,9,4,201815
19,3,0,0,0,204,0,0,0,204,292,496,7,4,201815
19,4,0,0,0,116,0,0,0,116,174,290,5,4,201815
19,5,0,0,0,337,0,0,0,337,354,691,8,4,201815
19,6,0,0,0,140,0,0,0,140,204,344,5,4,201815
19,7,0,0,0,93,0,0,0,93,148,241,10,3.5,201815
19,8,0,0,0,43,0,0,0,43,94,137,7,4,201815
19,9,0,0,0,41,0,0,0,41,189,230,9,3.25,201815
19,10,0,0,0,187,0,0,0,187,225,412,6,2.5,201815
19,11,0,0,0,464,0,0,0,464,577,1041,13,4,201815
19,12,0,0,0,129,0,0,0,129,190,319,8,3.666666667,201815
20,1,0,0,0,153,0,0,0,153,198,351,7,3.5,201815
20,2,0,0,0,33,0,0,0,33,255,288,6,3.333333333,201815
20,3,0,0,0,82,0,0,0,82,450,532,6,3.333333333,201815
20,4,0,0,0,21,0,0,0,21,139,160,6,3.333333333,201815
20,5,0,0,0,85,0,0,0,85,259,344,11,3.25,201815
20,6,0,0,0,39,0,0,0,39,170,209,8,3.25,201815
20,7,0,0,0,119,0,0,0,119,190,309,7,3.75,201815
20,8,0,0,0,547,0,0,0,547,690,1237,13,4,201815
20,9,0,0,0,142,0,0,0,142,282,424,8,3.666666667,201815
20,10,0,0,0,79,0,0,0,79,131,210,9,3.25,201815
21,1,0,0,0,125,0,0,0,125,262,387,9,3.4,201815
21,2,0,0,0,65,0,0,0,65,147,212,9,3.2,201815
21,3,0,0,0,185,0,0,0,185,297,482,8,3.5,201815
21,4,0,0,0,41,0,0,0,41,213,254,6,3.25,201815
21,5,0,0,0,194,0,0,0,194,206,400,8,3.666666667,201815
21,6,0,0,0,334,0,0,0,334,399,733,6,5,201815
21,7,0,0,0,139,0,0,0,139,182,321,9,3.666666667,201815
21,8,0,0,0,71,0,0,0,71,390,461,9,3.2,201815
21,9,0,0,0,345,0,0,0,345,447,792,9,4,201815
21,10,0,0,0,277,0,0,0,277,386,663,7,4,201815
21,11,0,0,0,83,0,0,0,83,54,137,4,4,201815
21,12,0,0,0,677,0,0,0,677,780,1457,14,3,201815
21,13,0,0,0,202,0,0,0,202,218,420,8,3.666666667,201815
21,14,0,0,0,93,0,0,0,93,302,395,12,3.333333333,201815
21,15,0,0,0,226,0,0,0,226,307,533,7,3.5,201815
22,1,0,0,0,113,0,0,0,113,256,369,11,3.2,201815
22,2,0,0,0,197,0,0,0,197,285,482,7,3.5,201815
22,3,0,0,0,396,0,0,0,396,452,848,9,3.666666667,201815
22,4,0,0,0,433,0,0,0,433,462,895,10,3,201815
22,5,0,0,0,147,0,0,0,147,277,424,10,3.5,201815
23,1,0,0,0,328,0,0,0,328,391,719,14,3.6,201815
23,2,0,0,0,157,0,0,0,157,569,726,8,2.6,201815
23,3,0,0,0,384,0,0,0,384,403,787,11,4,201815
23,4,0,0,0,301,0,0,0,301,272,573,8,3.666666667,201815
24,1,0,0,0,66,0,0,0,66,157,223,11,3.2,201815
24,2,0,0,0,108,0,0,0,108,146,254,6,3.5,201815
24,3,0,0,0,55,0,0,0,55,190,245,9,3.25,201815
24,4,0,0,0,106,0,0,0,106,158,264,5,3.5,201815
24,5,0,0,0,221,0,0,0,221,331,552,10,3.25,201815
24,6,0,0,0,412,0,0,0,412,445,857,9,4,201815
24,7,0,0,0,28,0,0,0,28,100,128,9,3.25,201815
25,1,0,0,0,162,0,0,0,162,204,366,14,3.75,201815
25,2,0,0,0,240,0,0,0,240,362,602,7,3.5,201815
25,3,0,0,0,121,0,0,0,121,157,278,9,3.6,201815
25,4,0,0,0,102,0,0,0,102,215,317,8,3.333333333,201815
25,5,0,0,0,265,0,0,0,265,367,632,9,3.666666667,201815
25,6,0,0,0,228,0,0,0,228,305,533,9,3.75,201815
25,7,0,0,0,224,0,0,0,224,323,547,7,4,201815
26,1,0,0,0,152,0,0,0,152,255,407,9,3.5,201815
26,2,0,0,0,232,0,0,0,232,298,530,12,3.4,201815
26,3,0,0,0,375,0,0,0,375,620,995,13,4,201815
26,4,0,0,0,106,0,0,0,106,179,285,9,3.2,201815
26,5,0,0,0,90,0,0,0,90,82,172,3,3.5,201815
26,6,0,0,0,292,0,0,0,292,334,626,10,3.333333333,201815
26,7,0,0,0,133,0,0,0,133,192,325,10,3.5,201815
27,1,0,0,0,126,0,0,0,126,187,313,9,3.5,201815
27,2,0,0,0,228,0,0,0,228,246,474,8,3.666666667,201815
27,3,0,0,0,219,0,0,0,219,298,517,7,3.666666667,201815
27,4,0,0,0,474,0,0,0,474,483,957,8,2.666666667,201815
27,5,0,0,0,60,0,0,0,60,157,217,6,3.333333333,201815
27,6,0,0,0,267,0,0,0,267,404,671,9,3.333333333,201815
28,1,0,0,0,212,0,0,0,212,355,567,13,4,201815
28,2,0,0,0,213,0,0,0,213,276,489,13,4,201815
28,3,0,0,0,61,0,0,0,61,91,152,7,3,201815
28,4,0,0,0,165,0,0,0,165,220,385,15,4,201815
28,5,0,0,0,160,0,0,0,160,202,362,10,2.8,201815
28,6,0,0,0,59,0,0,0,59,97,156,13,3.166666667,201815
28,7,0,0,0,303,0,0,0,303,312,615,6,4,201815
28,8,0,0,0,169,0,0,0,169,226,395,9,4,201815
28,9,0,0,0,104,0,0,0,104,103,207,9,3,201815
29,1,0,0,0,186,0,0,0,186,235,421,7,3.5,201815
29,2,0,0,0,389,0,0,0,389,473,862,11,3.2,201815
29,3,0,0,0,156,0,0,0,156,399,555,5,3.666666667,201815
30,1,0,0,0,52,0,0,0,52,101,153,7,3.333333333,201815
30,2,0,0,0,60,0,0,0,60,99,159,8,3.25,201815
30,3,0,0,0,135,0,0,0,135,205,340,6,3.666666667,201815
30,4,0,0,0,194,0,0,0,194,188,382,8,4,201815
30,5,0,0,0,184,0,0,0,184,197,381,7,3.5,201815
30,6,0,0,0,63,0,0,0,63,109,172,9,3.333333333,201815
30,7,0,0,0,127,0,0,0,127,160,287,12,3,201815
30,8,0,0,0,143,0,0,0,143,202,345,11,3.4,201815
30,9,0,0,0,142,0,0,0,142,220,362,8,3.5,201815
30,10,0,0,0,373,0,0,0,373,369,742,8,4.5,201815
30,11,0,0,0,234,0,0,0,234,213,447,6,3.5,201815
30,12,0,0,0,414,0,0,0,414,395,809,11,4,201815
30,13,0,0,0,100,0,0,0,100,141,241,10,3.4,201815
30,14,0,0,0,137,0,0,0,137,142,279,9,3.5,201815
30,15,0,0,0,265,0,0,0,265,323,588,11,3.666666667,201815
30,16,0,0,0,224,0,0,0,224,308,532,10,3.333333333,201815
30,17,0,0,0,0,0,0,0,0,199,199,8,3.5,201815
30,18,0,0,0,27,0,0,0,27,87,114,8,3.25,201815
30,19,0,0,0,82,0,0,0,82,104,186,13,3.6,201815
30,20,0,0,0,113,0,0,0,113,170,283,11,3.4,201815
31,1,0,0,0,107,0,0,0,107,688,795,8,4,201815
31,2,0,0,0,46,0,0,0,46,142,188,6,3.333333333,201815
31,3,0,0,0,626,0,0,0,626,754,1380,20,3.25,201815
31,4,0,0,0,192,0,0,0,192,314,506,3,5,201815
31,5,0,0,0,81,0,0,0,81,304,385,5,3.333333333,201815
32,1,0,0,0,74,0,0,0,74,117,191,12,3.2,201815
32,2,0,0,0,34,0,0,0,34,135,169,13,3.142857143,201815
32,3,0,0,0,139,0,0,0,139,235,374,13,3.4,201815
32,4,0,0,0,106,0,0,0,106,224,330,12,2.666666667,201815
1,1,0,0,0,184,0,0,0,184,221,405,13,5.5,201816
1,2,0,0,0,592,0,0,0,592,570,1162,9,3.6,201816
1,3,0,0,0,475,0,0,0,475,655,1130,10,5.75,201816
2,1,0,0,0,257,0,0,0,257,369,626,11,6,201816
2,2,0,0,0,441,0,0,0,441,558,999,8,6.5,201816
2,3,0,0,0,376,0,0,0,376,476,852,12,4.5,201816
2,4,0,0,0,184,0,0,0,184,241,425,9,6,201816
2,5,0,0,0,659,0,0,0,659,722,1381,14,6.333333333,201816
2,6,0,0,0,382,0,0,0,382,451,833,7,6,201816
2,7,0,0,0,229,0,0,0,229,519,748,12,5.75,201816
2,8,0,0,0,625,0,0,0,625,707,1332,8,6,201816
3,1,0,0,0,354,0,0,0,354,425,779,13,5.833333333,201816
3,2,0,0,0,231,0,0,0,231,301,532,9,5.666666667,201816
4,1,0,0,0,458,0,0,0,458,533,991,12,5.2,201816
4,2,0,0,0,261,0,0,0,261,477,738,14,5.2,201816
5,1,0,0,0,232,0,0,0,232,146,378,9,5.666666667,201816
5,2,0,0,0,52,0,0,0,52,308,360,10,5.2,201816
5,3,0,0,0,196,0,0,0,196,377,573,9,5.5,201816
5,4,0,0,0,507,0,0,0,507,658,1165,10,6,201816
5,5,0,0,0,407,0,0,0,407,468,875,8,6,201816
5,6,0,0,0,180,0,0,0,180,329,509,11,5.5,201816
5,7,0,0,0,230,0,0,0,230,302,532,10,3.666666667,201816
6,1,0,0,0,309,0,0,0,309,374,683,12,5,201816
6,2,0,0,0,163,0,0,0,163,230,393,9,5.666666667,201816
7,1,0,0,0,3,0,0,0,3,138,141,9,5.5,201816
7,2,0,0,0,56,0,0,0,56,478,534,7,4.25,201816
7,3,0,0,0,115,0,0,0,115,218,333,7,5.333333333,201816
7,4,0,0,0,77,0,0,0,77,289,366,11,5.8,201816
7,5,0,0,0,245,0,0,0,245,351,596,11,5.666666667,201816
7,6,0,0,0,273,0,0,0,273,484,757,8,4,201816
7,7,0,0,0,212,0,0,0,212,402,614,8,5.5,201816
7,8,0,0,0,207,0,0,0,207,260,467,10,4,201816
7,9,0,0,0,544,0,0,0,544,783,1327,10,6,201816
7,10,0,0,0,111,0,0,0,111,435,546,9,6,201816
7,11,0,0,0,14,0,0,0,14,110,124,6,5.333333333,201816
7,12,0,0,0,428,0,0,0,428,541,969,9,5.5,201816
7,13,0,0,0,16,0,0,0,16,299,315,9,5.5,201816
8,1,0,0,0,387,0,0,0,387,443,830,4,6,201816
8,2,0,0,0,301,0,0,0,301,382,683,16,5.5,201816
8,3,0,0,0,475,0,0,0,475,478,953,4,6,201816
8,4,0,0,0,383,0,0,0,383,499,882,9,6,201816
8,5,0,0,0,152,0,0,0,152,251,403,10,5.25,201816
8,6,0,0,0,503,0,0,0,503,589,1092,5,4,201816
8,7,0,0,0,124,0,0,0,124,255,379,7,5.25,201816
8,8,0,0,0,487,0,0,0,487,505,992,10,6,201816
8,9,0,0,0,73,0,0,0,73,244,317,10,5,201816
9,1,0,0,0,309,0,0,0,309,320,629,6,7,201816
9,2,0,0,0,1222,0,0,0,1222,1262,2484,12,6,201816
9,3,0,0,0,765,0,0,0,765,749,1514,7,6,201816
9,4,0,0,0,467,0,0,0,467,538,1005,11,6,201816
9,5,0,0,0,470,0,0,0,470,584,1054,7,6,201816
9,6,0,0,0,397,0,0,0,397,438,835,7,6,201816
9,7,0,0,0,443,0,0,0,443,624,1067,9,6,201816
9,8,0,0,0,295,0,0,0,295,406,701,6,7,201816
9,9,0,0,0,399,0,0,0,399,492,891,5,6,201816
9,10,0,0,0,601,0,0,0,601,809,1410,6,6,201816
9,11,0,0,0,812,0,0,0,812,1157,1969,7,6,201816
9,12,0,0,0,742,0,0,0,742,967,1709,11,6,201816
9,13,0,0,0,514,0,0,0,514,612,1126,4,6,201816
9,14,0,0,0,389,0,0,0,389,465,854,5,6,201816
9,15,0,0,0,1360,0,0,0,1360,1850,3210,10,4.666666667,201816
9,16,0,0,0,1045,0,0,0,1045,1055,2100,15,6,201816
9,17,0,0,0,488,0,0,0,488,553,1041,6,6,201816
9,18,0,0,0,755,0,0,0,755,832,1587,12,6,201816
9,19,0,0,0,581,0,0,0,581,707,1288,5,6,201816
9,20,0,0,0,76,0,0,0,76,128,204,5,6,201816
9,21,0,0,0,252,0,0,0,252,308,560,3,6,201816
9,22,0,0,0,425,0,0,0,425,415,840,5,6,201816
9,23,0,0,0,709,0,0,0,709,868,1577,7,7,201816
9,24,0,0,0,1105,0,0,0,1105,1265,2370,12,6,201816
10,1,0,0,0,205,0,0,0,205,467,672,12,4.666666667,201816
10,2,0,0,0,309,0,0,0,309,380,689,9,4.5,201816
10,3,0,0,0,146,0,0,0,146,416,562,11,5.4,201816
10,4,0,0,0,567,0,0,0,567,707,1274,13,4.666666667,201816
11,1,0,0,0,205,0,0,0,205,270,475,6,5.666666667,201816
11,2,0,0,0,307,0,0,0,307,297,604,7,6,201816
11,3,0,0,0,370,0,0,0,370,393,763,3,6,201816
11,4,0,0,0,246,0,0,0,246,320,566,7,4.25,201816
11,5,0,0,0,618,0,0,0,618,670,1288,7,6.5,201816
11,6,0,0,0,344,0,0,0,344,420,764,7,5.666666667,201816
11,7,0,0,0,262,0,0,0,262,302,564,9,5.5,201816
11,8,0,0,0,403,0,0,0,403,515,918,9,5.75,201816
11,9,0,0,0,519,0,0,0,519,523,1042,10,5.666666667,201816
11,10,0,0,0,266,0,0,0,266,395,661,11,5.6,201816
11,11,0,0,0,304,0,0,0,304,267,571,5,6,201816
11,12,0,0,0,527,0,0,0,527,600,1127,7,6,201816
11,13,0,0,0,165,0,0,0,165,214,379,8,5.5,201816
11,14,0,0,0,225,0,0,0,225,273,498,8,5.5,201816
11,15,0,0,0,286,0,0,0,286,319,605,9,6,201816
12,1,0,0,0,106,0,0,0,106,210,316,10,5,201816
12,2,0,0,0,361,0,0,0,361,509,870,10,5.5,201816
12,3,0,0,0,150,0,0,0,150,356,506,11,5.2,201816
12,4,0,0,0,507,0,0,0,507,640,1147,9,6,201816
12,5,0,0,0,59,0,0,0,59,283,342,10,5.25,201816
12,6,0,0,0,49,0,0,0,49,259,308,10,5.25,201816
12,7,0,0,0,382,0,0,0,382,444,826,8,6,201816
12,8,0,0,0,80,0,0,0,80,289,369,9,5.25,201816
12,9,0,0,0,441,0,0,0,441,573,1014,9,5.666666667,201816
13,1,0,0,0,105,0,0,0,105,185,290,9,5.333333333,201816
13,2,0,0,0,100,0,0,0,100,174,274,6,5.333333333,201816
13,3,0,0,0,176,0,0,0,176,223,399,12,5.25,201816
13,4,0,0,0,281,0,0,0,281,378,659,9,5.666666667,201816
13,5,0,0,0,357,0,0,0,357,401,758,9,5.75,201816
13,6,0,0,0,680,0,0,0,680,641,1321,11,5.666666667,201816
13,7,0,0,0,322,0,0,0,322,445,767,9,5.5,201816
14,1,0,0,0,30,0,0,0,30,113,143,6,5.5,201816
14,2,0,0,0,121,0,0,0,121,153,274,5,5.666666667,201816
14,3,0,0,0,76,0,0,0,76,109,185,8,5.4,201816
14,4,0,0,0,349,0,0,0,349,447,796,11,6,201816
14,5,0,0,0,246,0,0,0,246,369,615,9,5.5,201816
14,6,0,0,0,483,0,0,0,483,575,1058,11,6,201816
14,7,0,0,0,170,0,0,0,170,250,420,6,6,201816
14,8,0,0,0,745,0,0,0,745,871,1616,10,4.8,201816
14,9,0,0,0,505,0,0,0,505,597,1102,8,6,201816
14,10,0,0,0,527,0,0,0,527,562,1089,7,6,201816
14,11,0,0,0,197,0,0,0,197,205,402,4,6,201816
14,12,0,0,0,273,0,0,0,273,370,643,9,5.5,201816
14,13,0,0,0,242,0,0,0,242,183,425,6,6,201816
14,14,0,0,0,354,0,0,0,354,378,732,7,6,201816
14,15,0,0,0,206,0,0,0,206,235,441,10,5.6,201816
14,16,0,0,0,433,0,0,0,433,451,884,5,6,201816
14,17,0,0,0,39,0,0,0,39,111,150,7,5.25,201816
14,18,0,0,0,139,0,0,0,139,214,353,9,5.4,201816
14,19,0,0,0,199,0,0,0,199,303,502,8,5.25,201816
14,20,0,0,0,49,0,0,0,49,61,110,8,4,201816
15,1,0,0,0,87,0,0,0,87,223,310,7,5.333333333,201816
15,2,0,0,0,426,0,0,0,426,406,832,6,6,201816
15,3,0,0,0,442,0,0,0,442,603,1045,10,5.666666667,201816
15,4,0,0,0,541,0,0,0,541,620,1161,4,6,201816
15,5,0,0,0,326,0,0,0,326,444,770,8,5.666666667,201816
15,6,0,0,0,482,0,0,0,482,654,1136,7,6,201816
15,7,0,0,0,561,0,0,0,561,576,1137,10,6,201816
15,8,0,0,0,270,0,0,0,270,218,488,4,6,201816
15,9,0,0,0,202,0,0,0,202,313,515,9,5.75,201816
15,10,0,0,0,385,0,0,0,385,425,810,9,7,201816
15,11,0,0,0,554,0,0,0,554,570,1124,8,6,201816
15,12,0,0,0,580,0,0,0,580,704,1284,8,6,201816
15,13,0,0,0,447,0,0,0,447,474,921,8,6,201816
15,14,0,0,0,280,0,0,0,280,322,602,4,6,201816
15,15,0,0,0,499,0,0,0,499,580,1079,6,6,201816
15,16,0,0,0,638,0,0,0,638,696,1334,8,6,201816
15,17,0,0,0,387,0,0,0,387,440,827,8,6,201816
15,18,0,0,0,448,0,0,0,448,634,1082,7,5.666666667,201816
15,19,0,0,0,865,0,0,0,865,1074,1939,13,6,201816
15,20,0,0,0,325,0,0,0,325,392,717,6,6,201816
15,21,0,0,0,129,0,0,0,129,151,280,6,5.5,201816
15,22,0,0,0,899,0,0,0,899,1101,2000,14,6,201816
15,23,0,0,0,293,0,0,0,293,359,652,7,5.333333333,201816
15,24,0,0,0,338,0,0,0,338,418,756,4,6,201816
15,25,0,0,0,565,0,0,0,565,596,1161,6,6,201816
15,26,0,0,0,359,0,0,0,359,390,749,10,4,201816
15,27,0,0,0,611,0,0,0,611,789,1400,9,5.666666667,201816
15,28,0,0,0,441,0,0,0,441,535,976,9,5.666666667,201816
15,29,0,0,0,707,0,0,0,707,753,1460,8,6,201816
15,30,0,0,0,454,0,0,0,454,462,916,12,7,201816
15,31,0,0,0,161,0,0,0,161,257,418,6,4,201816
15,32,0,0,0,457,0,0,0,457,575,1032,9,6,201816
15,33,0,0,0,522,0,0,0,522,590,1112,7,6,201816
15,34,0,0,0,501,0,0,0,501,619,1120,8,6,201816
15,35,0,0,0,305,0,0,0,305,472,777,9,5.666666667,201816
15,36,0,0,0,248,0,0,0,248,364,612,9,5.5,201816
15,37,0,0,0,461,0,0,0,461,630,1091,7,6,201816
15,38,0,0,0,416,0,0,0,416,519,935,6,5.5,201816
15,39,0,0,0,225,0,0,0,225,301,526,4,6,201816
15,40,0,0,0,439,0,0,0,439,608,1047,9,6,201816
15,41,0,0,0,602,0,0,0,602,834,1436,11,6,201816
16,1,0,0,0,129,0,0,0,129,184,313,7,5.333333333,201816
16,2,0,0,0,67,0,0,0,67,135,202,9,5.25,201816
16,3,0,0,0,200,0,0,0,200,286,486,10,5.25,201816
16,4,0,0,0,152,0,0,0,152,192,344,8,5.5,201816
16,5,0,0,0,242,0,0,0,242,296,538,10,5.666666667,201816
16,6,0,0,0,131,0,0,0,131,231,362,12,5.5,201816
16,7,0,0,0,207,0,0,0,207,222,429,9,5.5,201816
16,8,0,0,0,618,0,0,0,618,734,1352,12,6,201816
16,9,0,0,0,289,0,0,0,289,330,619,9,6,201816
16,10,0,0,0,332,0,0,0,332,378,710,7,6.5,201816
16,11,0,0,0,145,0,0,0,145,257,402,10,5.4,201816
16,12,0,0,0,138,0,0,0,138,172,310,10,5.25,201816
17,1,0,0,0,499,0,0,0,499,599,1098,10,5,201816
17,2,0,0,0,402,0,0,0,402,439,841,8,5.666666667,201816
17,3,0,0,0,537,0,0,0,537,649,1186,8,5.5,201816
17,4,0,0,0,387,0,0,0,387,506,893,10,5.666666667,201816
17,5,0,0,0,139,0,0,0,139,247,386,5,5.5,201816
18,1,0,0,0,90,0,0,0,90,198,288,9,5.2,201816
18,2,0,0,0,516,0,0,0,516,601,1117,9,6.333333333,201816
18,3,0,0,0,124,0,0,0,124,267,391,8,5.5,201816
19,1,0,0,0,384,0,0,0,384,463,847,9,6,201816
19,2,0,0,0,520,0,0,0,520,672,1192,9,6,201816
19,3,0,0,0,387,0,0,0,387,492,879,7,6,201816
19,4,0,0,0,198,0,0,0,198,302,500,5,6,201816
19,5,0,0,0,599,0,0,0,599,602,1201,8,6,201816
19,6,0,0,0,265,0,0,0,265,323,588,5,6,201816
19,7,0,0,0,108,0,0,0,108,221,329,10,5.25,201816
19,8,0,0,0,81,0,0,0,81,143,224,7,6,201816
19,9,0,0,0,69,0,0,0,69,541,610,9,5.25,201816
19,10,0,0,0,353,0,0,0,353,412,765,6,3.5,201816
19,11,0,0,0,709,0,0,0,709,869,1578,13,6,201816
19,12,0,0,0,199,0,0,0,199,305,504,8,5.666666667,201816
20,1,0,0,0,209,0,0,0,209,320,529,7,5.5,201816
20,2,0,0,0,36,0,0,0,36,259,295,6,5.333333333,201816
20,3,0,0,0,112,0,0,0,112,223,335,6,5.333333333,201816
20,4,0,0,0,41,0,0,0,41,177,218,6,5.333333333,201816
20,5,0,0,0,142,0,0,0,142,356,498,11,5.25,201816
20,6,0,0,0,28,0,0,0,28,187,215,8,5,201816
20,7,0,0,0,174,0,0,0,174,341,515,7,5.75,201816
20,8,0,0,0,988,0,0,0,988,865,1853,15,6.5,201816
20,9,0,0,0,189,0,0,0,189,252,441,8,5.666666667,201816
20,10,0,0,0,100,0,0,0,100,273,373,9,5.25,201816
21,1,0,0,0,236,0,0,0,236,586,822,9,5.4,201816
21,2,0,0,0,95,0,0,0,95,402,497,9,5.2,201816
21,3,0,0,0,272,0,0,0,272,510,782,8,5.5,201816
21,4,0,0,0,72,0,0,0,72,289,361,6,5.25,201816
21,5,0,0,0,309,0,0,0,309,488,797,8,5.666666667,201816
21,6,0,0,0,523,0,0,0,523,636,1159,6,7,201816
21,7,0,0,0,185,0,0,0,185,327,512,9,5.666666667,201816
21,8,0,0,0,91,0,0,0,91,679,770,9,5.2,201816
21,9,0,0,0,549,0,0,0,549,700,1249,9,6,201816
21,10,0,0,0,439,0,0,0,439,555,994,7,6,201816
21,11,0,0,0,95,0,0,0,95,134,229,4,6,201816
21,12,0,0,0,1055,0,0,0,1055,1248,2303,15,4.666666667,201816
21,13,0,0,0,266,0,0,0,266,347,613,8,5.666666667,201816
21,14,0,0,0,130,0,0,0,130,467,597,12,5.333333333,201816
21,15,0,0,0,380,0,0,0,380,568,948,7,5.5,201816
22,1,0,0,0,137,0,0,0,137,298,435,11,5.2,201816
22,2,0,0,0,342,0,0,0,342,467,809,7,5.5,201816
22,3,0,0,0,688,0,0,0,688,755,1443,9,5.666666667,201816
22,4,0,0,0,805,0,0,0,805,926,1731,12,5,201816
22,5,0,0,0,234,0,0,0,234,383,617,10,5.5,201816
23,1,0,0,0,500,0,0,0,500,606,1106,14,5.6,201816
23,2,0,0,0,207,0,0,0,207,615,822,8,4.2,201816
23,3,0,0,0,629,0,0,0,629,592,1221,11,6,201816
23,4,0,0,0,361,0,0,0,361,559,920,8,5.666666667,201816
24,1,0,0,0,99,0,0,0,99,258,357,10,5.2,201816
24,2,0,0,0,171,0,0,0,171,252,423,6,5.5,201816
24,3,0,0,0,119,0,0,0,119,280,399,9,5.25,201816
24,4,0,0,0,157,0,0,0,157,330,487,5,5.5,201816
24,5,0,0,0,360,0,0,0,360,609,969,10,4.75,201816
24,6,0,0,0,687,0,0,0,687,815,1502,9,6,201816
24,7,0,0,0,44,0,0,0,44,145,189,9,5.25,201816
25,1,0,0,0,218,0,0,0,218,341,559,13,5.75,201816
25,2,0,0,0,427,0,0,0,427,442,869,7,5.5,201816
25,3,0,0,0,231,0,0,0,231,306,537,8,5.6,201816
25,4,0,0,0,175,0,0,0,175,263,438,8,5.333333333,201816
25,5,0,0,0,482,0,0,0,482,439,921,8,5.666666667,201816
25,6,0,0,0,353,0,0,0,353,473,826,8,5.75,201816
25,7,0,0,0,428,0,0,0,428,532,960,6,6,201816
26,1,0,0,0,286,0,0,0,286,307,593,9,5.5,201816
26,2,0,0,0,393,0,0,0,393,511,904,12,5.4,201816
26,3,0,0,0,680,0,0,0,680,871,1551,13,6,201816
26,4,0,0,0,164,0,0,0,164,238,402,9,5.2,201816
26,5,0,0,0,190,0,0,0,190,223,413,3,5.5,201816
26,6,0,0,0,487,0,0,0,487,403,890,10,5.333333333,201816
26,7,0,0,0,261,0,0,0,261,344,605,10,5.5,201816
27,1,0,0,0,244,0,0,0,244,345,589,9,5.5,201816
27,2,0,0,0,360,0,0,0,360,482,842,8,5.666666667,201816
27,3,0,0,0,355,0,0,0,355,467,822,7,5.666666667,201816
27,4,0,0,0,818,0,0,0,818,834,1652,8,4,201816
27,5,0,0,0,71,0,0,0,71,371,442,6,5.333333333,201816
27,6,0,0,0,402,0,0,0,402,661,1063,9,5.333333333,201816
28,1,0,0,0,387,0,0,0,387,451,838,13,6,201816
28,2,0,0,0,405,0,0,0,405,539,944,13,6,201816
28,3,0,0,0,110,0,0,0,110,148,258,7,5.333333333,201816
28,4,0,0,0,296,0,0,0,296,431,727,15,6,201816
28,5,0,0,0,277,0,0,0,277,374,651,9,4.2,201816
28,6,0,0,0,103,0,0,0,103,178,281,13,5.166666667,201816
28,7,0,0,0,467,0,0,0,467,558,1025,6,6,201816
28,8,0,0,0,303,0,0,0,303,338,641,9,6,201816
28,9,0,0,0,185,0,0,0,185,214,399,9,4.5,201816
29,1,0,0,0,341,0,0,0,341,379,720,7,5.5,201816
29,2,0,0,0,555,0,0,0,555,671,1226,11,4.8,201816
29,3,0,0,0,252,0,0,0,252,362,614,5,5.666666667,201816
30,1,0,0,0,69,0,0,0,69,124,193,7,5.333333333,201816
30,2,0,0,0,77,0,0,0,77,168,245,8,5.25,201816
30,3,0,0,0,217,0,0,0,217,218,435,6,5.666666667,201816
30,4,0,0,0,258,0,0,0,258,338,596,8,6,201816
30,5,0,0,0,281,0,0,0,281,361,642,7,5.5,201816
30,6,0,0,0,116,0,0,0,116,169,285,9,5.333333333,201816
30,7,0,0,0,175,0,0,0,175,308,483,11,5.25,201816
30,8,0,0,0,236,0,0,0,236,395,631,11,5.4,201816
30,9,0,0,0,207,0,0,0,207,303,510,8,5.5,201816
30,10,0,0,0,490,0,0,0,490,684,1174,7,6.5,201816
30,11,0,0,0,371,0,0,0,371,417,788,5,5.5,201816
30,12,0,0,0,579,0,0,0,579,740,1319,10,6,201816
30,13,0,0,0,160,0,0,0,160,224,384,10,5.4,201816
30,14,0,0,0,176,0,0,0,176,266,442,8,5.5,201816
30,15,0,0,0,433,0,0,0,433,474,907,11,5.666666667,201816
30,16,0,0,0,314,0,0,0,314,449,763,10,5.333333333,201816
30,17,0,0,0,169,0,0,0,169,245,414,8,5.5,201816
30,18,0,0,0,45,0,0,0,45,165,210,8,5.25,201816
30,19,0,0,0,134,0,0,0,134,192,326,13,5.6,201816
30,20,0,0,0,190,0,0,0,190,279,469,10,5.4,201816
31,1,0,0,0,172,0,0,0,172,553,725,8,6,201816
31,2,0,0,0,56,0,0,0,56,267,323,6,6,201816
31,3,0,0,0,945,0,0,0,945,1213,2158,20,4.75,201816
31,4,0,0,0,339,0,0,0,339,531,870,4,8,201816
31,5,0,0,0,85,0,0,0,85,249,334,5,5.333333333,201816
32,1,0,0,0,104,0,0,0,104,194,298,12,5.2,201816
32,2,0,0,0,44,0,0,0,44,140,184,13,5.142857143,201816
32,3,0,0,0,200,0,0,0,200,309,509,13,5.4,201816
32,4,0,0,0,211,0,0,0,211,374,585,12,4.333333333,201816
1,1,0,0,0,182,0,0,0,182,254,436,13,6.166666667,201817
1,2,0,0,0,533,0,0,0,533,616,1149,10,4.4,201817
1,3,0,0,0,478,0,0,0,478,601,1079,9,5.25,201817
2,1,0,0,0,221,0,0,0,221,395,616,11,6,201817
2,2,0,0,0,351,0,0,0,351,581,932,8,6.5,201817
2,3,0,0,0,341,0,0,0,341,654,995,12,4.5,201817
2,4,0,0,0,155,0,0,0,155,235,390,9,6,201817
2,5,0,0,0,618,0,0,0,618,954,1572,14,6.333333333,201817
2,6,0,0,0,377,0,0,0,377,464,841,7,6,201817
2,7,0,0,0,202,0,0,0,202,323,525,12,5.75,201817
2,8,0,0,0,496,0,0,0,496,620,1116,8,6,201817
3,1,0,0,0,355,0,0,0,355,447,802,13,5.833333333,201817
3,2,0,0,0,269,0,0,0,269,338,607,9,5.666666667,201817
4,1,0,0,0,376,0,0,0,376,527,903,13,5.6,201817
4,2,0,0,0,216,0,0,0,216,378,594,14,5.4,201817
5,1,0,0,0,256,0,0,0,256,130,386,9,7,201817
5,2,0,0,0,76,0,0,0,76,312,388,10,7,201817
5,3,0,0,0,252,0,0,0,252,342,594,9,7,201817
5,4,0,0,0,573,0,0,0,573,802,1375,9,7,201817
5,5,0,0,0,379,0,0,0,379,513,892,8,7,201817
5,6,0,0,0,191,0,0,0,191,433,624,12,7.5,201817
5,7,0,0,0,217,0,0,0,217,345,562,10,4.666666667,201817
6,1,0,0,0,265,0,0,0,265,425,690,11,5.666666667,201817
6,2,0,0,0,188,0,0,0,188,294,482,9,6.333333333,201817
7,1,0,0,0,17,0,0,0,17,150,167,9,7,201817
7,2,0,0,0,61,0,0,0,61,413,474,7,5.25,201817
7,3,0,0,0,72,0,0,0,72,265,337,7,6,201817
7,4,0,0,0,83,0,0,0,83,237,320,11,7,201817
7,5,0,0,0,215,0,0,0,215,335,550,11,7,201817
7,6,0,0,0,287,0,0,0,287,529,816,8,5.25,201817
7,7,0,0,0,234,0,0,0,234,391,625,8,7,201817
7,8,0,0,0,179,0,0,0,179,248,427,10,5.25,201817
7,9,0,0,0,517,0,0,0,517,991,1508,10,8,201817
7,10,0,0,0,88,0,0,0,88,361,449,9,7,201817
7,11,0,0,0,20,0,0,0,20,79,99,6,7,201817
7,12,0,0,0,461,0,0,0,461,563,1024,9,7,201817
7,13,0,0,0,32,0,0,0,32,391,423,9,7,201817
8,1,0,0,0,300,0,0,0,300,385,685,4,6,201817
8,2,0,0,0,238,0,0,0,238,364,602,16,5.5,201817
8,3,0,0,0,384,0,0,0,384,411,795,4,6,201817
8,4,0,0,0,364,0,0,0,364,429,793,9,6,201817
8,5,0,0,0,116,0,0,0,116,213,329,10,5.25,201817
8,6,0,0,0,438,0,0,0,438,679,1117,5,4,201817
8,7,0,0,0,108,0,0,0,108,303,411,7,5.25,201817
8,8,0,0,0,354,0,0,0,354,478,832,10,6,201817
8,9,0,0,0,82,0,0,0,82,240,322,10,6,201817
9,1,0,0,0,299,0,0,0,299,294,593,6,7,201817
9,2,0,0,0,1115,0,0,0,1115,1237,2352,12,6,201817
9,3,0,0,0,673,0,0,0,673,884,1557,7,6,201817
9,4,0,0,0,484,0,0,0,484,602,1086,11,6,201817
9,5,0,0,0,430,0,0,0,430,638,1068,7,6,201817
9,6,0,0,0,310,0,0,0,310,404,714,7,5,201817
9,7,0,0,0,427,0,0,0,427,543,970,9,6,201817
9,8,0,0,0,283,0,0,0,283,443,726,6,7,201817
9,9,0,0,0,392,0,0,0,392,518,910,5,6,201817
9,10,0,0,0,543,0,0,0,543,880,1423,6,6,201817
9,11,0,0,0,825,0,0,0,825,1062,1887,7,6,201817
9,12,0,0,0,743,0,0,0,743,1040,1783,11,6,201817
9,13,0,0,0,470,0,0,0,470,624,1094,4,6,201817
9,14,0,0,0,339,0,0,0,339,534,873,5,6,201817
9,15,0,0,0,1221,0,0,0,1221,1947,3168,9,4.333333333,201817
9,16,0,0,0,957,0,0,0,957,1238,2195,15,6,201817
9,17,0,0,0,438,0,0,0,438,503,941,6,6,201817
9,18,0,0,0,673,0,0,0,673,876,1549,12,6,201817
9,19,0,0,0,468,0,0,0,468,858,1326,5,6,201817
9,20,0,0,0,68,0,0,0,68,146,214,5,6,201817
9,21,0,0,0,179,0,0,0,179,317,496,3,6,201817
9,22,0,0,0,364,0,0,0,364,496,860,5,6,201817
9,23,0,0,0,701,0,0,0,701,774,1475,7,7,201817
9,24,0,0,0,1099,0,0,0,1099,1340,2439,13,6.5,201817
10,1,0,0,0,194,0,0,0,194,376,570,12,4.666666667,201817
10,2,0,0,0,288,0,0,0,288,399,687,9,5.5,201817
10,3,0,0,0,155,0,0,0,155,240,395,11,5.8,201817
10,4,0,0,0,524,0,0,0,524,711,1235,13,5.333333333,201817
11,1,0,0,0,181,0,0,0,181,316,497,6,6.333333333,201817
11,2,0,0,0,257,0,0,0,257,359,616,7,6,201817
11,3,0,0,0,336,0,0,0,336,438,774,3,7,201817
11,4,0,0,0,199,0,0,0,199,479,678,7,4.25,201817
11,5,0,0,0,595,0,0,0,595,746,1341,7,7,201817
11,6,0,0,0,303,0,0,0,303,431,734,7,5.666666667,201817
11,7,0,0,0,237,0,0,0,237,336,573,9,5.5,201817
11,8,0,0,0,433,0,0,0,433,508,941,9,5.75,201817
11,9,0,0,0,459,0,0,0,459,596,1055,10,5.666666667,201817
11,10,0,0,0,203,0,0,0,203,305,508,10,5.6,201817
11,11,0,0,0,308,0,0,0,308,335,643,5,6,201817
11,12,0,0,0,499,0,0,0,499,571,1070,7,7,201817
11,13,0,0,0,166,0,0,0,166,291,457,8,5.5,201817
11,14,0,0,0,196,0,0,0,196,278,474,8,5.5,201817
11,15,0,0,0,275,0,0,0,275,403,678,9,7,201817
12,1,0,0,0,90,0,0,0,90,170,260,10,5.4,201817
12,2,0,0,0,317,0,0,0,317,470,787,10,6,201817
12,3,0,0,0,166,0,0,0,166,363,529,11,5.4,201817
12,4,0,0,0,538,0,0,0,538,759,1297,9,6.333333333,201817
12,5,0,0,0,30,0,0,0,30,330,360,10,5.5,201817
12,6,0,0,0,64,0,0,0,64,238,302,10,5.5,201817
12,7,0,0,0,351,0,0,0,351,467,818,6,7,201817
12,8,0,0,0,66,0,0,0,66,294,360,9,5.5,201817
12,9,0,0,0,429,0,0,0,429,597,1026,9,6.333333333,201817
13,1,0,0,0,125,0,0,0,125,189,314,9,5.666666667,201817
13,2,0,0,0,114,0,0,0,114,168,282,6,5.666666667,201817
13,3,0,0,0,164,0,0,0,164,231,395,12,5.5,201817
13,4,0,0,0,252,0,0,0,252,383,635,9,6.333333333,201817
13,5,0,0,0,345,0,0,0,345,496,841,7,5.25,201817
13,6,0,0,0,721,0,0,0,721,890,1611,11,6.333333333,201817
13,7,0,0,0,301,0,0,0,301,486,787,8,6,201817
14,1,0,0,0,42,0,0,0,42,112,154,6,5.5,201817
14,2,0,0,0,110,0,0,0,110,142,252,5,5.666666667,201817
14,3,0,0,0,92,0,0,0,92,132,224,8,5.4,201817
14,4,0,0,0,402,0,0,0,402,406,808,11,6,201817
14,5,0,0,0,285,0,0,0,285,335,620,9,5.5,201817
14,6,0,0,0,450,0,0,0,450,565,1015,11,6,201817
14,7,0,0,0,191,0,0,0,191,247,438,6,6,201817
14,8,0,0,0,693,0,0,0,693,924,1617,10,4.6,201817
14,9,0,0,0,497,0,0,0,497,564,1061,8,6,201817
14,10,0,0,0,498,0,0,0,498,734,1232,7,6,201817
14,11,0,0,0,173,0,0,0,173,254,427,4,6,201817
14,12,0,0,0,261,0,0,0,261,344,605,9,5.5,201817
14,13,0,0,0,293,0,0,0,293,378,671,6,6,201817
14,14,0,0,0,328,0,0,0,328,451,779,7,6,201817
14,15,0,0,0,212,0,0,0,212,274,486,10,5.6,201817
14,16,0,0,0,418,0,0,0,418,557,975,5,6,201817
14,17,0,0,0,56,0,0,0,56,124,180,7,5.25,201817
14,18,0,0,0,150,0,0,0,150,237,387,9,5.4,201817
14,19,0,0,0,212,0,0,0,212,271,483,8,5.25,201817
14,20,0,0,0,60,0,0,0,60,89,149,10,5.666666667,201817
15,1,0,0,0,96,0,0,0,96,183,279,7,5.333333333,201817
15,2,0,0,0,424,0,0,0,424,463,887,6,6,201817
15,3,0,0,0,394,0,0,0,394,583,977,10,5.666666667,201817
15,4,0,0,0,514,0,0,0,514,502,1016,4,6,201817
15,5,0,0,0,260,0,0,0,260,388,648,8,5.666666667,201817
15,6,0,0,0,507,0,0,0,507,580,1087,7,6,201817
15,7,0,0,0,494,0,0,0,494,479,973,10,6,201817
15,8,0,0,0,234,0,0,0,234,361,595,4,6,201817
15,9,0,0,0,145,0,0,0,145,329,474,9,5.75,201817
15,10,0,0,0,325,0,0,0,325,426,751,9,7,201817
15,11,0,0,0,563,0,0,0,563,747,1310,8,6,201817
15,12,0,0,0,539,0,0,0,539,755,1294,8,6,201817
15,13,0,0,0,431,0,0,0,431,470,901,8,6,201817
15,14,0,0,0,277,0,0,0,277,378,655,4,6,201817
15,15,0,0,0,414,0,0,0,414,685,1099,6,6,201817
15,16,0,0,0,620,0,0,0,620,778,1398,8,6,201817
15,17,0,0,0,355,0,0,0,355,528,883,8,6,201817
15,18,0,0,0,429,0,0,0,429,674,1103,7,5.666666667,201817
15,19,0,0,0,803,0,0,0,803,956,1759,13,6,201817
15,20,0,0,0,291,0,0,0,291,400,691,6,6,201817
15,21,0,0,0,111,0,0,0,111,151,262,6,5.5,201817
15,22,0,0,0,769,0,0,0,769,1215,1984,14,6,201817
15,23,0,0,0,283,0,0,0,283,483,766,7,5.333333333,201817
15,24,0,0,0,305,0,0,0,305,482,787,4,6,201817
15,25,0,0,0,545,0,0,0,545,612,1157,6,6,201817
15,26,0,0,0,319,0,0,0,319,438,757,9,3.5,201817
15,27,0,0,0,578,0,0,0,578,718,1296,9,5.666666667,201817
15,28,0,0,0,447,0,0,0,447,656,1103,9,5.666666667,201817
15,29,0,0,0,615,0,0,0,615,812,1427,8,6,201817
15,30,0,0,0,414,0,0,0,414,514,928,12,7,201817
15,31,0,0,0,335,0,0,0,335,529,864,6,5,201817
15,32,0,0,0,428,0,0,0,428,595,1023,9,6,201817
15,33,0,0,0,495,0,0,0,495,487,982,7,6,201817
15,34,0,0,0,493,0,0,0,493,590,1083,8,6,201817
15,35,0,0,0,373,0,0,0,373,381,754,9,5.666666667,201817
15,36,0,0,0,209,0,0,0,209,387,596,9,5.5,201817
15,37,0,0,0,482,0,0,0,482,706,1188,7,6,201817
15,38,0,0,0,410,0,0,0,410,460,870,6,5.5,201817
15,39,0,0,0,245,0,0,0,245,318,563,4,6,201817
15,40,0,0,0,395,0,0,0,395,651,1046,9,6,201817
15,41,0,0,0,598,0,0,0,598,906,1504,11,6,201817
16,1,0,0,0,145,0,0,0,145,153,298,7,5.333333333,201817
16,2,0,0,0,58,0,0,0,58,140,198,9,5.25,201817
16,3,0,0,0,160,0,0,0,160,320,480,10,5.25,201817
16,4,0,0,0,145,0,0,0,145,277,422,8,5.5,201817
16,5,0,0,0,183,0,0,0,183,301,484,10,5.666666667,201817
16,6,0,0,0,122,0,0,0,122,232,354,12,5.5,201817
16,7,0,0,0,166,0,0,0,166,241,407,9,5.5,201817
16,8,0,0,0,592,0,0,0,592,743,1335,12,6,201817
16,9,0,0,0,262,0,0,0,262,399,661,9,6,201817
16,10,0,0,0,257,0,0,0,257,487,744,7,6.5,201817
16,11,0,0,0,150,0,0,0,150,281,431,10,5.4,201817
16,12,0,0,0,146,0,0,0,146,190,336,10,5.25,201817
17,1,0,0,0,479,0,0,0,479,747,1226,10,6,201817
17,2,0,0,0,335,0,0,0,335,535,870,8,6.333333333,201817
17,3,0,0,0,507,0,0,0,507,650,1157,8,7,201817
17,4,0,0,0,410,0,0,0,410,543,953,10,6.333333333,201817
17,5,0,0,0,147,0,0,0,147,251,398,5,6,201817
18,1,0,0,0,82,0,0,0,82,155,237,9,5.4,201817
18,2,0,0,0,499,0,0,0,499,638,1137,8,7,201817
18,3,0,0,0,162,0,0,0,162,252,414,8,6,201817
19,1,0,0,0,384,0,0,0,384,458,842,9,6,201817
19,2,0,0,0,563,0,0,0,563,602,1165,9,6,201817
19,3,0,0,0,384,0,0,0,384,518,902,7,6,201817
19,4,0,0,0,182,0,0,0,182,322,504,5,6,201817
19,5,0,0,0,680,0,0,0,680,757,1437,8,6,201817
19,6,0,0,0,223,0,0,0,223,362,585,5,6,201817
19,7,0,0,0,160,0,0,0,160,257,417,10,5.5,201817
19,8,0,0,0,69,0,0,0,69,153,222,7,6,201817
19,9,0,0,0,85,0,0,0,85,266,351,9,5.25,201817
19,10,0,0,0,359,0,0,0,359,428,787,6,3.5,201817
19,11,0,0,0,805,0,0,0,805,971,1776,13,6,201817
19,12,0,0,0,209,0,0,0,209,317,526,8,5.666666667,201817
20,1,0,0,0,191,0,0,0,191,309,500,7,5.5,201817
20,2,0,0,0,28,0,0,0,28,309,337,6,5.333333333,201817
20,3,0,0,0,91,0,0,0,91,244,335,6,5.333333333,201817
20,4,0,0,0,62,0,0,0,62,200,262,6,5.333333333,201817
20,5,0,0,0,121,0,0,0,121,358,479,11,5.25,201817
20,6,0,0,0,41,0,0,0,41,218,259,8,5.25,201817
20,7,0,0,0,169,0,0,0,169,365,534,7,5.75,201817
20,8,0,0,0,852,0,0,0,852,992,1844,14,6.5,201817
20,9,0,0,0,213,0,0,0,213,267,480,8,5.666666667,201817
20,10,0,0,0,59,0,0,0,59,293,352,9,5.25,201817
21,1,0,0,0,231,0,0,0,231,387,618,9,5.4,201817
21,2,0,0,0,90,0,0,0,90,193,283,9,5,201817
21,3,0,0,0,224,0,0,0,224,389,613,8,5.5,201817
21,4,0,0,0,51,0,0,0,51,190,241,6,5.25,201817
21,5,0,0,0,337,0,0,0,337,506,843,8,5.666666667,201817
21,6,0,0,0,534,0,0,0,534,666,1200,6,7,201817
21,7,0,0,0,259,0,0,0,259,329,588,9,5.666666667,201817
21,8,0,0,0,73,0,0,0,73,286,359,9,5.2,201817
21,9,0,0,0,473,0,0,0,473,673,1146,9,6,201817
21,10,0,0,0,370,0,0,0,370,624,994,7,5.5,201817
21,11,0,0,0,139,0,0,0,139,71,210,4,6,201817
21,12,0,0,0,887,0,0,0,887,1230,2117,14,4.333333333,201817
21,13,0,0,0,284,0,0,0,284,403,687,8,5.666666667,201817
21,14,0,0,0,143,0,0,0,143,259,402,12,5.333333333,201817
21,15,0,0,0,359,0,0,0,359,523,882,7,5.5,201817
22,1,0,0,0,150,0,0,0,150,292,442,11,5.2,201817
22,2,0,0,0,291,0,0,0,291,484,775,7,6,201817
22,3,0,0,0,555,0,0,0,555,785,1340,9,7,201817
22,4,0,0,0,728,0,0,0,728,905,1633,10,5.25,201817
22,5,0,0,0,198,0,0,0,198,419,617,10,6.25,201817
23,1,0,0,0,454,0,0,0,454,626,1080,14,6,201817
23,2,0,0,0,174,0,0,0,174,488,662,8,4.2,201817
23,3,0,0,0,578,0,0,0,578,686,1264,11,6,201817
23,4,0,0,0,337,0,0,0,337,605,942,8,5.666666667,201817
24,1,0,0,0,89,0,0,0,89,240,329,10,5.4,201817
24,2,0,0,0,156,0,0,0,156,256,412,6,6,201817
24,3,0,0,0,113,0,0,0,113,236,349,9,5.5,201817
24,4,0,0,0,178,0,0,0,178,232,410,5,6,201817
24,5,0,0,0,320,0,0,0,320,559,879,9,5.25,201817
24,6,0,0,0,639,0,0,0,639,824,1463,9,7,201817
24,7,0,0,0,50,0,0,0,50,107,157,9,5.5,201817
25,1,0,0,0,262,0,0,0,262,331,593,13,6.5,201817
25,2,0,0,0,426,0,0,0,426,533,959,6,5.5,201817
25,3,0,0,0,225,0,0,0,225,338,563,8,6.2,201817
25,4,0,0,0,160,0,0,0,160,257,417,8,5.333333333,201817
25,5,0,0,0,491,0,0,0,491,715,1206,8,6.333333333,201817
25,6,0,0,0,361,0,0,0,361,433,794,8,6.5,201817
25,7,0,0,0,485,0,0,0,485,607,1092,6,7,201817
26,1,0,0,0,269,0,0,0,269,308,577,9,5.5,201817
26,2,0,0,0,393,0,0,0,393,484,877,12,5.8,201817
26,3,0,0,0,664,0,0,0,664,918,1582,14,7.5,201817
26,4,0,0,0,179,0,0,0,179,327,506,9,5.4,201817
26,5,0,0,0,165,0,0,0,165,267,432,3,6,201817
26,6,0,0,0,438,0,0,0,438,552,990,10,5.666666667,201817
26,7,0,0,0,258,0,0,0,258,347,605,10,5.75,201817
27,1,0,0,0,234,0,0,0,234,350,584,9,6,201817
27,2,0,0,0,364,0,0,0,364,469,833,8,6.333333333,201817
27,3,0,0,0,320,0,0,0,320,432,752,7,6.333333333,201817
27,4,0,0,0,730,0,0,0,730,969,1699,8,5,201817
27,5,0,0,0,82,0,0,0,82,199,281,6,5.666666667,201817
27,6,0,0,0,417,0,0,0,417,602,1019,9,5.666666667,201817
28,1,0,0,0,349,0,0,0,349,587,936,13,7,201817
28,2,0,0,0,335,0,0,0,335,616,951,13,6.5,201817
28,3,0,0,0,104,0,0,0,104,141,245,7,5.666666667,201817
28,4,0,0,0,334,0,0,0,334,446,780,15,6.6,201817
28,5,0,0,0,292,0,0,0,292,413,705,10,4.6,201817
28,6,0,0,0,115,0,0,0,115,162,277,13,5.333333333,201817
28,7,0,0,0,455,0,0,0,455,562,1017,6,7,201817
28,8,0,0,0,268,0,0,0,268,387,655,9,7,201817
28,9,0,0,0,149,0,0,0,149,205,354,9,5.25,201817
29,1,0,0,0,287,0,0,0,287,374,661,7,5.75,201817
29,2,0,0,0,478,0,0,0,478,658,1136,11,5,201817
29,3,0,0,0,218,0,0,0,218,375,593,5,6,201817
30,1,0,0,0,60,0,0,0,60,142,202,7,5.333333333,201817
30,2,0,0,0,68,0,0,0,68,129,197,8,5.25,201817
30,3,0,0,0,204,0,0,0,204,242,446,6,5.666666667,201817
30,4,0,0,0,256,0,0,0,256,358,614,8,6,201817
30,5,0,0,0,214,0,0,0,214,338,552,7,5.5,201817
30,6,0,0,0,69,0,0,0,69,120,189,9,5.333333333,201817
30,7,0,0,0,140,0,0,0,140,210,350,11,5.25,201817
30,8,0,0,0,209,0,0,0,209,274,483,11,5.4,201817
30,9,0,0,0,200,0,0,0,200,261,461,8,5.5,201817
30,10,0,0,0,440,0,0,0,440,531,971,6,6,201817
30,11,0,0,0,369,0,0,0,369,458,827,5,5.5,201817
30,12,0,0,0,578,0,0,0,578,701,1279,10,6,201817
30,13,0,0,0,150,0,0,0,150,226,376,10,5.4,201817
30,14,0,0,0,186,0,0,0,186,243,429,8,5.5,201817
30,15,0,0,0,374,0,0,0,374,489,863,11,5.666666667,201817
30,16,0,0,0,303,0,0,0,303,344,647,10,5.333333333,201817
30,17,0,0,0,164,0,0,0,164,236,400,8,5.5,201817
30,18,0,0,0,33,0,0,0,33,126,159,8,5.25,201817
30,19,0,0,0,136,0,0,0,136,172,308,13,5.6,201817
30,20,0,0,0,195,0,0,0,195,282,477,10,5.4,201817
31,1,0,0,0,173,0,0,0,173,372,545,8,6,201817
31,2,0,0,0,69,0,0,0,69,880,949,6,6,201817
31,3,0,0,0,891,0,0,0,891,1301,2192,20,4.75,201817
31,4,0,0,0,339,0,0,0,339,627,966,3,7,201817
31,5,0,0,0,83,0,0,0,83,242,325,5,5.333333333,201817
32,1,0,0,0,97,0,0,0,97,160,257,12,5.4,201817
32,2,0,0,0,45,0,0,0,45,121,166,13,5.285714286,201817
32,3,0,0,0,168,0,0,0,168,352,520,13,5.6,201817
32,4,0,0,0,185,0,0,0,185,411,596,12,4.5,201817
1,1,0,0,0,46,0,0,0,46,66,112,11,0.833333333,201818
1,2,0,0,0,126,0,0,0,126,145,271,9,0.6,201818
1,3,0,0,0,100,0,0,0,100,166,266,9,0.75,201818
2,1,0,0,0,48,0,0,0,48,102,150,11,1,201818
2,2,0,0,0,82,0,0,0,82,124,206,8,1.5,201818
2,3,0,0,0,71,0,0,0,71,153,224,12,1,201818
2,4,0,0,0,36,0,0,0,36,51,87,9,1,201818
2,5,0,0,0,116,0,0,0,116,196,312,14,1.333333333,201818
2,6,0,0,0,69,0,0,0,69,111,180,7,1,201818
2,7,0,0,0,38,0,0,0,38,118,156,12,1,201818
2,8,0,0,0,110,0,0,0,110,171,281,8,1,201818
3,1,0,0,0,77,0,0,0,77,132,209,13,1.166666667,201818
3,2,0,0,0,46,0,0,0,46,97,143,9,1,201818
4,1,0,0,0,69,0,0,0,69,152,221,10,0.6,201818
4,2,0,0,0,40,0,0,0,40,317,357,14,1,201818
5,1,0,0,0,56,0,0,0,56,407,463,7,0.666666667,201818
5,2,0,0,0,21,0,0,0,21,79,100,10,1,201818
5,3,0,0,0,68,0,0,0,68,95,163,9,1,201818
5,4,0,0,0,124,0,0,0,124,232,356,10,1.333333333,201818
5,5,0,0,0,70,0,0,0,70,180,250,8,1,201818
5,6,0,0,0,41,0,0,0,41,129,170,11,1,201818
5,7,0,0,0,34,0,0,0,34,115,149,10,0.666666667,201818
6,1,0,0,0,72,0,0,0,72,131,203,11,0.833333333,201818
6,2,0,0,0,28,0,0,0,28,57,85,9,1,201818
7,1,0,0,0,21,0,0,0,21,29,50,9,1,201818
7,2,0,0,0,0,0,0,0,0,70,70,7,0.75,201818
7,3,0,0,0,38,0,0,0,38,85,123,7,1,201818
7,4,0,0,0,25,0,0,0,25,49,74,9,0.8,201818
7,5,0,0,0,50,0,0,0,50,92,142,11,1,201818
7,6,0,0,0,59,0,0,0,59,116,175,8,0.75,201818
7,7,0,0,0,53,0,0,0,53,132,185,8,1,201818
7,8,0,0,0,39,0,0,0,39,40,79,10,0.75,201818
7,9,0,0,0,80,0,0,0,80,184,264,10,1.333333333,201818
7,10,0,0,0,7,0,0,0,7,208,215,9,1,201818
7,11,0,0,0,6,0,0,0,6,11,17,4,0.666666667,201818
7,12,0,0,0,109,0,0,0,109,181,290,9,1,201818
7,13,0,0,0,3,0,0,0,3,23,26,7,0.75,201818
8,1,0,0,0,55,0,0,0,55,82,137,4,1,201818
8,2,0,0,0,53,0,0,0,53,91,144,16,1,201818
8,3,0,0,0,107,0,0,0,107,142,249,4,1,201818
8,4,0,0,0,65,0,0,0,65,147,212,9,1,201818
8,5,0,0,0,26,0,0,0,26,63,89,10,1,201818
8,6,0,0,0,108,0,0,0,108,185,293,5,0.666666667,201818
8,7,0,0,0,27,0,0,0,27,94,121,7,1,201818
8,8,0,0,0,92,0,0,0,92,250,342,10,1,201818
8,9,0,0,0,14,0,0,0,14,103,117,10,1,201818
9,1,0,0,0,50,0,0,0,50,76,126,6,2,201818
9,2,0,0,0,253,0,0,0,253,352,605,12,1,201818
9,3,0,0,0,150,0,0,0,150,208,358,7,1,201818
9,4,0,0,0,105,0,0,0,105,141,246,11,1,201818
9,5,0,0,0,87,0,0,0,87,208,295,7,1,201818
9,6,0,0,0,67,0,0,0,67,151,218,7,1,201818
9,7,0,0,0,82,0,0,0,82,154,236,9,1,201818
9,8,0,0,0,73,0,0,0,73,156,229,5,1,201818
9,9,0,0,0,76,0,0,0,76,100,176,5,1,201818
9,10,0,0,0,101,0,0,0,101,208,309,6,1,201818
9,11,0,0,0,181,0,0,0,181,298,479,7,1,201818
9,12,0,0,0,149,0,0,0,149,352,501,11,1,201818
9,13,0,0,0,96,0,0,0,96,217,313,4,1,201818
9,14,0,0,0,60,0,0,0,60,112,172,5,1,201818
9,15,0,0,0,227,0,0,0,227,590,817,9,1,201818
9,16,0,0,0,180,0,0,0,180,391,571,15,1,201818
9,17,0,0,0,86,0,0,0,86,180,266,6,1,201818
9,18,0,0,0,139,0,0,0,139,252,391,12,1,201818
9,19,0,0,0,84,0,0,0,84,169,253,5,1,201818
9,20,0,0,0,13,0,0,0,13,48,61,5,1,201818
9,21,0,0,0,54,0,0,0,54,77,131,3,1,201818
9,22,0,0,0,93,0,0,0,93,139,232,5,1,201818
9,23,0,0,0,134,0,0,0,134,305,439,7,2,201818
9,24,0,0,0,214,0,0,0,214,366,580,13,1.5,201818
10,1,0,0,0,53,0,0,0,53,125,178,12,1,201818
10,2,0,0,0,72,0,0,0,72,121,193,9,1,201818
10,3,0,0,0,28,0,0,0,28,104,132,11,1,201818
10,4,0,0,0,106,0,0,0,106,210,316,11,0.666666667,201818
11,1,0,0,0,46,0,0,0,46,71,117,6,1,201818
11,2,0,0,0,53,0,0,0,53,119,172,7,1,201818
11,3,0,0,0,79,0,0,0,79,76,155,3,1,201818
11,4,0,0,0,33,0,0,0,33,110,143,5,0.5,201818
11,5,0,0,0,110,0,0,0,110,211,321,4,1,201818
11,6,0,0,0,61,0,0,0,61,102,163,5,0.666666667,201818
11,7,0,0,0,57,0,0,0,57,111,168,4,0.5,201818
11,8,0,0,0,103,0,0,0,103,175,278,9,1,201818
11,9,0,0,0,115,0,0,0,115,154,269,9,1,201818
11,10,0,0,0,55,0,0,0,55,73,128,12,1,201818
11,11,0,0,0,63,0,0,0,63,85,148,4,1,201818
11,12,0,0,0,125,0,0,0,125,169,294,6,1,201818
11,13,0,0,0,32,0,0,0,32,86,118,7,1,201818
11,14,0,0,0,47,0,0,0,47,94,141,15,1,201818
11,15,0,0,0,73,0,0,0,73,98,171,5,1,201818
12,1,0,0,0,32,0,0,0,32,50,82,10,1,201818
12,2,0,0,0,63,0,0,0,63,139,202,8,0.75,201818
12,3,0,0,0,44,0,0,0,44,82,126,9,0.8,201818
12,4,0,0,0,98,0,0,0,98,219,317,9,1,201818
12,5,0,0,0,8,0,0,0,8,65,73,10,1,201818
12,6,0,0,0,14,0,0,0,14,63,77,10,1,201818
12,7,0,0,0,73,0,0,0,73,131,204,7,1.5,201818
12,8,0,0,0,13,0,0,0,13,66,79,7,0.75,201818
12,9,0,0,0,94,0,0,0,94,138,232,9,1,201818
13,1,0,0,0,22,0,0,0,22,38,60,9,1,201818
13,2,0,0,0,21,0,0,0,21,39,60,6,1,201818
13,3,0,0,0,23,0,0,0,23,71,94,12,1,201818
13,4,0,0,0,55,0,0,0,55,113,168,9,1,201818
13,5,0,0,0,64,0,0,0,64,101,165,9,1,201818
13,6,0,0,0,147,0,0,0,147,206,353,11,1,201818
13,7,0,0,0,70,0,0,0,70,164,234,8,1,201818
14,1,0,0,0,13,0,0,0,13,96,109,6,1,201818
14,2,0,0,0,19,0,0,0,19,28,47,5,1,201818
14,3,0,0,0,16,0,0,0,16,48,64,8,1,201818
14,4,0,0,0,85,0,0,0,85,155,240,11,1,201818
14,5,0,0,0,64,0,0,0,64,90,154,9,1,201818
14,6,0,0,0,96,0,0,0,96,224,320,11,1,201818
14,7,0,0,0,50,0,0,0,50,56,106,6,1,201818
14,8,0,0,0,168,0,0,0,168,262,430,10,0.8,201818
14,9,0,0,0,99,0,0,0,99,231,330,8,1,201818
14,10,0,0,0,100,0,0,0,100,220,320,7,1,201818
14,11,0,0,0,36,0,0,0,36,78,114,4,1,201818
14,12,0,0,0,43,0,0,0,43,89,132,9,1,201818
14,13,0,0,0,57,0,0,0,57,85,142,6,1,201818
14,14,0,0,0,59,0,0,0,59,140,199,7,1,201818
14,15,0,0,0,50,0,0,0,50,72,122,8,0.8,201818
14,16,0,0,0,80,0,0,0,80,126,206,5,1,201818
14,17,0,0,0,12,0,0,0,12,34,46,7,1,201818
14,18,0,0,0,32,0,0,0,32,60,92,9,1,201818
14,19,0,0,0,49,0,0,0,49,69,118,8,1,201818
14,20,0,0,0,13,0,0,0,13,38,51,10,1,201818
15,1,0,0,0,23,0,0,0,23,66,89,7,1,201818
15,2,0,0,0,88,0,0,0,88,157,245,6,1,201818
15,3,0,0,0,78,0,0,0,78,148,226,10,1,201818
15,4,0,0,0,100,0,0,0,100,215,315,4,1,201818
15,5,0,0,0,69,0,0,0,69,120,189,8,1,201818
15,6,0,0,0,94,0,0,0,94,166,260,7,1,201818
15,7,0,0,0,107,0,0,0,107,185,292,10,1,201818
15,8,0,0,0,41,0,0,0,41,99,140,4,1,201818
15,9,0,0,0,53,0,0,0,53,108,161,9,1,201818
15,10,0,0,0,71,0,0,0,71,126,197,9,2,201818
15,11,0,0,0,132,0,0,0,132,172,304,8,1,201818
15,12,0,0,0,117,0,0,0,117,237,354,8,1,201818
15,13,0,0,0,92,0,0,0,92,160,252,8,1,201818
15,14,0,0,0,71,0,0,0,71,76,147,4,1,201818
15,15,0,0,0,87,0,0,0,87,162,249,6,1,201818
15,16,0,0,0,132,0,0,0,132,191,323,8,1,201818
15,17,0,0,0,70,0,0,0,70,171,241,8,1,201818
15,18,0,0,0,91,0,0,0,91,250,341,7,1,201818
15,19,0,0,0,156,0,0,0,156,314,470,13,1,201818
15,20,0,0,0,80,0,0,0,80,145,225,6,1,201818
15,21,0,0,0,29,0,0,0,29,54,83,6,1,201818
15,22,0,0,0,168,0,0,0,168,277,445,14,1,201818
15,23,0,0,0,69,0,0,0,69,124,193,7,1,201818
15,24,0,0,0,60,0,0,0,60,119,179,4,1,201818
15,25,0,0,0,135,0,0,0,135,184,319,6,1,201818
15,26,0,0,0,72,0,0,0,72,145,217,8,0.5,201818
15,27,0,0,0,119,0,0,0,119,219,338,9,1,201818
15,28,0,0,0,93,0,0,0,93,227,320,9,1,201818
15,29,0,0,0,124,0,0,0,124,236,360,8,1,201818
15,30,0,0,0,84,0,0,0,84,171,255,11,1.5,201818
15,31,0,0,0,86,0,0,0,86,130,216,6,1,201818
15,32,0,0,0,101,0,0,0,101,139,240,9,1,201818
15,33,0,0,0,89,0,0,0,89,158,247,7,1,201818
15,34,0,0,0,82,0,0,0,82,164,246,8,1,201818
15,35,0,0,0,104,0,0,0,104,137,241,9,1,201818
15,36,0,0,0,60,0,0,0,60,134,194,9,1,201818
15,37,0,0,0,114,0,0,0,114,188,302,7,1,201818
15,38,0,0,0,93,0,0,0,93,167,260,6,1,201818
15,39,0,0,0,35,0,0,0,35,85,120,4,1,201818
15,40,0,0,0,71,0,0,0,71,196,267,9,1,201818
15,41,0,0,0,150,0,0,0,150,222,372,11,1,201818
16,1,0,0,0,47,0,0,0,47,79,126,7,1,201818
16,2,0,0,0,14,0,0,0,14,26,40,9,1,201818
16,3,0,0,0,44,0,0,0,44,55,99,8,0.75,201818
16,4,0,0,0,30,0,0,0,30,65,95,8,1,201818
16,5,0,0,0,66,0,0,0,66,100,166,10,1,201818
16,6,0,0,0,34,0,0,0,34,58,92,10,0.75,201818
16,7,0,0,0,45,0,0,0,45,107,152,9,1,201818
16,8,0,0,0,125,0,0,0,125,229,354,12,1,201818
16,9,0,0,0,64,0,0,0,64,141,205,9,1,201818
16,10,0,0,0,63,0,0,0,63,153,216,7,1.5,201818
16,11,0,0,0,26,0,0,0,26,91,117,10,1,201818
16,12,0,0,0,37,0,0,0,37,48,85,6,0.5,201818
17,1,0,0,0,91,0,0,0,91,275,366,9,1,201818
17,2,0,0,0,73,0,0,0,73,157,230,8,1,201818
17,3,0,0,0,89,0,0,0,89,134,223,8,1,201818
17,4,0,0,0,92,0,0,0,92,127,219,10,1,201818
17,5,0,0,0,23,0,0,0,23,77,100,5,1,201818
18,1,0,0,0,22,0,0,0,22,48,70,6,0.6,201818
18,2,0,0,0,118,0,0,0,118,125,243,9,1.333333333,201818
18,3,0,0,0,34,0,0,0,34,82,116,9,1,201818
19,1,0,0,0,68,0,0,0,68,197,265,9,1,201818
19,2,0,0,0,107,0,0,0,107,179,286,9,1,201818
19,3,0,0,0,85,0,0,0,85,162,247,7,1,201818
19,4,0,0,0,37,0,0,0,37,77,114,5,1,201818
19,5,0,0,0,154,0,0,0,154,274,428,8,1,201818
19,6,0,0,0,43,0,0,0,43,111,154,5,1,201818
19,7,0,0,0,39,0,0,0,39,104,143,10,1,201818
19,8,0,0,0,21,0,0,0,21,58,79,7,1,201818
19,9,0,0,0,27,0,0,0,27,89,116,9,1,201818
19,10,0,0,0,59,0,0,0,59,129,188,5,0.5,201818
19,11,0,0,0,124,0,0,0,124,277,401,13,1,201818
19,12,0,0,0,47,0,0,0,47,109,156,8,1,201818
20,1,0,0,0,32,0,0,0,32,77,109,7,1,201818
20,2,0,0,0,2,0,0,0,2,109,111,6,1,201818
20,3,0,0,0,28,0,0,0,28,36,64,6,1,201818
20,4,0,0,0,9,0,0,0,9,95,104,6,1,201818
20,5,0,0,0,27,0,0,0,27,80,107,11,1,201818
20,6,0,0,0,10,0,0,0,10,49,59,8,1,201818
20,7,0,0,0,38,0,0,0,38,116,154,7,1,201818
20,8,0,0,0,209,0,0,0,209,437,646,13,1,201818
20,9,0,0,0,40,0,0,0,40,86,126,8,1,201818
20,10,0,0,0,19,0,0,0,19,64,83,9,1,201818
21,1,0,0,0,57,0,0,0,57,133,190,9,1,201818
21,2,0,0,0,27,0,0,0,27,52,79,9,1,201818
21,3,0,0,0,47,0,0,0,47,113,160,8,1,201818
21,4,0,0,0,11,0,0,0,11,77,88,6,1,201818
21,5,0,0,0,64,0,0,0,64,132,196,8,1,201818
21,6,0,0,0,92,0,0,0,92,154,246,6,1,201818
21,7,0,0,0,59,0,0,0,59,94,153,9,1,201818
21,8,0,0,0,32,0,0,0,32,105,137,9,1,201818
21,9,0,0,0,122,0,0,0,122,220,342,9,1,201818
21,10,0,0,0,105,0,0,0,105,143,248,7,1,201818
21,11,0,0,0,30,0,0,0,30,44,74,4,1,201818
21,12,0,0,0,159,0,0,0,159,276,435,14,0.666666667,201818
21,13,0,0,0,82,0,0,0,82,144,226,8,1,201818
21,14,0,0,0,31,0,0,0,31,97,128,12,1,201818
21,15,0,0,0,79,0,0,0,79,229,308,7,1,201818
22,1,0,0,0,39,0,0,0,39,124,163,11,1,201818
22,2,0,0,0,73,0,0,0,73,135,208,7,1,201818
22,3,0,0,0,136,0,0,0,136,250,386,9,1,201818
22,4,0,0,0,139,0,0,0,139,287,426,10,0.75,201818
22,5,0,0,0,49,0,0,0,49,113,162,10,1,201818
23,1,0,0,0,87,0,0,0,87,208,295,14,1,201818
23,2,0,0,0,56,0,0,0,56,154,210,8,0.8,201818
23,3,0,0,0,128,0,0,0,128,153,281,11,1,201818
23,4,0,0,0,38,0,0,0,38,174,212,8,1,201818
24,1,0,0,0,20,0,0,0,20,83,103,10,1,201818
24,2,0,0,0,47,0,0,0,47,72,119,6,1,201818
24,3,0,0,0,30,0,0,0,30,66,96,9,1,201818
24,4,0,0,0,49,0,0,0,49,77,126,5,1,201818
24,5,0,0,0,70,0,0,0,70,198,268,9,0.75,201818
24,6,0,0,0,148,0,0,0,148,297,445,9,1,201818
24,7,0,0,0,15,0,0,0,15,38,53,9,1,201818
25,1,0,0,0,68,0,0,0,68,126,194,13,1,201818
25,2,0,0,0,87,0,0,0,87,187,274,6,1,201818
25,3,0,0,0,63,0,0,0,63,72,135,6,0.8,201818
25,4,0,0,0,33,0,0,0,33,54,87,8,1,201818
25,5,0,0,0,97,0,0,0,97,198,295,8,1,201818
25,6,0,0,0,86,0,0,0,86,128,214,8,1,201818
25,7,0,0,0,86,0,0,0,86,174,260,6,1,201818
26,1,0,0,0,55,0,0,0,55,127,182,9,1,201818
26,2,0,0,0,91,0,0,0,91,160,251,12,1,201818
26,3,0,0,0,146,0,0,0,146,320,466,13,1,201818
26,4,0,0,0,42,0,0,0,42,120,162,9,1,201818
26,5,0,0,0,31,0,0,0,31,97,128,3,1,201818
26,6,0,0,0,102,0,0,0,102,213,315,10,1,201818
26,7,0,0,0,66,0,0,0,66,106,172,10,1,201818
27,1,0,0,0,57,0,0,0,57,95,152,9,1,201818
27,2,0,0,0,94,0,0,0,94,135,229,8,1,201818
27,3,0,0,0,72,0,0,0,72,149,221,7,1,201818
27,4,0,0,0,176,0,0,0,176,188,364,8,1,201818
27,5,0,0,0,18,0,0,0,18,74,92,6,1,201818
27,6,0,0,0,77,0,0,0,77,168,245,9,1,201818
28,1,0,0,0,88,0,0,0,88,232,320,13,1,201818
28,2,0,0,0,83,0,0,0,83,133,216,13,1,201818
28,3,0,0,0,24,0,0,0,24,34,58,7,1,201818
28,4,0,0,0,82,0,0,0,82,133,215,15,1,201818
28,5,0,0,0,63,0,0,0,63,96,159,10,1,201818
28,6,0,0,0,21,0,0,0,21,32,53,13,1,201818
28,7,0,0,0,109,0,0,0,109,165,274,6,1,201818
28,8,0,0,0,57,0,0,0,57,137,194,9,1,201818
28,9,0,0,0,46,0,0,0,46,46,92,9,0.75,201818
29,1,0,0,0,79,0,0,0,79,95,174,7,1,201818
29,2,0,0,0,120,0,0,0,120,224,344,11,0.8,201818
29,3,0,0,0,60,0,0,0,60,126,186,5,1,201818
30,1,0,0,0,17,0,0,0,17,57,74,7,1,201818
30,2,0,0,0,15,0,0,0,15,29,44,8,1,201818
30,3,0,0,0,50,0,0,0,50,63,113,4,0.666666667,201818
30,4,0,0,0,64,0,0,0,64,114,178,8,1,201818
30,5,0,0,0,45,0,0,0,45,108,153,7,1,201818
30,6,0,0,0,14,0,0,0,14,45,59,9,1,201818
30,7,0,0,0,37,0,0,0,37,57,94,9,0.75,201818
30,8,0,0,0,10,0,0,0,10,63,73,9,0.8,201818
30,9,0,0,0,54,0,0,0,54,79,133,8,1,201818
30,10,0,0,0,104,0,0,0,104,202,306,7,1.5,201818
30,11,0,0,0,86,0,0,0,86,122,208,5,1,201818
30,12,0,0,0,121,0,0,0,121,246,367,10,1,201818
30,13,0,0,0,42,0,0,0,42,75,117,8,0.8,201818
30,14,0,0,0,34,0,0,0,34,99,133,8,1,201818
30,15,0,0,0,73,0,0,0,73,151,224,11,1,201818
30,16,0,0,0,64,0,0,0,64,114,178,8,0.666666667,201818
30,17,0,0,0,58,0,0,0,58,58,116,6,0.75,201818
30,18,0,0,0,8,0,0,0,8,26,34,8,1,201818
30,19,0,0,0,31,0,0,0,31,41,72,13,1,201818
30,20,0,0,0,38,0,0,0,38,90,128,10,1,201818
31,1,0,0,0,47,0,0,0,47,202,249,8,1,201818
31,2,0,0,0,7,0,0,0,7,110,117,6,1,201818
31,3,0,0,0,231,0,0,0,231,506,737,20,0.75,201818
31,4,0,0,0,56,0,0,0,56,137,193,3,1,201818
31,5,0,0,0,31,0,0,0,31,93,124,5,1,201818
32,1,0,0,0,30,0,0,0,30,46,76,10,0.8,201818
32,2,0,0,0,14,0,0,0,14,43,57,13,1,201818
32,3,0,0,0,37,0,0,0,37,122,159,13,1,201818
32,4,0,0,0,49,0,0,0,49,124,173,12,0.833333333,201818
1,1,0,0,0,128,0,0,0,128,148,276,6,6,201820
1,2,0,0,0,387,0,0,0,387,396,783,6,4.5,201820
1,3,0,0,0,395,0,0,0,395,423,818,6,6,201820
2,1,0,0,0,115,0,0,0,115,168,283,6,6,201820
2,2,0,0,0,330,0,0,0,330,314,644,4,6,201820
2,3,0,0,0,291,0,0,0,291,475,766,4,4,201820
2,4,0,0,0,145,0,0,0,145,123,268,4,6,201820
2,5,0,0,0,490,0,0,0,490,503,993,6,6,201820
2,6,0,0,0,278,0,0,0,278,306,584,4,6,201820
2,7,0,0,0,168,0,0,0,168,145,313,6,6,201820
2,8,0,0,0,457,0,0,0,457,482,939,4,6,201820
3,1,0,0,0,295,0,0,0,295,356,651,7,6,201820
3,2,0,0,0,117,0,0,0,117,182,299,4,6,201820
4,1,0,0,0,276,0,0,0,276,336,612,3,6,201820
4,2,0,0,0,196,0,0,0,196,157,353,2,6,201820
5,1,0,0,0,215,0,0,0,215,211,426,5,6,201820
5,2,0,0,0,53,0,0,0,53,44,97,2,6,201820
5,3,0,0,0,225,0,0,0,225,265,490,5,6,201820
5,4,0,0,0,408,0,0,0,408,444,852,5,6,201820
5,5,0,0,0,319,0,0,0,319,393,712,6,6,201820
5,6,0,0,0,135,0,0,0,135,183,318,3,6,201820
5,7,0,0,0,166,0,0,0,166,163,329,3,3,201820
6,1,0,0,0,217,0,0,0,217,260,477,8,5,201820
6,2,0,0,0,142,0,0,0,142,202,344,4,6,201820
7,1,0,0,0,48,0,0,0,48,47,95,2,6,201820
7,2,0,0,0,80,0,0,0,80,84,164,2,6,201820
7,3,0,0,0,102,0,0,0,102,123,225,2,6,201820
7,4,0,0,0,75,0,0,0,75,58,133,5,6.5,201820
7,5,0,0,0,189,0,0,0,189,204,393,4,6,201820
7,6,0,0,0,206,0,0,0,206,269,475,2,3,201820
7,7,0,0,0,156,0,0,0,156,208,364,4,6,201820
7,8,0,0,0,94,0,0,0,94,136,230,2,6,201820
7,9,0,0,0,213,0,0,0,213,412,625,4,6,201820
7,10,0,0,0,24,0,0,0,24,92,116,4,6,201820
7,11,0,0,0,11,0,0,0,11,8,19,2,6,201820
7,12,0,0,0,321,0,0,0,321,368,689,5,6,201820
7,13,0,0,0,23,0,0,0,23,17,40,3,6,201820
8,1,0,0,0,225,0,0,0,225,223,448,2,6,201820
8,2,0,0,0,196,0,0,0,196,226,422,5,6,201820
8,3,0,0,0,303,0,0,0,303,405,708,4,6,201820
8,4,0,0,0,258,0,0,0,258,303,561,4,6,201820
8,5,0,0,0,106,0,0,0,106,121,227,3,6,201820
8,6,0,0,0,375,0,0,0,375,384,759,4,4,201820
8,7,0,0,0,56,0,0,0,56,108,164,3,6,201820
8,8,0,0,0,356,0,0,0,356,323,679,4,6,201820
8,9,0,0,0,49,0,0,0,49,49,98,3,6,201820
9,1,0,0,0,257,0,0,0,257,365,622,2,6,201820
9,2,0,0,0,985,0,0,0,985,1027,2012,8,6,201820
9,3,0,0,0,499,0,0,0,499,693,1192,4,6,201820
9,4,0,0,0,452,0,0,0,452,478,930,3,6,201820
9,5,0,0,0,383,0,0,0,383,412,795,3,6,201820
9,6,0,0,0,362,0,0,0,362,363,725,3,6,201820
9,7,0,0,0,429,0,0,0,429,413,842,3,6,201820
9,8,0,0,0,257,0,0,0,257,281,538,2,6,201820
9,9,0,0,0,307,0,0,0,307,349,656,2,6,201820
9,10,0,0,0,461,0,0,0,461,422,883,3,6,201820
9,11,0,0,0,645,0,0,0,645,696,1341,4,6,201820
9,12,0,0,0,727,0,0,0,727,596,1323,5,6,201820
9,13,0,0,0,408,0,0,0,408,472,880,3,6,201820
9,14,0,0,0,367,0,0,0,367,352,719,3,6,201820
9,15,0,0,0,1055,0,0,0,1055,1089,2144,8,4,201820
9,16,0,0,0,887,0,0,0,887,947,1834,4,6,201820
9,17,0,0,0,399,0,0,0,399,383,782,3,6,201820
9,18,0,0,0,594,0,0,0,594,613,1207,6,6,201820
9,19,0,0,0,300,0,0,0,300,334,634,3,6,201820
9,20,0,0,0,75,0,0,0,75,81,156,2,6,201820
9,21,0,0,0,181,0,0,0,181,168,349,2,6,201820
9,22,0,0,0,326,0,0,0,326,427,753,3,6,201820
9,23,0,0,0,476,0,0,0,476,603,1079,3,6,201820
9,24,0,0,0,830,0,0,0,830,904,1734,6,6,201820
10,1,0,0,0,166,0,0,0,166,169,335,4,6,201820
10,2,0,0,0,242,0,0,0,242,250,492,2,6,201820
10,3,0,0,0,108,0,0,0,108,111,219,5,6.5,201820
10,4,0,0,0,394,0,0,0,394,373,767,4,4,201820
11,1,0,0,0,153,0,0,0,153,191,344,4,6,201820
11,2,0,0,0,206,0,0,0,206,231,437,6,6,201820
11,3,0,0,0,280,0,0,0,280,296,576,2,6,201820
11,4,0,0,0,189,0,0,0,189,163,352,5,4.333333333,201820
11,5,0,0,0,381,0,0,0,381,401,782,4,4.5,201820
11,6,0,0,0,246,0,0,0,246,312,558,4,6,201820
11,7,0,0,0,175,0,0,0,175,241,416,5,6,201820
11,8,0,0,0,334,0,0,0,334,300,634,7,6,201820
11,9,0,0,0,402,0,0,0,402,434,836,4,6,201820
11,10,0,0,0,233,0,0,0,233,195,428,6,6,201820
11,11,0,0,0,245,0,0,0,245,288,533,4,6,201820
11,12,0,0,0,335,0,0,0,335,480,815,4,6,201820
11,13,0,0,0,129,0,0,0,129,150,279,5,6,201820
11,14,0,0,0,152,0,0,0,152,150,302,4,6,201820
11,15,0,0,0,258,0,0,0,258,288,546,3,6,201820
12,1,0,0,0,85,0,0,0,85,91,176,2,6,201820
12,2,0,0,0,269,0,0,0,269,235,504,4,6,201820
12,3,0,0,0,141,0,0,0,141,136,277,2,6,201820
12,4,0,0,0,438,0,0,0,438,507,945,4,6,201820
12,5,0,0,0,34,0,0,0,34,44,78,2,6,201820
12,6,0,0,0,48,0,0,0,48,49,97,2,6,201820
12,7,0,0,0,279,0,0,0,279,307,586,3,6,201820
12,8,0,0,0,27,0,0,0,27,36,63,2,4,201820
12,9,0,0,0,355,0,0,0,355,305,660,4,6,201820
13,1,0,0,0,83,0,0,0,83,106,189,3,6,201820
13,2,0,0,0,91,0,0,0,91,102,193,2,6,201820
13,3,0,0,0,113,0,0,0,113,104,217,2,6,201820
13,4,0,0,0,219,0,0,0,219,253,472,4,6,201820
13,5,0,0,0,277,0,0,0,277,305,582,6,6,201820
13,6,0,0,0,558,0,0,0,558,529,1087,5,6,201820
13,7,0,0,0,246,0,0,0,246,243,489,5,6,201820
14,1,0,0,0,39,0,0,0,39,41,80,3,6,201820
14,2,0,0,0,81,0,0,0,81,102,183,4,6,201820
14,3,0,0,0,55,0,0,0,55,75,130,4,6,201820
14,4,0,0,0,282,0,0,0,282,319,601,4,6,201820
14,5,0,0,0,237,0,0,0,237,243,480,5,6,201820
14,6,0,0,0,364,0,0,0,364,353,717,3,6,201820
14,7,0,0,0,182,0,0,0,182,192,374,3,6,201820
14,8,0,0,0,672,0,0,0,672,718,1390,8,4.6,201820
14,9,0,0,0,172,0,0,0,172,293,465,5,8,201820
14,10,0,0,0,460,0,0,0,460,451,911,4,6,201820
14,11,0,0,0,289,0,0,0,289,302,591,2,6,201820
14,12,0,0,0,245,0,0,0,245,220,465,5,6,201820
14,13,0,0,0,242,0,0,0,242,290,532,4,6,201820
14,14,0,0,0,315,0,0,0,315,296,611,3,6,201820
14,15,0,0,0,166,0,0,0,166,208,374,6,6,201820
14,16,0,0,0,390,0,0,0,390,420,810,2,6,201820
14,17,0,0,0,50,0,0,0,50,44,94,2,6,201820
14,18,0,0,0,159,0,0,0,159,130,289,4,6,201820
14,19,0,0,0,136,0,0,0,136,147,283,2,6,201820
14,20,0,0,0,38,0,0,0,38,63,101,4,6,201820
15,1,0,0,0,94,0,0,0,94,95,189,3,6,201820
15,2,0,0,0,356,0,0,0,356,384,740,4,6,201820
15,3,0,0,0,336,0,0,0,336,382,718,5,6,201820
15,4,0,0,0,383,0,0,0,383,391,774,2,6,201820
15,5,0,0,0,233,0,0,0,233,252,485,4,6,201820
15,6,0,0,0,422,0,0,0,422,426,848,4,6,201820
15,7,0,0,0,524,0,0,0,524,681,1205,3,6,201820
15,8,0,0,0,235,0,0,0,235,236,471,2,6,201820
15,9,0,0,0,149,0,0,0,149,172,321,7,6,201820
15,10,0,0,0,287,0,0,0,287,301,588,3,6,201820
15,11,0,0,0,444,0,0,0,444,432,876,3,6,201820
15,12,0,0,0,494,0,0,0,494,505,999,6,5.666666667,201820
15,13,0,0,0,382,0,0,0,382,453,835,3,6,201820
15,14,0,0,0,255,0,0,0,255,266,521,2,6,201820
15,15,0,0,0,371,0,0,0,371,364,735,3,6,201820
15,16,0,0,0,444,0,0,0,444,621,1065,4,6,201820
15,17,0,0,0,299,0,0,0,299,331,630,3,6,201820
15,18,0,0,0,367,0,0,0,367,417,784,4,6,201820
15,19,0,0,0,617,0,0,0,617,673,1290,5,6,201820
15,20,0,0,0,272,0,0,0,272,253,525,3,6,201820
15,21,0,0,0,98,0,0,0,98,121,219,3,7,201820
15,22,0,0,0,705,0,0,0,705,770,1475,6,6,201820
15,23,0,0,0,225,0,0,0,225,233,458,3,6,201820
15,24,0,0,0,281,0,0,0,281,268,549,2,6,201820
15,25,0,0,0,366,0,0,0,366,430,796,3,6,201820
15,26,0,0,0,280,0,0,0,280,386,666,2,3,201820
15,27,0,0,0,481,0,0,0,481,551,1032,5,6,201820
15,28,0,0,0,414,0,0,0,414,440,854,4,6,201820
15,29,0,0,0,474,0,0,0,474,525,999,3,6,201820
15,30,0,0,0,324,0,0,0,324,334,658,6,6,201820
15,31,0,0,0,342,0,0,0,342,341,683,3,6,201820
15,32,0,0,0,374,0,0,0,374,367,741,4,6,201820
15,33,0,0,0,346,0,0,0,346,382,728,4,6,201820
15,34,0,0,0,421,0,0,0,421,448,869,3,6,201820
15,35,0,0,0,291,0,0,0,291,359,650,4,6,201820
15,36,0,0,0,161,0,0,0,161,179,340,4,6,201820
15,37,0,0,0,368,0,0,0,368,386,754,4,6,201820
15,38,0,0,0,339,0,0,0,339,382,721,2,6,201820
15,39,0,0,0,175,0,0,0,175,181,356,2,6,201820
15,40,0,0,0,272,0,0,0,272,362,634,6,6,201820
15,41,0,0,0,463,0,0,0,463,533,996,8,6,201820
16,1,0,0,0,140,0,0,0,140,179,319,2,6,201820
16,2,0,0,0,44,0,0,0,44,53,97,2,6,201820
16,3,0,0,0,176,0,0,0,176,159,335,2,6,201820
16,4,0,0,0,115,0,0,0,115,148,263,4,6,201820
16,5,0,0,0,176,0,0,0,176,199,375,5,6,201820
16,6,0,0,0,118,0,0,0,118,129,247,4,6,201820
16,7,0,0,0,126,0,0,0,126,158,284,4,6,201820
16,8,0,0,0,498,0,0,0,498,578,1076,5,6,201820
16,9,0,0,0,240,0,0,0,240,237,477,5,6,201820
16,10,0,0,0,210,0,0,0,210,256,466,4,6,201820
16,11,0,0,0,128,0,0,0,128,128,256,5,6,201820
16,12,0,0,0,87,0,0,0,87,134,221,2,6,201820
17,1,0,0,0,416,0,0,0,416,371,787,3,3.5,201820
17,2,0,0,0,240,0,0,0,240,279,519,4,6,201820
17,3,0,0,0,397,0,0,0,397,422,819,3,6,201820
17,4,0,0,0,310,0,0,0,310,404,714,5,6,201820
17,5,0,0,0,120,0,0,0,120,108,228,2,6,201820
18,1,0,0,0,72,0,0,0,72,65,137,2,6,201820
18,2,0,0,0,362,0,0,0,362,442,804,6,6,201820
18,3,0,0,0,138,0,0,0,138,146,284,4,6,201820
19,1,0,0,0,372,0,0,0,372,391,763,4,6,201820
19,2,0,0,0,417,0,0,0,417,507,924,5,6,201820
19,3,0,0,0,289,0,0,0,289,395,684,4,6,201820
19,4,0,0,0,190,0,0,0,190,156,346,2,6,201820
19,5,0,0,0,436,0,0,0,436,587,1023,6,6,201820
19,6,0,0,0,245,0,0,0,245,213,458,2,6,201820
19,7,0,0,0,95,0,0,0,95,145,240,4,6,201820
19,8,0,0,0,77,0,0,0,77,65,142,2,6,201820
19,9,0,0,0,63,0,0,0,63,71,134,2,6,201820
19,10,0,0,0,315,0,0,0,315,355,670,3,3.5,201820
19,11,0,0,0,625,0,0,0,625,629,1254,7,6,201820
19,12,0,0,0,119,0,0,0,119,169,288,4,6,201820
20,1,0,0,0,147,0,0,0,147,171,318,3,7,201820
20,2,0,0,0,13,0,0,0,13,23,36,2,6,201820
20,3,0,0,0,88,0,0,0,88,101,189,2,6,201820
20,4,0,0,0,37,0,0,0,37,50,87,2,6,201820
20,5,0,0,0,87,0,0,0,87,113,200,3,7,201820
20,6,0,0,0,54,0,0,0,54,55,109,2,6,201820
20,7,0,0,0,125,0,0,0,125,189,314,6,6,201820
20,8,0,0,0,597,0,0,0,597,865,1462,5,6,201820
20,9,0,0,0,162,0,0,0,162,190,352,4,6,201820
20,10,0,0,0,62,0,0,0,62,71,133,4,8,201820
21,1,0,0,0,173,0,0,0,173,196,369,4,6,201820
21,2,0,0,0,63,0,0,0,63,80,143,2,6,201820
21,3,0,0,0,182,0,0,0,182,209,391,4,6,201820
21,4,0,0,0,47,0,0,0,47,73,120,2,6,201820
21,5,0,0,0,182,0,0,0,182,286,468,4,6,201820
21,6,0,0,0,378,0,0,0,378,467,845,2,6,201820
21,7,0,0,0,214,0,0,0,214,203,417,4,6,201820
21,8,0,0,0,77,0,0,0,77,64,141,2,6,201820
21,9,0,0,0,359,0,0,0,359,443,802,4,6,201820
21,10,0,0,0,325,0,0,0,325,347,672,2,6,201820
21,11,0,0,0,123,0,0,0,123,166,289,2,6,201820
21,12,0,0,0,835,0,0,0,835,910,1745,4,4,201820
21,13,0,0,0,229,0,0,0,229,270,499,4,6,201820
21,14,0,0,0,104,0,0,0,104,129,233,4,6,201820
21,15,0,0,0,295,0,0,0,295,374,669,2,6,201820
22,1,0,0,0,81,0,0,0,81,138,219,2,6,201820
22,2,0,0,0,238,0,0,0,238,281,519,2,6,201820
22,3,0,0,0,466,0,0,0,466,571,1037,4,6,201820
22,4,0,0,0,513,0,0,0,513,583,1096,6,4.5,201820
22,5,0,0,0,156,0,0,0,156,211,367,4,6,201820
23,1,0,0,0,346,0,0,0,346,421,767,3,6,201820
23,2,0,0,0,189,0,0,0,189,137,326,1,3,201820
23,3,0,0,0,515,0,0,0,515,520,1035,2,6,201820
23,4,0,0,0,238,0,0,0,238,261,499,2,6,201820
24,1,0,0,0,60,0,0,0,60,73,133,2,6,201820
24,2,0,0,0,131,0,0,0,131,134,265,2,6,201820
24,3,0,0,0,80,0,0,0,80,86,166,2,6,201820
24,4,0,0,0,93,0,0,0,93,122,215,2,6,201820
24,5,0,0,0,354,0,0,0,354,293,647,6,4.5,201820
24,6,0,0,0,512,0,0,0,512,561,1073,4,6,201820
24,7,0,0,0,58,0,0,0,58,59,117,2,6,201820
25,1,0,0,0,227,0,0,0,227,242,469,5,6,201820
25,2,0,0,0,308,0,0,0,308,363,671,3,6,201820
25,3,0,0,0,170,0,0,0,170,223,393,5,6,201820
25,4,0,0,0,126,0,0,0,126,140,266,3,6,201820
25,5,0,0,0,393,0,0,0,393,405,798,5,6,201820
25,6,0,0,0,291,0,0,0,291,281,572,6,6,201820
25,7,0,0,0,371,0,0,0,371,361,732,4,6,201820
26,1,0,0,0,212,0,0,0,212,239,451,5,6,201820
26,2,0,0,0,330,0,0,0,330,344,674,5,6,201820
26,3,0,0,0,567,0,0,0,567,613,1180,6,6,201820
26,4,0,0,0,137,0,0,0,137,146,283,3,6,201820
26,5,0,0,0,89,0,0,0,89,139,228,1,6,201820
26,6,0,0,0,369,0,0,0,369,407,776,4,7,201820
26,7,0,0,0,187,0,0,0,187,227,414,4,6,201820
27,1,0,0,0,199,0,0,0,199,221,420,4,6,201820
27,2,0,0,0,273,0,0,0,273,318,591,4,6,201820
27,3,0,0,0,311,0,0,0,311,314,625,4,6,201820
27,4,0,0,0,644,0,0,0,644,616,1260,3,3,201820
27,5,0,0,0,87,0,0,0,87,77,164,2,6,201820
27,6,0,0,0,334,0,0,0,334,371,705,2,6,201820
28,1,0,0,0,308,0,0,0,308,314,622,10,6,201820
28,2,0,0,0,265,0,0,0,265,259,524,6,6,201820
28,3,0,0,0,85,0,0,0,85,91,176,3,6,201820
28,4,0,0,0,256,0,0,0,256,289,545,11,6,201820
28,5,0,0,0,240,0,0,0,240,168,408,2,3,201820
28,6,0,0,0,93,0,0,0,93,111,204,3,6,201820
28,7,0,0,0,299,0,0,0,299,353,652,6,6,201820
28,8,0,0,0,244,0,0,0,244,237,481,6,6,201820
28,9,0,0,0,123,0,0,0,123,151,274,6,6,201820
29,1,0,0,0,239,0,0,0,239,286,525,4,6,201820
29,2,0,0,0,338,0,0,0,338,482,820,6,4.5,201820
29,3,0,0,0,193,0,0,0,193,224,417,4,6,201820
30,1,0,0,0,34,0,0,0,34,68,102,2,6,201820
30,2,0,0,0,42,0,0,0,42,80,122,2,6,201820
30,3,0,0,0,165,0,0,0,165,190,355,4,6,201820
30,4,0,0,0,222,0,0,0,222,270,492,4,6,201820
30,5,0,0,0,224,0,0,0,224,222,446,2,6,201820
30,6,0,0,0,82,0,0,0,82,81,163,2,6,201820
30,7,0,0,0,125,0,0,0,125,152,277,2,6,201820
30,8,0,0,0,157,0,0,0,157,209,366,4,6,201820
30,9,0,0,0,150,0,0,0,150,180,330,4,6,201820
30,10,0,0,0,344,0,0,0,344,456,800,4,6,201820
30,11,0,0,0,287,0,0,0,287,398,685,2,6,201820
30,12,0,0,0,462,0,0,0,462,515,977,8,6,201820
30,13,0,0,0,118,0,0,0,118,123,241,4,6,201820
30,14,0,0,0,145,0,0,0,145,199,344,4,6,201820
30,15,0,0,0,284,0,0,0,284,336,620,4,6,201820
30,16,0,0,0,251,0,0,0,251,291,542,2,6,201820
30,17,0,0,0,267,0,0,0,267,167,434,4,6,201820
30,18,0,0,0,32,0,0,0,32,32,64,2,6,201820
30,19,0,0,0,116,0,0,0,116,119,235,6,6,201820
30,20,0,0,0,138,0,0,0,138,223,361,4,6,201820
31,1,0,0,0,128,0,0,0,128,103,231,4,6,201820
31,2,0,0,0,36,0,0,0,36,67,103,2,6,201820
31,3,0,0,0,665,0,0,0,665,949,1614,8,4.5,201820
31,4,0,0,0,269,0,0,0,269,370,639,2,6,201820
31,5,0,0,0,71,0,0,0,71,84,155,2,6,201820
32,1,0,0,0,73,0,0,0,73,91,164,2,6,201820
32,2,0,0,0,52,0,0,0,52,46,98,2,6,201820
32,3,0,0,0,160,0,0,0,160,191,351,4,6,201820
32,4,0,0,0,164,0,0,0,164,174,338,2,3,201820
1,1,0,0,0,75,0,0,0,75,89,164,6,4,201821
1,2,0,0,0,305,0,0,0,305,312,617,6,3,201821
1,3,0,0,0,329,0,0,0,329,304,633,7,4.333333333,201821
2,1,0,0,0,105,0,0,0,105,92,197,6,4,201821
2,2,0,0,0,204,0,0,0,204,275,479,4,4,201821
2,3,0,0,0,206,0,0,0,206,258,464,4,2.666666667,201821
2,4,0,0,0,106,0,0,0,106,91,197,4,4,201821
2,5,0,0,0,407,0,0,0,407,444,851,6,4,201821
2,6,0,0,0,165,0,0,0,165,243,408,4,4,201821
2,7,0,0,0,144,0,0,0,144,118,262,6,4,201821
2,8,0,0,0,332,0,0,0,332,338,670,4,4,201821
3,1,0,0,0,241,0,0,0,241,240,481,7,4,201821
3,2,0,0,0,81,0,0,0,81,123,204,4,4,201821
4,1,0,0,0,222,0,0,0,222,243,465,3,4,201821
4,2,0,0,0,138,0,0,0,138,110,248,2,4,201821
5,1,0,0,0,88,0,0,0,88,174,262,5,4,201821
5,2,0,0,0,35,0,0,0,35,36,71,2,4,201821
5,3,0,0,0,157,0,0,0,157,171,328,5,4,201821
5,4,0,0,0,284,0,0,0,284,304,588,5,4,201821
5,5,0,0,0,265,0,0,0,265,267,532,6,4,201821
5,6,0,0,0,109,0,0,0,109,88,197,3,4,201821
5,7,0,0,0,149,0,0,0,149,149,298,3,2,201821
6,1,0,0,0,177,0,0,0,177,179,356,7,3.2,201821
6,2,0,0,0,138,0,0,0,138,117,255,4,4,201821
7,1,0,0,0,33,0,0,0,33,27,60,2,4,201821
7,2,0,0,0,41,0,0,0,41,37,78,2,4,201821
7,3,0,0,0,89,0,0,0,89,114,203,2,4,201821
7,4,0,0,0,52,0,0,0,52,67,119,4,4,201821
7,5,0,0,0,137,0,0,0,137,187,324,4,4,201821
7,6,0,0,0,156,0,0,0,156,227,383,2,2,201821
7,7,0,0,0,137,0,0,0,137,218,355,4,4,201821
7,8,0,0,0,71,0,0,0,71,80,151,2,4,201821
7,9,0,0,0,315,0,0,0,315,393,708,4,4,201821
7,10,0,0,0,22,0,0,0,22,34,56,4,4,201821
7,11,0,0,0,22,0,0,0,22,8,30,2,4,201821
7,12,0,0,0,244,0,0,0,244,278,522,5,4,201821
7,13,0,0,0,23,0,0,0,23,17,40,3,4,201821
8,1,0,0,0,192,0,0,0,192,225,417,2,4,201821
8,2,0,0,0,155,0,0,0,155,211,366,5,4,201821
8,3,0,0,0,139,0,0,0,139,210,349,4,4,201821
8,4,0,0,0,193,0,0,0,193,169,362,4,4,201821
8,5,0,0,0,98,0,0,0,98,113,211,3,4,201821
8,6,0,0,0,296,0,0,0,296,267,563,4,2.666666667,201821
8,7,0,0,0,64,0,0,0,64,52,116,3,4,201821
8,8,0,0,0,278,0,0,0,278,358,636,4,4,201821
8,9,0,0,0,40,0,0,0,40,32,72,3,4,201821
9,1,0,0,0,197,0,0,0,197,205,402,2,4,201821
9,2,0,0,0,716,0,0,0,716,725,1441,8,4,201821
9,3,0,0,0,388,0,0,0,388,478,866,4,4,201821
9,4,0,0,0,364,0,0,0,364,358,722,3,4,201821
9,5,0,0,0,292,0,0,0,292,306,598,3,4,201821
9,6,0,0,0,245,0,0,0,245,283,528,3,4,201821
9,7,0,0,0,262,0,0,0,262,316,578,3,4,201821
9,8,0,0,0,185,0,0,0,185,211,396,2,4,201821
9,9,0,0,0,218,0,0,0,218,239,457,2,4,201821
9,10,0,0,0,237,0,0,0,237,267,504,3,4,201821
9,11,0,0,0,516,0,0,0,516,573,1089,4,4,201821
9,12,0,0,0,539,0,0,0,539,656,1195,5,4,201821
9,13,0,0,0,300,0,0,0,300,496,796,3,4,201821
9,14,0,0,0,267,0,0,0,267,220,487,3,4,201821
9,15,0,0,0,814,0,0,0,814,797,1611,9,3,201821
9,16,0,0,0,680,0,0,0,680,659,1339,4,4,201821
9,17,0,0,0,145,0,0,0,145,171,316,3,4,201821
9,18,0,0,0,480,0,0,0,480,455,935,6,4,201821
9,19,0,0,0,211,0,0,0,211,232,443,3,4,201821
9,20,0,0,0,43,0,0,0,43,45,88,2,4,201821
9,21,0,0,0,133,0,0,0,133,131,264,2,4,201821
9,22,0,0,0,224,0,0,0,224,261,485,3,4,201821
9,23,0,0,0,330,0,0,0,330,446,776,3,4,201821
9,24,0,0,0,625,0,0,0,625,661,1286,6,4,201821
10,1,0,0,0,122,0,0,0,122,127,249,4,4,201821
10,2,0,0,0,154,0,0,0,154,197,351,2,4,201821
10,3,0,0,0,83,0,0,0,83,49,132,4,4,201821
10,4,0,0,0,321,0,0,0,321,291,612,4,2.666666667,201821
11,1,0,0,0,126,0,0,0,126,144,270,4,4,201821
11,2,0,0,0,157,0,0,0,157,168,325,6,4,201821
11,3,0,0,0,219,0,0,0,219,231,450,2,4,201821
11,4,0,0,0,132,0,0,0,132,127,259,4,2.666666667,201821
11,5,0,0,0,370,0,0,0,370,401,771,4,4,201821
11,6,0,0,0,214,0,0,0,214,193,407,4,4,201821
11,7,0,0,0,115,0,0,0,115,145,260,5,4,201821
11,8,0,0,0,232,0,0,0,232,290,522,7,4,201821
11,9,0,0,0,320,0,0,0,320,292,612,4,4,201821
11,10,0,0,0,145,0,0,0,145,149,294,6,4,201821
11,11,0,0,0,159,0,0,0,159,218,377,4,4,201821
11,12,0,0,0,252,0,0,0,252,300,552,4,4,201821
11,13,0,0,0,91,0,0,0,91,125,216,5,4,201821
11,14,0,0,0,130,0,0,0,130,142,272,4,4,201821
11,15,0,0,0,166,0,0,0,166,175,341,3,4,201821
12,1,0,0,0,66,0,0,0,66,61,127,2,4,201821
12,2,0,0,0,195,0,0,0,195,231,426,4,4,201821
12,3,0,0,0,119,0,0,0,119,128,247,2,4,201821
12,4,0,0,0,304,0,0,0,304,380,684,4,4,201821
12,5,0,0,0,26,0,0,0,26,31,57,2,4,201821
12,6,0,0,0,36,0,0,0,36,46,82,2,4,201821
12,7,0,0,0,225,0,0,0,225,266,491,3,4,201821
12,8,0,0,0,36,0,0,0,36,36,72,2,3,201821
12,9,0,0,0,248,0,0,0,248,239,487,4,4,201821
13,1,0,0,0,74,0,0,0,74,70,144,3,4,201821
13,2,0,0,0,75,0,0,0,75,62,137,2,4,201821
13,3,0,0,0,95,0,0,0,95,97,192,2,4,201821
13,4,0,0,0,149,0,0,0,149,170,319,4,4,201821
13,5,0,0,0,222,0,0,0,222,187,409,6,4,201821
13,6,0,0,0,416,0,0,0,416,494,910,5,4,201821
13,7,0,0,0,195,0,0,0,195,164,359,5,4,201821
14,1,0,0,0,23,0,0,0,23,41,64,3,4,201821
14,2,0,0,0,68,0,0,0,68,51,119,4,4,201821
14,3,0,0,0,43,0,0,0,43,55,98,4,4,201821
14,4,0,0,0,242,0,0,0,242,264,506,4,4,201821
14,5,0,0,0,174,0,0,0,174,216,390,5,4,201821
14,6,0,0,0,241,0,0,0,241,251,492,3,4,201821
14,7,0,0,0,128,0,0,0,128,136,264,3,4,201821
14,8,0,0,0,541,0,0,0,541,647,1188,8,3.2,201821
14,9,0,0,0,147,0,0,0,147,151,298,5,5,201821
14,10,0,0,0,328,0,0,0,328,320,648,4,4,201821
14,11,0,0,0,200,0,0,0,200,177,377,2,4,201821
14,12,0,0,0,169,0,0,0,169,190,359,5,4,201821
14,13,0,0,0,181,0,0,0,181,163,344,4,4,201821
14,14,0,0,0,251,0,0,0,251,242,493,3,4,201821
14,15,0,0,0,110,0,0,0,110,125,235,6,4,201821
14,16,0,0,0,242,0,0,0,242,277,519,2,4,201821
14,17,0,0,0,36,0,0,0,36,35,71,2,4,201821
14,18,0,0,0,98,0,0,0,98,93,191,4,4,201821
14,19,0,0,0,106,0,0,0,106,124,230,2,4,201821
14,20,0,0,0,47,0,0,0,47,33,80,4,4,201821
15,1,0,0,0,74,0,0,0,74,59,133,3,4,201821
15,2,0,0,0,255,0,0,0,255,351,606,4,4,201821
15,3,0,0,0,248,0,0,0,248,267,515,5,4,201821
15,4,0,0,0,287,0,0,0,287,294,581,2,4,201821
15,5,0,0,0,141,0,0,0,141,174,315,4,4,201821
15,6,0,0,0,284,0,0,0,284,316,600,4,4,201821
15,7,0,0,0,349,0,0,0,349,496,845,3,4,201821
15,8,0,0,0,146,0,0,0,146,179,325,2,4,201821
15,9,0,0,0,85,0,0,0,85,104,189,7,4,201821
15,10,0,0,0,227,0,0,0,227,230,457,3,4,201821
15,11,0,0,0,320,0,0,0,320,304,624,3,4,201821
15,12,0,0,0,367,0,0,0,367,416,783,6,4,201821
15,13,0,0,0,303,0,0,0,303,313,616,3,4,201821
15,14,0,0,0,190,0,0,0,190,194,384,2,4,201821
15,15,0,0,0,281,0,0,0,281,283,564,3,4,201821
15,16,0,0,0,351,0,0,0,351,440,791,4,4,201821
15,17,0,0,0,200,0,0,0,200,264,464,3,4,201821
15,18,0,0,0,256,0,0,0,256,268,524,4,4,201821
15,19,0,0,0,471,0,0,0,471,559,1030,5,4,201821
15,20,0,0,0,161,0,0,0,161,175,336,3,4,201821
15,21,0,0,0,80,0,0,0,80,105,185,3,5,201821
15,22,0,0,0,550,0,0,0,550,530,1080,6,4,201821
15,23,0,0,0,166,0,0,0,166,174,340,3,4,201821
15,24,0,0,0,163,0,0,0,163,168,331,2,4,201821
15,25,0,0,0,262,0,0,0,262,329,591,3,4,201821
15,26,0,0,0,206,0,0,0,206,259,465,3,2.5,201821
15,27,0,0,0,404,0,0,0,404,356,760,5,4,201821
15,28,0,0,0,306,0,0,0,306,275,581,4,4,201821
15,29,0,0,0,316,0,0,0,316,383,699,3,4,201821
15,30,0,0,0,274,0,0,0,274,280,554,6,4,201821
15,31,0,0,0,255,0,0,0,255,272,527,3,4,201821
15,32,0,0,0,247,0,0,0,247,281,528,4,4,201821
15,33,0,0,0,297,0,0,0,297,348,645,4,4,201821
15,34,0,0,0,315,0,0,0,315,373,688,3,4,201821
15,35,0,0,0,201,0,0,0,201,277,478,4,4,201821
15,36,0,0,0,134,0,0,0,134,136,270,4,4,201821
15,37,0,0,0,306,0,0,0,306,315,621,4,4,201821
15,38,0,0,0,250,0,0,0,250,277,527,2,4,201821
15,39,0,0,0,86,0,0,0,86,134,220,2,4,201821
15,40,0,0,0,218,0,0,0,218,230,448,6,4,201821
15,41,0,0,0,382,0,0,0,382,318,700,8,4,201821
16,1,0,0,0,90,0,0,0,90,112,202,2,4,201821
16,2,0,0,0,45,0,0,0,45,26,71,2,4,201821
16,3,0,0,0,93,0,0,0,93,122,215,2,4,201821
16,4,0,0,0,103,0,0,0,103,95,198,4,4,201821
16,5,0,0,0,101,0,0,0,101,135,236,5,4,201821
16,6,0,0,0,102,0,0,0,102,96,198,4,4,201821
16,7,0,0,0,114,0,0,0,114,98,212,4,4,201821
16,8,0,0,0,376,0,0,0,376,445,821,5,4,201821
16,9,0,0,0,173,0,0,0,173,185,358,5,4,201821
16,10,0,0,0,160,0,0,0,160,148,308,4,4,201821
16,11,0,0,0,103,0,0,0,103,92,195,5,4,201821
16,12,0,0,0,65,0,0,0,65,104,169,2,4,201821
17,1,0,0,0,309,0,0,0,309,304,613,3,2.5,201821
17,2,0,0,0,204,0,0,0,204,247,451,4,4,201821
17,3,0,0,0,293,0,0,0,293,250,543,3,4,201821
17,4,0,0,0,236,0,0,0,236,277,513,5,4,201821
17,5,0,0,0,75,0,0,0,75,98,173,2,4,201821
18,1,0,0,0,57,0,0,0,57,78,135,2,4,201821
18,2,0,0,0,287,0,0,0,287,283,570,6,4,201821
18,3,0,0,0,102,0,0,0,102,88,190,4,4,201821
19,1,0,0,0,274,0,0,0,274,268,542,4,4,201821
19,2,0,0,0,274,0,0,0,274,326,600,5,4,201821
19,3,0,0,0,276,0,0,0,276,327,603,4,4,201821
19,4,0,0,0,129,0,0,0,129,122,251,2,4,201821
19,5,0,0,0,356,0,0,0,356,278,634,6,4,201821
19,6,0,0,0,153,0,0,0,153,208,361,2,4,201821
19,7,0,0,0,80,0,0,0,80,88,168,4,4,201821
19,8,0,0,0,46,0,0,0,46,61,107,2,4,201821
19,9,0,0,0,47,0,0,0,47,56,103,2,4,201821
19,10,0,0,0,240,0,0,0,240,257,497,2,2,201821
19,11,0,0,0,425,0,0,0,425,441,866,7,4,201821
19,12,0,0,0,122,0,0,0,122,36,158,4,4,201821
20,1,0,0,0,97,0,0,0,97,135,232,3,5,201821
20,2,0,0,0,20,0,0,0,20,20,40,2,4,201821
20,3,0,0,0,62,0,0,0,62,78,140,2,4,201821
20,4,0,0,0,22,0,0,0,22,21,43,2,4,201821
20,5,0,0,0,63,0,0,0,63,70,133,3,5,201821
20,6,0,0,0,30,0,0,0,30,32,62,2,3,201821
20,7,0,0,0,91,0,0,0,91,80,171,6,4,201821
20,8,0,0,0,531,0,0,0,531,570,1101,5,4,201821
20,9,0,0,0,109,0,0,0,109,162,271,4,4,201821
20,10,0,0,0,37,0,0,0,37,50,87,3,5,201821
21,1,0,0,0,143,0,0,0,143,145,288,4,4,201821
21,2,0,0,0,62,0,0,0,62,47,109,2,4,201821
21,3,0,0,0,112,0,0,0,112,171,283,4,4,201821
21,4,0,0,0,37,0,0,0,37,42,79,2,4,201821
21,5,0,0,0,178,0,0,0,178,171,349,4,4,201821
21,6,0,0,0,288,0,0,0,288,319,607,2,4,201821
21,7,0,0,0,159,0,0,0,159,171,330,4,4,201821
21,8,0,0,0,58,0,0,0,58,74,132,2,4,201821
21,9,0,0,0,265,0,0,0,265,412,677,4,4,201821
21,10,0,0,0,220,0,0,0,220,277,497,2,4,201821
21,11,0,0,0,75,0,0,0,75,119,194,2,4,201821
21,12,0,0,0,663,0,0,0,663,732,1395,4,2.666666667,201821
21,13,0,0,0,154,0,0,0,154,243,397,4,4,201821
21,14,0,0,0,67,0,0,0,67,90,157,4,4,201821
21,15,0,0,0,221,0,0,0,221,279,500,2,4,201821
22,1,0,0,0,57,0,0,0,57,76,133,3,5,201821
22,2,0,0,0,189,0,0,0,189,183,372,2,4,201821
22,3,0,0,0,362,0,0,0,362,404,766,4,4,201821
22,4,0,0,0,367,0,0,0,367,385,752,6,3,201821
22,5,0,0,0,94,0,0,0,94,116,210,4,4,201821
23,1,0,0,0,266,0,0,0,266,303,569,3,4,201821
23,2,0,0,0,135,0,0,0,135,135,270,1,2,201821
23,3,0,0,0,396,0,0,0,396,421,817,2,4,201821
23,4,0,0,0,205,0,0,0,205,216,421,2,4,201821
24,1,0,0,0,51,0,0,0,51,59,110,2,4,201821
24,2,0,0,0,119,0,0,0,119,114,233,2,4,201821
24,3,0,0,0,68,0,0,0,68,66,134,2,4,201821
24,4,0,0,0,73,0,0,0,73,73,146,2,4,201821
24,5,0,0,0,262,0,0,0,262,285,547,6,3,201821
24,6,0,0,0,451,0,0,0,451,478,929,4,4,201821
24,7,0,0,0,39,0,0,0,39,32,71,2,4,201821
25,1,0,0,0,154,0,0,0,154,167,321,5,4,201821
25,2,0,0,0,229,0,0,0,229,264,493,3,4,201821
25,3,0,0,0,125,0,0,0,125,125,250,5,4,201821
25,4,0,0,0,96,0,0,0,96,99,195,3,4,201821
25,5,0,0,0,330,0,0,0,330,334,664,5,4,201821
25,6,0,0,0,205,0,0,0,205,202,407,6,4,201821
25,7,0,0,0,257,0,0,0,257,305,562,4,4,201821
26,1,0,0,0,155,0,0,0,155,190,345,5,4,201821
26,2,0,0,0,240,0,0,0,240,282,522,5,4,201821
26,3,0,0,0,437,0,0,0,437,440,877,6,4,201821
26,4,0,0,0,117,0,0,0,117,88,205,3,4,201821
26,5,0,0,0,70,0,0,0,70,76,146,1,4,201821
26,6,0,0,0,299,0,0,0,299,299,598,4,5,201821
26,7,0,0,0,154,0,0,0,154,183,337,4,4,201821
27,1,0,0,0,149,0,0,0,149,151,300,4,4,201821
27,2,0,0,0,227,0,0,0,227,259,486,4,4,201821
27,3,0,0,0,258,0,0,0,258,236,494,4,4,201821
27,4,0,0,0,508,0,0,0,508,454,962,3,2,201821
27,5,0,0,0,77,0,0,0,77,81,158,2,4,201821
27,6,0,0,0,272,0,0,0,272,298,570,2,4,201821
28,1,0,0,0,226,0,0,0,226,221,447,10,4,201821
28,2,0,0,0,229,0,0,0,229,226,455,6,4,201821
28,3,0,0,0,57,0,0,0,57,101,158,3,4,201821
28,4,0,0,0,249,0,0,0,249,162,411,11,4,201821
28,5,0,0,0,176,0,0,0,176,199,375,2,2,201821
28,6,0,0,0,75,0,0,0,75,71,146,3,4,201821
28,7,0,0,0,269,0,0,0,269,222,491,6,4,201821
28,8,0,0,0,168,0,0,0,168,186,354,6,4,201821
28,9,0,0,0,98,0,0,0,98,88,186,6,4,201821
29,1,0,0,0,200,0,0,0,200,182,382,4,4,201821
29,2,0,0,0,286,0,0,0,286,271,557,6,3,201821
29,3,0,0,0,165,0,0,0,165,138,303,3,4,201821
30,1,0,0,0,46,0,0,0,46,40,86,2,4,201821
30,2,0,0,0,39,0,0,0,39,30,69,2,4,201821
30,3,0,0,0,149,0,0,0,149,128,277,4,4,201821
30,4,0,0,0,182,0,0,0,182,153,335,4,4,201821
30,5,0,0,0,175,0,0,0,175,189,364,2,4,201821
30,6,0,0,0,66,0,0,0,66,59,125,2,4,201821
30,7,0,0,0,108,0,0,0,108,127,235,2,4,201821
30,8,0,0,0,128,0,0,0,128,107,235,4,4,201821
30,9,0,0,0,106,0,0,0,106,106,212,4,4,201821
30,10,0,0,0,289,0,0,0,289,248,537,4,4,201821
30,11,0,0,0,240,0,0,0,240,224,464,2,4,201821
30,12,0,0,0,370,0,0,0,370,427,797,8,4,201821
30,13,0,0,0,86,0,0,0,86,84,170,4,4,201821
30,14,0,0,0,106,0,0,0,106,106,212,4,4,201821
30,15,0,0,0,221,0,0,0,221,243,464,4,4,201821
30,16,0,0,0,184,0,0,0,184,207,391,2,4,201821
30,17,0,0,0,97,0,0,0,97,121,218,4,4,201821
30,18,0,0,0,18,0,0,0,18,27,45,2,4,201821
30,19,0,0,0,68,0,0,0,68,73,141,6,4,201821
30,20,0,0,0,120,0,0,0,120,126,246,4,4,201821
31,1,0,0,0,90,0,0,0,90,62,152,4,4,201821
31,2,0,0,0,35,0,0,0,35,31,66,2,4,201821
31,3,0,0,0,502,0,0,0,502,588,1090,8,2.5,201821
31,4,0,0,0,211,0,0,0,211,210,421,2,4,201821
31,5,0,0,0,61,0,0,0,61,51,112,2,4,201821
32,1,0,0,0,85,0,0,0,85,56,141,2,4,201821
32,2,0,0,0,37,0,0,0,37,45,82,2,4,201821
32,3,0,0,0,114,0,0,0,114,97,211,4,4,201821
32,4,0,0,0,117,0,0,0,117,137,254,2,2,201821
1,1,0,0,0,166,0,0,0,166,125,291,6,6,201822
1,2,0,0,0,476,0,0,0,476,404,880,6,4.5,201822
1,3,0,0,0,482,0,0,0,482,415,897,6,6,201822
2,1,0,0,0,131,0,0,0,131,120,251,6,5.666666667,201822
2,2,0,0,0,193,0,0,0,193,256,449,4,6,201822
2,3,0,0,0,216,0,0,0,216,203,419,4,3.666666667,201822
2,4,0,0,0,124,0,0,0,124,160,284,4,5.5,201822
2,5,0,0,0,481,0,0,0,481,500,981,6,5.666666667,201822
2,6,0,0,0,215,0,0,0,215,263,478,4,5.5,201822
2,7,0,0,0,210,0,0,0,210,198,408,6,6,201822
2,8,0,0,0,400,0,0,0,400,404,804,4,5.5,201822
3,1,0,0,0,311,0,0,0,311,265,576,8,6.25,201822
3,2,0,0,0,101,0,0,0,101,112,213,4,6,201822
4,1,0,0,0,262,0,0,0,262,301,563,3,5,201822
4,2,0,0,0,190,0,0,0,190,119,309,2,5,201822
5,1,0,0,0,280,0,0,0,280,239,519,5,6,201822
5,2,0,0,0,53,0,0,0,53,60,113,2,6,201822
5,3,0,0,0,197,0,0,0,197,220,417,5,6,201822
5,4,0,0,0,424,0,0,0,424,370,794,5,6,201822
5,5,0,0,0,330,0,0,0,330,341,671,6,6,201822
5,6,0,0,0,144,0,0,0,144,154,298,3,6,201822
5,7,0,0,0,152,0,0,0,152,150,302,3,3,201822
6,1,0,0,0,253,0,0,0,253,225,478,7,4.8,201822
6,2,0,0,0,163,0,0,0,163,172,335,4,6,201822
7,1,0,0,0,36,0,0,0,36,46,82,2,6,201822
7,2,0,0,0,44,0,0,0,44,72,116,2,6,201822
7,3,0,0,0,90,0,0,0,90,97,187,2,6,201822
7,4,0,0,0,82,0,0,0,82,81,163,4,6,201822
7,5,0,0,0,98,0,0,0,98,88,186,4,4.5,201822
7,6,0,0,0,186,0,0,0,186,239,425,2,3,201822
7,7,0,0,0,145,0,0,0,145,182,327,4,6,201822
7,8,0,0,0,91,0,0,0,91,63,154,2,5,201822
7,9,0,0,0,393,0,0,0,393,434,827,4,6,201822
7,10,0,0,0,27,0,0,0,27,44,71,4,6,201822
7,11,0,0,0,29,0,0,0,29,23,52,2,6,201822
7,12,0,0,0,352,0,0,0,352,280,632,5,6,201822
7,13,0,0,0,25,0,0,0,25,34,59,3,6,201822
8,1,0,0,0,265,0,0,0,265,222,487,2,6,201822
8,2,0,0,0,207,0,0,0,207,123,330,5,5.5,201822
8,3,0,0,0,396,0,0,0,396,275,671,4,6,201822
8,4,0,0,0,260,0,0,0,260,237,497,4,6,201822
8,5,0,0,0,117,0,0,0,117,113,230,3,6,201822
8,6,0,0,0,433,0,0,0,433,407,840,5,4.333333333,201822
8,7,0,0,0,95,0,0,0,95,83,178,3,6,201822
8,8,0,0,0,251,0,0,0,251,275,526,4,4,201822
8,9,0,0,0,61,0,0,0,61,34,95,3,6,201822
9,1,0,0,0,261,0,0,0,261,221,482,2,5,201822
9,2,0,0,0,946,0,0,0,946,1072,2018,8,5.5,201822
9,3,0,0,0,540,0,0,0,540,361,901,4,5,201822
9,4,0,0,0,466,0,0,0,466,387,853,3,6,201822
9,5,0,0,0,369,0,0,0,369,311,680,3,5,201822
9,6,0,0,0,291,0,0,0,291,330,621,3,6,201822
9,7,0,0,0,345,0,0,0,345,313,658,3,5,201822
9,8,0,0,0,202,0,0,0,202,232,434,2,5,201822
9,9,0,0,0,255,0,0,0,255,186,441,2,5,201822
9,10,0,0,0,491,0,0,0,491,423,914,3,6,201822
9,11,0,0,0,520,0,0,0,520,462,982,4,5,201822
9,12,0,0,0,678,0,0,0,678,756,1434,5,5.5,201822
9,13,0,0,0,424,0,0,0,424,492,916,3,6,201822
9,14,0,0,0,335,0,0,0,335,401,736,3,6,201822
9,15,0,0,0,1180,0,0,0,1180,1084,2264,8,4,201822
9,16,0,0,0,881,0,0,0,881,806,1687,4,6,201822
9,17,0,0,0,209,0,0,0,209,373,582,3,6,201822
9,18,0,0,0,615,0,0,0,615,545,1160,6,5.5,201822
9,19,0,0,0,309,0,0,0,309,278,587,3,6,201822
9,20,0,0,0,19,0,0,0,19,41,60,2,6,201822
9,21,0,0,0,162,0,0,0,162,159,321,2,6,201822
9,22,0,0,0,284,0,0,0,284,302,586,3,5,201822
9,23,0,0,0,483,0,0,0,483,476,959,3,6,201822
9,24,0,0,0,784,0,0,0,784,924,1708,6,5.5,201822
10,1,0,0,0,159,0,0,0,159,155,314,4,6,201822
10,2,0,0,0,235,0,0,0,235,204,439,2,6,201822
10,3,0,0,0,108,0,0,0,108,96,204,4,6,201822
10,4,0,0,0,425,0,0,0,425,391,816,4,4,201822
11,1,0,0,0,133,0,0,0,133,138,271,4,6,201822
11,2,0,0,0,181,0,0,0,181,216,397,7,6,201822
11,3,0,0,0,249,0,0,0,249,275,524,2,6,201822
11,4,0,0,0,165,0,0,0,165,153,318,5,4.333333333,201822
11,5,0,0,0,454,0,0,0,454,396,850,4,6,201822
11,6,0,0,0,272,0,0,0,272,263,535,4,6,201822
11,7,0,0,0,145,0,0,0,145,177,322,5,6,201822
11,8,0,0,0,292,0,0,0,292,293,585,7,6,201822
11,9,0,0,0,415,0,0,0,415,428,843,4,6,201822
11,10,0,0,0,174,0,0,0,174,207,381,6,6,201822
11,11,0,0,0,210,0,0,0,210,236,446,4,5,201822
11,12,0,0,0,358,0,0,0,358,370,728,4,6,201822
11,13,0,0,0,128,0,0,0,128,105,233,5,6,201822
11,14,0,0,0,131,0,0,0,131,133,264,4,6,201822
11,15,0,0,0,189,0,0,0,189,187,376,3,5,201822
12,1,0,0,0,63,0,0,0,63,74,137,2,6,201822
12,2,0,0,0,205,0,0,0,205,223,428,4,6,201822
12,3,0,0,0,132,0,0,0,132,151,283,2,6,201822
12,4,0,0,0,389,0,0,0,389,366,755,4,5.5,201822
12,5,0,0,0,27,0,0,0,27,46,73,2,6,201822
12,6,0,0,0,46,0,0,0,46,39,85,2,6,201822
12,7,0,0,0,235,0,0,0,235,240,475,3,6,201822
12,8,0,0,0,50,0,0,0,50,36,86,2,6,201822
12,9,0,0,0,282,0,0,0,282,343,625,4,6,201822
13,1,0,0,0,78,0,0,0,78,79,157,3,5,201822
13,2,0,0,0,102,0,0,0,102,110,212,2,6,201822
13,3,0,0,0,129,0,0,0,129,101,230,2,6,201822
13,4,0,0,0,176,0,0,0,176,181,357,4,5.5,201822
13,5,0,0,0,288,0,0,0,288,315,603,6,6,201822
13,6,0,0,0,549,0,0,0,549,685,1234,5,5.5,201822
13,7,0,0,0,255,0,0,0,255,226,481,5,6,201822
14,1,0,0,0,30,0,0,0,30,27,57,3,6,201822
14,2,0,0,0,92,0,0,0,92,104,196,4,6,201822
14,3,0,0,0,57,0,0,0,57,43,100,4,6,201822
14,4,0,0,0,299,0,0,0,299,275,574,4,6,201822
14,5,0,0,0,227,0,0,0,227,211,438,5,6,201822
14,6,0,0,0,360,0,0,0,360,334,694,3,6,201822
14,7,0,0,0,121,0,0,0,121,140,261,3,6,201822
14,8,0,0,0,722,0,0,0,722,715,1437,8,4.8,201822
14,9,0,0,0,172,0,0,0,172,213,385,5,7,201822
14,10,0,0,0,415,0,0,0,415,473,888,4,6,201822
14,11,0,0,0,306,0,0,0,306,296,602,2,6,201822
14,12,0,0,0,235,0,0,0,235,219,454,5,6,201822
14,13,0,0,0,226,0,0,0,226,193,419,4,6,201822
14,14,0,0,0,188,0,0,0,188,250,438,3,5,201822
14,15,0,0,0,116,0,0,0,116,108,224,6,6,201822
14,16,0,0,0,340,0,0,0,340,361,701,2,6,201822
14,17,0,0,0,45,0,0,0,45,40,85,2,6,201822
14,18,0,0,0,115,0,0,0,115,141,256,4,6,201822
14,19,0,0,0,122,0,0,0,122,121,243,2,6,201822
14,20,0,0,0,53,0,0,0,53,46,99,4,6,201822
15,1,0,0,0,79,0,0,0,79,112,191,3,6,201822
15,2,0,0,0,341,0,0,0,341,414,755,4,6,201822
15,3,0,0,0,355,0,0,0,355,297,652,5,6,201822
15,4,0,0,0,379,0,0,0,379,426,805,2,6,201822
15,5,0,0,0,201,0,0,0,201,191,392,4,6,201822
15,6,0,0,0,488,0,0,0,488,388,876,4,6,201822
15,7,0,0,0,461,0,0,0,461,423,884,3,6,201822
15,8,0,0,0,207,0,0,0,207,200,407,2,6,201822
15,9,0,0,0,99,0,0,0,99,156,255,7,6,201822
15,10,0,0,0,274,0,0,0,274,224,498,3,5,201822
15,11,0,0,0,443,0,0,0,443,423,866,3,6,201822
15,12,0,0,0,502,0,0,0,502,391,893,6,6,201822
15,13,0,0,0,395,0,0,0,395,422,817,3,6,201822
15,14,0,0,0,248,0,0,0,248,244,492,2,6,201822
15,15,0,0,0,332,0,0,0,332,363,695,3,5,201822
15,16,0,0,0,495,0,0,0,495,408,903,4,6,201822
15,17,0,0,0,305,0,0,0,305,288,593,3,6,201822
15,18,0,0,0,381,0,0,0,381,370,751,4,6,201822
15,19,0,0,0,659,0,0,0,659,644,1303,5,6,201822
15,20,0,0,0,278,0,0,0,278,236,514,3,6,201822
15,21,0,0,0,96,0,0,0,96,97,193,3,7,201822
15,22,0,0,0,783,0,0,0,783,722,1505,6,6,201822
15,23,0,0,0,230,0,0,0,230,217,447,3,6,201822
15,24,0,0,0,249,0,0,0,249,269,518,2,6,201822
15,25,0,0,0,347,0,0,0,347,327,674,3,5,201822
15,26,0,0,0,261,0,0,0,261,304,565,2,3,201822
15,27,0,0,0,458,0,0,0,458,469,927,5,6,201822
15,28,0,0,0,379,0,0,0,379,422,801,4,6,201822
15,29,0,0,0,488,0,0,0,488,554,1042,3,6,201822
15,30,0,0,0,358,0,0,0,358,329,687,6,6,201822
15,31,0,0,0,331,0,0,0,331,310,641,3,6,201822
15,32,0,0,0,320,0,0,0,320,360,680,4,6,201822
15,33,0,0,0,403,0,0,0,403,349,752,4,6,201822
15,34,0,0,0,385,0,0,0,385,363,748,3,6,201822
15,35,0,0,0,268,0,0,0,268,233,501,4,6,201822
15,36,0,0,0,181,0,0,0,181,193,374,4,6,201822
15,37,0,0,0,410,0,0,0,410,354,764,4,6,201822
15,38,0,0,0,323,0,0,0,323,306,629,2,6,201822
15,39,0,0,0,129,0,0,0,129,120,249,2,6,201822
15,40,0,0,0,329,0,0,0,329,282,611,6,6,201822
15,41,0,0,0,493,0,0,0,493,477,970,8,6,201822
16,1,0,0,0,129,0,0,0,129,122,251,2,6,201822
16,2,0,0,0,40,0,0,0,40,47,87,2,6,201822
16,3,0,0,0,139,0,0,0,139,168,307,2,6,201822
16,4,0,0,0,112,0,0,0,112,131,243,4,6,201822
16,5,0,0,0,139,0,0,0,139,121,260,5,5,201822
16,6,0,0,0,106,0,0,0,106,132,238,4,6,201822
16,7,0,0,0,145,0,0,0,145,142,287,4,6,201822
16,8,0,0,0,433,0,0,0,433,412,845,5,5.5,201822
16,9,0,0,0,179,0,0,0,179,218,397,5,5.5,201822
16,10,0,0,0,260,0,0,0,260,225,485,4,6,201822
16,11,0,0,0,110,0,0,0,110,132,242,5,6,201822
16,12,0,0,0,94,0,0,0,94,85,179,2,6,201822
17,1,0,0,0,349,0,0,0,349,382,731,3,3,201822
17,2,0,0,0,256,0,0,0,256,239,495,4,6,201822
17,3,0,0,0,386,0,0,0,386,372,758,3,5,201822
17,4,0,0,0,322,0,0,0,322,302,624,5,5.5,201822
17,5,0,0,0,119,0,0,0,119,94,213,2,6,201822
18,1,0,0,0,49,0,0,0,49,47,96,2,6,201822
18,2,0,0,0,359,0,0,0,359,334,693,6,6,201822
18,3,0,0,0,126,0,0,0,126,130,256,4,6,201822
19,1,0,0,0,334,0,0,0,334,317,651,4,5.5,201822
19,2,0,0,0,443,0,0,0,443,410,853,5,5.5,201822
19,3,0,0,0,395,0,0,0,395,294,689,4,6,201822
19,4,0,0,0,172,0,0,0,172,151,323,2,6,201822
19,5,0,0,0,499,0,0,0,499,441,940,6,6,201822
19,6,0,0,0,236,0,0,0,236,196,432,2,5,201822
19,7,0,0,0,109,0,0,0,109,93,202,4,6,201822
19,8,0,0,0,49,0,0,0,49,63,112,2,5,201822
19,9,0,0,0,59,0,0,0,59,55,114,2,6,201822
19,10,0,0,0,289,0,0,0,289,322,611,2,3,201822
19,11,0,0,0,620,0,0,0,620,596,1216,7,6,201822
19,12,0,0,0,158,0,0,0,158,185,343,4,6,201822
20,1,0,0,0,113,0,0,0,113,118,231,3,6,201822
20,2,0,0,0,18,0,0,0,18,21,39,3,7,201822
20,3,0,0,0,98,0,0,0,98,89,187,2,6,201822
20,4,0,0,0,36,0,0,0,36,37,73,2,6,201822
20,5,0,0,0,88,0,0,0,88,95,183,2,6,201822
20,6,0,0,0,40,0,0,0,40,46,86,2,6,201822
20,7,0,0,0,136,0,0,0,136,110,246,6,6,201822
20,8,0,0,0,592,0,0,0,592,618,1210,5,5.5,201822
20,9,0,0,0,157,0,0,0,157,152,309,4,6,201822
20,10,0,0,0,56,0,0,0,56,54,110,2,6,201822
21,1,0,0,0,155,0,0,0,155,194,349,4,6,201822
21,2,0,0,0,68,0,0,0,68,72,140,2,6,201822
21,3,0,0,0,178,0,0,0,178,182,360,4,6,201822
21,4,0,0,0,50,0,0,0,50,49,99,2,6,201822
21,5,0,0,0,228,0,0,0,228,194,422,4,6,201822
21,6,0,0,0,401,0,0,0,401,380,781,2,5,201822
21,7,0,0,0,238,0,0,0,238,180,418,4,6,201822
21,8,0,0,0,68,0,0,0,68,61,129,2,6,201822
21,9,0,0,0,392,0,0,0,392,374,766,4,6,201822
21,10,0,0,0,299,0,0,0,299,261,560,2,5,201822
21,11,0,0,0,101,0,0,0,101,118,219,2,6,201822
21,12,0,0,0,779,0,0,0,779,846,1625,4,3.666666667,201822
21,13,0,0,0,158,0,0,0,158,288,446,4,6,201822
21,14,0,0,0,109,0,0,0,109,104,213,4,6,201822
21,15,0,0,0,258,0,0,0,258,273,531,2,5,201822
22,1,0,0,0,86,0,0,0,86,97,183,2,6,201822
22,2,0,0,0,238,0,0,0,238,231,469,2,6,201822
22,3,0,0,0,531,0,0,0,531,456,987,4,6,201822
22,4,0,0,0,576,0,0,0,576,511,1087,6,4.5,201822
22,5,0,0,0,142,0,0,0,142,170,312,4,6,201822
23,1,0,0,0,407,0,0,0,407,316,723,3,6,201822
23,2,0,0,0,175,0,0,0,175,184,359,1,3,201822
23,3,0,0,0,438,0,0,0,438,514,952,2,5.5,201822
23,4,0,0,0,307,0,0,0,307,270,577,2,6,201822
24,1,0,0,0,69,0,0,0,69,53,122,2,6,201822
24,2,0,0,0,126,0,0,0,126,156,282,2,6,201822
24,3,0,0,0,66,0,0,0,66,101,167,2,6,201822
24,4,0,0,0,95,0,0,0,95,93,188,2,6,201822
24,5,0,0,0,337,0,0,0,337,380,717,6,4.5,201822
24,6,0,0,0,424,0,0,0,424,462,886,4,5,201822
24,7,0,0,0,68,0,0,0,68,59,127,2,6,201822
25,1,0,0,0,179,0,0,0,179,191,370,5,5.666666667,201822
25,2,0,0,0,255,0,0,0,255,226,481,3,5,201822
25,3,0,0,0,140,0,0,0,140,138,278,5,6,201822
25,4,0,0,0,92,0,0,0,92,105,197,3,6,201822
25,5,0,0,0,335,0,0,0,335,369,704,5,6,201822
25,6,0,0,0,221,0,0,0,221,235,456,6,6,201822
25,7,0,0,0,342,0,0,0,342,311,653,4,6,201822
26,1,0,0,0,206,0,0,0,206,193,399,5,6,201822
26,2,0,0,0,256,0,0,0,256,327,583,6,6.5,201822
26,3,0,0,0,556,0,0,0,556,533,1089,6,5.5,201822
26,4,0,0,0,131,0,0,0,131,118,249,3,6,201822
26,5,0,0,0,85,0,0,0,85,80,165,1,5,201822
26,6,0,0,0,336,0,0,0,336,328,664,3,5,201822
26,7,0,0,0,160,0,0,0,160,184,344,4,6,201822
27,1,0,0,0,170,0,0,0,170,174,344,4,6,201822
27,2,0,0,0,254,0,0,0,254,252,506,4,6,201822
27,3,0,0,0,280,0,0,0,280,289,569,4,6,201822
27,4,0,0,0,576,0,0,0,576,662,1238,3,2.5,201822
27,5,0,0,0,98,0,0,0,98,75,173,2,6,201822
27,6,0,0,0,316,0,0,0,316,279,595,2,5,201822
28,1,0,0,0,308,0,0,0,308,291,599,10,5.8,201822
28,2,0,0,0,330,0,0,0,330,274,604,6,5.666666667,201822
28,3,0,0,0,73,0,0,0,73,101,174,3,6,201822
28,4,0,0,0,286,0,0,0,286,294,580,11,6,201822
28,5,0,0,0,221,0,0,0,221,209,430,2,3,201822
28,6,0,0,0,76,0,0,0,76,85,161,3,6,201822
28,7,0,0,0,344,0,0,0,344,257,601,6,6,201822
28,8,0,0,0,186,0,0,0,186,202,388,6,6,201822
28,9,0,0,0,112,0,0,0,112,136,248,6,6,201822
29,1,0,0,0,264,0,0,0,264,298,562,4,6,201822
29,2,0,0,0,336,0,0,0,336,339,675,7,4.25,201822
29,3,0,0,0,182,0,0,0,182,178,360,3,6,201822
30,1,0,0,0,43,0,0,0,43,50,93,2,6,201822
30,2,0,0,0,52,0,0,0,52,57,109,2,6,201822
30,3,0,0,0,174,0,0,0,174,185,359,4,6,201822
30,4,0,0,0,212,0,0,0,212,209,421,4,6,201822
30,5,0,0,0,179,0,0,0,179,166,345,2,5,201822
30,6,0,0,0,67,0,0,0,67,83,150,2,6,201822
30,7,0,0,0,75,0,0,0,75,63,138,2,4,201822
30,8,0,0,0,163,0,0,0,163,173,336,4,6,201822
30,9,0,0,0,151,0,0,0,151,129,280,4,6,201822
30,10,0,0,0,355,0,0,0,355,371,726,4,6,201822
30,11,0,0,0,274,0,0,0,274,314,588,2,6,201822
30,12,0,0,0,490,0,0,0,490,407,897,8,6,201822
30,13,0,0,0,106,0,0,0,106,118,224,4,6,201822
30,14,0,0,0,136,0,0,0,136,143,279,4,6,201822
30,15,0,0,0,238,0,0,0,238,240,478,4,6,201822
30,16,0,0,0,203,0,0,0,203,237,440,2,5,201822
30,17,0,0,0,146,0,0,0,146,165,311,4,6,201822
30,18,0,0,0,27,0,0,0,27,19,46,2,6,201822
30,19,0,0,0,96,0,0,0,96,101,197,6,5.666666667,201822
30,20,0,0,0,146,0,0,0,146,135,281,4,6,201822
31,1,0,0,0,115,0,0,0,115,70,185,4,6,201822
31,2,0,0,0,40,0,0,0,40,43,83,2,6,201822
31,3,0,0,0,648,0,0,0,648,706,1354,8,3.5,201822
31,4,0,0,0,295,0,0,0,295,235,530,2,6,201822
31,5,0,0,0,89,0,0,0,89,82,171,2,6,201822
32,1,0,0,0,81,0,0,0,81,116,197,2,6,201822
32,2,0,0,0,53,0,0,0,53,48,101,2,6,201822
32,3,0,0,0,175,0,0,0,175,131,306,4,5.5,201822
32,4,0,0,0,169,0,0,0,169,146,315,2,3,201822
1,1,0,0,0,148,0,0,0,148,175,323,6,6,201823
1,2,0,0,0,500,0,0,0,500,456,956,6,4.5,201823
1,3,0,0,0,520,0,0,0,520,437,957,6,6,201823
2,1,0,0,0,189,0,0,0,189,178,367,6,6,201823
2,2,0,0,0,269,0,0,0,269,224,493,4,6,201823
2,3,0,0,0,301,0,0,0,301,325,626,4,4,201823
2,4,0,0,0,100,0,0,0,100,119,219,4,6,201823
2,5,0,0,0,548,0,0,0,548,422,970,6,6,201823
2,6,0,0,0,255,0,0,0,255,213,468,4,6,201823
2,7,0,0,0,205,0,0,0,205,198,403,6,6,201823
2,8,0,0,0,512,0,0,0,512,440,952,4,6,201823
3,1,0,0,0,330,0,0,0,330,368,698,7,6,201823
3,2,0,0,0,143,0,0,0,143,109,252,4,6,201823
4,1,0,0,0,365,0,0,0,365,323,688,3,6,201823
4,2,0,0,0,231,0,0,0,231,166,397,2,6,201823
5,1,0,0,0,261,0,0,0,261,236,497,5,6,201823
5,2,0,0,0,56,0,0,0,56,49,105,2,6,201823
5,3,0,0,0,239,0,0,0,239,196,435,5,6,201823
5,4,0,0,0,399,0,0,0,399,399,798,5,6,201823
5,5,0,0,0,359,0,0,0,359,384,743,6,6,201823
5,6,0,0,0,145,0,0,0,145,145,290,3,6,201823
5,7,0,0,0,246,0,0,0,246,190,436,3,3,201823
6,1,0,0,0,274,0,0,0,274,255,529,8,5,201823
6,2,0,0,0,199,0,0,0,199,187,386,4,6,201823
7,1,0,0,0,59,0,0,0,59,41,100,3,6,201823
7,2,0,0,0,38,0,0,0,38,50,88,3,6,201823
7,3,0,0,0,111,0,0,0,111,123,234,3,6,201823
7,4,0,0,0,87,0,0,0,87,99,186,5,6,201823
7,5,0,0,0,251,0,0,0,251,246,497,9,6,201823
7,6,0,0,0,214,0,0,0,214,207,421,4,3,201823
7,7,0,0,0,196,0,0,0,196,151,347,4,6,201823
7,8,0,0,0,162,0,0,0,162,123,285,5,6,201823
7,9,0,0,0,502,0,0,0,502,376,878,7,6,201823
7,10,0,0,0,34,0,0,0,34,30,64,5,6,201823
7,11,0,0,0,22,0,0,0,22,30,52,2,6,201823
7,12,0,0,0,341,0,0,0,341,385,726,5,6,201823
7,13,0,0,0,14,0,0,0,14,32,46,3,6,201823
8,1,0,0,0,279,0,0,0,279,249,528,2,6,201823
8,2,0,0,0,281,0,0,0,281,258,539,5,6,201823
8,3,0,0,0,353,0,0,0,353,308,661,4,6,201823
8,4,0,0,0,321,0,0,0,321,266,587,4,6,201823
8,5,0,0,0,148,0,0,0,148,129,277,3,6,201823
8,6,0,0,0,414,0,0,0,414,401,815,4,4,201823
8,7,0,0,0,77,0,0,0,77,89,166,3,6,201823
8,8,0,0,0,389,0,0,0,389,279,668,4,6,201823
8,9,0,0,0,78,0,0,0,78,46,124,3,6,201823
9,1,0,0,0,298,0,0,0,298,321,619,2,6,201823
9,2,0,0,0,1077,0,0,0,1077,1218,2295,8,5.5,201823
9,3,0,0,0,602,0,0,0,602,569,1171,4,6,201823
9,4,0,0,0,587,0,0,0,587,538,1125,3,6,201823
9,5,0,0,0,498,0,0,0,498,413,911,3,6,201823
9,6,0,0,0,359,0,0,0,359,321,680,3,6,201823
9,7,0,0,0,529,0,0,0,529,419,948,3,6,201823
9,8,0,0,0,315,0,0,0,315,220,535,2,6,201823
9,9,0,0,0,367,0,0,0,367,268,635,2,6,201823
9,10,0,0,0,473,0,0,0,473,430,903,3,6,201823
9,11,0,0,0,766,0,0,0,766,811,1577,4,6,201823
9,12,0,0,0,845,0,0,0,845,779,1624,5,6,201823
9,13,0,0,0,464,0,0,0,464,446,910,3,6,201823
9,14,0,0,0,364,0,0,0,364,322,686,3,5,201823
9,15,0,0,0,1208,0,0,0,1208,1178,2386,8,4,201823
9,16,0,0,0,895,0,0,0,895,808,1703,4,5,201823
9,17,0,0,0,281,0,0,0,281,271,552,3,5,201823
9,18,0,0,0,732,0,0,0,732,636,1368,6,5.5,201823
9,19,0,0,0,366,0,0,0,366,263,629,3,5,201823
9,20,0,0,0,93,0,0,0,93,44,137,2,6,201823
9,21,0,0,0,187,0,0,0,187,181,368,2,6,201823
9,22,0,0,0,432,0,0,0,432,325,757,3,6,201823
9,23,0,0,0,462,0,0,0,462,436,898,3,6,201823
9,24,0,0,0,907,0,0,0,907,940,1847,6,6,201823
10,1,0,0,0,193,0,0,0,193,160,353,4,6,201823
10,2,0,0,0,254,0,0,0,254,238,492,2,6,201823
10,3,0,0,0,119,0,0,0,119,129,248,4,6,201823
10,4,0,0,0,471,0,0,0,471,444,915,4,4,201823
11,1,0,0,0,187,0,0,0,187,170,357,4,6,201823
11,2,0,0,0,255,0,0,0,255,197,452,6,6,201823
11,3,0,0,0,281,0,0,0,281,270,551,2,6,201823
11,4,0,0,0,194,0,0,0,194,181,375,4,4,201823
11,5,0,0,0,476,0,0,0,476,480,956,4,6,201823
11,6,0,0,0,284,0,0,0,284,300,584,4,6,201823
11,7,0,0,0,163,0,0,0,163,158,321,5,6,201823
11,8,0,0,0,347,0,0,0,347,328,675,7,6,201823
11,9,0,0,0,431,0,0,0,431,413,844,4,6,201823
11,10,0,0,0,218,0,0,0,218,155,373,6,6,201823
11,11,0,0,0,293,0,0,0,293,304,597,4,6,201823
11,12,0,0,0,427,0,0,0,427,371,798,4,6,201823
11,13,0,0,0,136,0,0,0,136,139,275,5,6,201823
11,14,0,0,0,180,0,0,0,180,150,330,4,6,201823
11,15,0,0,0,288,0,0,0,288,224,512,3,6,201823
12,1,0,0,0,86,0,0,0,86,97,183,2,6,201823
12,2,0,0,0,288,0,0,0,288,275,563,4,6,201823
12,3,0,0,0,144,0,0,0,144,136,280,2,6,201823
12,4,0,0,0,448,0,0,0,448,429,877,4,6,201823
12,5,0,0,0,27,0,0,0,27,21,48,2,6,201823
12,6,0,0,0,61,0,0,0,61,49,110,2,6,201823
12,7,0,0,0,337,0,0,0,337,251,588,3,6,201823
12,8,0,0,0,69,0,0,0,69,36,105,2,6,201823
12,9,0,0,0,340,0,0,0,340,336,676,4,6,201823
13,1,0,0,0,104,0,0,0,104,98,202,3,6,201823
13,2,0,0,0,93,0,0,0,93,102,195,2,6,201823
13,3,0,0,0,154,0,0,0,154,134,288,2,5,201823
13,4,0,0,0,223,0,0,0,223,229,452,4,6,201823
13,5,0,0,0,337,0,0,0,337,337,674,6,6,201823
13,6,0,0,0,734,0,0,0,734,668,1402,5,6,201823
13,7,0,0,0,278,0,0,0,278,264,542,5,6,201823
14,1,0,0,0,60,0,0,0,60,42,102,3,6,201823
14,2,0,0,0,110,0,0,0,110,87,197,4,6,201823
14,3,0,0,0,66,0,0,0,66,65,131,4,6,201823
14,4,0,0,0,302,0,0,0,302,283,585,4,6,201823
14,5,0,0,0,256,0,0,0,256,220,476,5,6,201823
14,6,0,0,0,345,0,0,0,345,421,766,3,5,201823
14,7,0,0,0,122,0,0,0,122,171,293,3,6,201823
14,8,0,0,0,785,0,0,0,785,716,1501,8,4.8,201823
14,9,0,0,0,211,0,0,0,211,230,441,5,7,201823
14,10,0,0,0,503,0,0,0,503,422,925,4,6,201823
14,11,0,0,0,315,0,0,0,315,306,621,2,6,201823
14,12,0,0,0,252,0,0,0,252,249,501,5,6,201823
14,13,0,0,0,284,0,0,0,284,231,515,4,6,201823
14,14,0,0,0,369,0,0,0,369,344,713,3,6,201823
14,15,0,0,0,183,0,0,0,183,156,339,6,6,201823
14,16,0,0,0,370,0,0,0,370,294,664,2,5,201823
14,17,0,0,0,76,0,0,0,76,55,131,2,6,201823
14,18,0,0,0,159,0,0,0,159,121,280,4,6,201823
14,19,0,0,0,199,0,0,0,199,137,336,2,6,201823
14,20,0,0,0,99,0,0,0,99,86,185,4,6,201823
15,1,0,0,0,92,0,0,0,92,84,176,3,6,201823
15,2,0,0,0,383,0,0,0,383,317,700,4,6,201823
15,3,0,0,0,446,0,0,0,446,424,870,5,6,201823
15,4,0,0,0,405,0,0,0,405,364,769,2,6,201823
15,5,0,0,0,222,0,0,0,222,222,444,4,6,201823
15,6,0,0,0,522,0,0,0,522,417,939,4,6,201823
15,7,0,0,0,481,0,0,0,481,458,939,3,5,201823
15,8,0,0,0,244,0,0,0,244,210,454,2,6,201823
15,9,0,0,0,126,0,0,0,126,120,246,7,6,201823
15,10,0,0,0,377,0,0,0,377,292,669,3,6,201823
15,11,0,0,0,513,0,0,0,513,472,985,3,6,201823
15,12,0,0,0,552,0,0,0,552,480,1032,6,6,201823
15,13,0,0,0,359,0,0,0,359,432,791,3,5,201823
15,14,0,0,0,315,0,0,0,315,275,590,2,6,201823
15,15,0,0,0,293,0,0,0,293,263,556,3,5,201823
15,16,0,0,0,579,0,0,0,579,529,1108,4,6,201823
15,17,0,0,0,272,0,0,0,272,291,563,3,5,201823
15,18,0,0,0,422,0,0,0,422,341,763,4,6,201823
15,19,0,0,0,804,0,0,0,804,844,1648,5,5.5,201823
15,20,0,0,0,264,0,0,0,264,274,538,3,5,201823
15,21,0,0,0,144,0,0,0,144,100,244,2,6,201823
15,22,0,0,0,854,0,0,0,854,823,1677,6,6,201823
15,23,0,0,0,248,0,0,0,248,257,505,3,6,201823
15,24,0,0,0,300,0,0,0,300,398,698,2,6,201823
15,25,0,0,0,457,0,0,0,457,367,824,3,6,201823
15,26,0,0,0,332,0,0,0,332,260,592,3,3.5,201823
15,27,0,0,0,582,0,0,0,582,510,1092,5,6,201823
15,28,0,0,0,427,0,0,0,427,353,780,4,6,201823
15,29,0,0,0,469,0,0,0,469,503,972,3,5,201823
15,30,0,0,0,402,0,0,0,402,318,720,6,5.5,201823
15,31,0,0,0,344,0,0,0,344,292,636,3,5,201823
15,32,0,0,0,371,0,0,0,371,294,665,4,5,201823
15,33,0,0,0,383,0,0,0,383,367,750,4,6,201823
15,34,0,0,0,521,0,0,0,521,465,986,3,6,201823
15,35,0,0,0,350,0,0,0,350,283,633,4,6,201823
15,36,0,0,0,241,0,0,0,241,221,462,4,6,201823
15,37,0,0,0,450,0,0,0,450,451,901,4,6,201823
15,38,0,0,0,390,0,0,0,390,351,741,2,6,201823
15,39,0,0,0,137,0,0,0,137,124,261,2,6,201823
15,40,0,0,0,420,0,0,0,420,298,718,6,6,201823
15,41,0,0,0,620,0,0,0,620,546,1166,8,6,201823
16,1,0,0,0,145,0,0,0,145,114,259,2,5,201823
16,2,0,0,0,62,0,0,0,62,54,116,2,6,201823
16,3,0,0,0,160,0,0,0,160,147,307,2,6,201823
16,4,0,0,0,149,0,0,0,149,102,251,4,6,201823
16,5,0,0,0,148,0,0,0,148,167,315,5,5.5,201823
16,6,0,0,0,117,0,0,0,117,104,221,4,6,201823
16,7,0,0,0,162,0,0,0,162,158,320,4,6,201823
16,8,0,0,0,623,0,0,0,623,543,1166,5,6,201823
16,9,0,0,0,229,0,0,0,229,203,432,5,6,201823
16,10,0,0,0,292,0,0,0,292,213,505,4,6,201823
16,11,0,0,0,131,0,0,0,131,131,262,5,6,201823
16,12,0,0,0,129,0,0,0,129,84,213,2,6,201823
17,1,0,0,0,460,0,0,0,460,373,833,3,3.5,201823
17,2,0,0,0,311,0,0,0,311,262,573,4,6,201823
17,3,0,0,0,465,0,0,0,465,403,868,3,6,201823
17,4,0,0,0,398,0,0,0,398,306,704,5,6,201823
17,5,0,0,0,135,0,0,0,135,112,247,2,6,201823
18,1,0,0,0,80,0,0,0,80,57,137,2,6,201823
18,2,0,0,0,377,0,0,0,377,413,790,6,6,201823
18,3,0,0,0,147,0,0,0,147,120,267,4,6,201823
19,1,0,0,0,385,0,0,0,385,313,698,4,6,201823
19,2,0,0,0,526,0,0,0,526,484,1010,5,6,201823
19,3,0,0,0,457,0,0,0,457,423,880,4,6,201823
19,4,0,0,0,183,0,0,0,183,172,355,2,5,201823
19,5,0,0,0,578,0,0,0,578,488,1066,6,6,201823
19,6,0,0,0,313,0,0,0,313,218,531,2,6,201823
19,7,0,0,0,149,0,0,0,149,133,282,4,6,201823
19,8,0,0,0,69,0,0,0,69,57,126,2,6,201823
19,9,0,0,0,69,0,0,0,69,51,120,2,6,201823
19,10,0,0,0,287,0,0,0,287,362,649,2,2.5,201823
19,11,0,0,0,679,0,0,0,679,469,1148,7,5.666666667,201823
19,12,0,0,0,160,0,0,0,160,168,328,4,5.5,201823
20,1,0,0,0,183,0,0,0,183,194,377,2,6,201823
20,2,0,0,0,20,0,0,0,20,25,45,2,6,201823
20,3,0,0,0,95,0,0,0,95,110,205,2,6,201823
20,4,0,0,0,38,0,0,0,38,42,80,2,6,201823
20,5,0,0,0,96,0,0,0,96,78,174,2,6,201823
20,6,0,0,0,75,0,0,0,75,49,124,2,6,201823
20,7,0,0,0,157,0,0,0,157,107,264,6,6,201823
20,8,0,0,0,886,0,0,0,886,747,1633,5,6,201823
20,9,0,0,0,169,0,0,0,169,144,313,4,6,201823
20,10,0,0,0,63,0,0,0,63,67,130,2,6,201823
21,1,0,0,0,247,0,0,0,247,177,424,4,6,201823
21,2,0,0,0,95,0,0,0,95,80,175,2,6,201823
21,3,0,0,0,249,0,0,0,249,189,438,4,6,201823
21,4,0,0,0,55,0,0,0,55,49,104,2,6,201823
21,5,0,0,0,244,0,0,0,244,236,480,4,5.5,201823
21,6,0,0,0,525,0,0,0,525,445,970,2,6,201823
21,7,0,0,0,303,0,0,0,303,223,526,4,6,201823
21,8,0,0,0,95,0,0,0,95,73,168,2,6,201823
21,9,0,0,0,474,0,0,0,474,382,856,4,6,201823
21,10,0,0,0,437,0,0,0,437,309,746,2,6,201823
21,11,0,0,0,156,0,0,0,156,137,293,2,6,201823
21,12,0,0,0,976,0,0,0,976,940,1916,4,4,201823
21,13,0,0,0,245,0,0,0,245,222,467,4,6,201823
21,14,0,0,0,175,0,0,0,175,104,279,4,6,201823
21,15,0,0,0,415,0,0,0,415,319,734,2,6,201823
22,1,0,0,0,102,0,0,0,102,101,203,2,6,201823
22,2,0,0,0,293,0,0,0,293,245,538,2,6,201823
22,3,0,0,0,585,0,0,0,585,444,1029,4,6,201823
22,4,0,0,0,610,0,0,0,610,580,1190,6,4.5,201823
22,5,0,0,0,167,0,0,0,167,145,312,4,6,201823
23,1,0,0,0,408,0,0,0,408,367,775,3,6,201823
23,2,0,0,0,174,0,0,0,174,185,359,1,3,201823
23,3,0,0,0,478,0,0,0,478,529,1007,2,6,201823
23,4,0,0,0,365,0,0,0,365,288,653,2,6,201823
24,1,0,0,0,74,0,0,0,74,67,141,2,6,201823
24,2,0,0,0,182,0,0,0,182,140,322,2,6,201823
24,3,0,0,0,105,0,0,0,105,81,186,2,6,201823
24,4,0,0,0,135,0,0,0,135,109,244,2,6,201823
24,5,0,0,0,448,0,0,0,448,387,835,6,4.5,201823
24,6,0,0,0,573,0,0,0,573,499,1072,4,6,201823
24,7,0,0,0,83,0,0,0,83,68,151,2,6,201823
25,1,0,0,0,222,0,0,0,222,223,445,5,6,201823
25,2,0,0,0,325,0,0,0,325,296,621,3,6,201823
25,3,0,0,0,218,0,0,0,218,159,377,5,6,201823
25,4,0,0,0,135,0,0,0,135,106,241,3,6,201823
25,5,0,0,0,423,0,0,0,423,373,796,5,6,201823
25,6,0,0,0,310,0,0,0,310,282,592,6,6,201823
25,7,0,0,0,390,0,0,0,390,373,763,4,6,201823
26,1,0,0,0,230,0,0,0,230,227,457,5,6,201823
26,2,0,0,0,367,0,0,0,367,275,642,6,6.5,201823
26,3,0,0,0,674,0,0,0,674,553,1227,6,6,201823
26,4,0,0,0,160,0,0,0,160,174,334,3,6,201823
26,5,0,0,0,88,0,0,0,88,113,201,1,6,201823
26,6,0,0,0,454,0,0,0,454,361,815,4,7,201823
26,7,0,0,0,238,0,0,0,238,194,432,4,6,201823
27,1,0,0,0,242,0,0,0,242,183,425,4,6,201823
27,2,0,0,0,318,0,0,0,318,295,613,4,6,201823
27,3,0,0,0,305,0,0,0,305,300,605,4,6,201823
27,4,0,0,0,714,0,0,0,714,665,1379,3,3,201823
27,5,0,0,0,74,0,0,0,74,85,159,2,6,201823
27,6,0,0,0,405,0,0,0,405,368,773,2,6,201823
28,1,0,0,0,373,0,0,0,373,315,688,10,6,201823
28,2,0,0,0,345,0,0,0,345,365,710,6,6,201823
28,3,0,0,0,97,0,0,0,97,93,190,3,6,201823
28,4,0,0,0,361,0,0,0,361,318,679,11,6,201823
28,5,0,0,0,256,0,0,0,256,212,468,2,3,201823
28,6,0,0,0,107,0,0,0,107,87,194,3,6,201823
28,7,0,0,0,383,0,0,0,383,371,754,6,6,201823
28,8,0,0,0,273,0,0,0,273,232,505,6,6,201823
28,9,0,0,0,152,0,0,0,152,136,288,6,6,201823
29,1,0,0,0,315,0,0,0,315,258,573,4,6,201823
29,2,0,0,0,480,0,0,0,480,370,850,7,4.75,201823
29,3,0,0,0,227,0,0,0,227,221,448,3,6,201823
30,1,0,0,0,76,0,0,0,76,50,126,2,6,201823
30,2,0,0,0,61,0,0,0,61,43,104,2,6,201823
30,3,0,0,0,176,0,0,0,176,188,364,4,6,201823
30,4,0,0,0,222,0,0,0,222,208,430,4,5.5,201823
30,5,0,0,0,232,0,0,0,232,210,442,2,6,201823
30,6,0,0,0,83,0,0,0,83,52,135,2,5,201823
30,7,0,0,0,172,0,0,0,172,136,308,2,5,201823
30,8,0,0,0,187,0,0,0,187,168,355,4,6,201823
30,9,0,0,0,176,0,0,0,176,168,344,4,6,201823
30,10,0,0,0,440,0,0,0,440,368,808,4,6,201823
30,11,0,0,0,333,0,0,0,333,282,615,2,6,201823
30,12,0,0,0,523,0,0,0,523,558,1081,8,6,201823
30,13,0,0,0,121,0,0,0,121,112,233,4,6,201823
30,14,0,0,0,177,0,0,0,177,138,315,4,6,201823
30,15,0,0,0,375,0,0,0,375,304,679,4,6,201823
30,16,0,0,0,274,0,0,0,274,251,525,2,6,201823
30,17,0,0,0,156,0,0,0,156,138,294,4,6,201823
30,18,0,0,0,29,0,0,0,29,28,57,2,6,201823
30,19,0,0,0,125,0,0,0,125,115,240,6,5.666666667,201823
30,20,0,0,0,174,0,0,0,174,154,328,4,6,201823
31,1,0,0,0,152,0,0,0,152,65,217,4,6,201823
31,2,0,0,0,51,0,0,0,51,45,96,2,6,201823
31,3,0,0,0,671,0,0,0,671,588,1259,8,4.25,201823
31,4,0,0,0,329,0,0,0,329,291,620,2,6,201823
31,5,0,0,0,87,0,0,0,87,68,155,2,6,201823
32,1,0,0,0,105,0,0,0,105,96,201,2,6,201823
32,2,0,0,0,43,0,0,0,43,47,90,2,6,201823
32,3,0,0,0,179,0,0,0,179,174,353,4,6,201823
32,4,0,0,0,183,0,0,0,183,174,357,3,3.5,201823
1,1,0,0,0,136,0,0,0,136,106,242,6,5.666666667,201824
1,2,0,0,0,510,0,0,0,510,452,962,6,4.5,201824
1,3,0,0,0,541,0,0,0,541,542,1083,6,6,201824
2,1,0,0,0,225,0,0,0,225,158,383,6,6,201824
2,2,0,0,0,294,0,0,0,294,286,580,4,6,201824
2,3,0,0,0,361,0,0,0,361,287,648,5,4.333333333,201824
2,4,0,0,0,120,0,0,0,120,111,231,4,6,201824
2,5,0,0,0,545,0,0,0,545,575,1120,6,6,201824
2,6,0,0,0,272,0,0,0,272,245,517,4,6,201824
2,7,0,0,0,211,0,0,0,211,215,426,6,6,201824
2,8,0,0,0,447,0,0,0,447,462,909,4,6,201824
3,1,0,0,0,328,0,0,0,328,346,674,7,6,201824
3,2,0,0,0,173,0,0,0,173,150,323,4,6,201824
4,1,0,0,0,351,0,0,0,351,361,712,3,6,201824
4,2,0,0,0,207,0,0,0,207,311,518,2,6,201824
5,1,0,0,0,254,0,0,0,254,273,527,6,6.5,201824
5,2,0,0,0,59,0,0,0,59,52,111,2,6,201824
5,3,0,0,0,237,0,0,0,237,218,455,5,6,201824
5,4,0,0,0,409,0,0,0,409,434,843,5,6,201824
5,5,0,0,0,400,0,0,0,400,389,789,6,6,201824
5,6,0,0,0,153,0,0,0,153,141,294,3,6,201824
5,7,0,0,0,219,0,0,0,219,218,437,3,3,201824
6,1,0,0,0,254,0,0,0,254,257,511,8,5,201824
6,2,0,0,0,181,0,0,0,181,198,379,4,6,201824
7,1,0,0,0,57,0,0,0,57,93,150,2,6,201824
7,2,0,0,0,44,0,0,0,44,41,85,2,5,201824
7,3,0,0,0,143,0,0,0,143,109,252,2,6,201824
7,4,0,0,0,107,0,0,0,107,73,180,4,6,201824
7,5,0,0,0,203,0,0,0,203,205,408,4,6,201824
7,6,0,0,0,260,0,0,0,260,183,443,2,3,201824
7,7,0,0,0,213,0,0,0,213,174,387,4,6,201824
7,8,0,0,0,162,0,0,0,162,159,321,2,6,201824
7,9,0,0,0,515,0,0,0,515,442,957,4,6,201824
7,10,0,0,0,31,0,0,0,31,27,58,4,6,201824
7,11,0,0,0,39,0,0,0,39,21,60,2,6,201824
7,12,0,0,0,380,0,0,0,380,339,719,5,6,201824
7,13,0,0,0,28,0,0,0,28,26,54,3,6,201824
8,1,0,0,0,331,0,0,0,331,299,630,2,6,201824
8,2,0,0,0,265,0,0,0,265,293,558,5,6,201824
8,3,0,0,0,426,0,0,0,426,314,740,4,6,201824
8,4,0,0,0,363,0,0,0,363,293,656,4,6,201824
8,5,0,0,0,151,0,0,0,151,148,299,3,6,201824
8,6,0,0,0,429,0,0,0,429,407,836,4,4,201824
8,7,0,0,0,90,0,0,0,90,96,186,3,6,201824
8,8,0,0,0,375,0,0,0,375,344,719,4,6,201824
8,9,0,0,0,76,0,0,0,76,52,128,3,6,201824
9,1,0,0,0,299,0,0,0,299,277,576,2,6,201824
9,2,0,0,0,1100,0,0,0,1100,1028,2128,8,6,201824
9,3,0,0,0,605,0,0,0,605,565,1170,4,6,201824
9,4,0,0,0,593,0,0,0,593,562,1155,3,6,201824
9,5,0,0,0,483,0,0,0,483,430,913,3,6,201824
9,6,0,0,0,430,0,0,0,430,393,823,3,6,201824
9,7,0,0,0,510,0,0,0,510,366,876,3,6,201824
9,8,0,0,0,305,0,0,0,305,229,534,2,6,201824
9,9,0,0,0,393,0,0,0,393,387,780,2,6,201824
9,10,0,0,0,507,0,0,0,507,485,992,3,6,201824
9,11,0,0,0,715,0,0,0,715,753,1468,4,6,201824
9,12,0,0,0,869,0,0,0,869,775,1644,5,6,201824
9,13,0,0,0,463,0,0,0,463,478,941,3,6,201824
9,14,0,0,0,412,0,0,0,412,371,783,3,6,201824
9,15,0,0,0,1280,0,0,0,1280,1147,2427,8,4,201824
9,16,0,0,0,1039,0,0,0,1039,853,1892,4,6,201824
9,17,0,0,0,371,0,0,0,371,306,677,3,6,201824
9,18,0,0,0,814,0,0,0,814,655,1469,6,6,201824
9,19,0,0,0,503,0,0,0,503,481,984,3,6,201824
9,20,0,0,0,59,0,0,0,59,79,138,2,6,201824
9,21,0,0,0,225,0,0,0,225,167,392,2,6,201824
9,22,0,0,0,356,0,0,0,356,348,704,3,6,201824
9,23,0,0,0,542,0,0,0,542,442,984,3,6,201824
9,24,0,0,0,1015,0,0,0,1015,920,1935,6,6,201824
10,1,0,0,0,202,0,0,0,202,182,384,4,6,201824
10,2,0,0,0,267,0,0,0,267,285,552,2,6,201824
10,3,0,0,0,100,0,0,0,100,85,185,4,6,201824
10,4,0,0,0,514,0,0,0,514,442,956,4,4,201824
11,1,0,0,0,152,0,0,0,152,167,319,4,6,201824
11,2,0,0,0,244,0,0,0,244,211,455,6,6,201824
11,3,0,0,0,305,0,0,0,305,284,589,2,6,201824
11,4,0,0,0,201,0,0,0,201,177,378,5,4.333333333,201824
11,5,0,0,0,505,0,0,0,505,452,957,4,6,201824
11,6,0,0,0,322,0,0,0,322,278,600,4,6,201824
11,7,0,0,0,154,0,0,0,154,175,329,5,6,201824
11,8,0,0,0,340,0,0,0,340,339,679,7,6,201824
11,9,0,0,0,501,0,0,0,501,448,949,4,6,201824
11,10,0,0,0,224,0,0,0,224,213,437,6,6,201824
11,11,0,0,0,283,0,0,0,283,248,531,4,6,201824
11,12,0,0,0,423,0,0,0,423,385,808,4,6,201824
11,13,0,0,0,138,0,0,0,138,125,263,5,6,201824
11,14,0,0,0,191,0,0,0,191,172,363,4,6,201824
11,15,0,0,0,268,0,0,0,268,212,480,3,6,201824
12,1,0,0,0,80,0,0,0,80,104,184,2,6,201824
12,2,0,0,0,333,0,0,0,333,260,593,4,6,201824
12,3,0,0,0,110,0,0,0,110,144,254,2,6,201824
12,4,0,0,0,453,0,0,0,453,442,895,4,6,201824
12,5,0,0,0,28,0,0,0,28,28,56,2,6,201824
12,6,0,0,0,78,0,0,0,78,48,126,2,6,201824
12,7,0,0,0,297,0,0,0,297,330,627,3,6,201824
12,8,0,0,0,80,0,0,0,80,76,156,2,6,201824
12,9,0,0,0,372,0,0,0,372,359,731,4,6,201824
13,1,0,0,0,103,0,0,0,103,99,202,3,6,201824
13,2,0,0,0,100,0,0,0,100,89,189,2,6,201824
13,3,0,0,0,134,0,0,0,134,150,284,2,6,201824
13,4,0,0,0,240,0,0,0,240,210,450,4,6,201824
13,5,0,0,0,305,0,0,0,305,310,615,6,6,201824
13,6,0,0,0,732,0,0,0,732,729,1461,5,6,201824
13,7,0,0,0,335,0,0,0,335,283,618,5,6,201824
14,1,0,0,0,36,0,0,0,36,41,77,3,6,201824
14,2,0,0,0,81,0,0,0,81,99,180,4,6,201824
14,3,0,0,0,76,0,0,0,76,68,144,4,6,201824
14,4,0,0,0,341,0,0,0,341,297,638,4,6,201824
14,5,0,0,0,280,0,0,0,280,237,517,5,6,201824
14,6,0,0,0,431,0,0,0,431,418,849,3,6,201824
14,7,0,0,0,228,0,0,0,228,137,365,3,6,201824
14,8,0,0,0,848,0,0,0,848,792,1640,8,4.8,201824
14,9,0,0,0,195,0,0,0,195,151,346,5,7,201824
14,10,0,0,0,469,0,0,0,469,359,828,4,6,201824
14,11,0,0,0,282,0,0,0,282,288,570,2,6,201824
14,12,0,0,0,287,0,0,0,287,249,536,5,6,201824
14,13,0,0,0,269,0,0,0,269,355,624,4,6,201824
14,14,0,0,0,338,0,0,0,338,266,604,3,6,201824
14,15,0,0,0,183,0,0,0,183,159,342,6,6,201824
14,16,0,0,0,397,0,0,0,397,399,796,2,6,201824
14,17,0,0,0,66,0,0,0,66,46,112,2,6,201824
14,18,0,0,0,151,0,0,0,151,120,271,4,6,201824
14,19,0,0,0,191,0,0,0,191,169,360,2,6,201824
14,20,0,0,0,70,0,0,0,70,93,163,4,6,201824
15,1,0,0,0,117,0,0,0,117,83,200,3,6,201824
15,2,0,0,0,406,0,0,0,406,438,844,4,6,201824
15,3,0,0,0,418,0,0,0,418,454,872,5,6,201824
15,4,0,0,0,435,0,0,0,435,466,901,2,6,201824
15,5,0,0,0,257,0,0,0,257,213,470,4,6,201824
15,6,0,0,0,487,0,0,0,487,540,1027,4,6,201824
15,7,0,0,0,542,0,0,0,542,493,1035,3,6,201824
15,8,0,0,0,237,0,0,0,237,221,458,2,6,201824
15,9,0,0,0,141,0,0,0,141,125,266,7,6,201824
15,10,0,0,0,362,0,0,0,362,340,702,3,6,201824
15,11,0,0,0,567,0,0,0,567,507,1074,3,6,201824
15,12,0,0,0,564,0,0,0,564,528,1092,6,6,201824
15,13,0,0,0,457,0,0,0,457,478,935,3,6,201824
15,14,0,0,0,266,0,0,0,266,307,573,2,6,201824
15,15,0,0,0,481,0,0,0,481,374,855,3,6,201824
15,16,0,0,0,582,0,0,0,582,568,1150,4,6,201824
15,17,0,0,0,396,0,0,0,396,282,678,3,6,201824
15,18,0,0,0,483,0,0,0,483,347,830,4,6,201824
15,19,0,0,0,744,0,0,0,744,802,1546,5,6,201824
15,20,0,0,0,274,0,0,0,274,245,519,3,5,201824
15,21,0,0,0,134,0,0,0,134,181,315,2,6,201824
15,22,0,0,0,801,0,0,0,801,906,1707,6,6,201824
15,23,0,0,0,275,0,0,0,275,228,503,3,6,201824
15,24,0,0,0,292,0,0,0,292,348,640,2,6,201824
15,25,0,0,0,394,0,0,0,394,374,768,3,6,201824
15,26,0,0,0,324,0,0,0,324,311,635,3,3.5,201824
15,27,0,0,0,570,0,0,0,570,568,1138,5,6,201824
15,28,0,0,0,475,0,0,0,475,470,945,4,6,201824
15,29,0,0,0,533,0,0,0,533,508,1041,3,6,201824
15,30,0,0,0,468,0,0,0,468,363,831,6,6,201824
15,31,0,0,0,379,0,0,0,379,344,723,3,6,201824
15,32,0,0,0,329,0,0,0,329,381,710,4,6,201824
15,33,0,0,0,436,0,0,0,436,371,807,4,6,201824
15,34,0,0,0,496,0,0,0,496,426,922,3,6,201824
15,35,0,0,0,355,0,0,0,355,316,671,4,6,201824
15,36,0,0,0,238,0,0,0,238,217,455,4,6,201824
15,37,0,0,0,498,0,0,0,498,466,964,4,6,201824
15,38,0,0,0,409,0,0,0,409,345,754,2,6,201824
15,39,0,0,0,243,0,0,0,243,152,395,2,6,201824
15,40,0,0,0,419,0,0,0,419,408,827,6,6,201824
15,41,0,0,0,601,0,0,0,601,571,1172,8,6,201824
16,1,0,0,0,173,0,0,0,173,121,294,2,6,201824
16,2,0,0,0,49,0,0,0,49,45,94,2,6,201824
16,3,0,0,0,181,0,0,0,181,155,336,2,6,201824
16,4,0,0,0,154,0,0,0,154,156,310,4,6,201824
16,5,0,0,0,176,0,0,0,176,159,335,5,6,201824
16,6,0,0,0,145,0,0,0,145,111,256,4,6,201824
16,7,0,0,0,161,0,0,0,161,159,320,4,6,201824
16,8,0,0,0,591,0,0,0,591,549,1140,5,6,201824
16,9,0,0,0,260,0,0,0,260,216,476,5,6,201824
16,10,0,0,0,300,0,0,0,300,288,588,4,6,201824
16,11,0,0,0,155,0,0,0,155,131,286,5,6,201824
16,12,0,0,0,110,0,0,0,110,107,217,2,6,201824
17,1,0,0,0,445,0,0,0,445,415,860,3,3.5,201824
17,2,0,0,0,371,0,0,0,371,330,701,4,6,201824
17,3,0,0,0,498,0,0,0,498,432,930,3,6,201824
17,4,0,0,0,418,0,0,0,418,411,829,5,6,201824
17,5,0,0,0,136,0,0,0,136,130,266,2,6,201824
18,1,0,0,0,69,0,0,0,69,54,123,2,6,201824
18,2,0,0,0,372,0,0,0,372,359,731,6,6,201824
18,3,0,0,0,136,0,0,0,136,128,264,4,6,201824
19,1,0,0,0,385,0,0,0,385,376,761,4,6,201824
19,2,0,0,0,481,0,0,0,481,422,903,5,6,201824
19,3,0,0,0,440,0,0,0,440,416,856,4,6,201824
19,4,0,0,0,236,0,0,0,236,205,441,2,6,201824
19,5,0,0,0,580,0,0,0,580,487,1067,6,6,201824
19,6,0,0,0,272,0,0,0,272,295,567,2,6,201824
19,7,0,0,0,130,0,0,0,130,152,282,4,6,201824
19,8,0,0,0,77,0,0,0,77,86,163,2,6,201824
19,9,0,0,0,90,0,0,0,90,77,167,2,6,201824
19,10,0,0,0,370,0,0,0,370,413,783,2,3,201824
19,11,0,0,0,636,0,0,0,636,689,1325,7,6,201824
19,12,0,0,0,132,0,0,0,132,128,260,4,6,201824
20,1,0,0,0,149,0,0,0,149,145,294,3,7,201824
20,2,0,0,0,18,0,0,0,18,21,39,2,6,201824
20,3,0,0,0,119,0,0,0,119,78,197,2,6,201824
20,4,0,0,0,45,0,0,0,45,26,71,2,6,201824
20,5,0,0,0,109,0,0,0,109,80,189,2,6,201824
20,6,0,0,0,56,0,0,0,56,61,117,2,6,201824
20,7,0,0,0,130,0,0,0,130,187,317,6,6,201824
20,8,0,0,0,848,0,0,0,848,605,1453,5,6,201824
20,9,0,0,0,195,0,0,0,195,149,344,4,6,201824
20,10,0,0,0,74,0,0,0,74,74,148,2,6,201824
21,1,0,0,0,218,0,0,0,218,203,421,4,6,201824
21,2,0,0,0,81,0,0,0,81,78,159,2,6,201824
21,3,0,0,0,249,0,0,0,249,223,472,4,6,201824
21,4,0,0,0,63,0,0,0,63,47,110,2,6,201824
21,5,0,0,0,264,0,0,0,264,247,511,4,6,201824
21,6,0,0,0,516,0,0,0,516,705,1221,2,6,201824
21,7,0,0,0,287,0,0,0,287,265,552,4,6,201824
21,8,0,0,0,88,0,0,0,88,83,171,2,6,201824
21,9,0,0,0,475,0,0,0,475,435,910,4,6,201824
21,10,0,0,0,389,0,0,0,389,471,860,2,6,201824
21,11,0,0,0,125,0,0,0,125,113,238,2,6,201824
21,12,0,0,0,1023,0,0,0,1023,1019,2042,4,4,201824
21,13,0,0,0,231,0,0,0,231,234,465,4,6,201824
21,14,0,0,0,160,0,0,0,160,106,266,4,6,201824
21,15,0,0,0,364,0,0,0,364,402,766,3,7,201824
22,1,0,0,0,46,0,0,0,46,102,148,2,6,201824
22,2,0,0,0,290,0,0,0,290,263,553,2,6,201824
22,3,0,0,0,618,0,0,0,618,541,1159,4,6,201824
22,4,0,0,0,614,0,0,0,614,605,1219,6,4.5,201824
22,5,0,0,0,181,0,0,0,181,177,358,4,6,201824
23,1,0,0,0,420,0,0,0,420,416,836,3,6,201824
23,2,0,0,0,211,0,0,0,211,198,409,1,3,201824
23,3,0,0,0,446,0,0,0,446,374,820,2,6,201824
23,4,0,0,0,357,0,0,0,357,370,727,2,6,201824
24,1,0,0,0,81,0,0,0,81,64,145,2,6,201824
24,2,0,0,0,135,0,0,0,135,148,283,2,6,201824
24,3,0,0,0,97,0,0,0,97,99,196,2,6,201824
24,4,0,0,0,113,0,0,0,113,114,227,2,6,201824
24,5,0,0,0,425,0,0,0,425,465,890,6,4.5,201824
24,6,0,0,0,579,0,0,0,579,539,1118,4,6,201824
24,7,0,0,0,80,0,0,0,80,57,137,2,6,201824
25,1,0,0,0,203,0,0,0,203,205,408,5,6,201824
25,2,0,0,0,374,0,0,0,374,299,673,3,6,201824
25,3,0,0,0,193,0,0,0,193,198,391,5,6,201824
25,4,0,0,0,130,0,0,0,130,113,243,3,6,201824
25,5,0,0,0,418,0,0,0,418,436,854,5,6,201824
25,6,0,0,0,324,0,0,0,324,273,597,6,6,201824
25,7,0,0,0,382,0,0,0,382,377,759,4,6,201824
26,1,0,0,0,244,0,0,0,244,186,430,5,6,201824
26,2,0,0,0,323,0,0,0,323,326,649,5,6,201824
26,3,0,0,0,722,0,0,0,722,730,1452,6,6,201824
26,4,0,0,0,175,0,0,0,175,133,308,3,6,201824
26,5,0,0,0,112,0,0,0,112,96,208,1,6,201824
26,6,0,0,0,465,0,0,0,465,429,894,4,7,201824
26,7,0,0,0,225,0,0,0,225,209,434,4,6,201824
27,1,0,0,0,235,0,0,0,235,191,426,4,6,201824
27,2,0,0,0,351,0,0,0,351,311,662,4,6,201824
27,3,0,0,0,333,0,0,0,333,293,626,4,6,201824
27,4,0,0,0,663,0,0,0,663,637,1300,3,3,201824
27,5,0,0,0,98,0,0,0,98,100,198,2,6,201824
27,6,0,0,0,358,0,0,0,358,397,755,2,6,201824
28,1,0,0,0,333,0,0,0,333,339,672,10,6,201824
28,2,0,0,0,336,0,0,0,336,366,702,6,6,201824
28,3,0,0,0,91,0,0,0,91,83,174,3,6,201824
28,4,0,0,0,346,0,0,0,346,340,686,11,6,201824
28,5,0,0,0,253,0,0,0,253,235,488,2,3,201824
28,6,0,0,0,86,0,0,0,86,109,195,3,6,201824
28,7,0,0,0,359,0,0,0,359,395,754,6,6,201824
28,8,0,0,0,249,0,0,0,249,241,490,6,6,201824
28,9,0,0,0,169,0,0,0,169,114,283,6,6,201824
29,1,0,0,0,304,0,0,0,304,341,645,4,6,201824
29,2,0,0,0,431,0,0,0,431,379,810,6,4.5,201824
29,3,0,0,0,193,0,0,0,193,253,446,3,6,201824
30,1,0,0,0,52,0,0,0,52,66,118,2,6,201824
30,2,0,0,0,68,0,0,0,68,62,130,2,6,201824
30,3,0,0,0,198,0,0,0,198,173,371,4,6,201824
30,4,0,0,0,217,0,0,0,217,219,436,4,6,201824
30,5,0,0,0,245,0,0,0,245,267,512,2,6,201824
30,6,0,0,0,86,0,0,0,86,97,183,2,6,201824
30,7,0,0,0,189,0,0,0,189,105,294,2,6,201824
30,8,0,0,0,174,0,0,0,174,200,374,4,6,201824
30,9,0,0,0,181,0,0,0,181,163,344,4,6,201824
30,10,0,0,0,417,0,0,0,417,419,836,4,6,201824
30,11,0,0,0,372,0,0,0,372,388,760,2,6,201824
30,12,0,0,0,496,0,0,0,496,525,1021,8,6,201824
30,13,0,0,0,119,0,0,0,119,114,233,4,6,201824
30,14,0,0,0,174,0,0,0,174,166,340,4,6,201824
30,15,0,0,0,361,0,0,0,361,337,698,4,6,201824
30,16,0,0,0,266,0,0,0,266,225,491,2,6,201824
30,17,0,0,0,150,0,0,0,150,133,283,4,6,201824
30,18,0,0,0,36,0,0,0,36,29,65,2,6,201824
30,19,0,0,0,113,0,0,0,113,113,226,6,6,201824
30,20,0,0,0,184,0,0,0,184,185,369,4,6,201824
31,1,0,0,0,147,0,0,0,147,82,229,4,6,201824
31,2,0,0,0,59,0,0,0,59,49,108,2,6,201824
31,3,0,0,0,909,0,0,0,909,713,1622,8,4.5,201824
31,4,0,0,0,277,0,0,0,277,304,581,2,6,201824
31,5,0,0,0,85,0,0,0,85,74,159,2,6,201824
32,1,0,0,0,124,0,0,0,124,107,231,2,6,201824
32,2,0,0,0,62,0,0,0,62,59,121,2,6,201824
32,3,0,0,0,181,0,0,0,181,207,388,4,6,201824
32,4,0,0,0,201,0,0,0,201,162,363,3,3.5,201824
1,1,0,0,0,162,0,0,0,162,177,339,6,6,201825
1,2,0,0,0,501,0,0,0,501,442,943,6,4.5,201825
1,3,0,0,0,537,0,0,0,537,500,1037,6,6,201825
2,1,0,0,0,229,0,0,0,229,226,455,6,6,201825
2,2,0,0,0,252,0,0,0,252,268,520,4,6,201825
2,3,0,0,0,306,0,0,0,306,330,636,4,4,201825
2,4,0,0,0,139,0,0,0,139,129,268,4,6,201825
2,5,0,0,0,514,0,0,0,514,524,1038,6,6,201825
2,6,0,0,0,243,0,0,0,243,290,533,4,6,201825
2,7,0,0,0,250,0,0,0,250,219,469,6,6,201825
2,8,0,0,0,462,0,0,0,462,436,898,4,6,201825
3,1,0,0,0,333,0,0,0,333,354,687,7,6,201825
3,2,0,0,0,156,0,0,0,156,159,315,4,6,201825
4,1,0,0,0,355,0,0,0,355,369,724,3,6,201825
4,2,0,0,0,256,0,0,0,256,180,436,2,6,201825
5,1,0,0,0,224,0,0,0,224,200,424,5,6,201825
5,2,0,0,0,84,0,0,0,84,62,146,2,6,201825
5,3,0,0,0,255,0,0,0,255,222,477,5,6,201825
5,4,0,0,0,457,0,0,0,457,420,877,5,6,201825
5,5,0,0,0,360,0,0,0,360,380,740,6,6,201825
5,6,0,0,0,168,0,0,0,168,146,314,3,6,201825
5,7,0,0,0,213,0,0,0,213,230,443,3,3,201825
6,1,0,0,0,294,0,0,0,294,272,566,7,4.8,201825
6,2,0,0,0,173,0,0,0,173,174,347,4,6,201825
7,1,0,0,0,41,0,0,0,41,54,95,2,6,201825
7,2,0,0,0,62,0,0,0,62,53,115,2,6,201825
7,3,0,0,0,137,0,0,0,137,119,256,2,6,201825
7,4,0,0,0,123,0,0,0,123,95,218,4,6,201825
7,5,0,0,0,235,0,0,0,235,228,463,4,6,201825
7,6,0,0,0,256,0,0,0,256,222,478,2,3,201825
7,7,0,0,0,193,0,0,0,193,165,358,4,6,201825
7,8,0,0,0,165,0,0,0,165,138,303,2,6,201825
7,9,0,0,0,515,0,0,0,515,601,1116,4,6,201825
7,10,0,0,0,25,0,0,0,25,40,65,4,6,201825
7,11,0,0,0,35,0,0,0,35,30,65,2,6,201825
7,12,0,0,0,393,0,0,0,393,333,726,5,6,201825
7,13,0,0,0,37,0,0,0,37,13,50,3,6,201825
8,1,0,0,0,279,0,0,0,279,335,614,2,6,201825
8,2,0,0,0,321,0,0,0,321,258,579,5,6,201825
8,3,0,0,0,433,0,0,0,433,305,738,4,6,201825
8,4,0,0,0,367,0,0,0,367,352,719,4,6,201825
8,5,0,0,0,144,0,0,0,144,122,266,3,6,201825
8,6,0,0,0,381,0,0,0,381,415,796,4,4,201825
8,7,0,0,0,105,0,0,0,105,92,197,3,6,201825
8,8,0,0,0,340,0,0,0,340,320,660,4,6,201825
8,9,0,0,0,72,0,0,0,72,77,149,3,6,201825
9,1,0,0,0,246,0,0,0,246,232,478,2,6,201825
9,2,0,0,0,1137,0,0,0,1137,1116,2253,8,6,201825
9,3,0,0,0,607,0,0,0,607,617,1224,4,6,201825
9,4,0,0,0,593,0,0,0,593,585,1178,3,6,201825
9,5,0,0,0,509,0,0,0,509,469,978,3,6,201825
9,6,0,0,0,431,0,0,0,431,404,835,3,6,201825
9,7,0,0,0,467,0,0,0,467,455,922,3,6,201825
9,8,0,0,0,310,0,0,0,310,274,584,2,6,201825
9,9,0,0,0,365,0,0,0,365,316,681,2,6,201825
9,10,0,0,0,538,0,0,0,538,514,1052,3,6,201825
9,11,0,0,0,746,0,0,0,746,705,1451,4,6,201825
9,12,0,0,0,860,0,0,0,860,835,1695,5,6,201825
9,13,0,0,0,496,0,0,0,496,457,953,3,6,201825
9,14,0,0,0,407,0,0,0,407,438,845,3,6,201825
9,15,0,0,0,1347,0,0,0,1347,1245,2592,8,4,201825
9,16,0,0,0,1099,0,0,0,1099,984,2083,4,6,201825
9,17,0,0,0,443,0,0,0,443,340,783,3,6,201825
9,18,0,0,0,809,0,0,0,809,723,1532,6,6,201825
9,19,0,0,0,490,0,0,0,490,420,910,3,6,201825
9,20,0,0,0,87,0,0,0,87,69,156,2,6,201825
9,21,0,0,0,216,0,0,0,216,184,400,2,6,201825
9,22,0,0,0,403,0,0,0,403,428,831,3,6,201825
9,23,0,0,0,663,0,0,0,663,572,1235,3,6,201825
9,24,0,0,0,1005,0,0,0,1005,1021,2026,6,6,201825
10,1,0,0,0,170,0,0,0,170,202,372,4,6,201825
10,2,0,0,0,264,0,0,0,264,282,546,2,6,201825
10,3,0,0,0,105,0,0,0,105,146,251,4,6,201825
10,4,0,0,0,529,0,0,0,529,557,1086,4,4,201825
11,1,0,0,0,190,0,0,0,190,144,334,4,6,201825
11,2,0,0,0,211,0,0,0,211,263,474,6,6,201825
11,3,0,0,0,268,0,0,0,268,300,568,2,6,201825
11,4,0,0,0,195,0,0,0,195,216,411,5,4.333333333,201825
11,5,0,0,0,489,0,0,0,489,459,948,4,6,201825
11,6,0,0,0,314,0,0,0,314,294,608,4,6,201825
11,7,0,0,0,145,0,0,0,145,183,328,5,6,201825
11,8,0,0,0,336,0,0,0,336,339,675,7,6,201825
11,9,0,0,0,416,0,0,0,416,465,881,4,6,201825
11,10,0,0,0,264,0,0,0,264,241,505,6,6,201825
11,11,0,0,0,253,0,0,0,253,249,502,4,6,201825
11,12,0,0,0,415,0,0,0,415,403,818,4,6,201825
11,13,0,0,0,140,0,0,0,140,155,295,5,6,201825
11,14,0,0,0,169,0,0,0,169,193,362,4,6,201825
11,15,0,0,0,246,0,0,0,246,272,518,3,6,201825
12,1,0,0,0,102,0,0,0,102,83,185,2,6,201825
12,2,0,0,0,320,0,0,0,320,282,602,4,6,201825
12,3,0,0,0,145,0,0,0,145,145,290,2,6,201825
12,4,0,0,0,462,0,0,0,462,451,913,4,6,201825
12,5,0,0,0,53,0,0,0,53,33,86,2,6,201825
12,6,0,0,0,72,0,0,0,72,62,134,2,6,201825
12,7,0,0,0,320,0,0,0,320,372,692,3,6,201825
12,8,0,0,0,75,0,0,0,75,65,140,2,6,201825
12,9,0,0,0,327,0,0,0,327,314,641,4,6,201825
13,1,0,0,0,107,0,0,0,107,87,194,3,6,201825
13,2,0,0,0,102,0,0,0,102,88,190,2,6,201825
13,3,0,0,0,157,0,0,0,157,147,304,2,6,201825
13,4,0,0,0,255,0,0,0,255,300,555,4,6,201825
13,5,0,0,0,299,0,0,0,299,310,609,6,6,201825
13,6,0,0,0,720,0,0,0,720,688,1408,5,6,201825
13,7,0,0,0,302,0,0,0,302,325,627,5,6,201825
14,1,0,0,0,41,0,0,0,41,46,87,3,6,201825
14,2,0,0,0,98,0,0,0,98,106,204,4,6,201825
14,3,0,0,0,56,0,0,0,56,63,119,4,6,201825
14,4,0,0,0,339,0,0,0,339,311,650,4,6,201825
14,5,0,0,0,226,0,0,0,226,279,505,5,6,201825
14,6,0,0,0,348,0,0,0,348,422,770,3,6,201825
14,7,0,0,0,220,0,0,0,220,205,425,3,6,201825
14,8,0,0,0,838,0,0,0,838,838,1676,8,4.8,201825
14,9,0,0,0,205,0,0,0,205,155,360,5,7,201825
14,10,0,0,0,515,0,0,0,515,495,1010,4,6,201825
14,11,0,0,0,294,0,0,0,294,270,564,2,6,201825
14,12,0,0,0,250,0,0,0,250,272,522,5,6,201825
14,13,0,0,0,281,0,0,0,281,358,639,4,6,201825
14,14,0,0,0,372,0,0,0,372,345,717,3,6,201825
14,15,0,0,0,147,0,0,0,147,190,337,6,6,201825
14,16,0,0,0,358,0,0,0,358,399,757,2,6,201825
14,17,0,0,0,63,0,0,0,63,41,104,2,6,201825
14,18,0,0,0,161,0,0,0,161,161,322,4,6,201825
14,19,0,0,0,164,0,0,0,164,180,344,2,6,201825
14,20,0,0,0,75,0,0,0,75,55,130,4,6,201825
15,1,0,0,0,120,0,0,0,120,109,229,3,6,201825
15,2,0,0,0,401,0,0,0,401,348,749,4,6,201825
15,3,0,0,0,448,0,0,0,448,394,842,5,6,201825
15,4,0,0,0,426,0,0,0,426,390,816,2,6,201825
15,5,0,0,0,292,0,0,0,292,243,535,4,6,201825
15,6,0,0,0,503,0,0,0,503,529,1032,4,6,201825
15,7,0,0,0,565,0,0,0,565,515,1080,3,6,201825
15,8,0,0,0,239,0,0,0,239,224,463,2,6,201825
15,9,0,0,0,179,0,0,0,179,125,304,7,6,201825
15,10,0,0,0,391,0,0,0,391,354,745,3,6,201825
15,11,0,0,0,512,0,0,0,512,487,999,3,6,201825
15,12,0,0,0,599,0,0,0,599,567,1166,6,6,201825
15,13,0,0,0,447,0,0,0,447,394,841,3,6,201825
15,14,0,0,0,283,0,0,0,283,272,555,2,6,201825
15,15,0,0,0,471,0,0,0,471,467,938,3,6,201825
15,16,0,0,0,569,0,0,0,569,548,1117,4,6,201825
15,17,0,0,0,350,0,0,0,350,351,701,3,6,201825
15,18,0,0,0,520,0,0,0,520,440,960,4,6,201825
15,19,0,0,0,763,0,0,0,763,868,1631,5,6,201825
15,20,0,0,0,289,0,0,0,289,303,592,3,6,201825
15,21,0,0,0,146,0,0,0,146,129,275,3,7,201825
15,22,0,0,0,876,0,0,0,876,914,1790,6,6,201825
15,23,0,0,0,277,0,0,0,277,272,549,3,6,201825
15,24,0,0,0,277,0,0,0,277,267,544,2,6,201825
15,25,0,0,0,487,0,0,0,487,404,891,3,6,201825
15,26,0,0,0,313,0,0,0,313,316,629,2,3,201825
15,27,0,0,0,559,0,0,0,559,614,1173,5,6,201825
15,28,0,0,0,468,0,0,0,468,479,947,4,6,201825
15,29,0,0,0,507,0,0,0,507,539,1046,3,6,201825
15,30,0,0,0,423,0,0,0,423,407,830,6,6,201825
15,31,0,0,0,426,0,0,0,426,358,784,3,6,201825
15,32,0,0,0,342,0,0,0,342,369,711,4,6,201825
15,33,0,0,0,456,0,0,0,456,357,813,4,6,201825
15,34,0,0,0,509,0,0,0,509,506,1015,3,6,201825
15,35,0,0,0,435,0,0,0,435,392,827,4,6,201825
15,36,0,0,0,234,0,0,0,234,250,484,4,6,201825
15,37,0,0,0,479,0,0,0,479,428,907,4,6,201825
15,38,0,0,0,423,0,0,0,423,410,833,2,6,201825
15,39,0,0,0,231,0,0,0,231,216,447,2,6,201825
15,40,0,0,0,421,0,0,0,421,378,799,6,6,201825
15,41,0,0,0,611,0,0,0,611,580,1191,8,6,201825
16,1,0,0,0,151,0,0,0,151,198,349,2,6,201825
16,2,0,0,0,68,0,0,0,68,58,126,2,6,201825
16,3,0,0,0,163,0,0,0,163,109,272,2,5,201825
16,4,0,0,0,126,0,0,0,126,159,285,4,6,201825
16,5,0,0,0,164,0,0,0,164,181,345,5,6,201825
16,6,0,0,0,129,0,0,0,129,140,269,4,6,201825
16,7,0,0,0,151,0,0,0,151,184,335,4,6,201825
16,8,0,0,0,581,0,0,0,581,609,1190,5,6,201825
16,9,0,0,0,231,0,0,0,231,237,468,5,6,201825
16,10,0,0,0,282,0,0,0,282,275,557,4,6,201825
16,11,0,0,0,145,0,0,0,145,170,315,5,6,201825
16,12,0,0,0,121,0,0,0,121,107,228,2,6,201825
17,1,0,0,0,446,0,0,0,446,444,890,3,3.5,201825
17,2,0,0,0,362,0,0,0,362,350,712,4,6,201825
17,3,0,0,0,492,0,0,0,492,478,970,3,6,201825
17,4,0,0,0,466,0,0,0,466,364,830,5,6,201825
17,5,0,0,0,149,0,0,0,149,129,278,2,6,201825
18,1,0,0,0,64,0,0,0,64,69,133,2,6,201825
18,2,0,0,0,395,0,0,0,395,370,765,6,6,201825
18,3,0,0,0,135,0,0,0,135,146,281,4,6,201825
19,1,0,0,0,419,0,0,0,419,431,850,4,6,201825
19,2,0,0,0,556,0,0,0,556,540,1096,5,6,201825
19,3,0,0,0,440,0,0,0,440,439,879,4,6,201825
19,4,0,0,0,226,0,0,0,226,233,459,2,6,201825
19,5,0,0,0,552,0,0,0,552,590,1142,6,6,201825
19,6,0,0,0,278,0,0,0,278,298,576,2,6,201825
19,7,0,0,0,121,0,0,0,121,117,238,4,6,201825
19,8,0,0,0,101,0,0,0,101,80,181,2,6,201825
19,9,0,0,0,68,0,0,0,68,63,131,2,6,201825
19,10,0,0,0,406,0,0,0,406,393,799,2,3,201825
19,11,0,0,0,693,0,0,0,693,641,1334,7,6,201825
19,12,0,0,0,178,0,0,0,178,102,280,4,6,201825
20,1,0,0,0,184,0,0,0,184,167,351,2,6,201825
20,2,0,0,0,21,0,0,0,21,18,39,2,6,201825
20,3,0,0,0,119,0,0,0,119,106,225,2,6,201825
20,4,0,0,0,52,0,0,0,52,39,91,2,6,201825
20,5,0,0,0,118,0,0,0,118,128,246,3,7,201825
20,6,0,0,0,48,0,0,0,48,60,108,2,6,201825
20,7,0,0,0,152,0,0,0,152,157,309,6,6,201825
20,8,0,0,0,865,0,0,0,865,775,1640,6,6.5,201825
20,9,0,0,0,220,0,0,0,220,186,406,4,6,201825
20,10,0,0,0,62,0,0,0,62,70,132,3,7,201825
21,1,0,0,0,232,0,0,0,232,252,484,4,6,201825
21,2,0,0,0,93,0,0,0,93,80,173,2,6,201825
21,3,0,0,0,256,0,0,0,256,228,484,4,6,201825
21,4,0,0,0,61,0,0,0,61,74,135,2,6,201825
21,5,0,0,0,293,0,0,0,293,281,574,4,6,201825
21,6,0,0,0,437,0,0,0,437,464,901,2,6,201825
21,7,0,0,0,294,0,0,0,294,268,562,4,6,201825
21,8,0,0,0,87,0,0,0,87,85,172,2,6,201825
21,9,0,0,0,509,0,0,0,509,509,1018,4,6,201825
21,10,0,0,0,442,0,0,0,442,348,790,2,6,201825
21,11,0,0,0,119,0,0,0,119,159,278,2,6,201825
21,12,0,0,0,996,0,0,0,996,1004,2000,5,4.333333333,201825
21,13,0,0,0,222,0,0,0,222,193,415,4,6,201825
21,14,0,0,0,141,0,0,0,141,182,323,4,6,201825
21,15,0,0,0,340,0,0,0,340,283,623,2,6,201825
22,1,0,0,0,38,0,0,0,38,55,93,3,7,201825
22,2,0,0,0,334,0,0,0,334,288,622,2,6,201825
22,3,0,0,0,653,0,0,0,653,683,1336,4,6,201825
22,4,0,0,0,675,0,0,0,675,536,1211,6,4.5,201825
22,5,0,0,0,182,0,0,0,182,180,362,4,6,201825
23,1,0,0,0,455,0,0,0,455,435,890,3,6,201825
23,2,0,0,0,203,0,0,0,203,188,391,1,3,201825
23,3,0,0,0,462,0,0,0,462,543,1005,2,6,201825
23,4,0,0,0,412,0,0,0,412,383,795,2,6,201825
24,1,0,0,0,93,0,0,0,93,92,185,2,6,201825
24,2,0,0,0,144,0,0,0,144,147,291,2,6,201825
24,3,0,0,0,88,0,0,0,88,109,197,2,6,201825
24,4,0,0,0,120,0,0,0,120,93,213,2,6,201825
24,5,0,0,0,424,0,0,0,424,465,889,6,4.5,201825
24,6,0,0,0,613,0,0,0,613,547,1160,4,6,201825
24,7,0,0,0,84,0,0,0,84,63,147,2,6,201825
25,1,0,0,0,220,0,0,0,220,212,432,5,6,201825
25,2,0,0,0,386,0,0,0,386,392,778,3,6,201825
25,3,0,0,0,178,0,0,0,178,204,382,5,6,201825
25,4,0,0,0,102,0,0,0,102,128,230,3,6,201825
25,5,0,0,0,423,0,0,0,423,429,852,5,6,201825
25,6,0,0,0,293,0,0,0,293,318,611,6,6,201825
25,7,0,0,0,401,0,0,0,401,365,766,4,6,201825
26,1,0,0,0,219,0,0,0,219,199,418,6,6.5,201825
26,2,0,0,0,357,0,0,0,357,411,768,5,6,201825
26,3,0,0,0,712,0,0,0,712,638,1350,6,6,201825
26,4,0,0,0,192,0,0,0,192,174,366,3,6,201825
26,5,0,0,0,81,0,0,0,81,104,185,1,6,201825
26,6,0,0,0,440,0,0,0,440,443,883,3,6,201825
26,7,0,0,0,239,0,0,0,239,211,450,4,6,201825
27,1,0,0,0,230,0,0,0,230,242,472,4,6,201825
27,2,0,0,0,316,0,0,0,316,345,661,4,6,201825
27,3,0,0,0,362,0,0,0,362,347,709,4,6,201825
27,4,0,0,0,645,0,0,0,645,603,1248,3,2.5,201825
27,5,0,0,0,84,0,0,0,84,98,182,2,6,201825
27,6,0,0,0,350,0,0,0,350,354,704,2,6,201825
28,1,0,0,0,314,0,0,0,314,307,621,10,6,201825
28,2,0,0,0,345,0,0,0,345,290,635,6,6,201825
28,3,0,0,0,84,0,0,0,84,102,186,3,6,201825
28,4,0,0,0,320,0,0,0,320,341,661,11,6,201825
28,5,0,0,0,274,0,0,0,274,238,512,2,3,201825
28,6,0,0,0,106,0,0,0,106,81,187,3,6,201825
28,7,0,0,0,379,0,0,0,379,383,762,6,6,201825
28,8,0,0,0,218,0,0,0,218,227,445,6,5.5,201825
28,9,0,0,0,158,0,0,0,158,204,362,6,6,201825
29,1,0,0,0,323,0,0,0,323,310,633,4,6,201825
29,2,0,0,0,425,0,0,0,425,427,852,6,4.5,201825
29,3,0,0,0,193,0,0,0,193,222,415,3,6,201825
30,1,0,0,0,74,0,0,0,74,63,137,2,6,201825
30,2,0,0,0,58,0,0,0,58,70,128,2,6,201825
30,3,0,0,0,189,0,0,0,189,212,401,4,6,201825
30,4,0,0,0,270,0,0,0,270,216,486,4,6,201825
30,5,0,0,0,217,0,0,0,217,236,453,2,6,201825
30,6,0,0,0,93,0,0,0,93,85,178,2,6,201825
30,7,0,0,0,150,0,0,0,150,161,311,2,6,201825
30,8,0,0,0,209,0,0,0,209,198,407,4,6,201825
30,9,0,0,0,153,0,0,0,153,195,348,4,6,201825
30,10,0,0,0,392,0,0,0,392,443,835,4,6,201825
30,11,0,0,0,353,0,0,0,353,323,676,2,6,201825
30,12,0,0,0,545,0,0,0,545,537,1082,8,6,201825
30,13,0,0,0,135,0,0,0,135,105,240,4,6,201825
30,14,0,0,0,198,0,0,0,198,165,363,4,6,201825
30,15,0,0,0,317,0,0,0,317,356,673,4,6,201825
30,16,0,0,0,306,0,0,0,306,302,608,2,6,201825
30,17,0,0,0,158,0,0,0,158,131,289,4,6,201825
30,18,0,0,0,28,0,0,0,28,31,59,2,6,201825
30,19,0,0,0,142,0,0,0,142,118,260,6,6,201825
30,20,0,0,0,190,0,0,0,190,174,364,4,6,201825
31,1,0,0,0,154,0,0,0,154,152,306,4,6,201825
31,2,0,0,0,43,0,0,0,43,59,102,2,6,201825
31,3,0,0,0,1019,0,0,0,1019,871,1890,8,4.5,201825
31,4,0,0,0,323,0,0,0,323,323,646,2,6,201825
31,5,0,0,0,110,0,0,0,110,115,225,2,6,201825
32,1,0,0,0,133,0,0,0,133,126,259,2,6,201825
32,2,0,0,0,65,0,0,0,65,70,135,2,6,201825
32,3,0,0,0,181,0,0,0,181,162,343,4,6,201825
32,4,0,0,0,185,0,0,0,185,192,377,3,3.5,201825
1,1,0,0,0,166,0,0,0,166,143,309,6,6,201826
1,2,0,0,0,453,0,0,0,453,474,927,6,4.5,201826
1,3,0,0,0,536,0,0,0,536,471,1007,6,6,201826
2,1,0,0,0,247,0,0,0,247,215,462,6,6,201826
2,2,0,0,0,317,0,0,0,317,282,599,4,6,201826
2,3,0,0,0,340,0,0,0,340,283,623,5,4.333333333,201826
2,4,0,0,0,127,0,0,0,127,141,268,4,6,201826
2,5,0,0,0,592,0,0,0,592,586,1178,6,6,201826
2,6,0,0,0,290,0,0,0,290,295,585,4,6,201826
2,7,0,0,0,237,0,0,0,237,225,462,6,6,201826
2,8,0,0,0,397,0,0,0,397,532,929,4,6,201826
3,1,0,0,0,356,0,0,0,356,287,643,7,6,201826
3,2,0,0,0,230,0,0,0,230,174,404,4,6,201826
4,1,0,0,0,342,0,0,0,342,292,634,3,5,201826
4,2,0,0,0,202,0,0,0,202,237,439,2,6,201826
5,1,0,0,0,273,0,0,0,273,211,484,5,6,201826
5,2,0,0,0,80,0,0,0,80,53,133,2,6,201826
5,3,0,0,0,276,0,0,0,276,257,533,5,6,201826
5,4,0,0,0,530,0,0,0,530,436,966,5,6,201826
5,5,0,0,0,403,0,0,0,403,342,745,6,6,201826
5,6,0,0,0,145,0,0,0,145,118,263,3,5,201826
5,7,0,0,0,176,0,0,0,176,155,331,3,2.5,201826
6,1,0,0,0,265,0,0,0,265,316,581,7,4.8,201826
6,2,0,0,0,200,0,0,0,200,182,382,4,6,201826
7,1,0,0,0,61,0,0,0,61,37,98,2,6,201826
7,2,0,0,0,56,0,0,0,56,60,116,2,6,201826
7,3,0,0,0,100,0,0,0,100,121,221,2,4,201826
7,4,0,0,0,179,0,0,0,179,111,290,4,6,201826
7,5,0,0,0,236,0,0,0,236,209,445,4,6,201826
7,6,0,0,0,252,0,0,0,252,271,523,2,3,201826
7,7,0,0,0,207,0,0,0,207,177,384,4,6,201826
7,8,0,0,0,235,0,0,0,235,178,413,2,6,201826
7,9,0,0,0,558,0,0,0,558,558,1116,4,6,201826
7,10,0,0,0,30,0,0,0,30,22,52,4,6,201826
7,11,0,0,0,21,0,0,0,21,32,53,2,6,201826
7,12,0,0,0,416,0,0,0,416,418,834,5,6,201826
7,13,0,0,0,31,0,0,0,31,11,42,3,6,201826
8,1,0,0,0,295,0,0,0,295,302,597,2,6,201826
8,2,0,0,0,270,0,0,0,270,299,569,5,6,201826
8,3,0,0,0,437,0,0,0,437,377,814,4,6,201826
8,4,0,0,0,308,0,0,0,308,315,623,4,6,201826
8,5,0,0,0,143,0,0,0,143,137,280,3,6,201826
8,6,0,0,0,420,0,0,0,420,409,829,4,4,201826
8,7,0,0,0,121,0,0,0,121,111,232,3,6,201826
8,8,0,0,0,381,0,0,0,381,397,778,4,6,201826
8,9,0,0,0,66,0,0,0,66,77,143,3,6,201826
9,1,0,0,0,360,0,0,0,360,308,668,2,5,201826
9,2,0,0,0,1099,0,0,0,1099,989,2088,8,5,201826
9,3,0,0,0,606,0,0,0,606,645,1251,4,5,201826
9,4,0,0,0,566,0,0,0,566,546,1112,3,6,201826
9,5,0,0,0,483,0,0,0,483,453,936,3,5,201826
9,6,0,0,0,368,0,0,0,368,373,741,3,5,201826
9,7,0,0,0,466,0,0,0,466,433,899,3,5,201826
9,8,0,0,0,308,0,0,0,308,317,625,2,6,201826
9,9,0,0,0,376,0,0,0,376,396,772,2,5,201826
9,10,0,0,0,614,0,0,0,614,552,1166,3,6,201826
9,11,0,0,0,787,0,0,0,787,780,1567,4,6,201826
9,12,0,0,0,946,0,0,0,946,888,1834,5,6,201826
9,13,0,0,0,558,0,0,0,558,487,1045,3,6,201826
9,14,0,0,0,469,0,0,0,469,447,916,3,6,201826
9,15,0,0,0,1426,0,0,0,1426,1477,2903,8,4,201826
9,16,0,0,0,1192,0,0,0,1192,969,2161,4,6,201826
9,17,0,0,0,542,0,0,0,542,403,945,3,6,201826
9,18,0,0,0,867,0,0,0,867,803,1670,6,6,201826
9,19,0,0,0,546,0,0,0,546,502,1048,3,6,201826
9,20,0,0,0,85,0,0,0,85,76,161,2,6,201826
9,21,0,0,0,260,0,0,0,260,224,484,2,6,201826
9,22,0,0,0,407,0,0,0,407,367,774,3,6,201826
9,23,0,0,0,447,0,0,0,447,505,952,3,5,201826
9,24,0,0,0,1072,0,0,0,1072,1025,2097,6,6,201826
10,1,0,0,0,209,0,0,0,209,181,390,4,6,201826
10,2,0,0,0,244,0,0,0,244,239,483,2,6,201826
10,3,0,0,0,126,0,0,0,126,102,228,5,6.5,201826
10,4,0,0,0,529,0,0,0,529,479,1008,4,4,201826
11,1,0,0,0,191,0,0,0,191,179,370,4,6,201826
11,2,0,0,0,216,0,0,0,216,209,425,6,6,201826
11,3,0,0,0,312,0,0,0,312,262,574,2,6,201826
11,4,0,0,0,231,0,0,0,231,211,442,5,4.333333333,201826
11,5,0,0,0,560,0,0,0,560,500,1060,4,6,201826
11,6,0,0,0,326,0,0,0,326,328,654,4,6,201826
11,7,0,0,0,152,0,0,0,152,162,314,5,6,201826
11,8,0,0,0,390,0,0,0,390,348,738,7,6,201826
11,9,0,0,0,453,0,0,0,453,426,879,4,6,201826
11,10,0,0,0,241,0,0,0,241,235,476,6,6,201826
11,11,0,0,0,284,0,0,0,284,281,565,4,6,201826
11,12,0,0,0,522,0,0,0,522,439,961,4,6,201826
11,13,0,0,0,150,0,0,0,150,143,293,5,6,201826
11,14,0,0,0,209,0,0,0,209,176,385,4,6,201826
11,15,0,0,0,277,0,0,0,277,264,541,3,6,201826
12,1,0,0,0,118,0,0,0,118,92,210,2,6,201826
12,2,0,0,0,295,0,0,0,295,288,583,4,6,201826
12,3,0,0,0,170,0,0,0,170,150,320,2,6,201826
12,4,0,0,0,492,0,0,0,492,429,921,4,6,201826
12,5,0,0,0,57,0,0,0,57,48,105,2,6,201826
12,6,0,0,0,55,0,0,0,55,67,122,2,6,201826
12,7,0,0,0,331,0,0,0,331,352,683,3,6,201826
12,8,0,0,0,85,0,0,0,85,80,165,2,6,201826
12,9,0,0,0,269,0,0,0,269,300,569,4,6,201826
13,1,0,0,0,106,0,0,0,106,116,222,3,6,201826
13,2,0,0,0,140,0,0,0,140,95,235,2,6,201826
13,3,0,0,0,180,0,0,0,180,136,316,2,6,201826
13,4,0,0,0,272,0,0,0,272,260,532,4,6,201826
13,5,0,0,0,291,0,0,0,291,287,578,6,6,201826
13,6,0,0,0,732,0,0,0,732,719,1451,5,6,201826
13,7,0,0,0,368,0,0,0,368,298,666,5,6,201826
14,1,0,0,0,74,0,0,0,74,49,123,3,6,201826
14,2,0,0,0,121,0,0,0,121,91,212,4,6,201826
14,3,0,0,0,78,0,0,0,78,74,152,4,6,201826
14,4,0,0,0,362,0,0,0,362,340,702,4,6,201826
14,5,0,0,0,253,0,0,0,253,261,514,5,6,201826
14,6,0,0,0,425,0,0,0,425,388,813,3,6,201826
14,7,0,0,0,146,0,0,0,146,173,319,3,6,201826
14,8,0,0,0,938,0,0,0,938,858,1796,8,4.8,201826
14,9,0,0,0,184,0,0,0,184,156,340,5,7,201826
14,10,0,0,0,569,0,0,0,569,536,1105,4,6,201826
14,11,0,0,0,295,0,0,0,295,241,536,2,6,201826
14,12,0,0,0,286,0,0,0,286,254,540,5,6,201826
14,13,0,0,0,263,0,0,0,263,315,578,4,6,201826
14,14,0,0,0,366,0,0,0,366,334,700,3,6,201826
14,15,0,0,0,178,0,0,0,178,170,348,6,6,201826
14,16,0,0,0,438,0,0,0,438,398,836,2,6,201826
14,17,0,0,0,60,0,0,0,60,80,140,2,6,201826
14,18,0,0,0,183,0,0,0,183,147,330,4,6,201826
14,19,0,0,0,168,0,0,0,168,157,325,2,6,201826
14,20,0,0,0,90,0,0,0,90,86,176,4,6,201826
15,1,0,0,0,121,0,0,0,121,107,228,3,6,201826
15,2,0,0,0,444,0,0,0,444,353,797,4,6,201826
15,3,0,0,0,454,0,0,0,454,448,902,5,6,201826
15,4,0,0,0,539,0,0,0,539,415,954,2,6,201826
15,5,0,0,0,376,0,0,0,376,247,623,4,6,201826
15,6,0,0,0,541,0,0,0,541,539,1080,4,6,201826
15,7,0,0,0,521,0,0,0,521,451,972,3,6,201826
15,8,0,0,0,249,0,0,0,249,247,496,2,6,201826
15,9,0,0,0,160,0,0,0,160,170,330,7,6,201826
15,10,0,0,0,372,0,0,0,372,349,721,3,5,201826
15,11,0,0,0,502,0,0,0,502,498,1000,3,5,201826
15,12,0,0,0,635,0,0,0,635,597,1232,6,6,201826
15,13,0,0,0,226,0,0,0,226,226,452,3,4,201826
15,14,0,0,0,302,0,0,0,302,213,515,2,6,201826
15,15,0,0,0,462,0,0,0,462,370,832,3,5,201826
15,16,0,0,0,610,0,0,0,610,595,1205,4,6,201826
15,17,0,0,0,366,0,0,0,366,365,731,3,5,201826
15,18,0,0,0,500,0,0,0,500,592,1092,4,6,201826
15,19,0,0,0,839,0,0,0,839,743,1582,5,5.5,201826
15,20,0,0,0,311,0,0,0,311,255,566,3,6,201826
15,21,0,0,0,154,0,0,0,154,132,286,2,6,201826
15,22,0,0,0,860,0,0,0,860,763,1623,6,5.5,201826
15,23,0,0,0,311,0,0,0,311,268,579,3,6,201826
15,24,0,0,0,336,0,0,0,336,268,604,2,6,201826
15,25,0,0,0,387,0,0,0,387,392,779,3,6,201826
15,26,0,0,0,318,0,0,0,318,319,637,2,3,201826
15,27,0,0,0,669,0,0,0,669,575,1244,5,6,201826
15,28,0,0,0,484,0,0,0,484,435,919,4,6,201826
15,29,0,0,0,472,0,0,0,472,419,891,3,5,201826
15,30,0,0,0,483,0,0,0,483,425,908,6,5.5,201826
15,31,0,0,0,449,0,0,0,449,303,752,3,5,201826
15,32,0,0,0,355,0,0,0,355,329,684,4,6,201826
15,33,0,0,0,477,0,0,0,477,385,862,4,6,201826
15,34,0,0,0,484,0,0,0,484,504,988,3,6,201826
15,35,0,0,0,408,0,0,0,408,435,843,4,6,201826
15,36,0,0,0,272,0,0,0,272,251,523,4,6,201826
15,37,0,0,0,493,0,0,0,493,447,940,4,6,201826
15,38,0,0,0,437,0,0,0,437,422,859,2,6,201826
15,39,0,0,0,295,0,0,0,295,254,549,2,6,201826
15,40,0,0,0,427,0,0,0,427,440,867,6,6,201826
15,41,0,0,0,713,0,0,0,713,648,1361,8,6,201826
16,1,0,0,0,127,0,0,0,127,151,278,2,6,201826
16,2,0,0,0,64,0,0,0,64,74,138,2,6,201826
16,3,0,0,0,126,0,0,0,126,161,287,2,6,201826
16,4,0,0,0,147,0,0,0,147,132,279,4,6,201826
16,5,0,0,0,165,0,0,0,165,174,339,5,6,201826
16,6,0,0,0,125,0,0,0,125,133,258,4,6,201826
16,7,0,0,0,160,0,0,0,160,132,292,4,6,201826
16,8,0,0,0,583,0,0,0,583,513,1096,5,6,201826
16,9,0,0,0,245,0,0,0,245,236,481,5,6,201826
16,10,0,0,0,310,0,0,0,310,288,598,4,6,201826
16,11,0,0,0,129,0,0,0,129,144,273,5,6,201826
16,12,0,0,0,154,0,0,0,154,137,291,2,6,201826
17,1,0,0,0,406,0,0,0,406,414,820,3,3,201826
17,2,0,0,0,379,0,0,0,379,356,735,4,6,201826
17,3,0,0,0,430,0,0,0,430,405,835,3,5,201826
17,4,0,0,0,436,0,0,0,436,439,875,5,5.5,201826
17,5,0,0,0,155,0,0,0,155,156,311,2,6,201826
18,1,0,0,0,69,0,0,0,69,69,138,2,6,201826
18,2,0,0,0,387,0,0,0,387,348,735,6,6,201826
18,3,0,0,0,129,0,0,0,129,121,250,4,6,201826
19,1,0,0,0,456,0,0,0,456,398,854,4,5.5,201826
19,2,0,0,0,502,0,0,0,502,477,979,5,6,201826
19,3,0,0,0,475,0,0,0,475,443,918,4,6,201826
19,4,0,0,0,231,0,0,0,231,198,429,2,6,201826
19,5,0,0,0,594,0,0,0,594,536,1130,6,6,201826
19,6,0,0,0,282,0,0,0,282,299,581,2,6,201826
19,7,0,0,0,161,0,0,0,161,125,286,4,6,201826
19,8,0,0,0,89,0,0,0,89,99,188,2,6,201826
19,9,0,0,0,75,0,0,0,75,76,151,2,6,201826
19,10,0,0,0,415,0,0,0,415,403,818,2,3,201826
19,11,0,0,0,755,0,0,0,755,684,1439,7,6,201826
19,12,0,0,0,169,0,0,0,169,189,358,4,6,201826
20,1,0,0,0,160,0,0,0,160,125,285,3,7,201826
20,2,0,0,0,26,0,0,0,26,17,43,2,6,201826
20,3,0,0,0,131,0,0,0,131,149,280,2,6,201826
20,4,0,0,0,78,0,0,0,78,56,134,2,6,201826
20,5,0,0,0,143,0,0,0,143,127,270,2,6,201826
20,6,0,0,0,59,0,0,0,59,53,112,2,6,201826
20,7,0,0,0,166,0,0,0,166,150,316,6,6,201826
20,8,0,0,0,813,0,0,0,813,744,1557,6,6,201826
20,9,0,0,0,211,0,0,0,211,175,386,4,6,201826
20,10,0,0,0,72,0,0,0,72,79,151,3,7,201826
21,1,0,0,0,269,0,0,0,269,245,514,4,6,201826
21,2,0,0,0,92,0,0,0,92,68,160,2,6,201826
21,3,0,0,0,267,0,0,0,267,348,615,4,6,201826
21,4,0,0,0,67,0,0,0,67,56,123,2,6,201826
21,5,0,0,0,263,0,0,0,263,310,573,4,6,201826
21,6,0,0,0,513,0,0,0,513,440,953,2,5,201826
21,7,0,0,0,325,0,0,0,325,247,572,4,6,201826
21,8,0,0,0,113,0,0,0,113,89,202,2,6,201826
21,9,0,0,0,476,0,0,0,476,642,1118,4,6,201826
21,10,0,0,0,417,0,0,0,417,413,830,2,6,201826
21,11,0,0,0,135,0,0,0,135,120,255,2,6,201826
21,12,0,0,0,999,0,0,0,999,956,1955,4,3.666666667,201826
21,13,0,0,0,243,0,0,0,243,238,481,4,6,201826
21,14,0,0,0,144,0,0,0,144,184,328,4,6,201826
21,15,0,0,0,368,0,0,0,368,359,727,2,6,201826
22,1,0,0,0,53,0,0,0,53,50,103,2,6,201826
22,2,0,0,0,295,0,0,0,295,298,593,2,6,201826
22,3,0,0,0,591,0,0,0,591,726,1317,4,5,201826
22,4,0,0,0,677,0,0,0,677,642,1319,6,4.5,201826
22,5,0,0,0,193,0,0,0,193,208,401,4,6,201826
23,1,0,0,0,471,0,0,0,471,397,868,3,6,201826
23,2,0,0,0,232,0,0,0,232,233,465,1,3,201826
23,3,0,0,0,511,0,0,0,511,569,1080,2,6,201826
23,4,0,0,0,430,0,0,0,430,426,856,2,6,201826
24,1,0,0,0,99,0,0,0,99,67,166,2,6,201826
24,2,0,0,0,181,0,0,0,181,147,328,2,6,201826
24,3,0,0,0,99,0,0,0,99,87,186,2,6,201826
24,4,0,0,0,157,0,0,0,157,174,331,2,6,201826
24,5,0,0,0,508,0,0,0,508,470,978,6,4.5,201826
24,6,0,0,0,562,0,0,0,562,488,1050,4,5,201826
24,7,0,0,0,102,0,0,0,102,61,163,2,6,201826
25,1,0,0,0,207,0,0,0,207,189,396,5,6,201826
25,2,0,0,0,323,0,0,0,323,288,611,3,5,201826
25,3,0,0,0,187,0,0,0,187,165,352,5,6,201826
25,4,0,0,0,139,0,0,0,139,117,256,3,6,201826
25,5,0,0,0,454,0,0,0,454,412,866,5,6,201826
25,6,0,0,0,284,0,0,0,284,293,577,6,6,201826
25,7,0,0,0,411,0,0,0,411,379,790,4,6,201826
26,1,0,0,0,201,0,0,0,201,219,420,5,6,201826
26,2,0,0,0,336,0,0,0,336,325,661,5,6,201826
26,3,0,0,0,650,0,0,0,650,671,1321,6,5.5,201826
26,4,0,0,0,165,0,0,0,165,172,337,3,6,201826
26,5,0,0,0,137,0,0,0,137,79,216,1,5,201826
26,6,0,0,0,479,0,0,0,479,502,981,3,6,201826
26,7,0,0,0,256,0,0,0,256,248,504,4,6,201826
27,1,0,0,0,281,0,0,0,281,242,523,4,6,201826
27,2,0,0,0,344,0,0,0,344,289,633,4,6,201826
27,3,0,0,0,372,0,0,0,372,361,733,4,6,201826
27,4,0,0,0,624,0,0,0,624,423,1047,3,2.5,201826
27,5,0,0,0,131,0,0,0,131,91,222,2,6,201826
27,6,0,0,0,433,0,0,0,433,431,864,2,6,201826
28,1,0,0,0,303,0,0,0,303,280,583,10,6,201826
28,2,0,0,0,322,0,0,0,322,303,625,6,5.666666667,201826
28,3,0,0,0,86,0,0,0,86,70,156,3,6,201826
28,4,0,0,0,336,0,0,0,336,271,607,11,6,201826
28,5,0,0,0,315,0,0,0,315,281,596,2,3,201826
28,6,0,0,0,111,0,0,0,111,111,222,3,6,201826
28,7,0,0,0,395,0,0,0,395,367,762,6,6,201826
28,8,0,0,0,243,0,0,0,243,260,503,6,6,201826
28,9,0,0,0,159,0,0,0,159,172,331,6,6,201826
29,1,0,0,0,392,0,0,0,392,283,675,4,6,201826
29,2,0,0,0,517,0,0,0,517,534,1051,6,4.5,201826
29,3,0,0,0,216,0,0,0,216,210,426,3,6,201826
30,1,0,0,0,60,0,0,0,60,68,128,2,6,201826
30,2,0,0,0,61,0,0,0,61,61,122,2,6,201826
30,3,0,0,0,178,0,0,0,178,211,389,4,6,201826
30,4,0,0,0,262,0,0,0,262,258,520,4,6,201826
30,5,0,0,0,260,0,0,0,260,193,453,2,6,201826
30,6,0,0,0,107,0,0,0,107,82,189,2,6,201826
30,7,0,0,0,152,0,0,0,152,142,294,2,6,201826
30,8,0,0,0,195,0,0,0,195,189,384,4,6,201826
30,9,0,0,0,169,0,0,0,169,169,338,4,6,201826
30,10,0,0,0,467,0,0,0,467,382,849,4,6,201826
30,11,0,0,0,380,0,0,0,380,308,688,2,6,201826
30,12,0,0,0,543,0,0,0,543,425,968,8,6,201826
30,13,0,0,0,129,0,0,0,129,140,269,4,6,201826
30,14,0,0,0,149,0,0,0,149,194,343,4,6,201826
30,15,0,0,0,361,0,0,0,361,344,705,4,6,201826
30,16,0,0,0,274,0,0,0,274,231,505,2,5,201826
30,17,0,0,0,159,0,0,0,159,157,316,4,6,201826
30,18,0,0,0,39,0,0,0,39,30,69,2,6,201826
30,19,0,0,0,122,0,0,0,122,124,246,6,5.666666667,201826
30,20,0,0,0,142,0,0,0,142,112,254,4,5.5,201826
31,1,0,0,0,132,0,0,0,132,127,259,4,6,201826
31,2,0,0,0,57,0,0,0,57,50,107,2,6,201826
31,3,0,0,0,964,0,0,0,964,843,1807,8,4.5,201826
31,4,0,0,0,350,0,0,0,350,293,643,2,6,201826
31,5,0,0,0,104,0,0,0,104,103,207,2,6,201826
32,1,0,0,0,149,0,0,0,149,149,298,2,6,201826
32,2,0,0,0,54,0,0,0,54,54,108,2,6,201826
32,3,0,0,0,227,0,0,0,227,171,398,4,6,201826
32,4,0,0,0,172,0,0,0,172,210,382,3,3.5,201826
1,1,0,0,0,175,0,0,0,175,156,331,6,6,201827
1,2,0,0,0,471,0,0,0,471,514,985,7,4.75,201827
1,3,0,0,0,534,0,0,0,534,572,1106,6,6,201827
2,1,0,0,0,215,0,0,0,215,238,453,6,6,201827
2,2,0,0,0,283,0,0,0,283,322,605,4,6,201827
2,3,0,0,0,339,0,0,0,339,327,666,4,4,201827
2,4,0,0,0,144,0,0,0,144,106,250,4,6,201827
2,5,0,0,0,598,0,0,0,598,452,1050,6,6,201827
2,6,0,0,0,282,0,0,0,282,286,568,4,6,201827
2,7,0,0,0,258,0,0,0,258,228,486,6,6,201827
2,8,0,0,0,445,0,0,0,445,462,907,4,6,201827
3,1,0,0,0,327,0,0,0,327,335,662,7,6,201827
3,2,0,0,0,213,0,0,0,213,194,407,4,5.5,201827
4,1,0,0,0,468,0,0,0,468,379,847,3,6,201827
4,2,0,0,0,245,0,0,0,245,253,498,2,6,201827
5,1,0,0,0,222,0,0,0,222,265,487,5,6,201827
5,2,0,0,0,67,0,0,0,67,79,146,2,6,201827
5,3,0,0,0,301,0,0,0,301,293,594,5,6,201827
5,4,0,0,0,447,0,0,0,447,503,950,5,6,201827
5,5,0,0,0,461,0,0,0,461,412,873,6,6,201827
5,6,0,0,0,228,0,0,0,228,205,433,3,6,201827
5,7,0,0,0,292,0,0,0,292,243,535,3,3,201827
6,1,0,0,0,294,0,0,0,294,308,602,7,4.8,201827
6,2,0,0,0,203,0,0,0,203,199,402,4,6,201827
7,1,0,0,0,68,0,0,0,68,66,134,2,6,201827
7,2,0,0,0,50,0,0,0,50,62,112,2,6,201827
7,3,0,0,0,218,0,0,0,218,151,369,2,6,201827
7,4,0,0,0,230,0,0,0,230,129,359,4,6,201827
7,5,0,0,0,267,0,0,0,267,257,524,4,6,201827
7,6,0,0,0,274,0,0,0,274,222,496,2,3,201827
7,7,0,0,0,238,0,0,0,238,223,461,4,6,201827
7,8,0,0,0,244,0,0,0,244,246,490,2,5,201827
7,9,0,0,0,607,0,0,0,607,532,1139,4,6,201827
7,10,0,0,0,40,0,0,0,40,38,78,4,6,201827
7,11,0,0,0,34,0,0,0,34,15,49,2,6,201827
7,12,0,0,0,508,0,0,0,508,357,865,5,6,201827
7,13,0,0,0,46,0,0,0,46,11,57,3,6,201827
8,1,0,0,0,291,0,0,0,291,286,577,2,6,201827
8,2,0,0,0,238,0,0,0,238,282,520,5,5.5,201827
8,3,0,0,0,432,0,0,0,432,563,995,4,6,201827
8,4,0,0,0,335,0,0,0,335,321,656,4,5.5,201827
8,5,0,0,0,182,0,0,0,182,149,331,3,6,201827
8,6,0,0,0,505,0,0,0,505,408,913,4,4,201827
8,7,0,0,0,147,0,0,0,147,132,279,3,6,201827
8,8,0,0,0,299,0,0,0,299,300,599,4,4,201827
8,9,0,0,0,85,0,0,0,85,78,163,3,6,201827
9,1,0,0,0,326,0,0,0,326,348,674,2,6,201827
9,2,0,0,0,1335,0,0,0,1335,1274,2609,8,6,201827
9,3,0,0,0,787,0,0,0,787,670,1457,4,6,201827
9,4,0,0,0,662,0,0,0,662,659,1321,3,6,201827
9,5,0,0,0,564,0,0,0,564,504,1068,3,6,201827
9,6,0,0,0,458,0,0,0,458,463,921,3,6,201827
9,7,0,0,0,567,0,0,0,567,538,1105,3,6,201827
9,8,0,0,0,423,0,0,0,423,325,748,2,6,201827
9,9,0,0,0,387,0,0,0,387,371,758,2,5,201827
9,10,0,0,0,444,0,0,0,444,482,926,3,6,201827
9,11,0,0,0,743,0,0,0,743,782,1525,4,5,201827
9,12,0,0,0,921,0,0,0,921,849,1770,5,5,201827
9,13,0,0,0,575,0,0,0,575,529,1104,3,6,201827
9,14,0,0,0,442,0,0,0,442,369,811,3,5,201827
9,15,0,0,0,1550,0,0,0,1550,1466,3016,8,4,201827
9,16,0,0,0,1134,0,0,0,1134,1388,2522,4,5,201827
9,17,0,0,0,517,0,0,0,517,513,1030,3,6,201827
9,18,0,0,0,802,0,0,0,802,843,1645,6,5,201827
9,19,0,0,0,451,0,0,0,451,443,894,3,6,201827
9,20,0,0,0,95,0,0,0,95,64,159,2,5,201827
9,21,0,0,0,267,0,0,0,267,302,569,2,6,201827
9,22,0,0,0,407,0,0,0,407,363,770,3,5,201827
9,23,0,0,0,630,0,0,0,630,545,1175,3,5,201827
9,24,0,0,0,1066,0,0,0,1066,1106,2172,6,6,201827
10,1,0,0,0,209,0,0,0,209,220,429,4,6,201827
10,2,0,0,0,249,0,0,0,249,269,518,2,6,201827
10,3,0,0,0,128,0,0,0,128,102,230,4,6,201827
10,4,0,0,0,548,0,0,0,548,544,1092,4,4,201827
11,1,0,0,0,216,0,0,0,216,224,440,4,6,201827
11,2,0,0,0,243,0,0,0,243,234,477,6,6,201827
11,3,0,0,0,326,0,0,0,326,309,635,2,6,201827
11,4,0,0,0,193,0,0,0,193,218,411,5,4.333333333,201827
11,5,0,0,0,522,0,0,0,522,548,1070,4,6,201827
11,6,0,0,0,354,0,0,0,354,346,700,4,6,201827
11,7,0,0,0,160,0,0,0,160,147,307,5,6,201827
11,8,0,0,0,320,0,0,0,320,372,692,7,6,201827
11,9,0,0,0,514,0,0,0,514,480,994,4,6,201827
11,10,0,0,0,247,0,0,0,247,275,522,6,6,201827
11,11,0,0,0,233,0,0,0,233,234,467,4,5,201827
11,12,0,0,0,455,0,0,0,455,564,1019,4,6,201827
11,13,0,0,0,143,0,0,0,143,152,295,5,6,201827
11,14,0,0,0,186,0,0,0,186,190,376,4,6,201827
11,15,0,0,0,213,0,0,0,213,275,488,3,5,201827
12,1,0,0,0,138,0,0,0,138,108,246,2,6,201827
12,2,0,0,0,381,0,0,0,381,313,694,4,6,201827
12,3,0,0,0,147,0,0,0,147,150,297,2,6,201827
12,4,0,0,0,438,0,0,0,438,486,924,4,5.5,201827
12,5,0,0,0,90,0,0,0,90,42,132,2,6,201827
12,6,0,0,0,65,0,0,0,65,65,130,2,6,201827
12,7,0,0,0,385,0,0,0,385,370,755,3,6,201827
12,8,0,0,0,120,0,0,0,120,89,209,2,6,201827
12,9,0,0,0,343,0,0,0,343,297,640,4,6,201827
13,1,0,0,0,112,0,0,0,112,96,208,3,5,201827
13,2,0,0,0,168,0,0,0,168,106,274,2,6,201827
13,3,0,0,0,169,0,0,0,169,171,340,2,5,201827
13,4,0,0,0,262,0,0,0,262,270,532,4,5.5,201827
13,5,0,0,0,331,0,0,0,331,330,661,6,6,201827
13,6,0,0,0,911,0,0,0,911,810,1721,5,6,201827
13,7,0,0,0,392,0,0,0,392,347,739,5,6,201827
14,1,0,0,0,79,0,0,0,79,58,137,3,6,201827
14,2,0,0,0,120,0,0,0,120,121,241,4,6,201827
14,3,0,0,0,87,0,0,0,87,41,128,4,6,201827
14,4,0,0,0,314,0,0,0,314,292,606,4,5,201827
14,5,0,0,0,279,0,0,0,279,238,517,5,6,201827
14,6,0,0,0,390,0,0,0,390,458,848,3,5,201827
14,7,0,0,0,168,0,0,0,168,140,308,3,5,201827
14,8,0,0,0,1080,0,0,0,1080,1088,2168,8,4.8,201827
14,9,0,0,0,232,0,0,0,232,153,385,5,7,201827
14,10,0,0,0,610,0,0,0,610,505,1115,4,6,201827
14,11,0,0,0,363,0,0,0,363,328,691,2,6,201827
14,12,0,0,0,265,0,0,0,265,242,507,5,6,201827
14,13,0,0,0,287,0,0,0,287,318,605,4,6,201827
14,14,0,0,0,339,0,0,0,339,339,678,3,5,201827
14,15,0,0,0,176,0,0,0,176,184,360,6,6,201827
14,16,0,0,0,322,0,0,0,322,314,636,2,5,201827
14,17,0,0,0,102,0,0,0,102,64,166,2,6,201827
14,18,0,0,0,219,0,0,0,219,171,390,4,6,201827
14,19,0,0,0,207,0,0,0,207,187,394,2,6,201827
14,20,0,0,0,71,0,0,0,71,60,131,4,5.5,201827
15,1,0,0,0,150,0,0,0,150,127,277,3,6,201827
15,2,0,0,0,410,0,0,0,410,431,841,4,6,201827
15,3,0,0,0,487,0,0,0,487,447,934,5,6,201827
15,4,0,0,0,515,0,0,0,515,487,1002,2,6,201827
15,5,0,0,0,364,0,0,0,364,326,690,4,6,201827
15,6,0,0,0,579,0,0,0,579,570,1149,4,6,201827
15,7,0,0,0,680,0,0,0,680,599,1279,3,6,201827
15,8,0,0,0,217,0,0,0,217,221,438,2,6,201827
15,9,0,0,0,163,0,0,0,163,164,327,7,6,201827
15,10,0,0,0,380,0,0,0,380,391,771,3,6,201827
15,11,0,0,0,602,0,0,0,602,482,1084,3,6,201827
15,12,0,0,0,640,0,0,0,640,601,1241,6,6,201827
15,13,0,0,0,471,0,0,0,471,437,908,3,6,201827
15,14,0,0,0,324,0,0,0,324,315,639,2,6,201827
15,15,0,0,0,548,0,0,0,548,498,1046,3,6,201827
15,16,0,0,0,621,0,0,0,621,579,1200,4,6,201827
15,17,0,0,0,355,0,0,0,355,415,770,3,6,201827
15,18,0,0,0,509,0,0,0,509,556,1065,4,6,201827
15,19,0,0,0,863,0,0,0,863,911,1774,5,6,201827
15,20,0,0,0,343,0,0,0,343,307,650,3,6,201827
15,21,0,0,0,153,0,0,0,153,163,316,3,7,201827
15,22,0,0,0,1050,0,0,0,1050,989,2039,6,6,201827
15,23,0,0,0,346,0,0,0,346,291,637,3,6,201827
15,24,0,0,0,343,0,0,0,343,383,726,2,6,201827
15,25,0,0,0,516,0,0,0,516,501,1017,3,6,201827
15,26,0,0,0,357,0,0,0,357,325,682,2,2.5,201827
15,27,0,0,0,655,0,0,0,655,662,1317,5,6,201827
15,28,0,0,0,484,0,0,0,484,434,918,4,6,201827
15,29,0,0,0,662,0,0,0,662,585,1247,3,6,201827
15,30,0,0,0,434,0,0,0,434,566,1000,6,6,201827
15,31,0,0,0,538,0,0,0,538,488,1026,3,6,201827
15,32,0,0,0,469,0,0,0,469,363,832,4,6,201827
15,33,0,0,0,496,0,0,0,496,554,1050,4,6,201827
15,34,0,0,0,550,0,0,0,550,484,1034,3,6,201827
15,35,0,0,0,441,0,0,0,441,428,869,4,6,201827
15,36,0,0,0,266,0,0,0,266,259,525,4,6,201827
15,37,0,0,0,515,0,0,0,515,564,1079,4,6,201827
15,38,0,0,0,424,0,0,0,424,469,893,2,6,201827
15,39,0,0,0,292,0,0,0,292,284,576,2,6,201827
15,40,0,0,0,430,0,0,0,430,449,879,6,6,201827
15,41,0,0,0,743,0,0,0,743,716,1459,8,6,201827
16,1,0,0,0,124,0,0,0,124,119,243,2,5,201827
16,2,0,0,0,77,0,0,0,77,86,163,2,6,201827
16,3,0,0,0,149,0,0,0,149,134,283,2,6,201827
16,4,0,0,0,175,0,0,0,175,149,324,4,6,201827
16,5,0,0,0,168,0,0,0,168,176,344,5,5.5,201827
16,6,0,0,0,146,0,0,0,146,141,287,4,6,201827
16,7,0,0,0,181,0,0,0,181,196,377,4,6,201827
16,8,0,0,0,583,0,0,0,583,661,1244,5,5.5,201827
16,9,0,0,0,277,0,0,0,277,240,517,5,5.5,201827
16,10,0,0,0,351,0,0,0,351,330,681,4,6,201827
16,11,0,0,0,142,0,0,0,142,146,288,5,6,201827
16,12,0,0,0,165,0,0,0,165,144,309,2,6,201827
17,1,0,0,0,417,0,0,0,417,576,993,3,3.5,201827
17,2,0,0,0,380,0,0,0,380,400,780,4,6,201827
17,3,0,0,0,529,0,0,0,529,492,1021,3,6,201827
17,4,0,0,0,515,0,0,0,515,489,1004,5,6,201827
17,5,0,0,0,153,0,0,0,153,172,325,2,6,201827
18,1,0,0,0,58,0,0,0,58,106,164,2,6,201827
18,2,0,0,0,388,0,0,0,388,392,780,6,6,201827
18,3,0,0,0,131,0,0,0,131,147,278,4,6,201827
19,1,0,0,0,559,0,0,0,559,446,1005,4,6,201827
19,2,0,0,0,537,0,0,0,537,504,1041,5,5.5,201827
19,3,0,0,0,549,0,0,0,549,462,1011,4,6,201827
19,4,0,0,0,244,0,0,0,244,240,484,2,5,201827
19,5,0,0,0,562,0,0,0,562,583,1145,6,6,201827
19,6,0,0,0,306,0,0,0,306,266,572,2,5,201827
19,7,0,0,0,116,0,0,0,116,147,263,4,6,201827
19,8,0,0,0,72,0,0,0,72,81,153,2,5,201827
19,9,0,0,0,75,0,0,0,75,80,155,2,6,201827
19,10,0,0,0,377,0,0,0,377,385,762,2,2.5,201827
19,11,0,0,0,749,0,0,0,749,713,1462,7,5,201827
19,12,0,0,0,137,0,0,0,137,122,259,2,3,201827
20,1,0,0,0,164,0,0,0,164,156,320,2,5,201827
20,2,0,0,0,43,0,0,0,43,16,59,2,6,201827
20,3,0,0,0,132,0,0,0,132,126,258,2,6,201827
20,4,0,0,0,78,0,0,0,78,65,143,2,6,201827
20,5,0,0,0,156,0,0,0,156,133,289,2,6,201827
20,6,0,0,0,73,0,0,0,73,61,134,2,6,201827
20,7,0,0,0,195,0,0,0,195,183,378,6,6,201827
20,8,0,0,0,1057,0,0,0,1057,912,1969,5,6,201827
20,9,0,0,0,211,0,0,0,211,219,430,4,6,201827
20,10,0,0,0,73,0,0,0,73,65,138,2,6,201827
21,1,0,0,0,275,0,0,0,275,275,550,4,6,201827
21,2,0,0,0,106,0,0,0,106,121,227,2,6,201827
21,3,0,0,0,328,0,0,0,328,199,527,4,6,201827
21,4,0,0,0,106,0,0,0,106,82,188,2,6,201827
21,5,0,0,0,293,0,0,0,293,259,552,4,6,201827
21,6,0,0,0,554,0,0,0,554,578,1132,2,6,201827
21,7,0,0,0,308,0,0,0,308,353,661,4,6,201827
21,8,0,0,0,134,0,0,0,134,118,252,2,6,201827
21,9,0,0,0,504,0,0,0,504,468,972,4,5.5,201827
21,10,0,0,0,431,0,0,0,431,413,844,2,5,201827
21,11,0,0,0,140,0,0,0,140,118,258,2,6,201827
21,12,0,0,0,1122,0,0,0,1122,1031,2153,5,4,201827
21,13,0,0,0,285,0,0,0,285,231,516,4,6,201827
21,14,0,0,0,165,0,0,0,165,156,321,4,6,201827
21,15,0,0,0,358,0,0,0,358,331,689,2,5,201827
22,1,0,0,0,62,0,0,0,62,59,121,2,6,201827
22,2,0,0,0,346,0,0,0,346,347,693,2,6,201827
22,3,0,0,0,705,0,0,0,705,684,1389,4,6,201827
22,4,0,0,0,668,0,0,0,668,770,1438,6,4.5,201827
22,5,0,0,0,195,0,0,0,195,189,384,4,6,201827
23,1,0,0,0,388,0,0,0,388,450,838,3,6,201827
23,2,0,0,0,245,0,0,0,245,220,465,1,3,201827
23,3,0,0,0,441,0,0,0,441,451,892,2,6,201827
23,4,0,0,0,455,0,0,0,455,444,899,2,6,201827
24,1,0,0,0,114,0,0,0,114,109,223,2,6,201827
24,2,0,0,0,178,0,0,0,178,215,393,2,6,201827
24,3,0,0,0,106,0,0,0,106,95,201,2,6,201827
24,4,0,0,0,169,0,0,0,169,147,316,2,6,201827
24,5,0,0,0,494,0,0,0,494,541,1035,6,4.5,201827
24,6,0,0,0,779,0,0,0,779,700,1479,4,6,201827
24,7,0,0,0,94,0,0,0,94,88,182,2,6,201827
25,1,0,0,0,212,0,0,0,212,230,442,5,6,201827
25,2,0,0,0,376,0,0,0,376,420,796,3,6,201827
25,3,0,0,0,169,0,0,0,169,225,394,5,6,201827
25,4,0,0,0,127,0,0,0,127,139,266,3,6,201827
25,5,0,0,0,393,0,0,0,393,434,827,5,6,201827
25,6,0,0,0,280,0,0,0,280,299,579,6,6,201827
25,7,0,0,0,418,0,0,0,418,432,850,4,6,201827
26,1,0,0,0,227,0,0,0,227,234,461,5,6,201827
26,2,0,0,0,311,0,0,0,311,259,570,5,5.5,201827
26,3,0,0,0,560,0,0,0,560,719,1279,6,5,201827
26,4,0,0,0,173,0,0,0,173,167,340,3,6,201827
26,5,0,0,0,281,0,0,0,281,89,370,1,6,201827
26,6,0,0,0,424,0,0,0,424,408,832,3,5,201827
26,7,0,0,0,244,0,0,0,244,235,479,4,6,201827
27,1,0,0,0,281,0,0,0,281,216,497,4,6,201827
27,2,0,0,0,410,0,0,0,410,340,750,4,6,201827
27,3,0,0,0,472,0,0,0,472,372,844,4,6,201827
27,4,0,0,0,774,0,0,0,774,781,1555,3,3,201827
27,5,0,0,0,121,0,0,0,121,127,248,2,6,201827
27,6,0,0,0,412,0,0,0,412,397,809,2,5,201827
28,1,0,0,0,348,0,0,0,348,316,664,10,6,201827
28,2,0,0,0,350,0,0,0,350,376,726,6,6,201827
28,3,0,0,0,91,0,0,0,91,94,185,3,6,201827
28,4,0,0,0,389,0,0,0,389,364,753,11,6,201827
28,5,0,0,0,335,0,0,0,335,304,639,2,3,201827
28,6,0,0,0,110,0,0,0,110,115,225,3,6,201827
28,7,0,0,0,437,0,0,0,437,494,931,6,6,201827
28,8,0,0,0,281,0,0,0,281,264,545,6,6,201827
28,9,0,0,0,150,0,0,0,150,157,307,6,6,201827
29,1,0,0,0,361,0,0,0,361,369,730,4,6,201827
29,2,0,0,0,548,0,0,0,548,530,1078,6,4.5,201827
29,3,0,0,0,233,0,0,0,233,222,455,3,6,201827
30,1,0,0,0,71,0,0,0,71,68,139,2,6,201827
30,2,0,0,0,85,0,0,0,85,75,160,2,6,201827
30,3,0,0,0,213,0,0,0,213,217,430,4,6,201827
30,4,0,0,0,214,0,0,0,214,234,448,4,5,201827
30,5,0,0,0,252,0,0,0,252,244,496,2,5,201827
30,6,0,0,0,106,0,0,0,106,133,239,2,5,201827
30,7,0,0,0,160,0,0,0,160,175,335,2,5,201827
30,8,0,0,0,216,0,0,0,216,191,407,4,6,201827
30,9,0,0,0,170,0,0,0,170,172,342,4,6,201827
30,10,0,0,0,464,0,0,0,464,450,914,4,6,201827
30,11,0,0,0,337,0,0,0,337,327,664,2,6,201827
30,12,0,0,0,624,0,0,0,624,546,1170,8,6,201827
30,13,0,0,0,100,0,0,0,100,153,253,4,6,201827
30,14,0,0,0,160,0,0,0,160,173,333,4,6,201827
30,15,0,0,0,327,0,0,0,327,301,628,4,5.5,201827
30,16,0,0,0,335,0,0,0,335,294,629,2,6,201827
30,17,0,0,0,142,0,0,0,142,168,310,4,6,201827
30,18,0,0,0,42,0,0,0,42,36,78,2,6,201827
30,19,0,0,0,180,0,0,0,180,164,344,6,6,201827
30,20,0,0,0,174,0,0,0,174,232,406,4,6,201827
31,1,0,0,0,196,0,0,0,196,111,307,4,6,201827
31,2,0,0,0,65,0,0,0,65,58,123,2,6,201827
31,3,0,0,0,945,0,0,0,945,876,1821,8,4.5,201827
31,4,0,0,0,444,0,0,0,444,346,790,2,6,201827
31,5,0,0,0,156,0,0,0,156,133,289,2,6,201827
32,1,0,0,0,161,0,0,0,161,147,308,2,6,201827
32,2,0,0,0,57,0,0,0,57,48,105,2,6,201827
32,3,0,0,0,174,0,0,0,174,221,395,4,5.5,201827
32,4,0,0,0,233,0,0,0,233,194,427,2,3,201827
1,1,0,0,0,95,0,0,0,95,214,309,12,6,201828
1,2,0,0,0,452,0,0,0,452,532,984,13,4.75,201828
1,3,0,0,0,476,0,0,0,476,571,1047,12,6,201828
2,1,0,0,0,227,0,0,0,227,235,462,12,6,201828
2,2,0,0,0,314,0,0,0,314,296,610,8,6,201828
2,3,0,0,0,346,0,0,0,346,440,786,8,4,201828
2,4,0,0,0,137,0,0,0,137,189,326,8,6,201828
2,5,0,0,0,532,0,0,0,532,719,1251,12,6,201828
2,6,0,0,0,268,0,0,0,268,299,567,8,6,201828
2,7,0,0,0,274,0,0,0,274,299,573,12,6,201828
2,8,0,0,0,380,0,0,0,380,517,897,8,6,201828
3,1,0,0,0,345,0,0,0,345,410,755,14,6,201828
3,2,0,0,0,234,0,0,0,234,273,507,8,6,201828
4,1,0,0,0,458,0,0,0,458,478,936,6,6,201828
4,2,0,0,0,300,0,0,0,300,275,575,4,6,201828
5,1,0,0,0,230,0,0,0,230,307,537,10,6,201828
5,2,0,0,0,73,0,0,0,73,103,176,4,6,201828
5,3,0,0,0,234,0,0,0,234,290,524,10,6,201828
5,4,0,0,0,494,0,0,0,494,512,1006,10,6,201828
5,5,0,0,0,492,0,0,0,492,574,1066,12,6,201828
5,6,0,0,0,215,0,0,0,215,247,462,6,6,201828
5,7,0,0,0,285,0,0,0,285,358,643,6,3,201828
6,1,0,0,0,336,0,0,0,336,340,676,14,4.8,201828
6,2,0,0,0,243,0,0,0,243,296,539,8,6,201828
7,1,0,0,0,72,0,0,0,72,86,158,4,6,201828
7,2,0,0,0,57,0,0,0,57,73,130,4,6,201828
7,3,0,0,0,172,0,0,0,172,187,359,4,6,201828
7,4,0,0,0,145,0,0,0,145,242,387,8,6,201828
7,5,0,0,0,277,0,0,0,277,294,571,8,6,201828
7,6,0,0,0,323,0,0,0,323,308,631,4,3,201828
7,7,0,0,0,275,0,0,0,275,259,534,8,6,201828
7,8,0,0,0,251,0,0,0,251,292,543,5,7,201828
7,9,0,0,0,628,0,0,0,628,720,1348,8,6,201828
7,10,0,0,0,32,0,0,0,32,30,62,8,6,201828
7,11,0,0,0,19,0,0,0,19,56,75,4,6,201828
7,12,0,0,0,455,0,0,0,455,542,997,10,6,201828
7,13,0,0,0,43,0,0,0,43,52,95,6,6,201828
8,1,0,0,0,262,0,0,0,262,383,645,4,6,201828
8,2,0,0,0,236,0,0,0,236,391,627,10,6,201828
8,3,0,0,0,273,0,0,0,273,436,709,8,6,201828
8,4,0,0,0,301,0,0,0,301,417,718,8,6,201828
8,5,0,0,0,177,0,0,0,177,192,369,6,6,201828
8,6,0,0,0,514,0,0,0,514,584,1098,8,4,201828
8,7,0,0,0,110,0,0,0,110,157,267,6,6,201828
8,8,0,0,0,341,0,0,0,341,354,695,8,5,201828
8,9,0,0,0,112,0,0,0,112,90,202,6,6,201828
9,1,0,0,0,353,0,0,0,353,346,699,4,6,201828
9,2,0,0,0,1252,0,0,0,1252,1839,3091,16,6,201828
9,3,0,0,0,806,0,0,0,806,890,1696,8,6,201828
9,4,0,0,0,549,0,0,0,549,750,1299,6,6,201828
9,5,0,0,0,576,0,0,0,576,582,1158,6,6,201828
9,6,0,0,0,452,0,0,0,452,492,944,6,6,201828
9,7,0,0,0,615,0,0,0,615,569,1184,6,6,201828
9,8,0,0,0,387,0,0,0,387,501,888,4,6,201828
9,9,0,0,0,421,0,0,0,421,508,929,4,6,201828
9,10,0,0,0,461,0,0,0,461,675,1136,6,6,201828
9,11,0,0,0,628,0,0,0,628,916,1544,8,6,201828
9,12,0,0,0,1182,0,0,0,1182,1458,2640,10,6,201828
9,13,0,0,0,563,0,0,0,563,628,1191,6,6,201828
9,14,0,0,0,483,0,0,0,483,623,1106,6,6,201828
9,15,0,0,0,1624,0,0,0,1624,1610,3234,18,4.666666667,201828
9,16,0,0,0,1270,0,0,0,1270,1660,2930,8,6,201828
9,17,0,0,0,680,0,0,0,680,572,1252,6,6,201828
9,18,0,0,0,864,0,0,0,864,936,1800,12,6,201828
9,19,0,0,0,367,0,0,0,367,562,929,6,6,201828
9,20,0,0,0,207,0,0,0,207,141,348,4,6,201828
9,21,0,0,0,272,0,0,0,272,369,641,4,6,201828
9,22,0,0,0,421,0,0,0,421,393,814,6,5,201828
9,23,0,0,0,574,0,0,0,574,761,1335,6,6,201828
9,24,0,0,0,1223,0,0,0,1223,1357,2580,12,6,201828
10,1,0,0,0,176,0,0,0,176,264,440,8,6,201828
10,2,0,0,0,204,0,0,0,204,259,463,4,6,201828
10,3,0,0,0,109,0,0,0,109,141,250,8,6,201828
10,4,0,0,0,462,0,0,0,462,602,1064,8,4,201828
11,1,0,0,0,165,0,0,0,165,224,389,8,6,201828
11,2,0,0,0,206,0,0,0,206,255,461,12,6,201828
11,3,0,0,0,305,0,0,0,305,380,685,4,6,201828
11,4,0,0,0,179,0,0,0,179,277,456,9,4.333333333,201828
11,5,0,0,0,484,0,0,0,484,563,1047,8,6,201828
11,6,0,0,0,320,0,0,0,320,386,706,8,6,201828
11,7,0,0,0,175,0,0,0,175,249,424,10,6,201828
11,8,0,0,0,275,0,0,0,275,361,636,14,6,201828
11,9,0,0,0,372,0,0,0,372,534,906,8,6,201828
11,10,0,0,0,215,0,0,0,215,284,499,12,6,201828
11,11,0,0,0,289,0,0,0,289,324,613,8,6,201828
11,12,0,0,0,450,0,0,0,450,573,1023,8,6,201828
11,13,0,0,0,130,0,0,0,130,167,297,10,6,201828
11,14,0,0,0,148,0,0,0,148,227,375,8,6,201828
11,15,0,0,0,219,0,0,0,219,240,459,6,6,201828
12,1,0,0,0,121,0,0,0,121,150,271,4,6,201828
12,2,0,0,0,309,0,0,0,309,434,743,8,6,201828
12,3,0,0,0,136,0,0,0,136,156,292,4,6,201828
12,4,0,0,0,475,0,0,0,475,539,1014,8,6,201828
12,5,0,0,0,84,0,0,0,84,80,164,4,6,201828
12,6,0,0,0,18,0,0,0,18,100,118,4,6,201828
12,7,0,0,0,325,0,0,0,325,369,694,6,6,201828
12,8,0,0,0,122,0,0,0,122,116,238,4,6,201828
12,9,0,0,0,286,0,0,0,286,378,664,8,6,201828
13,1,0,0,0,108,0,0,0,108,157,265,6,6,201828
13,2,0,0,0,146,0,0,0,146,182,328,4,6,201828
13,3,0,0,0,202,0,0,0,202,220,422,4,6,201828
13,4,0,0,0,309,0,0,0,309,294,603,8,6,201828
13,5,0,0,0,319,0,0,0,319,469,788,12,6,201828
13,6,0,0,0,832,0,0,0,832,975,1807,10,6,201828
13,7,0,0,0,398,0,0,0,398,459,857,10,6,201828
14,1,0,0,0,53,0,0,0,53,67,120,6,6,201828
14,2,0,0,0,125,0,0,0,125,169,294,8,6,201828
14,3,0,0,0,72,0,0,0,72,113,185,8,6,201828
14,4,0,0,0,384,0,0,0,384,396,780,8,5.5,201828
14,5,0,0,0,264,0,0,0,264,308,572,10,6,201828
14,6,0,0,0,439,0,0,0,439,388,827,6,6,201828
14,7,0,0,0,268,0,0,0,268,217,485,6,6,201828
14,8,0,0,0,1039,0,0,0,1039,1097,2136,16,4.8,201828
14,9,0,0,0,222,0,0,0,222,361,583,10,8,201828
14,10,0,0,0,573,0,0,0,573,708,1281,8,6,201828
14,11,0,0,0,298,0,0,0,298,336,634,4,6,201828
14,12,0,0,0,266,0,0,0,266,315,581,10,6,201828
14,13,0,0,0,240,0,0,0,240,336,576,8,6,201828
14,14,0,0,0,330,0,0,0,330,384,714,6,6,201828
14,15,0,0,0,142,0,0,0,142,202,344,12,6,201828
14,16,0,0,0,319,0,0,0,319,424,743,4,6,201828
14,17,0,0,0,94,0,0,0,94,115,209,4,6,201828
14,18,0,0,0,253,0,0,0,253,187,440,8,6,201828
14,19,0,0,0,150,0,0,0,150,235,385,4,6,201828
14,20,0,0,0,90,0,0,0,90,91,181,8,6,201828
15,1,0,0,0,121,0,0,0,121,189,310,6,6,201828
15,2,0,0,0,386,0,0,0,386,586,972,8,6,201828
15,3,0,0,0,414,0,0,0,414,566,980,10,6,201828
15,4,0,0,0,451,0,0,0,451,709,1160,4,6,201828
15,5,0,0,0,345,0,0,0,345,466,811,8,6,201828
15,6,0,0,0,503,0,0,0,503,653,1156,8,6,201828
15,7,0,0,0,603,0,0,0,603,711,1314,6,6,201828
15,8,0,0,0,286,0,0,0,286,273,559,4,6,201828
15,9,0,0,0,143,0,0,0,143,193,336,14,6,201828
15,10,0,0,0,367,0,0,0,367,423,790,6,6,201828
15,11,0,0,0,442,0,0,0,442,614,1056,6,6,201828
15,12,0,0,0,559,0,0,0,559,764,1323,12,6,201828
15,13,0,0,0,387,0,0,0,387,514,901,6,6,201828
15,14,0,0,0,281,0,0,0,281,419,700,4,6,201828
15,15,0,0,0,481,0,0,0,481,558,1039,6,6,201828
15,16,0,0,0,535,0,0,0,535,790,1325,8,6,201828
15,17,0,0,0,384,0,0,0,384,494,878,6,6,201828
15,18,0,0,0,496,0,0,0,496,626,1122,8,6,201828
15,19,0,0,0,729,0,0,0,729,1046,1775,10,5.5,201828
15,20,0,0,0,363,0,0,0,363,458,821,6,6,201828
15,21,0,0,0,176,0,0,0,176,168,344,4,6,201828
15,22,0,0,0,928,0,0,0,928,1098,2026,12,6,201828
15,23,0,0,0,281,0,0,0,281,398,679,6,6,201828
15,24,0,0,0,321,0,0,0,321,381,702,4,6,201828
15,25,0,0,0,418,0,0,0,418,542,960,6,6,201828
15,26,0,0,0,379,0,0,0,379,403,782,5,3.5,201828
15,27,0,0,0,628,0,0,0,628,847,1475,10,6,201828
15,28,0,0,0,421,0,0,0,421,599,1020,8,6,201828
15,29,0,0,0,641,0,0,0,641,667,1308,6,6,201828
15,30,0,0,0,401,0,0,0,401,565,966,12,6,201828
15,31,0,0,0,393,0,0,0,393,582,975,6,6,201828
15,32,0,0,0,403,0,0,0,403,453,856,8,6,201828
15,33,0,0,0,448,0,0,0,448,586,1034,8,6,201828
15,34,0,0,0,556,0,0,0,556,627,1183,6,6,201828
15,35,0,0,0,432,0,0,0,432,537,969,8,6,201828
15,36,0,0,0,276,0,0,0,276,329,605,8,6,201828
15,37,0,0,0,500,0,0,0,500,578,1078,8,6,201828
15,38,0,0,0,398,0,0,0,398,470,868,4,6,201828
15,39,0,0,0,261,0,0,0,261,333,594,4,6,201828
15,40,0,0,0,402,0,0,0,402,478,880,12,6,201828
15,41,0,0,0,698,0,0,0,698,928,1626,16,6,201828
16,1,0,0,0,141,0,0,0,141,144,285,4,6,201828
16,2,0,0,0,60,0,0,0,60,83,143,4,6,201828
16,3,0,0,0,135,0,0,0,135,184,319,4,6,201828
16,4,0,0,0,142,0,0,0,142,187,329,8,6,201828
16,5,0,0,0,186,0,0,0,186,226,412,10,5.5,201828
16,6,0,0,0,119,0,0,0,119,157,276,8,6,201828
16,7,0,0,0,131,0,0,0,131,206,337,8,6,201828
16,8,0,0,0,631,0,0,0,631,626,1257,10,6,201828
16,9,0,0,0,195,0,0,0,195,304,499,10,6,201828
16,10,0,0,0,320,0,0,0,320,330,650,8,6,201828
16,11,0,0,0,103,0,0,0,103,160,263,10,6,201828
16,12,0,0,0,123,0,0,0,123,169,292,4,6,201828
17,1,0,0,0,550,0,0,0,550,516,1066,6,4,201828
17,2,0,0,0,376,0,0,0,376,437,813,8,6,201828
17,3,0,0,0,458,0,0,0,458,694,1152,6,6,201828
17,4,0,0,0,447,0,0,0,447,675,1122,10,6,201828
17,5,0,0,0,137,0,0,0,137,169,306,4,6,201828
18,1,0,0,0,68,0,0,0,68,80,148,4,6,201828
18,2,0,0,0,355,0,0,0,355,470,825,12,6,201828
18,3,0,0,0,137,0,0,0,137,172,309,8,6,201828
19,1,0,0,0,547,0,0,0,547,664,1211,8,6,201828
19,2,0,0,0,466,0,0,0,466,548,1014,10,6,201828
19,3,0,0,0,496,0,0,0,496,518,1014,8,6,201828
19,4,0,0,0,273,0,0,0,273,288,561,4,6,201828
19,5,0,0,0,506,0,0,0,506,636,1142,12,6,201828
19,6,0,0,0,394,0,0,0,394,308,702,4,6,201828
19,7,0,0,0,130,0,0,0,130,141,271,8,6,201828
19,8,0,0,0,101,0,0,0,101,104,205,4,6,201828
19,9,0,0,0,71,0,0,0,71,98,169,4,6,201828
19,10,0,0,0,399,0,0,0,399,456,855,4,3,201828
19,11,0,0,0,847,0,0,0,847,845,1692,14,6,201828
19,12,0,0,0,123,0,0,0,123,133,256,4,3,201828
20,1,0,0,0,215,0,0,0,215,200,415,4,5,201828
20,2,0,0,0,36,0,0,0,36,42,78,4,6,201828
20,3,0,0,0,115,0,0,0,115,139,254,4,6,201828
20,4,0,0,0,57,0,0,0,57,124,181,4,6,201828
20,5,0,0,0,163,0,0,0,163,156,319,4,6,201828
20,6,0,0,0,58,0,0,0,58,48,106,4,6,201828
20,7,0,0,0,148,0,0,0,148,168,316,12,6,201828
20,8,0,0,0,979,0,0,0,979,1155,2134,10,6,201828
20,9,0,0,0,214,0,0,0,214,315,529,8,6,201828
20,10,0,0,0,65,0,0,0,65,68,133,5,7,201828
21,1,0,0,0,244,0,0,0,244,368,612,8,6,201828
21,2,0,0,0,86,0,0,0,86,105,191,4,6,201828
21,3,0,0,0,343,0,0,0,343,339,682,8,6,201828
21,4,0,0,0,85,0,0,0,85,86,171,4,6,201828
21,5,0,0,0,272,0,0,0,272,353,625,8,6,201828
21,6,0,0,0,559,0,0,0,559,696,1255,4,6,201828
21,7,0,0,0,302,0,0,0,302,336,638,8,6,201828
21,8,0,0,0,93,0,0,0,93,159,252,4,6,201828
21,9,0,0,0,590,0,0,0,590,560,1150,8,6,201828
21,10,0,0,0,485,0,0,0,485,629,1114,4,6,201828
21,11,0,0,0,135,0,0,0,135,167,302,4,6,201828
21,12,0,0,0,1201,0,0,0,1201,1174,2375,8,4,201828
21,13,0,0,0,253,0,0,0,253,382,635,8,6,201828
21,14,0,0,0,171,0,0,0,171,171,342,8,6,201828
21,15,0,0,0,358,0,0,0,358,467,825,4,6,201828
22,1,0,0,0,49,0,0,0,49,63,112,4,6,201828
22,2,0,0,0,286,0,0,0,286,381,667,4,6,201828
22,3,0,0,0,671,0,0,0,671,814,1485,8,6,201828
22,4,0,0,0,694,0,0,0,694,747,1441,12,4.5,201828
22,5,0,0,0,240,0,0,0,240,268,508,8,6,201828
23,1,0,0,0,478,0,0,0,478,537,1015,6,6,201828
23,2,0,0,0,259,0,0,0,259,273,532,2,3,201828
23,3,0,0,0,520,0,0,0,520,719,1239,4,6,201828
23,4,0,0,0,505,0,0,0,505,588,1093,4,6,201828
24,1,0,0,0,92,0,0,0,92,92,184,4,6,201828
24,2,0,0,0,196,0,0,0,196,238,434,4,6,201828
24,3,0,0,0,111,0,0,0,111,134,245,4,6,201828
24,4,0,0,0,197,0,0,0,197,219,416,4,6,201828
24,5,0,0,0,563,0,0,0,563,561,1124,12,4.5,201828
24,6,0,0,0,718,0,0,0,718,715,1433,8,6,201828
24,7,0,0,0,113,0,0,0,113,147,260,4,6,201828
25,1,0,0,0,162,0,0,0,162,245,407,10,6,201828
25,2,0,0,0,329,0,0,0,329,416,745,6,6,201828
25,3,0,0,0,180,0,0,0,180,218,398,10,6,201828
25,4,0,0,0,112,0,0,0,112,157,269,6,6,201828
25,5,0,0,0,515,0,0,0,515,475,990,10,6,201828
25,6,0,0,0,305,0,0,0,305,339,644,12,6,201828
25,7,0,0,0,407,0,0,0,407,496,903,8,6,201828
26,1,0,0,0,168,0,0,0,168,270,438,10,6,201828
26,2,0,0,0,353,0,0,0,353,433,786,10,6,201828
26,3,0,0,0,828,0,0,0,828,710,1538,12,6,201828
26,4,0,0,0,154,0,0,0,154,250,404,6,6,201828
26,5,0,0,0,97,0,0,0,97,225,322,2,5,201828
26,6,0,0,0,416,0,0,0,416,597,1013,6,6,201828
26,7,0,0,0,258,0,0,0,258,331,589,8,6,201828
27,1,0,0,0,241,0,0,0,241,340,581,8,6,201828
27,2,0,0,0,300,0,0,0,300,426,726,8,6,201828
27,3,0,0,0,396,0,0,0,396,434,830,8,6,201828
27,4,0,0,0,685,0,0,0,685,937,1622,6,3,201828
27,5,0,0,0,100,0,0,0,100,132,232,4,6,201828
27,6,0,0,0,440,0,0,0,440,519,959,4,6,201828
28,1,0,0,0,392,0,0,0,392,418,810,20,6,201828
28,2,0,0,0,203,0,0,0,203,365,568,12,6,201828
28,3,0,0,0,55,0,0,0,55,102,157,6,6,201828
28,4,0,0,0,276,0,0,0,276,368,644,22,6,201828
28,5,0,0,0,305,0,0,0,305,367,672,4,3,201828
28,6,0,0,0,137,0,0,0,137,159,296,6,6,201828
28,7,0,0,0,388,0,0,0,388,483,871,12,6,201828
28,8,0,0,0,300,0,0,0,300,345,645,12,6,201828
28,9,0,0,0,101,0,0,0,101,147,248,12,6,201828
29,1,0,0,0,325,0,0,0,325,534,859,8,6,201828
29,2,0,0,0,518,0,0,0,518,597,1115,12,4.5,201828
29,3,0,0,0,214,0,0,0,214,271,485,6,6,201828
30,1,0,0,0,57,0,0,0,57,77,134,4,6,201828
30,2,0,0,0,57,0,0,0,57,95,152,4,6,201828
30,3,0,0,0,183,0,0,0,183,219,402,8,6,201828
30,4,0,0,0,269,0,0,0,269,362,631,8,6,201828
30,5,0,0,0,278,0,0,0,278,263,541,4,6,201828
30,6,0,0,0,111,0,0,0,111,153,264,4,6,201828
30,7,0,0,0,174,0,0,0,174,209,383,4,6,201828
30,8,0,0,0,183,0,0,0,183,224,407,8,6,201828
30,9,0,0,0,162,0,0,0,162,196,358,8,6,201828
30,10,0,0,0,481,0,0,0,481,540,1021,8,6,201828
30,11,0,0,0,355,0,0,0,355,409,764,4,6,201828
30,12,0,0,0,617,0,0,0,617,607,1224,16,6,201828
30,13,0,0,0,139,0,0,0,139,146,285,8,6,201828
30,14,0,0,0,140,0,0,0,140,189,329,8,6,201828
30,15,0,0,0,377,0,0,0,377,383,760,8,6,201828
30,16,0,0,0,249,0,0,0,249,429,678,4,6,201828
30,17,0,0,0,134,0,0,0,134,150,284,8,6,201828
30,18,0,0,0,39,0,0,0,39,41,80,4,6,201828
30,19,0,0,0,137,0,0,0,137,187,324,12,6,201828
30,20,0,0,0,197,0,0,0,197,239,436,8,6,201828
31,1,0,0,0,170,0,0,0,170,137,307,8,6,201828
31,2,0,0,0,68,0,0,0,68,77,145,4,6,201828
31,3,0,0,0,1062,0,0,0,1062,1033,2095,16,4.5,201828
31,4,0,0,0,409,0,0,0,409,455,864,4,6,201828
31,5,0,0,0,137,0,0,0,137,151,288,4,6,201828
32,1,0,0,0,136,0,0,0,136,188,324,4,6,201828
32,2,0,0,0,53,0,0,0,53,81,134,4,6,201828
32,3,0,0,0,181,0,0,0,181,212,393,8,6,201828
32,4,0,0,0,189,0,0,0,189,296,485,4,3,201828
1,1,0,0,0,0,0,0,0,0,81,81,6,5,201830
1,2,0,0,0,0,0,0,0,0,440,440,6,3.75,201830
1,3,0,0,0,0,0,0,0,0,751,751,6,5,201830
2,1,0,0,0,0,0,0,0,0,234,234,6,5,201830
2,2,0,0,0,0,0,0,0,0,315,315,4,5,201830
2,3,0,0,0,0,0,0,0,0,302,302,4,3.333333333,201830
2,4,0,0,0,0,0,0,0,0,55,55,4,5,201830
2,5,0,0,0,0,0,0,0,0,682,682,6,5,201830
2,6,0,0,0,0,0,0,0,0,330,330,4,5,201830
2,7,0,0,0,0,0,0,0,0,249,249,6,5,201830
2,8,0,0,0,0,0,0,0,0,462,462,4,5,201830
3,1,0,0,0,0,0,0,0,0,460,460,7,5,201830
3,2,0,0,0,0,0,0,0,0,208,208,4,5,201830
4,1,0,0,0,0,0,0,0,0,592,592,3,5,201830
4,2,0,0,0,0,0,0,0,0,354,354,2,5,201830
5,1,0,0,0,0,0,0,0,0,347,347,5,5,201830
5,2,0,0,0,0,0,0,0,0,95,95,3,6,201830
5,3,0,0,0,0,0,0,0,0,293,293,5,5,201830
5,4,0,0,0,0,0,0,0,0,584,584,5,5,201830
5,5,0,0,0,0,0,0,0,0,434,434,6,5,201830
5,6,0,0,0,0,0,0,0,0,219,219,3,5,201830
5,7,0,0,0,0,0,0,0,0,279,279,3,2.5,201830
6,1,0,0,0,0,0,0,0,0,369,369,7,4,201830
6,2,0,0,0,0,0,0,0,0,133,133,4,5,201830
7,1,0,0,0,0,0,0,0,0,51,51,2,5,201830
7,2,0,0,0,0,0,0,0,0,59,59,2,5,201830
7,3,0,0,0,0,0,0,0,0,237,237,2,5,201830
7,4,0,0,0,0,0,0,0,0,249,249,4,5,201830
7,5,0,0,0,0,0,0,0,0,330,330,4,5,201830
7,6,0,0,0,0,0,0,0,0,463,463,2,2.5,201830
7,7,0,0,0,0,0,0,0,0,454,454,4,5,201830
7,8,0,0,0,0,0,0,0,0,192,192,2,5,201830
7,9,0,0,0,0,0,0,0,0,793,793,4,5,201830
7,10,0,0,0,0,0,0,0,0,56,56,4,5,201830
7,11,0,0,0,0,0,0,0,0,22,22,2,5,201830
7,12,0,0,0,0,0,0,0,0,564,564,5,5,201830
7,13,0,0,0,0,0,0,0,0,97,97,3,5,201830
8,1,0,0,0,0,0,0,0,0,168,168,2,5,201830
8,2,0,0,0,0,0,0,0,0,173,173,5,5,201830
8,3,0,0,0,0,0,0,0,0,427,427,4,5,201830
8,4,0,0,0,0,0,0,0,0,436,436,4,5,201830
8,5,0,0,0,0,0,0,0,0,234,234,3,5,201830
8,6,0,0,0,0,0,0,0,0,635,635,4,3.333333333,201830
8,7,0,0,0,0,0,0,0,0,118,118,3,5,201830
8,8,0,0,0,0,0,0,0,0,593,593,4,5,201830
8,9,0,0,0,0,0,0,0,0,205,205,3,5,201830
9,1,0,0,0,0,0,0,0,0,405,405,2,5,201830
9,2,0,0,0,0,0,0,0,0,2550,2550,8,5,201830
9,3,0,0,0,0,0,0,0,0,1146,1146,4,5,201830
9,4,0,0,0,0,0,0,0,0,559,559,3,5,201830
9,5,0,0,0,0,0,0,0,0,829,829,3,5,201830
9,6,0,0,0,0,0,0,0,0,564,564,3,5,201830
9,7,0,0,0,0,0,0,0,0,1148,1148,3,5,201830
9,8,0,0,0,0,0,0,0,0,742,742,2,5,201830
9,9,0,0,0,0,0,0,0,0,425,425,2,5,201830
9,10,0,0,0,0,0,0,0,0,666,666,3,5,201830
9,11,0,0,0,0,0,0,0,0,983,983,4,5,201830
9,12,0,0,0,0,0,0,0,0,1672,1672,5,5,201830
9,13,0,0,0,0,0,0,0,0,699,699,3,5,201830
9,14,0,0,0,0,0,0,0,0,306,306,3,5,201830
9,15,0,0,0,0,0,0,0,0,2457,2457,9,3.666666667,201830
9,16,0,0,0,0,0,0,0,0,1770,1770,4,5,201830
9,17,0,0,0,0,0,0,0,0,1129,1129,3,5,201830
9,18,0,0,0,0,0,0,0,0,1525,1525,6,5,201830
9,19,0,0,0,0,0,0,0,0,297,297,3,5,201830
9,20,0,0,0,0,0,0,0,0,197,197,2,5,201830
9,21,0,0,0,0,0,0,0,0,353,353,2,5,201830
9,22,0,0,0,0,0,0,0,0,549,549,3,5,201830
9,23,0,0,0,0,0,0,0,0,1071,1071,3,5,201830
9,24,0,0,0,0,0,0,0,0,1754,1754,6,5,201830
10,1,0,0,0,0,0,0,0,0,227,227,4,5,201830
10,2,0,0,0,0,0,0,0,0,245,245,2,5,201830
10,3,0,0,0,0,0,0,0,0,122,122,4,5,201830
10,4,0,0,0,0,0,0,0,0,626,626,4,3.333333333,201830
11,1,0,0,0,0,0,0,0,0,209,209,4,5,201830
11,2,0,0,0,0,0,0,0,0,315,315,6,5,201830
11,3,0,0,0,0,0,0,0,0,229,229,2,5,201830
11,4,0,0,0,0,0,0,0,0,134,134,4,3.333333333,201830
11,5,0,0,0,0,0,0,0,0,636,636,4,5,201830
11,6,0,0,0,0,0,0,0,0,343,343,4,5,201830
11,7,0,0,0,0,0,0,0,0,84,84,5,5,201830
11,8,0,0,0,0,0,0,0,0,316,316,7,5,201830
11,9,0,0,0,0,0,0,0,0,46,46,4,5,201830
11,10,0,0,0,0,0,0,0,0,193,193,6,5,201830
11,11,0,0,0,0,0,0,0,0,367,367,4,5,201830
11,12,0,0,0,0,0,0,0,0,483,483,4,5,201830
11,13,0,0,0,0,0,0,0,0,138,138,5,5,201830
11,14,0,0,0,0,0,0,0,0,192,192,4,4.5,201830
11,15,0,0,0,0,0,0,0,0,269,269,3,5,201830
12,1,0,0,0,0,0,0,0,0,169,169,2,5,201830
12,2,0,0,0,0,0,0,0,0,453,453,4,5,201830
12,3,0,0,0,0,0,0,0,0,110,110,2,5,201830
12,4,0,0,0,0,0,0,0,0,495,495,4,5,201830
12,5,0,0,0,0,0,0,0,0,128,128,2,5,201830
12,6,0,0,0,0,0,0,0,0,73,73,2,5,201830
12,7,0,0,0,0,0,0,0,0,322,322,3,5,201830
12,8,0,0,0,0,0,0,0,0,201,201,2,5,201830
12,9,0,0,0,0,0,0,0,0,339,339,4,5,201830
13,1,0,0,0,0,0,0,0,0,77,77,3,5,201830
13,2,0,0,0,0,0,0,0,0,217,217,2,5,201830
13,3,0,0,0,0,0,0,0,0,240,240,2,5,201830
13,4,0,0,0,0,0,0,0,0,388,388,4,5,201830
13,5,0,0,0,0,0,0,0,0,65,65,6,5,201830
13,6,0,0,0,0,0,0,0,0,683,683,5,5,201830
13,7,0,0,0,0,0,0,0,0,553,553,5,5,201830
14,1,0,0,0,0,0,0,0,0,110,110,3,5,201830
14,2,0,0,0,0,0,0,0,0,57,57,4,5,201830
14,3,0,0,0,0,0,0,0,0,141,141,4,5,201830
14,4,0,0,0,0,0,0,0,0,592,592,4,5,201830
14,5,0,0,0,0,0,0,0,0,406,406,5,5,201830
14,6,0,0,0,0,0,0,0,0,551,551,3,5,201830
14,7,0,0,0,0,0,0,0,0,318,318,3,5,201830
14,8,0,0,0,0,0,0,0,0,1260,1260,8,4,201830
14,9,0,0,0,0,0,0,0,0,459,459,5,6,201830
14,10,0,0,0,0,0,0,0,0,996,996,4,5,201830
14,11,0,0,0,0,0,0,0,0,341,341,2,5,201830
14,12,0,0,0,0,0,0,0,0,320,320,5,5,201830
14,13,0,0,0,0,0,0,0,0,305,305,4,5,201830
14,14,0,0,0,0,0,0,0,0,648,648,3,5,201830
14,15,0,0,0,0,0,0,0,0,136,136,6,5,201830
14,16,0,0,0,0,0,0,0,0,327,327,2,5,201830
14,17,0,0,0,0,0,0,0,0,208,208,2,5,201830
14,18,0,0,0,0,0,0,0,0,483,483,4,5,201830
14,19,0,0,0,0,0,0,0,0,257,257,2,5,201830
14,20,0,0,0,0,0,0,0,0,94,94,4,5,201830
15,1,0,0,0,0,0,0,0,0,75,75,3,5,201830
15,2,0,0,0,0,0,0,0,0,597,597,4,5,201830
15,3,0,0,0,0,0,0,0,0,550,550,5,5,201830
15,4,0,0,0,0,0,0,0,0,638,638,2,5,201830
15,5,0,0,0,0,0,0,0,0,496,496,4,5,201830
15,6,0,0,0,0,0,0,0,0,705,705,4,5,201830
15,7,0,0,0,0,0,0,0,0,815,815,3,5,201830
15,8,0,0,0,0,0,0,0,0,343,343,2,5,201830
15,9,0,0,0,0,0,0,0,0,137,137,7,5,201830
15,10,0,0,0,0,0,0,0,0,482,482,3,5,201830
15,11,0,0,0,0,0,0,0,0,530,530,3,5,201830
15,12,0,0,0,0,0,0,0,0,855,855,6,5,201830
15,13,0,0,0,0,0,0,0,0,647,647,3,5,201830
15,14,0,0,0,0,0,0,0,0,253,253,2,5,201830
15,15,0,0,0,0,0,0,0,0,746,746,3,5,201830
15,16,0,0,0,0,0,0,0,0,677,677,4,5,201830
15,17,0,0,0,0,0,0,0,0,516,516,3,5,201830
15,18,0,0,0,0,0,0,0,0,756,756,4,5,201830
15,19,0,0,0,0,0,0,0,0,940,940,5,5,201830
15,20,0,0,0,0,0,0,0,0,348,348,3,5,201830
15,21,0,0,0,0,0,0,0,0,222,222,3,6,201830
15,22,0,0,0,0,0,0,0,0,1136,1136,6,5,201830
15,23,0,0,0,0,0,0,0,0,356,356,3,5,201830
15,24,0,0,0,0,0,0,0,0,348,348,2,5,201830
15,25,0,0,0,0,0,0,0,0,755,755,3,5,201830
15,26,0,0,0,0,0,0,0,0,514,514,3,3,201830
15,27,0,0,0,0,0,0,0,0,756,756,5,5,201830
15,28,0,0,0,0,0,0,0,0,391,391,4,5,201830
15,29,0,0,0,0,0,0,0,0,816,816,3,5,201830
15,30,0,0,0,0,0,0,0,0,734,734,6,5,201830
15,31,0,0,0,0,0,0,0,0,902,902,3,5,201830
15,32,0,0,0,0,0,0,0,0,447,447,4,5,201830
15,33,0,0,0,0,0,0,0,0,794,794,4,5,201830
15,34,0,0,0,0,0,0,0,0,770,770,3,5,201830
15,35,0,0,0,0,0,0,0,0,452,452,4,5,201830
15,36,0,0,0,0,0,0,0,0,364,364,4,5,201830
15,37,0,0,0,0,0,0,0,0,846,846,4,5,201830
15,38,0,0,0,0,0,0,0,0,709,709,2,5,201830
15,39,0,0,0,0,0,0,0,0,215,215,2,5,201830
15,40,0,0,0,0,0,0,0,0,496,496,6,5,201830
15,41,0,0,0,0,0,0,0,0,620,620,8,5,201830
16,1,0,0,0,0,0,0,0,0,168,168,2,5,201830
16,2,0,0,0,0,0,0,0,0,33,33,2,5,201830
16,3,0,0,0,0,0,0,0,0,175,175,2,5,201830
16,4,0,0,0,0,0,0,0,0,148,148,4,5,201830
16,5,0,0,0,0,0,0,0,0,109,109,5,5,201830
16,6,0,0,0,0,0,0,0,0,133,133,4,5,201830
16,7,0,0,0,0,0,0,0,0,102,102,4,5,201830
16,8,0,0,0,0,0,0,0,0,730,730,5,5,201830
16,9,0,0,0,0,0,0,0,0,270,270,5,5,201830
16,10,0,0,0,0,0,0,0,0,343,343,4,5,201830
16,11,0,0,0,0,0,0,0,0,27,27,5,5,201830
16,12,0,0,0,0,0,0,0,0,171,171,2,5,201830
17,1,0,0,0,0,0,0,0,0,785,785,3,3,201830
17,2,0,0,0,0,0,0,0,0,310,310,4,5,201830
17,3,0,0,0,0,0,0,0,0,333,333,3,5,201830
17,4,0,0,0,0,0,0,0,0,497,497,5,5,201830
17,5,0,0,0,0,0,0,0,0,185,185,2,5,201830
18,1,0,0,0,0,0,0,0,0,99,99,2,5,201830
18,2,0,0,0,0,0,0,0,0,267,267,6,5,201830
18,3,0,0,0,0,0,0,0,0,256,256,4,5,201830
19,1,0,0,0,0,0,0,0,0,819,819,4,5,201830
19,2,0,0,0,0,0,0,0,0,988,988,5,5,201830
19,3,0,0,0,0,0,0,0,0,773,773,4,5,201830
19,4,0,0,0,0,0,0,0,0,483,483,2,5,201830
19,5,0,0,0,0,0,0,0,0,940,940,6,5,201830
19,6,0,0,0,0,0,0,0,0,589,589,2,5,201830
19,7,0,0,0,0,0,0,0,0,161,161,4,5,201830
19,8,0,0,0,0,0,0,0,0,96,96,2,5,201830
19,9,0,0,0,0,0,0,0,0,75,75,2,5,201830
19,10,0,0,0,0,0,0,0,0,578,578,2,2.5,201830
19,11,0,0,0,0,0,0,0,0,1089,1089,7,5,201830
19,12,0,0,0,0,0,0,0,0,256,256,2,2.5,201830
20,1,0,0,0,0,0,0,0,0,229,229,3,6,201830
20,2,0,0,0,0,0,0,0,0,66,66,2,5,201830
20,3,0,0,0,0,0,0,0,0,123,123,2,5,201830
20,4,0,0,0,0,0,0,0,0,79,79,2,5,201830
20,5,0,0,0,0,0,0,0,0,160,160,2,5,201830
20,6,0,0,0,0,0,0,0,0,92,92,2,5,201830
20,7,0,0,0,0,0,0,0,0,215,215,6,5,201830
20,8,0,0,0,0,0,0,0,0,1718,1718,5,5,201830
20,9,0,0,0,0,0,0,0,0,308,308,4,5,201830
20,10,0,0,0,0,0,0,0,0,92,92,2,5,201830
21,1,0,0,0,0,0,0,0,0,138,138,4,5,201830
21,2,0,0,0,0,0,0,0,0,171,171,2,5,201830
21,3,0,0,0,0,0,0,0,0,523,523,4,5,201830
21,4,0,0,0,0,0,0,0,0,122,122,2,5,201830
21,5,0,0,0,0,0,0,0,0,254,254,4,5,201830
21,6,0,0,0,0,0,0,0,0,416,416,2,5,201830
21,7,0,0,0,0,0,0,0,0,551,551,4,5,201830
21,8,0,0,0,0,0,0,0,0,138,138,2,5,201830
21,9,0,0,0,0,0,0,0,0,797,797,4,5,201830
21,10,0,0,0,0,0,0,0,0,551,551,2,5,201830
21,11,0,0,0,0,0,0,0,0,171,171,2,5,201830
21,12,0,0,0,0,0,0,0,0,1465,1465,5,3.666666667,201830
21,13,0,0,0,0,0,0,0,0,359,359,4,5,201830
21,14,0,0,0,0,0,0,0,0,246,246,4,5,201830
21,15,0,0,0,0,0,0,0,0,495,495,2,5,201830
22,1,0,0,0,0,0,0,0,0,54,54,2,5,201830
22,2,0,0,0,0,0,0,0,0,368,368,2,5,201830
22,3,0,0,0,0,0,0,0,0,737,737,4,5,201830
22,4,0,0,0,0,0,0,0,0,907,907,6,3.75,201830
22,5,0,0,0,0,0,0,0,0,229,229,4,5,201830
23,1,0,0,0,0,0,0,0,0,683,683,3,5,201830
23,2,0,0,0,0,0,0,0,0,317,317,1,2.5,201830
23,3,0,0,0,0,0,0,0,0,517,517,2,5,201830
23,4,0,0,0,0,0,0,0,0,434,434,2,5,201830
24,1,0,0,0,0,0,0,0,0,164,164,2,5,201830
24,2,0,0,0,0,0,0,0,0,170,170,2,5,201830
24,3,0,0,0,0,0,0,0,0,43,43,2,5,201830
24,4,0,0,0,0,0,0,0,0,174,174,2,5,201830
24,5,0,0,0,0,0,0,0,0,425,425,6,3.75,201830
24,6,0,0,0,0,0,0,0,0,1178,1178,4,5,201830
24,7,0,0,0,0,0,0,0,0,157,157,2,5,201830
25,1,0,0,0,0,0,0,0,0,191,191,5,5,201830
25,2,0,0,0,0,0,0,0,0,354,354,3,5,201830
25,3,0,0,0,0,0,0,0,0,152,152,5,5,201830
25,4,0,0,0,0,0,0,0,0,153,153,3,5,201830
25,5,0,0,0,0,0,0,0,0,571,571,5,5,201830
25,6,0,0,0,0,0,0,0,0,396,396,6,5,201830
25,7,0,0,0,0,0,0,0,0,545,545,4,5,201830
26,1,0,0,0,0,0,0,0,0,337,337,5,5,201830
26,2,0,0,0,0,0,0,0,0,448,448,5,5,201830
26,3,0,0,0,0,0,0,0,0,1235,1235,6,5,201830
26,4,0,0,0,0,0,0,0,0,177,177,3,5,201830
26,5,0,0,0,0,0,0,0,0,259,259,1,5,201830
26,6,0,0,0,0,0,0,0,0,406,406,3,5,201830
26,7,0,0,0,0,0,0,0,0,311,311,4,5,201830
27,1,0,0,0,0,0,0,0,0,419,419,4,5,201830
27,2,0,0,0,0,0,0,0,0,436,436,4,5,201830
27,3,0,0,0,0,0,0,0,0,591,591,4,4,201830
27,4,0,0,0,0,0,0,0,0,788,788,3,2.5,201830
27,5,0,0,0,0,0,0,0,0,153,153,2,5,201830
27,6,0,0,0,0,0,0,0,0,444,444,2,5,201830
28,1,0,0,0,0,0,0,0,0,499,499,10,5,201830
28,2,0,0,0,0,0,0,0,0,257,257,6,5,201830
28,3,0,0,0,0,0,0,0,0,77,77,3,5,201830
28,4,0,0,0,0,0,0,0,0,385,385,11,5,201830
28,5,0,0,0,0,0,0,0,0,406,406,2,2.5,201830
28,6,0,0,0,0,0,0,0,0,66,66,3,5,201830
28,7,0,0,0,0,0,0,0,0,524,524,6,5,201830
28,8,0,0,0,0,0,0,0,0,320,320,6,5,201830
28,9,0,0,0,0,0,0,0,0,81,81,6,5,201830
29,1,0,0,0,0,0,0,0,0,182,182,4,5,201830
29,2,0,0,0,0,0,0,0,0,664,664,6,3.75,201830
29,3,0,0,0,0,0,0,0,0,190,190,3,5,201830
30,1,0,0,0,0,0,0,0,0,60,60,2,5,201830
30,2,0,0,0,0,0,0,0,0,14,14,2,5,201830
30,3,0,0,0,0,0,0,0,0,197,197,4,5,201830
30,4,0,0,0,0,0,0,0,0,292,292,4,5,201830
30,5,0,0,0,0,0,0,0,0,391,391,2,5,201830
30,6,0,0,0,0,0,0,0,0,122,122,2,5,201830
30,7,0,0,0,0,0,0,0,0,243,243,2,5,201830
30,8,0,0,0,0,0,0,0,0,219,219,4,5,201830
30,9,0,0,0,0,0,0,0,0,176,176,4,5,201830
30,10,0,0,0,0,0,0,0,0,457,457,4,5,201830
30,11,0,0,0,0,0,0,0,0,386,386,2,5,201830
30,12,0,0,0,0,0,0,0,0,785,785,8,5,201830
30,13,0,0,0,0,0,0,0,0,173,173,4,5,201830
30,14,0,0,0,0,0,0,0,0,184,184,4,5,201830
30,15,0,0,0,0,0,0,0,0,437,437,4,5,201830
30,16,0,0,0,0,0,0,0,0,296,296,2,5,201830
30,17,0,0,0,0,0,0,0,0,248,248,4,5,201830
30,18,0,0,0,0,0,0,0,0,48,48,2,5,201830
30,19,0,0,0,0,0,0,0,0,106,106,6,5,201830
30,20,0,0,0,0,0,0,0,0,171,171,4,5,201830
31,1,0,0,0,0,0,0,0,0,311,311,4,5,201830
31,2,0,0,0,0,0,0,0,0,54,54,2,5,201830
31,3,0,0,0,0,0,0,0,0,1718,1718,8,3.75,201830
31,4,0,0,0,0,0,0,0,0,573,573,2,5,201830
31,5,0,0,0,0,0,0,0,0,168,168,2,5,201830
32,1,0,0,0,0,0,0,0,0,54,54,2,5,201830
32,2,0,0,0,0,0,0,0,0,49,49,2,5,201830
32,3,0,0,0,0,0,0,0,0,183,183,4,5,201830
32,4,0,0,0,0,0,0,0,0,155,155,2,2.5,201830
1,1,149,46,228,134,15,65,0,637,15,652,4,6,201832
1,2,200,91,481,353,33,135,1,1294,158,1452,9,6,201832
1,3,136,93,470,381,33,123,10,1246,18,1264,9,6,201832
2,1,152,20,294,252,4,68,1,791,8,799,6,6,201832
2,2,116,14,160,239,4,75,0,608,11,619,3,6,201832
2,3,67,13,81,28,5,10,0,204,0,204,3,3.5,201832
2,4,78,17,243,98,20,26,1,483,1,484,3,6,201832
2,5,344,63,654,238,44,131,2,1476,19,1495,6,6,201832
2,6,63,11,148,49,15,16,1,303,2,305,3,6,201832
2,7,192,24,394,236,11,75,6,938,7,945,6,6,201832
2,8,54,7,110,50,2,21,0,244,0,244,2,6,201832
3,1,83,22,167,168,5,76,0,521,19,540,9,6,201832
3,2,111,11,210,145,8,25,0,510,5,515,4,6,201832
4,1,107,24,133,220,8,54,0,546,6,552,3,6,201832
4,2,43,2,103,81,2,19,0,250,1,251,2,6,201832
5,1,225,29,336,236,24,98,0,948,9,957,7,6,201832
5,2,38,10,44,56,0,19,0,167,2,169,2,6,201832
5,3,119,39,178,212,19,99,26,692,22,714,5,6,201832
5,4,182,57,454,319,5,125,6,1148,25,1173,7,6,201832
5,5,150,47,318,296,13,91,10,925,14,939,8,6,201832
5,6,75,19,163,150,6,43,11,467,30,497,3,6,201832
5,7,107,26,176,172,0,60,2,543,17,560,8,6,201832
6,1,141,36,237,221,4,78,0,717,13,730,9,6,201832
6,2,136,24,257,109,22,78,3,629,7,636,7,6,201832
7,1,10,10,10,40,30,15,0,115,0,115,3,6,201832
7,2,3,0,3,9,0,2,0,17,0,17,3,3,201832
7,3,67,2,10,32,9,9,0,129,9,138,3,6,201832
7,4,30,4,24,45,0,15,0,118,6,124,5,6,201832
7,5,289,13,121,244,9,48,0,724,59,783,9,5.5,201832
7,6,72,12,90,117,5,38,5,339,15,354,4,6,201832
7,7,93,18,87,108,2,28,0,336,8,344,4,6,201832
7,8,95,9,46,111,7,15,0,283,4,287,5,6,201832
7,9,69,13,98,110,5,27,0,322,0,322,3,6,201832
7,10,83,6,53,93,18,26,0,279,6,285,5,6,201832
7,11,12,3,8,11,0,5,0,39,1,40,2,6,201832
7,12,39,12,52,121,0,17,0,241,1,242,2,6,201832
7,13,15,1,10,21,0,6,0,53,0,53,3,6,201832
8,1,120,17,267,126,3,51,0,584,8,592,4,6,201832
8,2,246,38,445,257,19,112,3,1120,13,1133,13,6,201832
8,3,180,60,356,277,25,96,8,1002,19,1021,4,6,201832
8,4,149,27,311,208,8,121,12,836,18,854,4,6,201832
8,5,71,10,104,94,9,43,0,331,13,344,3,6,201832
8,6,185,48,350,304,36,172,32,1127,28,1155,8,4.333333333,201832
8,7,107,12,104,92,2,55,0,372,11,383,3,6,201832
8,8,169,73,366,301,14,141,7,1071,61,1132,11,3.5,201832
8,9,39,23,78,60,6,37,0,243,10,253,3,6,201832
9,1,67,11,97,83,31,26,2,317,4,321,5,6,201832
9,2,186,95,527,656,30,154,2,1650,50,1700,12,6,201832
9,3,96,44,324,285,43,94,25,911,21,932,7,6,201832
9,4,144,32,233,378,26,80,5,898,11,909,11,6,201832
9,5,89,20,209,205,53,72,5,653,17,670,7,6,201832
9,6,77,29,145,132,40,63,3,489,28,517,7,6,201832
9,7,75,38,230,323,7,66,0,739,36,775,9,6,201832
9,8,45,6,128,111,8,43,15,356,15,371,5,6,201832
9,9,70,9,133,202,13,28,4,459,4,463,5,6,201832
9,10,74,19,195,203,18,54,0,563,13,576,6,6,201832
9,11,53,14,103,108,9,47,0,334,0,334,7,6,201832
9,12,61,24,211,209,18,67,7,597,0,597,6,6,201832
9,13,76,14,160,181,22,63,6,522,11,533,4,6,201832
9,14,107,15,219,191,53,66,8,659,6,665,5,6,201832
9,15,78,24,317,287,6,86,0,798,17,815,4,6,201832
9,16,190,86,365,419,49,153,0,1262,16,1278,15,6,201832
9,17,114,17,175,242,14,60,1,623,23,646,6,6,201832
9,18,50,12,145,193,13,53,1,467,20,487,6,6,201832
9,19,35,14,68,53,35,24,2,231,11,242,5,6,201832
9,20,26,6,47,70,4,19,1,173,3,176,5,6,201832
9,21,62,14,70,116,17,25,3,307,7,314,3,6,201832
9,22,49,8,54,54,19,19,1,204,7,211,5,6,201832
9,23,81,31,197,293,39,73,2,716,20,736,6,6,201832
9,24,222,48,327,374,21,110,8,1110,25,1135,12,6,201832
10,1,76,9,34,54,0,17,0,190,9,199,2,6,201832
10,2,87,27,143,85,14,55,23,434,2,436,2,6,201832
10,3,74,16,87,85,8,52,1,323,9,332,4,5.5,201832
10,4,243,63,327,363,16,121,2,1135,54,1189,4,6,201832
11,1,175,25,101,118,7,55,7,488,14,502,5,6,201832
11,2,252,35,199,174,18,67,3,748,11,759,7,6,201832
11,3,54,21,96,104,8,32,13,328,8,336,3,5,201832
11,4,157,33,82,123,0,35,0,430,12,442,5,4.333333333,201832
11,5,159,60,180,230,17,64,1,711,4,715,8,3.5,201832
11,6,148,59,208,194,23,66,8,706,33,739,4,6,201832
11,7,182,29,141,171,15,79,0,617,16,633,5,6,201832
11,8,91,18,89,84,11,29,0,322,17,339,4,6,201832
11,9,312,86,315,347,7,94,0,1161,23,1184,4,6,201832
11,10,269,59,231,224,28,117,33,961,41,1002,6,6,201832
11,11,168,54,162,141,12,52,0,589,11,600,4,6,201832
11,12,157,44,238,216,5,58,0,718,6,724,3,6,201832
11,13,133,22,91,101,12,48,19,426,16,442,5,6,201832
11,14,127,36,123,114,9,29,0,438,17,455,4,5,201832
11,15,151,41,142,122,3,55,1,515,5,520,3,6,201832
12,1,35,20,54,19,1,14,0,143,2,145,2,6,201832
12,2,94,34,106,207,14,32,0,487,17,504,6,6,201832
12,3,42,7,39,53,1,17,0,159,4,163,3,6,201832
12,4,97,43,161,276,15,36,0,628,51,679,7,6,201832
12,5,99,9,69,92,0,20,1,290,0,290,4,6,201832
12,6,104,9,64,50,0,10,0,237,5,242,4,6,201832
12,7,162,39,164,177,4,43,12,601,17,618,4,6,201832
12,8,34,6,21,22,0,5,0,88,5,93,3,6,201832
12,9,129,31,126,283,7,45,3,624,14,638,7,6,201832
13,1,63,8,52,84,3,13,0,223,77,300,3,6,201832
13,2,57,11,26,78,14,24,8,218,0,218,2,6,201832
13,3,40,12,54,63,20,18,0,207,0,207,2,6,201832
13,4,65,20,140,144,27,29,1,426,2,428,2,6,201832
13,7,84,33,255,213,19,42,3,649,10,659,6,5.666666667,201832
13,5,122,32,191,173,40,72,8,638,124,762,6,6,201832
13,6,99,50,317,504,8,72,0,1050,10,1060,6,6,201832
14,1,15,9,8,10,1,12,0,55,0,55,1,6,201832
14,2,48,6,48,32,0,13,0,147,0,147,2,6,201832
14,3,46,9,59,31,0,28,0,173,1,174,2,6,201832
14,4,136,37,168,248,8,76,8,681,17,698,4,6,201832
14,5,86,16,178,79,11,35,0,405,1,406,2,6,201832
14,6,155,23,214,175,10,72,0,649,0,649,3,6,201832
14,7,116,17,183,82,0,35,0,433,4,437,3,6,201832
14,8,185,56,432,297,16,109,4,1099,33,1132,9,5,201832
14,9,72,30,119,122,5,36,0,384,14,398,5,7,201832
14,10,148,36,222,168,2,62,3,641,14,655,4,6,201832
14,11,79,30,101,115,5,45,1,376,5,381,2,6,201832
14,12,198,22,315,101,5,70,1,712,6,718,5,6,201832
14,13,101,18,143,79,4,35,0,380,1,381,2,6,201832
14,14,97,28,163,123,8,60,8,487,22,509,3,6,201832
14,15,199,65,140,152,5,104,12,677,39,716,6,6,201832
14,16,107,10,142,70,13,48,2,392,40,432,2,6,201832
14,17,24,9,27,19,4,19,7,109,3,112,2,6,201832
14,18,132,30,123,80,20,44,24,453,15,468,4,6,201832
14,19,112,30,108,92,7,61,0,410,5,415,2,6,201832
14,20,89,8,92,28,0,31,0,248,0,248,2,6,201832
15,1,33,3,42,18,35,11,0,142,0,142,2,6,201832
15,2,81,18,187,200,7,53,3,549,7,556,4,6,201832
15,3,42,4,84,57,19,24,1,231,1,232,2,6,201832
15,4,63,16,123,144,16,21,0,383,6,389,2,6,201832
15,5,18,12,64,67,10,14,0,185,2,187,3,6,201832
15,6,29,7,82,117,7,24,1,267,5,272,3,6,201832
15,7,95,26,185,223,20,60,2,611,4,615,2,6,201832
15,8,51,4,116,120,1,23,0,315,5,320,2,6,201832
15,9,75,5,46,72,34,25,6,263,9,272,7,6,201832
15,10,60,18,100,123,25,24,4,354,2,356,3,6,201832
15,11,82,25,132,199,6,43,0,487,1,488,3,6,201832
15,12,51,7,77,58,25,20,0,238,3,241,2,6,201832
15,13,33,16,84,83,26,38,0,280,11,291,3,5,201832
15,14,59,12,80,100,13,36,0,300,6,306,2,6,201832
15,15,70,59,162,167,15,52,0,525,12,537,3,6,201832
15,16,60,32,126,198,16,24,5,461,5,466,4,6,201832
15,17,84,20,129,166,4,80,25,508,7,515,3,6,201832
15,18,45,6,56,86,3,19,0,215,1,216,2,6,201832
15,19,110,71,248,442,11,71,3,956,10,966,3,6,201832
15,20,69,19,168,146,13,62,0,477,3,480,3,6,201832
15,21,36,10,38,66,5,30,0,185,0,185,4,6,201832
15,22,100,62,217,282,12,61,18,752,3,755,2,6,201832
15,23,65,14,80,178,2,32,0,371,4,375,3,6,201832
15,24,49,17,98,119,16,36,4,339,10,349,2,6,201832
15,25,55,13,136,129,6,39,1,379,5,384,6,5,201832
15,26,73,7,109,137,20,48,0,394,2,396,2,6,201832
15,27,44,16,62,88,1,25,0,236,5,241,3,6,201832
15,28,147,30,379,221,24,77,4,882,4,886,4,6,201832
15,29,61,29,157,213,2,64,0,526,1,527,3,6,201832
15,30,69,22,137,121,23,28,1,401,10,411,4,6,201832
15,31,95,66,189,205,4,57,0,616,4,620,3,6,201832
15,32,90,20,139,231,15,52,0,547,48,595,4,6,201832
15,33,34,18,90,73,13,15,0,243,0,243,3,6,201832
15,34,98,22,160,223,7,52,2,564,8,572,3,6,201832
15,35,62,11,76,82,0,33,0,264,2,266,3,6,201832
15,36,90,12,87,97,12,29,3,330,16,346,5,6,201832
15,37,86,20,131,191,19,46,7,500,14,514,6,6,201832
15,38,84,23,102,173,2,34,0,418,15,433,4,6,201832
15,39,20,9,60,79,12,12,2,194,1,195,2,6,201832
15,40,48,13,66,93,10,14,0,244,4,248,5,6,201832
15,41,68,28,241,284,14,47,0,682,7,689,7,6,201832
16,1,58,20,138,72,4,37,0,329,10,339,2,6,201832
16,2,63,17,37,52,8,42,2,221,2,223,2,6,201832
16,3,75,18,64,83,6,30,0,276,10,286,2,6,201832
16,4,81,12,75,49,0,17,0,234,0,234,2,6,201832
16,5,82,14,51,39,3,25,0,214,9,223,2,6,201832
16,6,56,13,60,48,12,16,0,205,0,205,2,6,201832
16,7,78,22,56,65,10,30,0,261,15,276,2,6,201832
16,8,227,46,339,331,2,124,7,1076,0,1076,2,6,201832
16,9,79,57,107,78,5,40,0,366,1,367,2,6,201832
16,10,43,6,57,80,0,20,0,206,4,210,2,6,201832
16,11,44,6,37,25,25,19,0,156,17,173,2,6,201832
16,12,102,22,117,66,1,34,0,342,3,345,2,6,201832
17,1,105,22,211,166,14,60,2,580,23,603,3,7,201832
17,2,125,26,184,182,12,35,5,569,89,658,7,6,201832
17,3,114,17,141,179,7,39,0,497,15,512,3,6,201832
17,4,168,29,181,201,13,88,4,684,30,714,6,6,201832
17,5,44,9,58,73,2,19,0,205,10,215,3,6,201832
18,1,58,31,47,75,1,36,0,248,6,254,2,6,201832
18,2,208,81,347,302,69,125,0,1132,26,1158,8,6,201832
18,3,99,13,165,110,6,29,0,422,9,431,4,6,201832
19,1,49,18,123,138,12,49,0,389,1,390,4,6,201832
19,2,186,25,428,179,22,96,1,937,1,938,5,6,201832
19,3,145,32,283,209,14,64,3,750,8,758,4,5.5,201832
19,4,53,9,112,93,6,38,22,333,10,343,2,6,201832
19,5,79,24,98,139,9,41,12,402,5,407,4,3,201832
19,6,34,18,78,116,0,36,4,286,12,298,2,5,201832
19,7,95,6,217,52,2,25,0,397,2,399,2,6,201832
19,8,17,6,43,29,0,14,0,109,2,111,2,4,201832
19,9,40,14,42,37,6,29,10,178,2,180,2,6,201832
19,10,67,11,92,142,2,28,0,342,5,347,2,5,201832
19,11,165,69,303,321,3,143,0,1004,2,1006,4,6,201832
19,12,37,6,45,41,2,18,0,149,0,149,2,5,201832
20,1,87,15,93,96,17,51,7,366,4,370,2,6,201832
20,2,15,5,7,16,1,4,0,48,0,48,2,6,201832
20,3,58,17,64,94,4,31,1,269,0,269,2,6,201832
20,4,43,10,27,29,6,10,5,130,2,132,2,6,201832
20,5,45,10,58,53,3,25,0,194,1,195,2,6,201832
20,6,34,6,30,48,11,12,1,142,0,142,2,6,201832
20,7,62,22,42,87,5,16,0,234,1,235,4,6,201832
20,8,244,61,368,674,15,137,62,1561,36,1597,14,3.333333333,201832
20,9,82,16,49,81,7,20,9,264,3,267,6,6,201832
20,10,61,6,32,51,2,22,0,174,0,174,2,6,201832
21,1,74,6,61,130,5,28,0,304,45,349,4,6,201832
21,2,2,2,8,10,0,2,0,24,1,25,2,6,201832
21,3,81,6,78,68,9,52,0,294,1,295,4,6,201832
21,4,23,0,11,12,5,11,3,65,10,75,2,5,201832
21,5,88,15,139,87,4,38,8,379,5,384,4,5.5,201832
21,6,94,23,217,281,24,92,41,772,24,796,2,6,201832
21,7,71,13,86,92,21,38,0,321,12,333,4,5.5,201832
21,8,44,9,36,58,6,17,0,170,5,175,2,6,201832
21,9,120,33,320,261,32,101,8,875,19,894,4,6,201832
21,10,111,21,147,169,11,76,20,555,12,567,2,6,201832
21,11,29,2,62,57,4,25,3,182,1,183,2,6,201832
21,12,160,40,470,460,13,140,9,1292,18,1310,4,6,201832
21,13,136,16,157,185,38,79,1,612,13,625,4,6,201832
21,14,64,10,51,60,2,36,0,223,1,224,4,6,201832
21,15,87,11,165,132,16,51,0,462,2,464,2,6,201832
22,1,69,14,65,103,0,17,0,268,27,295,3,6,201832
22,2,111,19,187,76,37,46,27,503,9,512,5,6,201832
22,3,230,49,561,424,11,93,0,1368,16,1384,8,6,201832
22,4,180,61,499,360,23,96,0,1219,17,1236,10,5.666666667,201832
22,5,74,16,246,73,19,44,1,473,8,481,6,6,201832
23,1,167,9,544,126,5,42,9,902,14,916,5,6,201832
23,2,58,15,112,115,1,35,0,336,9,345,4,6,201832
23,3,166,14,477,148,4,37,0,846,0,846,2,6,201832
23,4,140,14,582,165,7,47,0,955,9,964,3,6,201832
24,1,60,20,48,50,0,39,0,217,7,224,2,6,201832
24,2,97,28,106,112,2,49,0,394,14,408,2,6,201832
24,3,87,23,62,66,14,36,0,288,16,304,2,6,201832
24,4,61,14,80,93,7,46,12,313,58,371,2,6,201832
24,5,185,45,348,352,14,91,0,1035,86,1121,6,5.666666667,201832
24,6,186,49,352,308,9,102,0,1006,21,1027,2,6,201832
24,7,18,3,16,32,0,8,0,77,4,81,2,6,201832
25,1,71,18,120,181,6,72,11,479,18,497,3,6,201832
25,2,179,49,241,327,11,104,0,911,14,925,3,6,201832
25,3,95,27,105,173,4,51,15,470,0,470,5,4.666666667,201832
25,4,46,19,67,123,6,38,0,299,5,304,3,6,201832
25,5,168,29,233,406,10,129,1,976,29,1005,5,6,201832
25,6,99,17,150,152,18,85,0,521,9,530,4,6,201832
25,7,80,12,103,147,4,45,0,391,2,393,2,6,201832
26,1,28,6,35,47,1,27,0,144,0,144,2,6,201832
26,2,63,9,91,70,0,30,0,263,3,266,2,6,201832
26,3,179,35,281,380,10,214,4,1103,57,1160,13,6,201832
26,4,13,8,11,22,1,4,0,59,1,60,2,5,201832
26,5,50,12,38,94,1,35,0,230,6,236,1,6,201832
26,6,168,28,278,318,1,133,0,926,38,964,7,6,201832
26,7,85,14,81,130,7,51,0,368,5,373,6,6,201832
27,1,73,9,47,113,8,28,0,278,16,294,5,6,201832
27,2,63,7,62,140,4,19,0,295,11,306,6,6,201832
27,3,75,11,40,152,4,23,1,306,22,328,5,6,201832
27,4,80,24,110,303,9,32,0,558,26,584,5,6,201832
27,5,21,1,17,34,1,11,0,85,1,86,2,6,201832
27,6,67,12,79,183,4,37,0,382,10,392,5,6,201832
28,1,107,17,187,132,6,49,0,498,0,498,7,6,201832
28,2,197,23,327,248,15,60,79,949,4,953,6,6,201832
28,3,55,8,46,56,0,12,0,177,0,177,3,6,201832
28,4,166,44,261,163,22,77,41,774,0,774,8,6,201832
28,5,61,22,122,155,6,59,0,425,0,425,4,6,201832
28,6,33,12,48,64,5,25,9,196,1,197,4,6,201832
28,7,105,32,334,279,20,83,0,853,0,853,6,6,201832
28,8,33,14,90,108,13,40,0,298,6,304,4,6,201832
28,9,133,21,232,141,21,34,24,606,54,660,9,6,201832
29,1,51,8,66,47,15,16,0,203,36,239,2,6,201832
29,2,124,30,143,254,20,70,26,667,55,722,8,6,201832
29,3,75,18,93,193,4,35,0,418,44,462,3,6,201832
30,1,5,2,6,12,0,7,5,37,0,37,2,6,201832
30,2,1,1,2,3,2,0,7,16,1,17,2,6,201832
30,3,57,14,97,48,21,26,23,286,10,296,4,6,201832
30,4,27,6,58,70,9,21,0,191,5,196,8,4,201832
30,5,58,19,108,181,3,60,0,429,0,429,2,6,201832
30,6,32,4,59,57,3,13,1,169,2,171,5,6,201832
30,7,55,22,55,83,7,36,0,258,11,269,2,6,201832
30,8,61,13,111,113,19,29,2,348,20,368,5,6,201832
30,9,70,12,84,67,13,34,16,296,9,305,4,6,201832
30,10,69,38,212,268,18,84,14,703,24,727,6,6,201832
30,11,23,11,108,124,1,33,0,300,20,320,2,6,201832
30,12,44,23,107,146,1,37,6,364,12,376,7,6,201832
30,13,62,13,64,118,10,35,1,303,19,322,4,6,201832
30,14,46,15,73,81,11,41,1,268,6,274,5,6,201832
30,15,104,11,109,131,18,43,32,448,10,458,9,6,201832
30,16,58,11,109,162,13,63,19,435,9,444,6,6,201832
30,17,36,21,64,92,6,29,1,249,4,253,4,6,201832
30,18,27,3,10,21,1,8,1,71,2,73,2,6,201832
30,19,49,9,60,108,10,25,1,262,16,278,6,6,201832
30,20,10,0,23,14,4,3,0,54,0,54,2,6,201832
31,1,50,3,41,64,5,10,0,173,4,177,4,6,201832
31,2,15,2,30,3,15,12,0,77,3,80,2,6,201832
31,3,197,44,643,461,62,120,0,1527,31,1558,20,6,201832
31,4,2,0,8,7,1,2,0,20,2,22,2,6,201832
31,5,38,5,42,25,18,28,0,156,1,157,2,6,201832
32,1,67,27,87,103,11,37,9,341,10,351,4,6,201832
32,2,78,19,51,61,3,47,0,259,29,288,2,6,201832
32,3,110,52,143,159,7,60,6,537,10,547,7,6,201832
32,4,90,33,127,103,5,50,5,413,14,427,4,6,201832
1,1,232,62,323,287,45,90,3,1042,388,1430,13,5.5,201833
1,2,265,63,693,396,67,149,10,1643,1197,2840,10,4.75,201833
1,3,207,98,653,411,35,122,5,1531,785,2316,9,6,201833
2,1,231,20,466,389,13,91,3,1213,402,1615,11,6,201833
2,2,277,47,510,557,19,182,0,1592,265,1857,8,6.5,201833
2,3,363,39,609,423,13,185,0,1632,150,1782,11,4.333333333,201833
2,4,243,15,758,287,31,62,2,1398,281,1679,9,6,201833
2,5,608,55,1330,552,122,247,11,2925,786,3711,14,6.333333333,201833
2,6,361,48,747,308,31,114,0,1609,193,1802,7,6,201833
2,7,382,33,694,476,21,127,8,1741,260,2001,10,6,201833
2,8,385,37,866,498,11,143,1,1941,167,2108,8,6,201833
3,1,155,26,289,278,9,95,0,852,267,1119,9,6,201833
3,2,267,18,645,267,22,53,0,1272,267,1539,9,5.666666667,201833
4,1,140,14,196,289,11,55,0,705,305,1010,6,6,201833
4,2,70,4,140,111,7,19,0,351,149,500,6,6,201833
5,1,299,46,503,304,48,138,0,1338,198,1536,9,5.666666667,201833
5,2,206,37,356,305,21,74,1,1000,89,1089,10,5.2,201833
5,3,197,47,333,362,46,132,58,1175,328,1503,9,5.5,201833
5,4,226,50,553,441,12,127,12,1421,592,2013,9,5.666666667,201833
5,5,180,51,439,389,19,88,23,1189,419,1608,8,6,201833
5,6,128,32,276,225,16,43,30,750,196,946,11,5.5,201833
5,7,218,27,248,283,3,62,2,843,287,1130,10,5.5,201833
6,1,152,36,362,273,10,100,8,941,375,1316,11,5.8,201833
6,2,196,39,418,217,56,95,4,1025,347,1372,9,5.666666667,201833
7,1,170,3,94,107,5,17,0,396,43,439,3,6,201833
7,2,80,1,22,69,0,10,0,182,9,191,3,6,201833
7,3,216,4,63,74,43,19,0,419,53,472,7,4,201833
7,4,117,7,45,93,1,19,0,282,26,308,5,6,201833
7,5,500,21,189,435,14,56,5,1220,330,1550,11,4.666666667,201833
7,6,169,21,204,251,14,59,9,727,192,919,9,3.25,201833
7,7,156,21,123,182,6,47,0,535,103,638,4,6,201833
7,8,343,17,181,462,29,95,0,1127,137,1264,12,5.25,201833
7,9,217,51,315,358,20,112,0,1073,57,1130,8,6.5,201833
7,10,210,7,164,197,28,37,0,643,93,736,5,6,201833
7,11,128,5,150,101,4,15,0,403,5,408,6,5.333333333,201833
7,12,281,22,246,422,5,74,0,1050,125,1175,5,6,201833
7,13,20,1,26,29,0,9,0,85,5,90,3,6,201833
8,1,177,19,405,205,8,44,0,858,275,1133,4,6,201833
8,2,368,58,637,364,26,153,9,1615,577,2192,16,5.5,201833
8,3,244,46,512,375,15,96,12,1300,543,1843,4,6,201833
8,4,171,42,441,315,28,120,17,1134,361,1495,4,5.5,201833
8,5,143,19,192,184,11,63,0,612,171,783,10,2.25,201833
8,6,267,56,521,435,50,170,27,1526,593,2119,8,4.333333333,201833
8,7,292,65,317,308,16,103,1,1102,68,1170,7,5.25,201833
8,8,242,39,479,425,19,120,10,1334,563,1897,10,6,201833
8,9,76,14,108,95,8,59,0,360,25,385,3,6,201833
9,1,162,33,259,162,60,63,11,750,123,873,5,6,201833
9,2,319,124,937,950,59,199,9,2597,739,3336,12,6,201833
9,3,161,42,494,390,52,155,22,1316,561,1877,7,6,201833
9,4,241,33,437,530,56,107,13,1417,579,1996,11,6,201833
9,5,147,27,319,338,54,98,5,988,299,1287,7,6,201833
9,6,118,30,190,161,60,87,5,651,193,844,7,6,201833
9,7,109,28,328,382,6,78,0,931,313,1244,9,6,201833
9,8,110,17,313,240,27,83,25,815,216,1031,5,6,201833
9,9,118,23,261,309,42,75,9,837,226,1063,5,6,201833
9,10,134,29,393,372,20,81,0,1029,279,1308,6,6,201833
9,11,207,42,560,497,48,153,2,1509,234,1743,7,6,201833
9,12,179,53,633,547,26,137,22,1597,290,1887,11,5.5,201833
9,13,119,29,325,417,42,91,20,1043,233,1276,4,6,201833
9,14,128,20,238,194,92,73,18,763,306,1069,5,6,201833
9,15,253,56,1122,1016,36,214,4,2701,515,3216,9,6.5,201833
9,16,252,77,504,601,75,174,0,1683,581,2264,15,6,201833
9,17,189,17,278,282,19,79,2,866,299,1165,6,6,201833
9,18,232,49,476,667,53,128,4,1609,244,1853,12,6,201833
9,19,225,55,360,330,137,100,14,1221,107,1328,5,6,201833
9,20,46,6,79,70,10,30,6,247,106,353,5,6,201833
9,21,136,24,212,219,47,69,16,723,142,865,3,6,201833
9,22,190,39,288,302,125,105,14,1063,100,1163,5,6,201833
9,23,160,28,359,446,76,97,5,1171,360,1531,6,6,201833
9,24,369,72,667,789,87,179,15,2178,516,2694,12,6,201833
10,1,190,158,131,131,103,32,0,745,105,850,4,6,201833
10,2,200,34,314,282,40,82,34,986,65,1051,4,6,201833
10,3,113,38,135,159,13,57,0,515,194,709,6,6,201833
10,4,341,62,472,468,13,104,0,1460,579,2039,11,6,201833
11,1,358,45,148,199,6,75,15,846,245,1091,6,4.666666667,201833
11,2,337,38,258,238,31,85,8,995,307,1302,7,6,201833
11,3,150,54,218,262,17,71,23,795,219,1014,3,6,201833
11,4,235,32,164,194,6,63,0,694,230,924,5,4.333333333,201833
11,5,418,164,466,489,4,111,0,1652,452,2104,8,6,201833
11,6,274,51,419,280,34,88,15,1161,175,1336,7,5.666666667,201833
11,7,324,64,323,404,16,93,0,1224,318,1542,9,5.5,201833
11,8,327,62,411,360,21,90,7,1278,207,1485,7,6,201833
11,9,420,88,413,461,12,131,3,1528,687,2215,10,5.666666667,201833
11,10,326,80,311,315,28,104,49,1213,546,1759,10,4.8,201833
11,11,221,48,275,265,15,74,0,898,39,937,5,6,201833
11,12,370,79,662,559,16,107,0,1793,418,2211,7,6,201833
11,13,253,47,189,162,23,58,50,782,258,1040,8,4.5,201833
11,14,232,51,239,266,26,70,16,900,245,1145,8,4.5,201833
11,15,206,45,223,259,0,70,0,803,251,1054,8,6,201833
12,1,218,40,281,105,43,51,1,739,69,808,10,5.2,201833
12,2,236,64,282,372,17,70,0,1041,274,1315,10,5,201833
12,3,268,67,283,385,22,76,2,1103,101,1204,11,5.2,201833
12,4,208,73,346,464,19,87,1,1198,338,1536,7,6,201833
12,5,392,44,249,336,7,61,62,1151,131,1282,10,5.25,201833
12,6,198,9,93,106,5,23,0,434,81,515,4,6,201833
12,7,288,27,272,293,8,71,6,965,299,1264,4,6,201833
12,8,104,3,68,50,0,10,0,235,42,277,3,6,201833
12,9,215,61,287,398,13,95,2,1071,251,1322,7,6,201833
13,1,149,17,113,239,23,51,2,594,137,731,5,6,201833
13,2,109,24,82,151,35,47,10,458,17,475,2,6,201833
13,3,70,8,124,125,71,43,0,441,103,544,6,6,201833
13,4,153,24,259,260,39,81,2,818,59,877,5,6,201833
13,7,206,69,576,529,50,85,9,1524,251,1775,7,6,201833
13,5,213,26,385,276,65,99,22,1086,643,1729,7,6,201833
13,6,237,76,727,1145,29,122,0,2336,309,2645,10,6,201833
14,1,104,34,85,66,10,51,0,350,31,381,3,6,201833
14,2,263,39,248,148,10,103,2,813,103,916,5,5,201833
14,3,275,36,282,174,4,126,6,903,91,994,6,4.666666667,201833
14,4,276,40,325,348,17,104,7,1117,363,1480,6,6,201833
14,5,224,36,455,258,30,55,7,1065,49,1114,9,4.5,201833
14,6,307,33,526,289,10,95,1,1261,371,1632,11,6,201833
14,7,166,20,230,101,0,33,0,550,146,696,6,6,201833
14,8,410,80,885,818,15,223,7,2438,600,3038,11,5,201833
14,9,115,26,199,183,21,50,0,594,72,666,12,7,201833
14,10,229,38,371,280,12,109,3,1042,352,1394,7,6,201833
14,11,174,37,218,248,24,85,1,787,214,1001,4,6,201833
14,12,283,16,471,124,3,56,0,953,227,1180,9,4.5,201833
14,13,313,32,385,276,16,89,0,1111,148,1259,6,6,201833
14,14,175,31,323,288,5,98,0,920,254,1174,7,6,201833
14,15,453,94,347,347,34,161,11,1447,382,1829,10,5.6,201833
14,16,203,31,356,187,24,99,9,909,282,1191,5,6,201833
14,17,86,17,79,34,5,28,14,263,54,317,2,6,201833
14,18,237,37,208,113,23,55,39,712,60,772,4,6,201833
14,19,200,45,209,217,11,76,4,762,217,979,8,3,201833
14,20,158,17,244,106,4,61,6,596,142,738,10,5.666666667,201833
15,1,156,18,148,86,173,47,4,632,75,707,7,5.333333333,201833
15,2,174,32,329,378,19,84,10,1026,289,1315,6,6,201833
15,3,293,44,320,342,65,77,11,1152,57,1209,10,5,201833
15,4,236,38,317,405,43,93,13,1145,189,1334,4,6,201833
15,5,148,31,245,280,11,55,0,770,19,789,8,5.666666667,201833
15,6,189,35,439,443,45,98,2,1251,80,1331,7,6,201833
15,7,166,32,346,373,35,96,1,1049,248,1297,10,6,201833
15,8,86,18,179,213,4,42,1,543,38,581,4,6,201833
15,9,196,15,105,184,67,26,18,611,112,723,9,5.75,201833
15,10,127,29,298,268,45,71,11,849,139,988,6,6,201833
15,11,194,34,366,455,20,102,0,1171,257,1428,8,6,201833
15,12,245,35,603,524,26,111,1,1545,115,1660,8,6,201833
15,13,95,19,197,232,66,59,0,668,72,740,8,6,201833
15,14,73,27,145,165,25,48,0,483,256,739,4,6,201833
15,15,221,76,376,372,28,96,0,1169,274,1443,6,6,201833
15,16,267,64,489,698,18,127,4,1667,194,1861,8,6,201833
15,17,106,33,207,250,13,70,46,725,215,940,8,6,201833
15,18,221,35,316,395,20,92,4,1083,132,1215,7,5.666666667,201833
15,19,217,99,546,694,10,114,1,1681,231,1912,10,6,201833
15,20,93,21,210,267,11,62,0,664,98,762,6,6,201833
15,21,151,22,143,181,26,66,0,589,106,695,6,5.5,201833
15,22,315,82,598,711,23,159,47,1935,360,2295,14,6,201833
15,23,128,23,176,242,27,65,0,661,167,828,3,6,201833
15,24,216,36,306,328,26,60,5,977,176,1153,4,6,201833
15,25,211,61,344,339,16,89,4,1064,199,1263,6,6,201833
15,26,113,5,213,215,34,60,0,640,180,820,8,6,201833
15,27,238,42,355,517,3,77,8,1240,161,1401,9,5.666666667,201833
15,28,233,42,620,396,62,91,6,1450,415,1865,9,5.666666667,201833
15,29,243,63,452,588,10,121,1,1478,166,1644,8,6,201833
15,30,181,31,392,417,33,72,13,1139,45,1184,18,7,201833
15,31,150,74,239,320,8,83,0,874,259,1133,6,6,201833
15,32,137,22,301,381,28,63,0,932,319,1251,9,6,201833
15,33,170,28,313,314,16,73,0,914,11,925,4,6,201833
15,34,143,26,220,377,19,78,5,868,235,1103,8,6,201833
15,35,231,30,204,293,14,65,3,840,142,982,7,6,201833
15,36,152,35,156,194,7,42,0,586,140,726,5,6,201833
15,37,189,30,361,399,52,107,15,1153,241,1394,7,6,201833
15,38,171,51,291,360,8,84,0,965,229,1194,4,6,201833
15,39,188,42,328,450,23,68,1,1100,65,1165,4,6,201833
15,40,241,26,259,405,44,86,0,1061,95,1156,9,6,201833
15,41,201,51,516,539,33,91,32,1463,327,1790,11,6,201833
16,1,194,26,259,217,12,55,5,768,204,972,7,5.333333333,201833
16,2,194,37,136,240,15,85,0,707,118,825,9,5.25,201833
16,3,201,28,139,219,26,50,0,663,134,797,10,5.25,201833
16,4,297,43,318,255,45,109,0,1067,135,1202,8,5.5,201833
16,5,347,92,303,230,30,101,15,1118,129,1247,10,5.666666667,201833
16,6,270,55,225,197,25,65,0,837,76,913,12,5.5,201833
16,7,312,44,229,193,32,86,2,898,227,1125,9,5.5,201833
16,8,364,78,617,506,19,146,1,1731,556,2287,12,6,201833
16,9,297,65,336,270,19,97,0,1084,143,1227,9,6,201833
16,10,219,25,383,334,18,94,0,1073,140,1213,7,6.5,201833
16,11,282,41,216,188,78,96,2,903,140,1043,10,5.4,201833
16,12,242,38,228,143,20,56,1,728,179,907,10,5.25,201833
17,1,201,28,459,416,22,93,1,1220,300,1520,10,8,201833
17,2,183,21,295,281,11,60,12,863,312,1175,9,5.666666667,201833
17,3,241,35,251,350,7,60,0,944,268,1212,6,6,201833
17,4,267,33,355,356,16,93,1,1121,374,1495,10,5.666666667,201833
17,5,89,12,125,118,8,28,0,380,111,491,5,5.5,201833
18,1,83,18,88,135,11,36,0,371,124,495,3,4,201833
18,2,261,55,385,341,60,97,0,1199,579,1778,8,6,201833
18,3,133,30,280,150,7,34,0,634,193,827,4,6,201833
19,1,240,46,400,388,16,117,14,1221,197,1418,9,6,201833
19,2,339,35,720,292,31,108,0,1525,440,1965,9,6,201833
19,3,339,47,688,342,24,142,12,1594,147,1741,7,6,201833
19,4,136,25,217,154,33,64,56,685,176,861,5,6,201833
19,5,451,71,607,655,13,172,20,1989,275,2264,8,6,201833
19,6,99,19,284,284,7,69,4,766,148,914,5,6,201833
19,7,138,9,421,122,1,30,0,721,205,926,6,6,201833
19,8,51,14,161,85,1,22,0,334,18,352,7,6,201833
19,9,58,14,76,71,7,29,15,270,78,348,3,6,201833
19,10,141,29,269,272,6,78,0,795,158,953,5,6,201833
19,11,478,121,881,862,26,236,8,2612,556,3168,13,6,201833
19,12,244,25,534,247,12,88,5,1155,67,1222,6,6,201833
20,1,147,20,142,126,26,66,17,544,200,744,5,6,201833
20,2,21,1,17,25,0,7,0,71,22,93,2,6,201833
20,3,84,10,91,137,11,25,1,359,73,432,2,6,201833
20,4,220,35,150,326,46,59,16,852,96,948,6,4.666666667,201833
20,5,80,8,96,128,7,24,0,343,143,486,4,6,201833
20,6,122,7,67,118,43,23,0,380,43,423,2,6,201833
20,7,183,42,208,247,0,45,0,725,112,837,7,5.75,201833
20,8,515,68,540,848,30,205,122,2328,767,3095,14,6.5,201833
20,9,247,24,117,175,36,69,18,686,56,742,6,6,201833
20,10,133,8,81,117,1,22,0,362,63,425,2,6,201833
21,1,120,10,123,232,1,37,1,524,188,712,4,6,201833
21,2,82,9,77,118,3,27,0,316,11,327,2,6,201833
21,3,179,10,221,124,35,72,17,658,119,777,5,6,201833
21,4,84,2,47,61,23,26,0,243,30,273,2,6,201833
21,5,212,19,337,284,21,91,6,970,168,1138,6,6,201833
21,6,220,30,376,447,34,119,52,1278,127,1405,6,6,201833
21,7,196,23,147,260,38,61,1,726,146,872,7,6,201833
21,8,91,3,91,118,5,26,5,339,81,420,3,6,201833
21,9,205,24,466,410,44,105,25,1279,438,1717,9,6,201833
21,10,190,24,286,270,22,75,24,891,288,1179,5,6,201833
21,11,47,5,117,77,11,24,4,285,104,389,4,6,201833
21,12,332,34,823,802,52,198,37,2278,631,2909,15,6,201833
21,13,231,20,247,335,51,106,9,999,213,1212,6,6,201833
21,14,113,7,106,114,3,38,1,382,103,485,6,6,201833
21,15,223,14,309,275,42,77,2,942,204,1146,5,6,201833
22,1,104,11,83,136,1,24,0,359,134,493,3,6,201833
22,2,188,30,289,166,29,53,32,787,241,1028,7,5,201833
22,3,315,53,825,575,18,126,2,1914,678,2592,10,5.666666667,201833
22,4,240,44,665,479,32,91,0,1551,599,2150,11,4.75,201833
22,5,217,34,438,211,37,53,2,992,184,1176,10,5.5,201833
23,1,230,12,1057,205,9,38,11,1562,497,2059,14,4.4,201833
23,2,158,21,259,243,6,37,0,724,175,899,8,3.75,201833
23,3,201,9,509,248,20,49,0,1036,20,1056,12,5,201833
23,4,176,10,736,250,18,32,0,1222,310,1532,7,4.333333333,201833
24,1,88,16,64,88,2,24,0,282,112,394,3,4,201833
24,2,161,28,175,136,8,42,0,550,191,741,4,4,201833
24,3,140,30,114,132,19,39,0,474,176,650,4,4,201833
24,4,150,37,200,174,30,74,29,694,155,849,4,4,201833
24,5,304,54,445,473,9,96,0,1381,465,1846,6,6,201833
24,6,420,92,664,546,24,158,3,1907,220,2127,4,6,201833
24,7,78,10,71,85,10,22,0,276,30,306,2,6,201833
25,1,142,32,229,287,38,79,12,819,281,1100,7,5.75,201833
25,2,243,36,404,499,27,107,0,1316,479,1795,5,5.5,201833
25,3,279,34,375,399,26,114,3,1230,347,1577,8,5.6,201833
25,4,169,40,166,290,10,68,23,766,164,930,7,5.333333333,201833
25,5,237,43,384,528,19,131,0,1342,584,1926,7,5.666666667,201833
25,6,216,31,423,370,46,139,10,1235,268,1503,8,5.5,201833
25,7,290,29,349,506,7,152,1,1334,267,1601,4,6,201833
26,1,276,28,364,248,11,106,0,1033,87,1120,9,4.5,201833
26,2,349,18,513,483,2,133,0,1498,181,1679,12,4.2,201833
26,3,317,45,451,605,12,232,11,1673,596,2269,13,6,201833
26,4,117,29,136,233,6,64,11,596,39,635,9,4,201833
26,5,72,12,113,144,9,37,0,387,142,529,3,5.5,201833
26,6,230,34,384,394,5,121,0,1168,488,1656,10,4.666666667,201833
26,7,168,26,144,247,19,71,0,675,167,842,10,5,201833
27,1,118,16,92,187,6,31,3,453,157,610,4,6,201833
27,2,237,26,189,339,5,47,0,843,115,958,6,6,201833
27,3,133,11,114,259,9,37,0,563,141,704,5,6,201833
27,4,175,20,222,424,6,63,3,913,304,1217,6,3.5,201833
27,5,42,4,35,76,3,13,0,173,52,225,2,6,201833
27,6,131,17,158,325,4,49,1,685,183,868,5,6,201833
28,1,268,36,537,396,9,96,1,1343,166,1509,13,6,201833
28,2,263,38,459,251,20,103,91,1225,454,1679,11,6,201833
28,3,104,14,104,102,1,24,0,349,8,357,3,6,201833
28,4,370,41,570,418,36,141,87,1663,120,1783,15,6,201833
28,5,168,38,262,321,14,85,11,899,204,1103,10,4.4,201833
28,6,64,15,91,89,8,33,20,320,112,432,4,6,201833
28,7,184,31,525,366,36,101,0,1243,465,1708,6,6,201833
28,8,120,49,320,292,36,108,13,938,181,1119,9,6,201833
28,9,185,15,354,186,12,48,47,847,240,1087,9,6,201833
29,1,275,68,396,402,83,79,0,1303,102,1405,7,5.5,201833
29,2,198,42,266,475,27,82,40,1130,308,1438,10,5.5,201833
29,3,168,28,146,284,18,51,0,695,248,943,5,5.666666667,201833
30,1,40,8,49,67,4,22,25,215,25,240,3,6,201833
30,2,73,9,51,51,18,17,56,275,9,284,2,6,201833
30,3,158,20,219,146,53,86,73,755,156,911,4,6,201833
30,4,110,19,264,214,21,78,1,707,141,848,8,6,201833
30,5,121,17,165,252,4,54,0,613,178,791,5,6,201833
30,6,49,6,82,100,1,16,2,256,86,342,5,6,201833
30,7,124,20,113,129,19,46,13,464,119,583,5,6,201833
30,8,123,16,176,198,20,68,3,604,200,804,5,6,201833
30,9,173,25,158,142,35,57,45,635,168,803,4,6,201833
30,10,160,33,289,299,21,105,48,955,425,1380,6,5,201833
30,11,136,21,295,347,7,98,0,904,230,1134,4,6,201833
30,12,241,43,511,568,22,167,4,1556,266,1822,10,6,201833
30,13,124,8,104,167,33,56,21,513,167,680,4,6,201833
30,14,109,21,197,160,32,61,7,587,137,724,4,6,201833
30,15,238,15,227,233,29,119,103,964,246,1210,9,6,201833
30,16,153,13,209,318,21,98,21,833,204,1037,6,6,201833
30,17,104,21,139,149,21,70,1,505,86,591,4,6,201833
30,18,50,2,22,56,0,12,0,142,18,160,2,6,201833
30,19,125,14,145,151,10,53,1,499,142,641,9,6,201833
30,20,102,16,138,150,29,49,0,484,26,510,4,6,201833
31,1,166,17,156,262,14,57,0,672,68,740,8,5.5,201833
31,2,82,26,144,47,201,36,0,536,52,588,6,5.333333333,201833
31,3,341,54,833,586,59,132,0,2005,686,2691,20,6,201833
31,4,81,9,293,195,32,43,1,654,30,684,3,6,201833
31,5,144,7,157,175,40,48,0,571,10,581,5,5.333333333,201833
32,1,171,56,178,180,27,57,38,707,181,888,12,3.6,201833
32,2,212,48,159,126,57,70,24,696,186,882,13,2.571428571,201833
32,3,196,63,243,259,16,88,13,878,271,1149,13,4,201833
32,4,208,60,207,221,10,66,13,785,211,996,13,3.166666667,201833
1,1,220,52,349,233,68,59,9,990,685,1675,13,5.5,201834
1,2,290,51,691,432,76,103,7,1650,1381,3031,10,4.75,201834
1,3,220,101,698,492,38,108,8,1665,1226,2891,9,6,201834
2,1,198,19,463,383,18,82,3,1166,952,2118,11,6,201834
2,2,306,29,496,534,25,161,0,1551,1033,2584,7,6,201834
2,3,418,40,634,432,28,175,4,1731,444,2175,11,4.25,201834
2,4,257,17,772,267,22,60,3,1398,953,2351,9,6,201834
2,5,564,70,1301,567,136,203,13,2854,2044,4898,13,6,201834
2,6,331,34,733,368,27,108,0,1601,978,2579,7,6,201834
2,7,404,39,730,468,38,126,4,1809,1350,3159,12,5.75,201834
2,8,369,32,929,563,21,127,3,2044,1025,3069,8,6,201834
3,1,194,19,312,272,21,102,4,924,623,1547,12,5.666666667,201834
3,2,223,18,627,298,30,43,0,1239,837,2076,9,5.666666667,201834
4,1,181,33,284,491,21,82,0,1092,536,1628,11,5.25,201834
4,2,244,25,331,384,23,62,0,1069,283,1352,14,5,201834
5,1,279,36,491,356,35,89,0,1286,1108,2394,9,5.666666667,201834
5,2,210,28,380,355,14,68,0,1055,245,1300,10,5.2,201834
5,3,215,33,364,326,42,109,64,1153,897,2050,9,5.5,201834
5,4,240,40,584,386,16,102,59,1427,1146,2573,9,5.666666667,201834
5,5,223,47,446,388,14,79,11,1208,947,2155,8,6,201834
5,6,158,26,292,284,10,55,28,853,563,1416,11,5.5,201834
5,7,193,24,285,305,9,70,1,887,542,1429,10,5.5,201834
6,1,230,62,442,343,11,103,14,1205,671,1876,11,5.8,201834
6,2,233,34,430,240,68,69,2,1076,679,1755,9,5.666666667,201834
7,1,407,12,198,309,7,33,4,970,255,1225,9,5.25,201834
7,2,402,18,200,360,8,43,0,1031,94,1125,9,5.25,201834
7,3,588,12,238,230,180,45,0,1293,284,1577,7,5.333333333,201834
7,4,187,17,163,189,7,50,66,679,180,859,11,5.4,201834
7,5,726,16,265,741,9,81,10,1848,1103,2951,11,5.666666667,201834
7,6,309,36,354,490,34,97,22,1342,508,1850,9,4.25,201834
7,7,348,36,267,412,31,60,0,1154,290,1444,8,5.5,201834
7,8,332,21,327,538,47,151,0,1416,427,1843,12,5.25,201834
7,9,272,51,379,446,25,118,0,1291,528,1819,9,5.666666667,201834
7,10,299,16,302,608,47,57,0,1329,370,1699,9,5.5,201834
7,11,224,7,96,150,14,19,0,510,18,528,6,5.333333333,201834
7,12,424,24,309,522,12,75,0,1366,705,2071,9,5.25,201834
7,13,177,7,118,305,1,30,0,638,43,681,9,4.5,201834
8,1,166,14,402,170,12,46,0,810,743,1553,4,6,201834
8,2,348,47,811,403,52,126,3,1790,1136,2926,17,5.75,201834
8,3,233,48,476,372,15,76,1,1221,1089,2310,4,6,201834
8,4,189,45,480,327,23,79,12,1155,989,2144,9,6,201834
8,5,265,32,320,314,48,99,2,1080,450,1530,10,5.25,201834
8,6,300,52,491,396,41,143,37,1460,1247,2707,8,4.333333333,201834
8,7,309,56,298,343,20,97,0,1123,533,1656,7,5.25,201834
8,8,234,51,443,410,11,116,13,1278,1094,2372,10,6,201834
8,9,210,40,251,239,47,90,0,877,366,1243,10,5.2,201834
9,1,71,20,177,109,51,42,6,476,296,772,5,4,201834
9,2,351,123,961,1030,67,212,25,2769,1857,4626,12,6,201834
9,3,183,61,508,462,50,132,34,1430,899,2329,7,6,201834
9,4,247,51,497,583,49,98,15,1540,961,2501,11,6,201834
9,5,169,26,390,359,68,83,1,1096,693,1789,7,6,201834
9,6,111,26,256,178,74,52,23,720,535,1255,7,6,201834
9,7,120,32,410,445,5,75,1,1088,760,1848,9,6,201834
9,8,91,24,333,262,25,94,34,863,520,1383,5,6,201834
9,9,153,29,310,327,55,85,4,963,612,1575,5,6,201834
9,10,134,22,453,406,14,78,0,1107,671,1778,6,6,201834
9,11,205,35,623,472,87,156,0,1578,837,2415,7,6,201834
9,12,181,55,598,610,20,121,19,1604,1019,2623,11,6,201834
9,13,140,24,414,391,57,93,30,1149,724,1873,4,6,201834
9,14,154,19,236,204,75,83,19,790,656,1446,5,6,201834
9,15,261,67,1157,956,29,230,5,2705,1464,4169,9,6.5,201834
9,16,331,73,614,669,89,150,1,1927,1366,3293,15,6,201834
9,17,162,21,316,290,22,77,0,888,666,1554,6,6,201834
9,18,232,64,496,616,52,132,9,1601,1015,2616,12,6,201834
9,19,258,74,482,377,151,110,11,1463,660,2123,5,6,201834
9,20,46,9,74,85,9,26,6,255,162,417,5,6,201834
9,21,149,24,264,250,35,56,7,785,458,1243,3,6,201834
9,22,224,35,363,340,140,103,31,1236,574,1810,5,6,201834
9,23,153,30,360,405,64,75,14,1101,775,1876,6,6,201834
9,24,403,57,712,665,89,172,15,2113,1408,3521,12,6,201834
10,1,269,37,271,244,25,78,36,960,479,1439,12,4.833333333,201834
10,2,272,47,353,424,30,93,21,1240,644,1884,9,5.25,201834
10,3,229,55,234,354,23,86,65,1046,405,1451,11,5.4,201834
10,4,334,51,505,521,7,114,2,1534,1182,2716,12,4.333333333,201834
11,1,371,52,232,252,18,61,6,992,613,1605,6,5.666666667,201834
11,2,374,51,293,253,33,63,12,1079,791,1870,7,6,201834
11,3,195,42,287,302,26,58,35,945,518,1463,3,6,201834
11,4,276,45,199,269,10,61,0,860,494,1354,8,4.5,201834
11,5,407,61,467,529,32,127,6,1629,1073,2702,7,6,201834
11,6,295,60,477,326,46,90,20,1314,1037,2351,7,5.666666667,201834
11,7,366,48,333,375,19,81,0,1222,757,1979,9,5.5,201834
11,8,305,60,365,381,28,98,18,1255,762,2017,9,5.75,201834
11,9,405,110,522,551,21,123,18,1750,1078,2828,10,5.333333333,201834
11,10,377,89,344,370,27,94,35,1336,989,2325,10,5.6,201834
11,11,216,61,290,263,16,58,0,904,562,1466,5,6,201834
11,12,345,86,564,498,9,98,0,1600,1263,2863,7,6,201834
11,13,441,69,333,297,29,106,37,1312,518,1830,8,5.5,201834
11,14,354,50,347,341,30,91,1,1214,546,1760,8,5.5,201834
11,15,210,48,245,253,4,50,0,810,569,1379,9,6,201834
12,1,262,51,285,156,19,49,0,822,242,1064,10,5,201834
12,2,295,59,290,416,21,70,0,1151,686,1837,10,5.25,201834
12,3,329,85,377,396,31,80,0,1298,280,1578,11,5.2,201834
12,4,234,62,365,554,27,72,0,1314,863,2177,9,5.666666667,201834
12,5,559,31,305,336,1,78,30,1340,369,1709,10,5.25,201834
12,6,409,38,239,365,25,41,0,1117,329,1446,10,5.25,201834
12,7,358,42,341,400,10,54,27,1232,763,1995,6,5.5,201834
12,8,380,19,240,319,6,35,0,999,154,1153,9,5.25,201834
12,9,362,44,340,497,20,59,3,1325,844,2169,9,5.666666667,201834
13,1,254,38,169,447,55,80,5,1048,416,1464,9,5.333333333,201834
13,2,166,22,119,236,55,60,18,676,258,934,6,5.333333333,201834
13,3,132,21,220,255,114,57,0,799,293,1092,12,5.25,201834
13,4,171,24,279,287,46,61,0,868,672,1540,5,6,201834
13,7,236,84,663,560,80,78,12,1713,1007,2720,11,5.6,201834
13,5,239,25,408,349,78,108,22,1229,949,2178,9,5.75,201834
13,6,287,83,937,1235,50,140,0,2732,1684,4416,14,5.5,201834
14,1,265,48,188,162,30,98,25,816,97,913,6,5.5,201834
14,2,283,44,275,178,17,109,1,907,441,1348,5,5.666666667,201834
14,3,347,51,415,341,38,148,13,1353,493,1846,8,5.4,201834
14,4,203,42,336,378,18,78,5,1060,865,1925,11,6,201834
14,5,275,27,557,305,33,91,2,1290,519,1809,9,5.5,201834
14,6,234,32,551,274,13,86,0,1190,929,2119,11,6,201834
14,7,150,15,243,136,0,36,0,580,522,1102,6,6,201834
14,8,398,72,923,844,23,186,8,2454,1502,3956,11,5,201834
14,9,106,28,203,184,30,32,0,583,315,898,12,7,201834
14,10,249,50,446,309,10,95,7,1166,744,1910,7,6,201834
14,11,211,40,178,288,28,61,2,808,549,1357,4,6,201834
14,12,377,29,536,198,15,79,0,1234,894,2128,9,5.5,201834
14,13,255,24,314,230,8,90,0,921,815,1736,6,6,201834
14,14,217,37,338,377,13,85,0,1067,671,1738,7,6,201834
14,15,297,65,247,296,32,131,10,1078,626,1704,10,5.6,201834
14,16,145,23,226,109,25,48,5,581,698,1279,5,5,201834
14,17,228,47,209,175,24,82,20,785,147,932,7,5.25,201834
14,18,397,52,374,261,52,94,40,1270,287,1557,9,5.2,201834
14,19,283,50,328,276,36,83,6,1062,471,1533,8,5.25,201834
14,20,199,20,250,168,11,61,3,712,262,974,10,5.666666667,201834
15,1,199,21,215,111,226,57,2,831,209,1040,7,5.333333333,201834
15,2,190,30,352,364,33,65,16,1050,688,1738,6,6,201834
15,3,305,49,359,443,100,96,28,1380,497,1877,10,5.666666667,201834
15,4,254,41,362,379,26,116,13,1191,695,1886,4,6,201834
15,5,218,33,342,344,14,67,3,1021,491,1512,8,5.666666667,201834
15,6,162,32,402,446,48,82,6,1178,778,1956,7,6,201834
15,7,205,58,414,379,44,96,3,1199,782,1981,10,6,201834
15,8,96,12,200,215,4,48,6,581,451,1032,4,6,201834
15,9,276,13,175,183,134,38,17,836,337,1173,9,5.75,201834
15,10,138,32,324,333,49,88,12,976,518,1494,6,6,201834
15,11,236,32,374,416,34,87,0,1179,788,1967,8,6,201834
15,12,287,21,626,531,23,79,2,1569,811,2380,8,6,201834
15,13,123,30,226,235,68,61,0,743,423,1166,8,6,201834
15,14,88,15,143,180,22,53,0,501,345,846,4,6,201834
15,15,214,92,354,442,29,101,0,1232,623,1855,6,6,201834
15,16,298,58,540,619,17,94,8,1634,824,2458,8,6,201834
15,17,120,38,216,274,11,113,72,844,530,1374,8,6,201834
15,18,303,48,414,396,31,94,4,1290,534,1824,7,5.666666667,201834
15,19,258,98,638,828,7,140,6,1975,1372,3347,10,6,201834
15,20,109,19,250,295,11,64,0,748,548,1296,6,6,201834
15,21,93,14,123,188,9,55,0,482,205,687,6,5.5,201834
15,22,336,94,595,858,27,127,41,2078,1224,3302,14,6,201834
15,23,243,35,318,465,44,95,0,1200,459,1659,6,5.333333333,201834
15,24,180,47,330,311,18,59,5,950,610,1560,4,6,201834
15,25,219,51,426,341,16,91,17,1161,648,1809,6,6,201834
15,26,150,9,256,248,39,62,0,764,444,1208,8,6,201834
15,27,281,29,443,527,6,90,22,1398,550,1948,9,5.666666667,201834
15,28,232,32,593,427,69,88,9,1450,922,2372,9,5.666666667,201834
15,29,272,53,510,655,12,127,0,1629,935,2564,8,6,201834
15,30,229,38,446,387,35,66,18,1219,256,1475,16,6,201834
15,31,154,86,230,354,3,66,0,893,671,1564,6,6,201834
15,32,184,19,367,417,35,71,5,1098,670,1768,9,6,201834
15,33,203,34,330,435,29,65,0,1096,118,1214,4,6,201834
15,34,161,32,305,416,20,78,0,1012,560,1572,8,6,201834
15,35,300,33,328,409,25,101,0,1196,522,1718,9,5.666666667,201834
15,36,232,21,306,249,35,43,3,889,297,1186,9,5.5,201834
15,37,222,22,373,428,54,105,17,1221,682,1903,7,6,201834
15,38,207,55,361,444,13,89,5,1174,563,1737,6,5.5,201834
15,39,192,33,364,421,21,53,0,1084,659,1743,4,6,201834
15,40,315,33,334,466,82,83,0,1313,572,1885,9,6,201834
15,41,271,39,625,560,27,94,28,1644,856,2500,11,6,201834
16,1,200,28,273,190,12,48,2,753,355,1108,7,5.333333333,201834
16,2,209,40,177,240,17,78,0,761,239,1000,9,5.25,201834
16,3,240,37,224,263,24,50,0,838,333,1171,10,5.25,201834
16,4,325,32,354,246,36,120,0,1113,508,1621,8,5.5,201834
16,5,309,69,268,235,47,99,29,1056,604,1660,10,5.666666667,201834
16,6,295,50,225,237,36,64,0,907,526,1433,12,5.5,201834
16,7,278,47,225,240,34,88,0,912,502,1414,9,5.25,201834
16,8,360,62,699,519,9,135,8,1792,1300,3092,12,6,201834
16,9,307,62,334,313,23,113,1,1153,761,1914,9,6,201834
16,10,196,27,326,327,5,82,0,963,608,1571,6,6,201834
16,11,281,44,242,191,97,96,1,952,422,1374,10,5.4,201834
16,12,270,43,297,189,29,80,2,910,351,1261,10,5.25,201834
17,1,208,26,422,374,23,78,0,1131,817,1948,11,4.5,201834
17,2,220,12,320,304,10,46,7,919,572,1491,8,5.666666667,201834
17,3,340,41,435,440,10,76,0,1342,783,2125,8,5.5,201834
17,4,303,42,445,425,26,84,1,1326,719,2045,10,5.666666667,201834
17,5,131,17,142,155,6,35,1,487,198,685,5,5.5,201834
18,1,268,33,195,273,37,93,7,906,267,1173,7,5.25,201834
18,2,293,51,463,386,64,73,0,1330,1013,2343,8,6,201834
18,3,242,27,403,385,12,74,1,1144,451,1595,8,5.5,201834
19,1,250,42,489,417,13,121,20,1352,787,2139,9,6,201834
19,2,354,30,824,322,34,124,0,1688,1222,2910,9,6,201834
19,3,312,37,685,396,30,105,6,1571,931,2502,7,6,201834
19,4,126,17,240,147,74,57,73,734,434,1168,5,6,201834
19,5,426,69,612,675,14,124,9,1929,1166,3095,8,6,201834
19,6,95,12,265,270,14,69,16,741,453,1194,5,6,201834
19,7,270,31,532,354,3,67,1,1258,521,1779,10,5.25,201834
19,8,44,11,123,95,0,22,0,295,200,495,7,6,201834
19,9,169,23,209,172,17,66,25,681,200,881,9,5.25,201834
19,10,154,23,286,378,7,76,10,934,490,1424,7,4,201834
19,11,480,99,797,865,36,213,0,2490,1640,4130,13,6,201834
19,12,209,17,603,284,10,87,5,1215,301,1516,8,5.666666667,201834
20,1,283,48,243,226,324,94,36,1254,406,1660,7,5.5,201834
20,2,257,25,197,318,33,33,1,864,63,927,6,5.333333333,201834
20,3,241,34,250,307,148,63,0,1043,317,1360,6,5.333333333,201834
20,4,199,26,178,338,80,52,15,888,207,1095,6,5.333333333,201834
20,5,315,44,347,494,83,89,0,1372,313,1685,11,5.25,201834
20,6,241,15,224,310,176,64,2,1032,162,1194,8,5.25,201834
20,7,231,23,235,294,16,70,0,869,398,1267,7,5.75,201834
20,8,580,73,625,882,33,177,158,2528,1723,4251,13,6,201834
20,9,390,37,241,280,64,105,30,1147,477,1624,8,5.666666667,201834
20,10,325,36,356,406,31,58,0,1212,304,1516,9,5.25,201834
21,1,271,17,248,401,14,56,0,1007,396,1403,9,5.4,201834
21,2,217,21,222,230,104,54,0,848,149,997,9,5.2,201834
21,3,281,16,364,208,116,89,33,1107,365,1472,8,5.5,201834
21,4,213,9,197,127,65,56,33,700,151,851,6,5.25,201834
21,5,294,21,455,376,29,88,16,1279,706,1985,8,5.666666667,201834
21,6,263,35,439,490,46,98,66,1437,1207,2644,6,6,201834
21,7,388,24,302,378,65,115,4,1276,459,1735,9,5.666666667,201834
21,8,389,36,456,415,97,98,9,1500,226,1726,9,5.2,201834
21,9,266,31,560,411,64,134,29,1495,975,2470,9,6,201834
21,10,298,33,460,337,34,111,43,1316,641,1957,7,5.5,201834
21,11,76,4,152,95,17,32,5,381,201,582,4,6,201834
21,12,400,36,908,912,57,173,20,2506,1756,4262,16,4.333333333,201834
21,13,330,31,319,386,56,91,13,1226,776,2002,8,5.666666667,201834
21,14,236,19,231,235,85,68,18,892,309,1201,12,5.333333333,201834
21,15,342,29,479,352,49,96,15,1362,607,1969,7,5.5,201834
22,1,283,42,263,338,23,34,1,984,246,1230,11,5.2,201834
22,2,205,28,346,180,44,60,9,872,527,1399,7,5.5,201834
22,3,372,89,894,580,36,110,0,2081,1488,3569,10,5.666666667,201834
22,4,252,52,639,493,37,80,3,1556,1328,2884,10,5,201834
22,5,187,30,519,233,31,43,9,1052,538,1590,10,5.5,201834
23,1,329,14,1537,316,16,51,9,2272,917,3189,14,5.6,201834
23,2,255,44,481,475,14,57,0,1326,403,1729,8,5.25,201834
23,3,379,20,1002,391,40,48,0,1880,1288,3168,12,6,201834
23,4,119,7,527,183,9,29,0,874,1080,1954,8,5.666666667,201834
24,1,165,48,140,191,24,38,0,606,246,852,10,5.2,201834
24,2,137,24,197,154,14,54,0,580,377,957,6,5.5,201834
24,3,258,48,228,271,38,61,1,905,322,1227,9,5.25,201834
24,4,250,57,285,210,64,91,63,1020,360,1380,5,5.5,201834
24,5,322,49,507,497,10,105,0,1490,1058,2548,9,6,201834
24,6,385,60,648,565,27,119,1,1805,1611,3416,9,6,201834
24,7,189,25,161,196,34,25,0,630,143,773,9,5.25,201834
25,1,169,31,239,385,54,92,20,990,481,1471,13,5.75,201834
25,2,223,31,379,471,16,99,0,1219,1013,2232,7,5.5,201834
25,3,240,34,321,361,40,74,2,1072,707,1779,8,5.6,201834
25,4,184,41,207,271,18,77,29,827,366,1193,8,5.333333333,201834
25,5,263,32,391,550,27,123,0,1386,851,2237,8,5.666666667,201834
25,6,187,33,421,381,78,101,7,1208,692,1900,8,5.75,201834
25,7,268,31,380,463,5,125,0,1272,702,1974,6,6,201834
26,1,313,29,450,345,13,99,0,1249,462,1711,9,5.5,201834
26,2,323,29,530,489,14,152,1,1538,774,2312,12,5.4,201834
26,3,318,46,496,622,7,175,15,1679,1152,2831,13,6,201834
26,4,164,36,240,290,27,94,4,855,286,1141,9,5.2,201834
26,5,114,9,167,190,10,57,0,547,172,719,3,5.5,201834
26,6,241,32,417,457,9,124,0,1280,893,2173,10,5.333333333,201834
26,7,123,24,168,218,28,43,0,604,467,1071,10,5.5,201834
27,1,232,27,255,306,30,52,0,902,361,1263,8,5.5,201834
27,2,364,39,261,364,16,55,0,1099,525,1624,8,5.666666667,201834
27,3,212,12,135,327,7,43,0,736,396,1132,7,5.666666667,201834
27,4,283,32,318,642,17,70,12,1374,707,2081,8,4,201834
27,5,110,9,88,195,4,32,0,438,118,556,6,5.333333333,201834
27,6,230,37,277,482,10,64,0,1100,508,1608,7,5.5,201834
28,1,227,36,542,400,8,85,0,1298,786,2084,13,6,201834
28,2,275,52,594,381,25,98,114,1539,916,2455,13,5.75,201834
28,3,195,32,248,369,11,79,1,935,99,1034,7,5.333333333,201834
28,4,388,60,631,467,46,101,101,1794,1195,2989,15,6,201834
28,5,226,44,287,407,31,108,19,1122,520,1642,10,4.4,201834
28,6,126,20,203,226,28,47,29,679,209,888,13,5.166666667,201834
28,7,188,39,507,400,31,84,0,1249,890,2139,6,6,201834
28,8,132,44,324,283,54,89,13,939,533,1472,9,6,201834
28,9,190,17,372,195,18,51,49,892,604,1496,11,5.75,201834
29,1,336,56,390,415,64,76,0,1337,545,1882,7,5.5,201834
29,2,298,25,319,501,28,94,52,1317,813,2130,11,5.75,201834
29,3,163,38,202,348,25,63,0,839,442,1281,5,5.666666667,201834
30,1,115,25,156,206,35,33,38,608,106,714,7,5.333333333,201834
30,2,206,20,164,85,38,24,163,700,145,845,8,5.25,201834
30,3,221,24,349,176,120,82,179,1151,494,1645,6,5,201834
30,4,137,7,274,239,25,65,0,747,396,1143,8,6,201834
30,5,177,41,253,421,19,77,0,988,462,1450,7,5.5,201834
30,6,250,21,210,231,126,35,1,874,182,1056,9,5.333333333,201834
30,7,299,27,241,272,103,73,34,1049,337,1386,11,5.25,201834
30,8,257,42,399,387,53,97,29,1264,437,1701,11,5.4,201834
30,9,302,26,283,218,65,112,144,1150,420,1570,8,5.5,201834
30,10,234,37,457,378,35,112,41,1294,901,2195,6,6,201834
30,11,206,29,436,511,12,100,0,1294,555,1849,5,5.5,201834
30,12,275,30,548,623,22,151,2,1651,910,2561,10,6,201834
30,13,306,19,225,364,76,98,44,1132,353,1485,10,5.4,201834
30,14,258,34,315,290,77,98,3,1075,392,1467,8,5.5,201834
30,15,365,29,318,293,38,129,125,1297,691,1988,11,5.666666667,201834
30,16,259,33,377,409,69,98,57,1302,641,1943,10,5.333333333,201834
30,17,300,53,309,381,30,90,2,1165,236,1401,8,5.5,201834
30,18,309,13,238,277,22,79,32,970,127,1097,8,5.25,201834
30,19,273,19,317,326,39,77,0,1051,355,1406,13,5.6,201834
30,20,227,27,263,315,80,88,0,1000,251,1251,10,5.4,201834
31,1,213,14,164,303,14,46,1,755,155,910,8,5.5,201834
31,2,68,7,139,29,177,33,0,453,135,588,6,5.333333333,201834
31,3,412,62,926,703,81,156,0,2340,1674,4014,20,6,201834
31,4,109,16,352,252,43,48,0,820,338,1158,3,6,201834
31,5,204,21,196,361,105,74,0,961,16,977,5,5.333333333,201834
32,1,274,89,242,227,52,78,53,1015,395,1410,12,5,201834
32,2,307,109,280,197,113,74,82,1162,290,1452,13,5.142857143,201834
32,3,257,73,268,328,15,77,6,1024,559,1583,13,5.4,201834
32,4,337,144,389,340,49,107,43,1409,465,1874,13,4.5,201834
1,1,251,52,371,313,50,60,10,1107,872,1979,13,5.5,201835
1,2,250,59,650,417,74,102,4,1556,1604,3160,10,4.75,201835
1,3,175,74,632,401,40,110,4,1436,1533,2969,9,6,201835
2,1,192,18,378,350,8,57,3,1006,1003,2009,11,6,201835
2,2,228,29,446,546,18,126,1,1394,1346,2740,7,6,201835
2,3,369,41,693,441,22,129,3,1698,1823,3521,11,4.25,201835
2,4,219,19,672,233,22,68,0,1233,1337,2570,9,6,201835
2,5,535,45,1226,608,119,191,9,2733,2553,5286,13,6,201835
2,6,280,26,666,349,37,78,1,1437,1416,2853,7,6,201835
2,7,309,41,695,448,40,87,14,1634,1551,3185,12,5.75,201835
2,8,316,26,811,531,17,107,5,1813,1842,3655,8,6,201835
3,1,213,19,385,358,21,115,5,1116,789,1905,12,5.666666667,201835
3,2,237,10,584,242,17,47,0,1137,1111,2248,9,5.666666667,201835
4,1,237,38,307,452,32,84,0,1150,783,1933,11,5.25,201835
4,2,257,21,415,329,18,80,9,1129,383,1512,14,5.2,201835
5,1,325,31,482,447,28,97,0,1410,1064,2474,9,5.666666667,201835
5,2,220,33,325,325,14,60,6,983,482,1465,10,5.2,201835
5,3,201,30,333,288,49,80,55,1036,688,1724,9,5.5,201835
5,4,269,46,539,412,11,104,68,1449,1324,2773,9,5.666666667,201835
5,5,199,30,452,428,23,90,13,1235,1082,2317,8,6,201835
5,6,158,25,272,283,12,40,22,812,553,1365,11,5.5,201835
5,7,186,19,311,332,17,47,1,913,717,1630,10,5.5,201835
6,1,178,37,375,338,15,76,8,1027,879,1906,11,5.8,201835
6,2,202,23,374,244,69,62,3,977,894,1871,9,5.666666667,201835
7,1,296,12,213,462,4,36,14,1037,429,1466,9,5.25,201835
7,2,378,8,144,669,26,33,0,1258,187,1445,9,5.25,201835
7,3,472,9,183,326,88,61,0,1139,463,1602,7,5.333333333,201835
7,4,257,23,333,253,9,78,30,983,198,1181,11,5.4,201835
7,5,537,19,228,644,6,57,3,1494,1274,2768,11,5.666666667,201835
7,6,348,41,385,477,31,100,31,1413,679,2092,9,4.25,201835
7,7,315,40,296,415,25,85,0,1176,348,1524,8,5.5,201835
7,8,431,24,267,634,16,88,0,1460,594,2054,12,5.25,201835
7,9,309,54,380,447,18,99,0,1307,1129,2436,11,6,201835
7,10,301,21,300,540,41,65,0,1268,570,1838,9,5.5,201835
7,11,199,8,131,222,10,17,0,587,38,625,6,5.333333333,201835
7,12,388,29,345,559,2,82,0,1405,1063,2468,9,5.5,201835
7,13,188,10,129,309,0,34,0,670,70,740,9,5.25,201835
8,1,158,19,401,214,12,30,2,836,762,1598,4,6,201835
8,2,333,45,701,400,19,110,7,1615,1374,2989,16,5.5,201835
8,3,255,32,478,350,24,67,1,1207,1148,2355,4,6,201835
8,4,189,25,506,334,26,93,13,1186,996,2182,9,6,201835
8,5,254,45,411,355,52,113,0,1230,567,1797,10,5.25,201835
8,6,253,50,506,447,45,120,34,1455,1311,2766,7,4.333333333,201835
8,7,295,49,295,365,19,90,0,1113,649,1762,7,5.25,201835
8,8,213,48,461,459,14,88,14,1297,1190,2487,10,6,201835
8,9,299,64,233,376,44,93,65,1174,364,1538,10,5.2,201835
9,1,151,34,303,171,76,58,14,807,820,1627,5,6,201835
9,2,361,138,1018,1067,67,182,13,2846,2361,5207,12,6,201835
9,3,160,66,528,476,68,144,33,1475,1366,2841,7,6,201835
9,4,222,40,482,618,51,111,17,1541,1363,2904,11,6,201835
9,5,191,25,374,326,65,85,3,1069,906,1975,7,6,201835
9,6,115,32,246,204,67,73,21,758,603,1361,7,6,201835
9,7,133,27,353,425,2,68,1,1009,878,1887,9,6,201835
9,8,78,22,372,290,11,87,35,895,682,1577,5,6,201835
9,9,137,16,359,295,37,54,11,909,801,1710,5,6,201835
9,10,120,32,466,427,32,79,0,1156,936,2092,6,6,201835
9,11,240,35,548,451,54,130,0,1458,1269,2727,7,6,201835
9,12,167,52,592,582,30,124,35,1582,1353,2935,11,6,201835
9,13,148,32,380,362,70,78,34,1104,928,2032,4,6,201835
9,14,162,20,241,239,77,64,14,817,701,1518,5,6,201835
9,15,259,50,1137,984,27,179,1,2637,2214,4851,9,6.5,201835
9,16,296,65,596,697,100,136,4,1894,1628,3522,15,6,201835
9,17,182,13,321,325,36,62,1,940,756,1696,6,6,201835
9,18,234,52,485,625,48,129,4,1577,1396,2973,12,6,201835
9,19,219,66,439,397,115,115,8,1359,1220,2579,5,6,201835
9,20,51,15,109,91,18,28,8,320,218,538,5,6,201835
9,21,153,19,246,212,38,35,21,724,659,1383,3,6,201835
9,22,209,19,336,287,123,90,44,1108,1025,2133,5,6,201835
9,23,154,39,395,435,50,77,11,1161,1109,2270,6,6,201835
9,24,387,61,823,819,93,133,28,2344,1992,4336,12,6,201835
10,1,297,40,246,287,19,72,29,990,672,1662,8,4.666666667,201835
10,2,261,38,367,365,33,90,43,1197,1078,2275,7,5.25,201835
10,3,221,44,224,282,10,75,33,889,537,1426,9,5.4,201835
10,4,328,43,446,481,15,88,0,1401,1410,2811,12,5,201835
11,1,332,51,247,223,9,71,5,938,816,1754,6,5.666666667,201835
11,2,322,40,298,239,28,73,17,1017,994,2011,7,6,201835
11,3,196,39,291,261,17,57,45,906,799,1705,3,6,201835
11,4,266,36,228,294,14,55,0,893,610,1503,8,4.5,201835
11,5,377,104,419,515,20,137,3,1575,1509,3084,7,6,201835
11,6,259,56,323,292,30,85,19,1064,1058,2122,7,5.666666667,201835
11,7,279,41,272,297,26,54,0,969,1035,2004,9,5,201835
11,8,279,37,335,389,23,56,16,1135,1080,2215,9,5.75,201835
11,9,375,91,427,432,22,110,17,1474,1418,2892,10,5.666666667,201835
11,10,340,61,332,375,25,93,43,1269,1078,2347,10,5.6,201835
11,11,219,45,244,240,20,50,0,818,1170,1988,5,6,201835
11,12,282,56,516,454,6,71,1,1386,1432,2818,7,6,201835
11,13,316,51,274,232,24,67,27,991,746,1737,8,5.5,201835
11,14,304,58,297,317,32,65,0,1073,833,1906,8,5.5,201835
11,15,225,56,248,288,5,67,4,893,773,1666,8,6,201835
12,1,200,27,295,106,30,58,4,720,454,1174,10,5.2,201835
12,2,325,47,281,435,39,103,0,1230,954,2184,10,5.5,201835
12,3,301,47,300,393,18,71,0,1130,639,1769,11,5.2,201835
12,4,220,54,405,461,22,61,1,1224,1084,2308,9,5.666666667,201835
12,5,398,32,287,260,0,48,15,1040,736,1776,10,5.25,201835
12,6,328,22,200,337,18,31,0,936,517,1453,10,5.25,201835
12,7,269,28,324,336,16,54,23,1050,906,1956,6,5.5,201835
12,8,288,25,273,277,11,45,0,919,248,1167,9,5.25,201835
12,9,246,45,312,465,12,67,3,1150,1142,2292,9,5.666666667,201835
13,1,235,31,181,481,48,82,2,1060,574,1634,9,5.333333333,201835
13,2,189,36,161,289,76,60,7,818,536,1354,6,5.333333333,201835
13,3,191,41,292,324,115,72,0,1035,469,1504,12,5.25,201835
13,4,160,27,253,252,42,55,0,789,822,1611,5,6,201835
13,7,273,81,629,661,125,81,12,1862,1445,3307,10,5.6,201835
13,5,261,29,440,374,111,125,33,1373,1034,2407,9,5.75,201835
13,6,314,112,932,1238,95,157,0,2848,2126,4974,13,5.5,201835
14,1,202,41,169,172,28,62,21,695,300,995,6,5.25,201835
14,2,262,28,230,179,34,89,8,830,640,1470,5,5,201835
14,3,360,44,371,308,35,135,17,1270,742,2012,8,5.2,201835
14,4,191,23,284,325,19,75,8,925,966,1891,11,6,201835
14,5,273,35,545,333,44,95,3,1328,1007,2335,9,5.5,201835
14,6,267,28,481,280,11,61,0,1128,1075,2203,11,6,201835
14,7,142,15,231,106,0,37,0,531,530,1061,6,6,201835
14,8,361,53,824,833,25,169,3,2268,2050,4318,11,4.6,201835
14,9,119,19,186,192,29,37,0,582,624,1206,12,7,201835
14,10,215,30,433,288,14,100,5,1085,962,2047,7,6,201835
14,11,193,29,211,257,27,62,4,783,660,1443,4,6,201835
14,12,318,26,530,185,10,68,2,1139,880,2019,9,5.25,201835
14,13,234,21,358,233,19,51,0,916,852,1768,6,6,201835
14,14,170,32,309,326,18,85,2,942,783,1725,7,5,201835
14,15,345,72,297,305,39,102,16,1176,777,1953,10,5.6,201835
14,16,184,30,355,199,11,62,7,848,643,1491,5,6,201835
14,17,261,51,237,210,27,85,30,901,185,1086,7,5.25,201835
14,18,368,46,324,282,61,77,59,1217,376,1593,9,5.4,201835
14,19,316,56,318,356,41,82,36,1205,729,1934,8,5.25,201835
14,20,262,28,346,160,14,54,16,880,523,1403,10,5.666666667,201835
15,1,179,23,196,126,276,40,3,843,397,1240,7,5.333333333,201835
15,2,173,27,361,339,16,75,15,1006,915,1921,6,6,201835
15,3,346,44,335,415,89,91,28,1348,1184,2532,10,5.666666667,201835
15,4,234,30,321,365,27,105,17,1099,990,2089,4,6,201835
15,5,208,46,293,310,19,69,4,949,834,1783,8,5.666666667,201835
15,6,171,18,399,482,50,86,17,1223,1018,2241,7,6,201835
15,7,231,38,419,405,28,94,0,1215,1001,2216,10,6,201835
15,8,93,22,204,223,5,39,9,595,543,1138,4,6,201835
15,9,402,21,186,208,158,55,33,1063,576,1639,9,5.75,201835
15,10,143,24,320,340,36,58,2,923,868,1791,6,6,201835
15,11,220,25,352,422,19,72,1,1111,1039,2150,8,6,201835
15,12,325,21,652,540,38,86,1,1663,1369,3032,8,6,201835
15,13,98,24,168,226,53,52,0,621,703,1324,8,6,201835
15,14,107,24,154,157,26,40,0,508,460,968,4,6,201835
15,15,201,82,341,424,34,88,0,1170,1072,2242,6,6,201835
15,16,272,55,497,559,8,119,8,1518,1317,2835,8,6,201835
15,17,147,27,258,274,21,77,80,884,748,1632,8,6,201835
15,18,335,48,386,495,38,82,7,1391,981,2372,7,5.666666667,201835
15,19,255,102,601,771,9,121,9,1868,1565,3433,10,6,201835
15,20,116,28,245,295,15,53,2,754,650,1404,6,6,201835
15,21,122,14,129,176,14,52,0,507,414,921,6,5.5,201835
15,22,336,62,659,751,27,123,49,2007,1762,3769,14,6,201835
15,23,307,24,340,462,49,115,1,1298,773,2071,6,5.333333333,201835
15,24,188,28,317,334,36,61,3,967,867,1834,4,6,201835
15,25,256,45,420,342,28,84,5,1180,973,2153,6,6,201835
15,26,169,17,258,216,40,61,0,761,637,1398,9,5.5,201835
15,27,292,35,445,544,16,111,36,1479,1191,2670,9,5.666666667,201835
15,28,294,44,565,362,96,115,14,1490,1271,2761,9,5.666666667,201835
15,29,246,55,458,616,13,96,1,1485,1427,2912,8,6,201835
15,30,275,41,501,447,43,87,19,1413,922,2335,16,6,201835
15,31,177,58,252,328,8,60,0,883,805,1688,6,6,201835
15,32,227,21,359,418,28,72,3,1128,851,1979,9,6,201835
15,33,249,24,397,372,8,73,0,1123,566,1689,4,6,201835
15,34,144,19,270,483,7,75,0,998,881,1879,8,6,201835
15,35,376,36,301,417,16,99,2,1247,793,2040,9,5.666666667,201835
15,36,274,26,288,270,54,57,6,975,640,1615,9,5.5,201835
15,37,244,30,417,443,48,86,18,1286,1089,2375,7,6,201835
15,38,225,48,378,430,10,76,0,1167,939,2106,6,5.5,201835
15,39,173,33,348,366,21,69,9,1019,962,1981,4,6,201835
15,40,402,25,328,476,114,104,0,1449,1053,2502,9,6,201835
15,41,280,47,619,533,27,72,24,1602,1382,2984,11,6,201835
16,1,221,25,281,280,30,70,1,908,704,1612,7,5.333333333,201835
16,2,192,50,167,237,12,56,0,714,720,1434,9,5.25,201835
16,3,242,41,200,291,35,54,0,863,598,1461,10,5.25,201835
16,4,275,36,285,210,32,93,0,931,805,1736,8,5.5,201835
16,5,287,57,272,261,45,103,12,1037,1017,2054,10,5.666666667,201835
16,6,250,44,208,196,18,51,0,767,665,1432,12,5.5,201835
16,7,309,41,229,244,51,74,0,948,843,1791,9,5.5,201835
16,8,332,48,632,501,13,89,6,1621,1604,3225,12,6,201835
16,9,246,41,336,330,17,92,0,1062,977,2039,9,6,201835
16,10,171,31,354,289,15,60,0,920,918,1838,6,6,201835
16,11,235,30,205,140,120,71,0,801,691,1492,10,5.4,201835
16,12,249,28,260,213,21,68,2,841,717,1558,10,5.25,201835
17,1,182,24,346,392,16,67,7,1034,1040,2074,10,4,201835
17,2,194,20,360,327,15,42,2,960,753,1713,8,5.666666667,201835
17,3,286,27,329,408,11,83,0,1144,958,2102,8,5.5,201835
17,4,301,27,404,392,20,88,1,1233,990,2223,10,5.666666667,201835
17,5,140,10,163,141,12,34,0,500,352,852,5,5.5,201835
18,1,233,31,184,277,37,57,4,823,326,1149,7,5.25,201835
18,2,258,51,451,370,70,81,0,1281,1172,2453,8,6,201835
18,3,213,30,395,330,15,52,0,1035,648,1683,8,5.5,201835
19,1,213,41,434,386,14,105,27,1220,1103,2323,9,6,201835
19,2,359,25,783,301,42,109,0,1619,1454,3073,9,6,201835
19,3,307,29,626,417,31,85,9,1504,1370,2874,7,6,201835
19,4,139,18,222,178,55,48,81,741,609,1350,5,6,201835
19,5,315,53,493,587,22,107,24,1601,1732,3333,8,6,201835
19,6,100,20,251,279,17,51,14,732,617,1349,5,6,201835
19,7,239,29,493,268,11,54,1,1095,728,1823,10,4.75,201835
19,8,59,7,123,118,1,12,0,320,322,642,7,6,201835
19,9,198,26,230,283,40,78,11,866,260,1126,9,5.25,201835
19,10,157,16,271,355,7,77,5,888,756,1644,6,5.5,201835
19,11,456,77,745,833,19,207,0,2337,2286,4623,13,6,201835
19,12,229,17,663,263,12,66,3,1253,1000,2253,8,5.666666667,201835
20,1,341,42,256,226,58,89,46,1058,667,1725,7,5.5,201835
20,2,228,26,182,260,41,33,0,770,249,1019,6,5.333333333,201835
20,3,145,24,204,283,42,38,0,736,471,1207,6,5.333333333,201835
20,4,235,36,173,342,61,68,19,934,605,1539,6,5.333333333,201835
20,5,261,34,221,347,42,59,0,964,345,1309,11,5.25,201835
20,6,179,24,148,342,155,32,2,882,415,1297,8,5.25,201835
20,7,194,20,211,247,17,41,1,731,683,1414,7,5.75,201835
20,8,544,69,510,836,27,148,148,2282,2156,4438,13,6,201835
20,9,506,33,282,327,105,109,52,1414,834,2248,8,5.666666667,201835
20,10,390,24,289,500,27,65,0,1295,444,1739,9,5.25,201835
21,1,260,21,247,454,15,51,0,1048,622,1670,9,5.4,201835
21,2,253,25,291,213,117,62,1,962,307,1269,9,5.2,201835
21,3,372,30,428,249,100,122,43,1344,671,2015,8,5.5,201835
21,4,236,7,156,111,51,55,49,665,369,1034,6,5.25,201835
21,5,263,22,405,304,19,94,25,1132,978,2110,8,5.666666667,201835
21,6,267,31,427,497,45,111,90,1468,1202,2670,6,6,201835
21,7,409,28,319,397,59,123,3,1338,839,2177,9,5.666666667,201835
21,8,336,12,481,351,82,95,14,1371,355,1726,9,5.2,201835
21,9,293,30,495,503,56,109,49,1535,1227,2762,9,6,201835
21,10,343,35,438,359,51,98,66,1390,1015,2405,7,5.5,201835
21,11,74,2,155,106,19,23,4,383,314,697,4,6,201835
21,12,407,36,921,866,69,165,44,2508,2165,4673,15,4,201835
21,13,367,25,364,397,47,98,10,1308,1072,2380,8,5.666666667,201835
21,14,266,33,241,239,47,59,5,890,370,1260,12,5.333333333,201835
21,15,349,15,462,357,40,78,16,1317,940,2257,7,5.5,201835
22,1,316,49,267,342,22,41,0,1037,497,1534,11,5.2,201835
22,2,213,28,422,223,40,55,30,1011,750,1761,7,5.5,201835
22,3,325,54,858,558,24,80,7,1906,1625,3531,9,5.666666667,201835
22,4,234,44,628,482,34,86,2,1510,1413,2923,10,5,201835
22,5,142,23,398,244,56,45,4,912,732,1644,10,5.5,201835
23,1,319,10,1436,292,11,49,17,2134,1695,3829,14,5.6,201835
23,2,257,41,413,642,18,50,0,1421,659,2080,8,5.25,201835
23,3,295,21,1163,434,46,59,0,2018,1569,3587,12,6,201835
23,4,115,13,511,233,9,24,0,905,817,1722,7,5.666666667,201835
24,1,170,48,200,237,35,43,6,739,304,1043,10,5.2,201835
24,2,142,25,195,173,12,49,0,596,489,1085,6,5.5,201835
24,3,235,48,199,243,70,54,0,849,451,1300,9,5.25,201835
24,4,198,46,200,197,39,55,70,805,651,1456,5,5.5,201835
24,5,269,37,440,447,5,102,0,1300,1262,2562,9,6,201835
24,6,366,68,597,558,24,102,1,1716,1680,3396,9,6,201835
24,7,250,16,208,229,27,44,0,774,348,1122,9,5.25,201835
25,1,135,20,221,321,34,58,3,792,724,1516,13,5.75,201835
25,2,231,35,429,459,11,117,0,1282,1073,2355,7,5.5,201835
25,3,261,29,354,391,78,83,8,1204,791,1995,8,5.6,201835
25,4,189,37,211,322,11,61,49,880,634,1514,8,5.333333333,201835
25,5,216,29,379,532,17,72,0,1245,1143,2388,8,5.666666667,201835
25,6,258,25,384,366,52,98,2,1185,983,2168,8,5.75,201835
25,7,271,31,354,435,5,95,0,1191,1104,2295,6,6,201835
26,1,254,29,392,332,12,111,0,1130,781,1911,9,5.5,201835
26,2,312,20,485,477,6,88,0,1388,1076,2464,12,5.4,201835
26,3,285,32,485,620,8,195,1,1626,1479,3105,13,6,201835
26,4,153,16,176,246,23,37,14,665,495,1160,9,5.2,201835
26,5,188,20,144,147,8,65,0,572,163,735,3,5.5,201835
26,6,217,27,405,415,10,95,0,1169,1002,2171,10,5.333333333,201835
26,7,161,20,194,227,38,52,0,692,437,1129,10,5.5,201835
27,1,199,19,153,221,41,37,0,670,448,1118,8,5.5,201835
27,2,311,30,261,402,28,54,0,1086,783,1869,8,5.666666667,201835
27,3,256,20,159,310,6,39,0,790,592,1382,7,5.666666667,201835
27,4,264,26,314,626,13,54,14,1311,1012,2323,8,4,201835
27,5,152,10,114,184,6,33,4,503,180,683,6,5.333333333,201835
27,6,198,29,237,443,7,51,0,965,671,1636,7,5.5,201835
28,1,225,33,485,390,10,71,0,1214,1171,2385,13,6,201835
28,2,306,45,678,363,29,74,90,1585,1186,2771,13,5.75,201835
28,3,139,17,193,197,9,38,1,594,232,826,7,5.333333333,201835
28,4,309,46,518,433,27,89,99,1521,1760,3281,15,6,201835
28,5,188,45,341,459,35,76,31,1175,728,1903,10,4.4,201835
28,6,126,19,166,190,26,32,23,582,347,929,13,5.166666667,201835
28,7,231,32,482,439,60,81,0,1325,1111,2436,6,6,201835
28,8,139,22,335,336,44,67,11,954,787,1741,9,6,201835
28,9,163,10,362,191,15,48,36,825,833,1658,11,5.75,201835
29,1,322,44,406,380,40,60,2,1254,1072,2326,7,5.5,201835
29,2,288,28,302,517,44,85,67,1331,1124,2455,12,4.8,201835
29,3,165,39,208,288,11,48,0,759,533,1292,5,5.666666667,201835
30,1,153,24,214,308,35,45,29,808,287,1095,7,5.333333333,201835
30,2,224,27,215,134,56,43,286,985,293,1278,8,5.25,201835
30,3,262,28,369,203,104,91,215,1272,801,2073,6,5.666666667,201835
30,4,136,13,290,242,32,75,0,788,623,1411,8,6,201835
30,5,170,29,212,381,15,76,0,883,670,1553,7,5.5,201835
30,6,233,18,239,252,49,46,0,837,446,1283,9,5.333333333,201835
30,7,324,48,329,363,76,88,44,1272,483,1755,11,5.25,201835
30,8,318,44,364,431,98,122,24,1401,671,2072,11,5,201835
30,9,268,26,288,199,83,84,118,1066,710,1776,8,5.25,201835
30,10,218,28,419,409,49,85,47,1255,1068,2323,6,6,201835
30,11,157,28,405,437,17,69,0,1113,1114,2227,6,5.5,201835
30,12,245,21,443,547,23,128,0,1407,1163,2570,10,5,201835
30,13,365,31,275,459,49,89,38,1306,547,1853,10,5,201835
30,14,177,46,275,260,45,63,14,880,479,1359,8,4.5,201835
30,15,327,20,322,251,51,116,145,1232,949,2181,11,5.666666667,201835
30,16,260,21,357,376,52,91,87,1244,909,2153,10,5.333333333,201835
30,17,335,41,302,337,76,88,14,1193,411,1604,8,5.5,201835
30,18,227,19,160,313,20,60,49,848,259,1107,8,5.25,201835
30,19,242,26,285,283,35,57,0,928,563,1491,13,5,201835
30,20,252,24,269,368,92,89,0,1094,542,1636,10,5.4,201835
31,1,237,45,204,391,24,45,0,946,524,1470,8,5.5,201835
31,2,89,22,158,26,220,34,0,549,172,721,6,5.333333333,201835
31,3,351,64,959,775,124,153,0,2426,1977,4403,20,6,201835
31,4,99,20,352,235,42,47,0,795,607,1402,3,6,201835
31,5,216,31,188,301,29,52,0,817,377,1194,5,5,201835
32,1,261,76,246,259,53,78,69,1042,672,1714,12,5.2,201835
32,2,394,120,321,287,163,121,87,1493,612,2105,13,5.142857143,201835
32,3,191,58,249,293,17,86,14,908,635,1543,13,5.4,201835
32,4,305,112,299,332,55,119,65,1287,771,2058,13,4.5,201835
1,1,251,53,292,282,68,57,5,1008,975,1983,13,5,201836
1,2,233,44,598,403,71,75,13,1437,1240,2677,10,4,201836
1,3,192,52,503,398,32,84,5,1266,1255,2521,9,5,201836
2,1,203,22,408,375,13,76,2,1099,1022,2121,11,6,201836
2,2,260,26,463,643,8,124,1,1525,1352,2877,7,6,201836
2,3,364,37,638,472,18,116,0,1645,1367,3012,11,4.25,201836
2,4,227,15,721,247,29,54,0,1293,1190,2483,9,6,201836
2,5,480,52,1157,598,132,164,18,2601,2612,5213,13,6,201836
2,6,274,25,673,373,28,85,0,1458,1351,2809,7,6,201836
2,7,371,30,677,555,32,100,9,1774,1682,3456,12,5.75,201836
2,8,294,19,811,519,23,87,5,1758,1824,3582,8,6,201836
3,1,253,29,358,352,17,74,13,1096,851,1947,12,5.666666667,201836
3,2,240,11,577,241,19,34,0,1122,1175,2297,9,5.666666667,201836
4,1,251,28,257,472,28,57,0,1093,993,2086,11,5.25,201836
4,2,253,22,405,383,21,63,5,1152,676,1828,14,5.2,201836
5,1,258,27,417,361,50,83,0,1196,1042,2238,9,5.666666667,201836
5,2,116,18,226,246,16,36,2,660,726,1386,10,5.2,201836
5,3,178,28,263,297,33,78,66,943,820,1763,9,5.5,201836
5,4,259,36,550,408,18,107,96,1474,1372,2846,9,5.666666667,201836
5,5,191,41,448,474,20,77,38,1289,1146,2435,8,6,201836
5,6,159,21,281,286,7,40,24,818,644,1462,11,5.5,201836
5,7,177,28,372,327,7,47,1,959,895,1854,10,5.5,201836
6,1,184,32,362,289,15,64,59,1005,1098,2103,12,5,201836
6,2,199,20,413,214,87,70,10,1013,1055,2068,9,5.666666667,201836
7,1,516,25,265,465,15,73,53,1412,427,1839,9,5.25,201836
7,2,495,8,202,441,21,52,0,1219,272,1491,9,5.25,201836
7,3,451,7,219,368,93,52,0,1190,540,1730,7,5.333333333,201836
7,4,254,18,203,323,21,69,89,977,263,1240,11,5.4,201836
7,5,412,23,201,567,13,53,10,1279,1215,2494,11,5.666666667,201836
7,6,345,22,355,472,30,106,22,1352,1225,2577,9,4.25,201836
7,7,381,29,319,437,40,80,0,1286,529,1815,8,5.5,201836
7,8,399,17,293,530,22,73,0,1334,667,2001,12,5.25,201836
7,9,281,36,339,450,14,87,0,1207,1321,2528,9,5.666666667,201836
7,10,255,16,286,539,23,50,0,1169,1170,2339,9,5.5,201836
7,11,233,6,117,214,18,20,0,608,50,658,6,5.333333333,201836
7,12,373,24,322,580,5,64,0,1368,1132,2500,9,5.5,201836
7,13,184,16,106,394,2,37,0,739,84,823,9,5.25,201836
8,1,143,11,464,230,14,42,6,910,762,1672,4,6,201836
8,2,370,35,778,474,21,99,7,1784,1765,3549,16,5.5,201836
8,3,194,34,467,414,19,78,3,1209,1163,2372,4,6,201836
8,4,174,28,453,308,34,74,15,1086,1014,2100,9,6,201836
8,5,316,60,429,368,47,105,0,1325,636,1961,10,5.25,201836
8,6,254,32,475,416,51,111,50,1389,1360,2749,7,4.333333333,201836
8,7,270,48,351,382,17,72,0,1140,693,1833,7,5.25,201836
8,8,225,42,491,449,14,90,17,1328,1224,2552,11,7,201836
8,9,241,41,217,288,61,92,4,944,363,1307,10,5.2,201836
9,1,96,13,216,150,69,45,15,604,501,1105,5,6,201836
9,2,357,120,1069,1132,70,196,14,2958,2568,5526,12,6,201836
9,3,158,57,549,459,68,122,48,1461,1237,2698,7,6,201836
9,4,230,27,471,547,65,83,18,1441,1449,2890,11,6,201836
9,5,184,26,379,350,54,77,1,1071,1028,2099,7,6,201836
9,6,111,29,248,221,69,77,19,774,679,1453,7,6,201836
9,7,110,19,398,444,5,57,0,1033,938,1971,9,6,201836
9,8,86,19,362,300,25,71,42,905,803,1708,5,6,201836
9,9,160,20,280,313,45,55,18,891,855,1746,5,6,201836
9,10,165,29,436,421,23,60,0,1134,1074,2208,6,6,201836
9,11,224,36,578,545,72,113,0,1568,1372,2940,7,6,201836
9,12,144,62,649,588,40,105,48,1636,1443,3079,11,6,201836
9,13,122,40,388,414,51,76,49,1140,1005,2145,4,6,201836
9,14,141,17,262,217,62,74,10,783,729,1512,5,6,201836
9,15,261,55,1031,1019,45,167,4,2582,1657,4239,9,4.333333333,201836
9,16,277,75,658,758,97,158,6,2029,1828,3857,15,6,201836
9,17,198,19,341,369,29,62,5,1023,864,1887,6,6,201836
9,18,222,49,540,679,46,112,1,1649,1441,3090,12,6,201836
9,19,236,61,447,404,148,103,22,1421,1290,2711,5,6,201836
9,20,46,16,93,86,10,22,10,283,261,544,5,6,201836
9,21,130,16,233,235,49,55,27,745,717,1462,3,6,201836
9,22,179,26,327,313,97,68,43,1053,1096,2149,5,6,201836
9,23,179,24,399,472,60,72,18,1224,990,2214,6,6,201836
9,24,398,50,811,828,76,153,15,2331,2083,4414,12,6,201836
10,1,279,42,298,296,43,86,43,1087,609,1696,8,4.833333333,201836
10,2,236,24,363,374,39,73,48,1157,1166,2323,7,5.25,201836
10,3,206,50,262,318,24,64,59,983,1011,1994,9,5.4,201836
10,4,316,39,433,523,11,93,0,1415,1335,2750,12,4.333333333,201836
11,1,330,30,235,239,20,52,7,913,895,1808,6,5.666666667,201836
11,2,329,28,274,238,22,52,14,957,974,1931,7,6,201836
11,3,196,37,280,287,16,47,50,913,841,1754,3,6,201836
11,4,92,131,152,248,63,38,19,743,756,1499,8,4.5,201836
11,5,363,80,485,487,9,90,10,1524,1513,3037,7,6,201836
11,6,243,37,421,327,41,70,25,1164,1219,2383,7,5.666666667,201836
11,7,320,53,299,334,29,77,0,1112,1207,2319,9,5.5,201836
11,8,257,54,380,410,37,55,15,1208,1142,2350,9,5.75,201836
11,9,394,106,412,433,16,105,14,1480,1581,3061,10,5.666666667,201836
11,10,272,75,282,331,38,62,55,1115,1111,2226,10,5.6,201836
11,11,233,85,254,274,34,40,0,920,928,1848,5,6,201836
11,12,306,44,584,503,16,56,1,1510,1452,2962,7,6,201836
11,13,344,68,288,242,27,56,35,1060,1143,2203,8,5.5,201836
11,14,310,34,297,325,30,63,0,1059,1110,2169,8,5.5,201836
11,15,217,53,205,264,7,50,1,797,811,1608,8,6,201836
12,1,232,27,278,97,45,35,0,714,985,1699,10,5.2,201836
12,2,319,54,268,395,21,66,0,1123,1126,2249,10,5.5,201836
12,3,327,57,323,399,23,65,0,1194,1478,2672,11,5.2,201836
12,4,235,36,354,515,27,70,0,1237,1150,2387,9,5.666666667,201836
12,5,365,27,280,259,0,43,18,992,1662,2654,10,5.25,201836
12,6,289,19,184,322,13,25,0,852,883,1735,10,5.25,201836
12,7,379,28,380,403,22,77,36,1325,1122,2447,6,5.5,201836
12,8,343,26,318,286,10,47,0,1030,446,1476,9,5.25,201836
12,9,272,39,313,456,23,65,3,1171,1209,2380,9,5.666666667,201836
13,1,243,33,208,431,77,79,10,1081,787,1868,9,5.333333333,201836
13,2,185,31,160,272,118,71,9,846,570,1416,6,5.333333333,201836
13,3,179,29,249,300,113,88,2,960,729,1689,12,5.25,201836
13,4,162,18,325,253,32,72,0,862,829,1691,5,6,201836
13,7,322,96,676,661,83,101,15,1954,1675,3629,10,5.6,201836
13,5,256,38,448,429,99,126,47,1443,1084,2527,9,5.75,201836
13,6,322,81,883,1099,65,117,0,2567,2642,5209,13,5.5,201836
14,1,220,36,181,186,36,62,30,751,676,1427,6,5.5,201836
14,2,302,25,257,169,35,113,3,904,959,1863,5,5.666666667,201836
14,3,380,49,437,317,26,110,32,1351,991,2342,8,5.2,201836
14,4,196,30,287,411,25,53,18,1020,939,1959,11,6,201836
14,5,242,33,516,302,39,77,5,1214,1238,2452,9,5.5,201836
14,6,231,16,496,299,16,70,0,1128,926,2054,11,5,201836
14,7,154,15,266,162,0,29,0,626,517,1143,6,6,201836
14,8,367,74,863,968,26,154,0,2452,2329,4781,11,4.8,201836
14,9,123,30,175,269,41,32,0,670,528,1198,12,7,201836
14,10,249,37,440,371,12,75,10,1194,1028,2222,7,6,201836
14,11,162,24,154,217,25,55,18,655,718,1373,4,6,201836
14,12,328,21,593,193,8,65,0,1208,1211,2419,9,5.5,201836
14,13,196,19,333,242,17,62,0,869,862,1731,6,5.5,201836
14,14,182,34,308,426,26,77,14,1067,1016,2083,7,6,201836
14,15,333,67,263,301,32,104,16,1116,894,2010,10,5.6,201836
14,16,184,42,328,200,13,74,27,868,644,1512,5,6,201836
14,17,262,48,230,226,42,54,20,882,579,1461,7,5.25,201836
14,18,336,47,343,289,39,73,48,1175,823,1998,9,5.4,201836
14,19,279,43,286,288,40,80,12,1028,1176,2204,8,5.25,201836
14,20,205,29,308,153,11,45,15,766,610,1376,10,4.666666667,201836
15,1,292,21,238,160,356,73,20,1160,930,2090,7,5.333333333,201836
15,2,168,18,366,366,17,69,16,1020,1034,2054,6,6,201836
15,3,414,32,377,386,160,109,10,1488,1128,2616,10,5.666666667,201836
15,4,254,38,350,392,24,89,11,1158,1084,2242,4,6,201836
15,5,205,31,318,373,23,54,17,1021,894,1915,8,5.666666667,201836
15,6,164,17,371,444,50,82,14,1142,1071,2213,7,6,201836
15,7,224,30,425,420,33,77,1,1210,1103,2313,10,6,201836
15,8,97,23,191,235,5,47,11,609,585,1194,4,6,201836
15,9,415,22,167,214,182,49,40,1089,789,1878,9,5.75,201836
15,10,178,22,310,364,32,62,4,972,870,1842,6,6,201836
15,11,227,21,350,450,46,66,1,1161,1115,2276,8,6,201836
15,12,329,27,699,567,50,81,0,1753,1507,3260,8,6,201836
15,13,109,24,215,213,58,43,0,662,672,1334,8,6,201836
15,14,76,12,152,165,28,42,0,475,461,936,4,6,201836
15,15,207,54,370,481,27,91,1,1231,1126,2357,6,6,201836
15,16,252,39,456,680,14,90,5,1536,1598,3134,8,6,201836
15,17,136,29,259,267,17,83,97,888,823,1711,8,6,201836
15,18,317,38,384,409,44,92,9,1293,1121,2414,7,5.333333333,201836
15,19,240,82,606,824,19,103,14,1888,1732,3620,10,6,201836
15,20,85,23,259,305,20,30,3,725,705,1430,6,6,201836
15,21,167,13,162,233,18,42,0,635,565,1200,6,5.5,201836
15,22,343,61,636,781,31,130,57,2039,1887,3926,14,6,201836
15,23,269,28,340,463,54,107,0,1261,1056,2317,6,5.333333333,201836
15,24,166,37,310,304,34,61,8,920,902,1822,4,6,201836
15,25,193,41,392,318,15,57,8,1024,1028,2052,6,6,201836
15,26,167,8,253,249,45,58,1,781,730,1511,9,3.5,201836
15,27,333,35,438,526,11,95,29,1467,1309,2776,9,5.333333333,201836
15,28,257,35,538,399,84,74,9,1396,1384,2780,9,5.666666667,201836
15,29,249,50,489,627,13,112,4,1544,1548,3092,8,6,201836
15,30,248,23,429,379,27,59,9,1174,1005,2179,16,5.5,201836
15,31,165,52,253,350,7,39,0,866,843,1709,6,6,201836
15,32,219,26,344,458,38,74,4,1163,1046,2209,9,6,201836
15,33,252,11,396,412,17,72,0,1160,1651,2811,4,6,201836
15,34,184,22,277,459,18,59,7,1026,941,1967,8,6,201836
15,35,382,32,307,421,22,105,0,1269,1155,2424,9,5.666666667,201836
15,36,316,25,291,321,111,47,12,1123,822,1945,9,5.5,201836
15,37,225,28,395,524,49,102,31,1354,1207,2561,7,6,201836
15,38,256,47,423,525,10,71,0,1332,1090,2422,6,5.5,201836
15,39,174,50,301,327,19,51,9,931,828,1759,4,6,201836
15,40,437,25,436,444,96,112,0,1550,1243,2793,9,6,201836
15,41,296,38,645,591,29,76,28,1703,1489,3192,11,6,201836
16,1,214,22,274,188,29,61,3,791,700,1491,7,5.333333333,201836
16,2,206,34,144,208,30,50,0,672,618,1290,9,5.25,201836
16,3,311,36,268,300,21,45,0,981,812,1793,10,5.25,201836
16,4,246,32,339,242,33,93,2,987,1072,2059,8,5.5,201836
16,5,278,61,279,241,26,91,19,995,875,1870,10,5.666666667,201836
16,6,297,50,255,301,41,58,0,1002,802,1804,12,5.5,201836
16,7,268,42,237,266,38,73,1,925,773,1698,9,5.5,201836
16,8,376,72,651,560,15,118,12,1804,1614,3418,12,6,201836
16,9,256,30,371,288,15,83,2,1045,967,2012,9,6,201836
16,10,191,19,388,371,9,73,0,1051,868,1919,7,6.5,201836
16,11,301,31,273,185,120,61,1,972,727,1699,10,5.4,201836
16,12,273,23,328,179,17,77,5,902,660,1562,10,5.25,201836
17,1,192,24,390,372,20,76,3,1077,898,1975,10,4,201836
17,2,191,27,375,342,14,47,8,1004,898,1902,8,5.666666667,201836
17,3,356,28,409,458,18,76,0,1345,1141,2486,8,5.5,201836
17,4,273,32,375,406,27,69,2,1184,1363,2547,10,5.666666667,201836
17,5,114,17,150,170,10,27,0,488,558,1046,5,5.5,201836
18,1,222,27,157,250,20,63,7,746,531,1277,7,5.25,201836
18,2,270,58,461,440,93,80,0,1402,1275,2677,8,6,201836
18,3,203,26,354,305,19,41,0,948,886,1834,8,5.5,201836
19,1,231,26,430,424,22,97,23,1253,1241,2494,9,6,201836
19,2,369,25,796,320,32,87,0,1629,1524,3153,9,6,201836
19,3,316,27,748,383,21,98,17,1610,1374,2984,7,6,201836
19,4,137,33,254,166,74,58,103,825,688,1513,5,6,201836
19,5,393,43,531,632,19,112,33,1763,1662,3425,8,6,201836
19,6,108,15,267,310,8,85,19,812,699,1511,5,6,201836
19,7,187,13,521,261,3,43,1,1029,956,1985,10,5.5,201836
19,8,59,7,111,99,0,19,0,295,293,588,7,6,201836
19,9,221,42,349,393,54,77,17,1153,265,1418,9,5.25,201836
19,10,153,22,275,375,7,69,43,944,842,1786,6,3.5,201836
19,11,455,76,749,961,40,164,0,2445,2281,4726,13,6,201836
19,12,249,13,566,243,14,56,16,1157,933,2090,8,5.666666667,201836
20,1,242,21,216,247,243,65,48,1082,1178,2260,7,5.5,201836
20,2,204,25,221,258,42,26,0,776,388,1164,6,5.333333333,201836
20,3,145,18,197,200,62,46,0,668,920,1588,6,5.333333333,201836
20,4,183,22,134,210,61,60,14,684,1052,1736,6,5.333333333,201836
20,5,161,24,287,331,85,62,2,952,1233,2185,11,5.25,201836
20,6,166,13,133,177,135,25,2,651,804,1455,8,5.25,201836
20,7,201,19,208,323,12,48,0,811,812,1623,7,5.75,201836
20,8,512,60,553,824,31,146,158,2284,2222,4506,14,4.333333333,201836
20,9,306,33,232,290,78,82,44,1065,1144,2209,8,5.666666667,201836
20,10,317,21,252,431,16,41,0,1078,1275,2353,9,5.25,201836
21,1,232,27,261,403,21,65,1,1010,937,1947,9,5.4,201836
21,2,304,31,380,228,156,60,0,1159,312,1471,9,5.2,201836
21,3,333,26,369,208,114,96,48,1194,969,2163,8,5.5,201836
21,4,215,18,171,149,65,61,50,729,545,1274,6,5.25,201836
21,5,295,19,427,363,32,87,19,1242,1194,2436,8,5.666666667,201836
21,6,245,17,477,507,44,84,64,1438,1426,2864,6,6,201836
21,7,374,18,289,358,72,111,0,1222,1194,2416,9,5.666666667,201836
21,8,334,20,504,389,123,104,6,1480,373,1853,9,5.2,201836
21,9,228,22,521,447,63,96,42,1419,1443,2862,9,6,201836
21,10,242,26,405,312,45,67,71,1168,1088,2256,7,5,201836
21,11,80,1,156,107,14,20,2,380,365,745,4,6,201836
21,12,389,39,926,889,83,182,48,2556,2301,4857,16,4.333333333,201836
21,13,315,19,295,386,42,74,12,1143,1089,2232,8,5.666666667,201836
21,14,264,21,229,262,59,69,17,921,832,1753,12,5.333333333,201836
21,15,339,22,496,350,59,95,28,1389,1362,2751,7,5.5,201836
22,1,257,67,283,293,35,31,0,966,858,1824,11,5.2,201836
22,2,210,23,384,209,33,47,17,923,896,1819,7,5.5,201836
22,3,366,101,836,602,38,102,0,2045,2019,4064,9,5.666666667,201836
22,4,249,48,650,454,34,78,23,1536,1445,2981,9,4.333333333,201836
22,5,233,21,488,225,58,59,4,1088,1090,2178,10,5.5,201836
23,1,332,7,1493,313,17,46,10,2218,2077,4295,14,5.6,201836
23,2,251,26,525,400,12,45,0,1259,937,2196,8,5.25,201836
23,3,299,15,1033,447,30,49,0,1873,1657,3530,12,5,201836
23,4,150,5,537,218,7,22,0,939,757,1696,7,5.666666667,201836
24,1,204,43,156,247,25,32,1,708,555,1263,10,5.2,201836
24,2,225,45,266,211,32,80,1,860,572,1432,6,5.5,201836
24,3,187,47,201,245,50,47,0,777,824,1601,9,5,201836
24,4,229,47,212,196,38,63,88,873,904,1777,5,5.5,201836
24,5,321,36,442,527,7,99,0,1432,1265,2697,9,6,201836
24,6,378,82,627,555,23,112,3,1780,1646,3426,9,6,201836
24,7,256,23,249,227,51,38,0,844,505,1349,9,5.25,201836
25,1,192,24,264,374,53,76,14,997,938,1935,13,5.75,201836
25,2,248,40,395,530,14,92,0,1319,1187,2506,7,5.5,201836
25,3,263,29,318,408,52,72,5,1147,954,2101,8,5.6,201836
25,4,180,41,186,334,22,66,50,879,675,1554,8,5.333333333,201836
25,5,248,37,398,583,17,91,0,1374,1397,2771,8,5.666666667,201836
25,6,222,28,430,352,79,84,10,1205,1155,2360,8,5.75,201836
25,7,258,25,356,461,3,78,0,1181,1124,2305,6,6,201836
26,1,263,19,412,349,24,92,0,1159,937,2096,9,5.5,201836
26,2,285,17,548,456,8,119,0,1433,1214,2647,12,5.4,201836
26,3,339,46,503,581,14,212,17,1712,1550,3262,13,6,201836
26,4,120,18,198,287,23,43,15,704,474,1178,9,5.2,201836
26,5,100,11,135,161,9,51,0,467,376,843,3,5.5,201836
26,6,218,31,464,474,10,104,0,1301,1179,2480,10,5.333333333,201836
26,7,175,23,179,275,36,60,0,748,601,1349,10,5.5,201836
27,1,206,37,232,265,51,50,7,848,901,1749,8,5.5,201836
27,2,330,42,305,444,24,58,0,1203,961,2164,8,5.666666667,201836
27,3,243,29,181,404,9,46,0,912,746,1658,7,5.666666667,201836
27,4,235,34,367,654,19,72,24,1405,1319,2724,8,4,201836
27,5,167,12,147,248,1,31,4,610,459,1069,6,5.333333333,201836
27,6,214,29,255,423,5,62,0,988,1008,1996,7,5.5,201836
28,1,245,29,561,445,15,69,0,1364,1218,2582,13,6,201836
28,2,274,36,628,399,35,79,150,1601,1491,3092,13,5.75,201836
28,3,166,31,218,339,8,49,0,811,651,1462,7,5.333333333,201836
28,4,318,38,566,467,41,102,112,1644,1543,3187,15,6,201836
28,5,204,48,357,468,30,77,26,1210,1151,2361,10,4.4,201836
28,6,211,45,260,318,43,56,33,966,645,1611,13,5.166666667,201836
28,7,254,37,509,493,66,86,0,1445,1277,2722,6,6,201836
28,8,147,36,330,342,54,53,14,976,914,1890,9,6,201836
28,9,175,21,359,245,37,29,77,943,789,1732,11,5.75,201836
29,1,281,38,371,329,50,57,1,1127,1303,2430,7,5.5,201836
29,2,262,27,328,517,40,87,57,1318,1239,2557,12,4.8,201836
29,3,162,28,206,335,10,47,0,788,843,1631,5,5.666666667,201836
30,1,145,27,208,268,53,40,39,780,659,1439,7,5.333333333,201836
30,2,245,24,157,142,58,42,288,956,562,1518,8,5.25,201836
30,3,244,22,354,178,140,77,174,1189,1164,2353,6,5.666666667,201836
30,4,129,12,302,244,39,57,0,783,705,1488,8,6,201836
30,5,200,29,203,389,14,50,0,885,874,1759,7,5.5,201836
30,6,264,17,284,242,69,63,0,939,731,1670,9,5.333333333,201836
30,7,242,23,250,266,65,60,47,953,1107,2060,11,5.25,201836
30,8,273,26,405,469,58,71,15,1317,1138,2455,11,5.4,201836
30,9,329,38,273,193,67,76,132,1108,1002,2110,8,5.5,201836
30,10,215,33,466,404,46,92,88,1344,945,2289,6,6,201836
30,11,207,22,418,480,4,85,0,1216,992,2208,6,5.5,201836
30,12,281,29,528,656,27,136,0,1657,1661,3318,10,6,201836
30,13,297,28,249,328,91,90,132,1215,1207,2422,10,5.4,201836
30,14,258,32,353,250,88,78,35,1094,1040,2134,8,5.5,201836
30,15,394,28,317,324,46,93,153,1355,1207,2562,11,5.666666667,201836
30,16,272,14,345,387,92,79,113,1302,1255,2557,10,5.333333333,201836
30,17,269,55,252,348,33,65,23,1045,1033,2078,8,5.5,201836
30,18,333,17,243,302,11,57,43,1006,825,1831,8,5.25,201836
30,19,226,19,238,344,44,63,0,934,1025,1959,13,5.6,201836
30,20,264,26,232,381,74,60,0,1037,978,2015,10,5.4,201836
31,1,181,28,181,339,23,41,0,793,625,1418,8,5.5,201836
31,2,103,20,180,33,344,38,0,718,170,888,6,5.333333333,201836
31,3,385,42,939,707,117,124,0,2314,2261,4575,20,6,201836
31,4,112,23,325,287,45,46,0,838,715,1553,3,6,201836
31,5,162,30,151,399,40,42,0,824,886,1710,5,5.333333333,201836
32,1,272,79,247,281,66,72,46,1063,972,2035,12,5.2,201836
32,2,297,90,303,210,135,100,74,1209,1335,2544,13,5.142857143,201836
32,3,224,62,272,328,12,53,6,957,972,1929,13,5.4,201836
32,4,281,115,304,301,58,87,71,1217,1249,2466,13,4.5,201836
1,1,239,42,321,266,77,61,8,1014,976,1990,13,5.5,201837
1,2,259,52,625,471,70,87,24,1588,1490,3078,10,4.75,201837
1,3,180,72,672,472,30,93,7,1526,1452,2978,9,6,201837
2,1,196,20,418,399,9,73,2,1117,1084,2201,11,6,201837
2,2,215,21,411,685,15,114,0,1461,1390,2851,7,6,201837
2,3,377,38,621,486,21,98,2,1643,1509,3152,11,4.25,201837
2,4,254,16,594,234,20,52,0,1170,1240,2410,9,6,201837
2,5,436,40,1160,601,127,157,11,2532,2535,5067,13,6,201837
2,6,244,24,597,377,22,102,0,1366,1429,2795,7,6,201837
2,7,365,31,689,518,32,110,12,1757,1603,3360,12,5.75,201837
2,8,269,18,813,505,14,82,8,1709,1732,3441,8,6,201837
3,1,191,14,312,364,10,79,0,970,1027,1997,12,5.666666667,201837
3,2,139,15,412,225,16,40,0,847,1068,1915,9,5.666666667,201837
4,1,198,18,275,439,27,43,0,1000,1053,2053,11,5.25,201837
4,2,237,37,445,385,26,62,4,1196,867,2063,14,5.2,201837
5,1,249,30,419,337,29,85,0,1149,1045,2194,9,5.666666667,201837
5,2,205,28,324,334,20,47,3,961,1091,2052,10,5.2,201837
5,3,209,21,315,344,51,73,71,1084,1113,2197,9,5.5,201837
5,4,249,39,562,403,24,104,127,1508,1444,2952,9,5.666666667,201837
5,5,225,24,470,440,22,64,20,1265,1211,2476,8,6,201837
5,6,135,16,307,268,11,35,38,810,761,1571,11,5.5,201837
5,7,196,21,361,276,5,40,2,901,811,1712,10,5.5,201837
6,1,191,29,391,318,20,66,62,1077,1041,2118,12,5,201837
6,2,202,20,330,206,77,54,20,909,982,1891,9,5.666666667,201837
7,1,373,9,224,380,12,68,20,1086,470,1556,9,5.25,201837
7,2,380,19,186,559,29,42,0,1215,385,1600,9,5.25,201837
7,3,512,12,343,252,166,73,0,1358,612,1970,7,5.333333333,201837
7,4,223,23,189,379,4,59,32,909,375,1284,11,5.4,201837
7,5,386,24,272,605,20,59,2,1368,1275,2643,11,5.666666667,201837
7,6,327,23,343,455,34,77,15,1274,1304,2578,8,4,201837
7,7,340,38,316,409,46,82,0,1231,671,1902,8,5.25,201837
7,8,399,14,216,587,15,56,0,1287,1320,2607,12,5.25,201837
7,9,251,43,355,509,36,69,0,1263,1271,2534,10,6,201837
7,10,234,20,236,535,37,58,0,1120,1271,2391,9,5.5,201837
7,11,243,6,79,172,15,21,0,536,391,927,6,5.333333333,201837
7,12,402,18,334,604,14,60,0,1432,1197,2629,9,5.5,201837
7,13,236,21,152,360,0,34,0,803,119,922,9,5.25,201837
8,1,167,12,446,237,17,40,9,928,830,1758,4,6,201837
8,2,336,38,821,496,37,109,17,1854,1641,3495,16,5.5,201837
8,3,229,28,479,378,24,70,3,1211,1207,2418,4,6,201837
8,4,177,38,465,371,32,94,43,1220,1007,2227,9,6,201837
8,5,340,65,478,376,65,135,1,1460,635,2095,10,5.25,201837
8,6,257,33,501,510,54,130,52,1537,1380,2917,7,4.333333333,201837
8,7,285,47,296,348,16,72,1,1065,952,2017,7,5.25,201837
8,8,244,46,434,463,7,119,17,1330,1268,2598,11,7,201837
8,9,177,25,215,246,34,82,2,781,608,1389,10,4.6,201837
9,1,130,16,264,174,93,65,31,773,706,1479,5,6,201837
9,2,304,104,949,1061,89,152,33,2692,2649,5341,12,6,201837
9,3,158,50,530,471,60,115,78,1462,1454,2916,7,6,201837
9,4,205,32,499,573,54,88,30,1481,1427,2908,11,6,201837
9,5,151,25,373,386,58,71,0,1064,924,1988,7,6,201837
9,6,121,37,232,228,91,59,39,807,717,1524,7,6,201837
9,7,147,27,366,473,1,59,1,1074,1016,2090,9,6,201837
9,8,75,9,313,230,27,50,49,753,710,1463,5,5,201837
9,9,129,16,322,325,43,59,17,911,874,1785,5,6,201837
9,10,128,20,413,442,28,75,0,1106,1053,2159,6,6,201837
9,11,213,32,628,590,61,134,0,1658,1470,3128,7,6,201837
9,12,142,57,597,578,48,84,71,1577,1482,3059,11,6,201837
9,13,127,17,393,363,58,68,60,1086,1067,2153,4,6,201837
9,14,106,11,230,175,87,50,19,678,768,1446,5,6,201837
9,15,221,45,1094,1050,37,149,25,2621,1842,4463,10,4.666666667,201837
9,16,270,56,638,717,74,136,6,1897,1775,3672,15,6,201837
9,17,165,18,320,362,37,59,2,963,893,1856,6,6,201837
9,18,194,40,477,704,45,120,3,1583,1511,3094,12,6,201837
9,19,205,69,443,358,171,99,18,1363,1333,2696,5,6,201837
9,20,56,12,78,101,10,23,1,281,274,555,5,6,201837
9,21,129,15,228,241,51,49,17,730,720,1450,3,6,201837
9,22,209,19,339,303,94,73,42,1079,979,2058,5,6,201837
9,23,146,27,421,489,72,60,19,1234,1113,2347,6,6,201837
9,24,339,43,705,929,90,134,33,2273,2123,4396,12,6,201837
10,1,290,66,295,417,40,73,65,1246,793,2039,8,5,201837
10,2,249,43,412,400,39,90,50,1283,1171,2454,7,5.25,201837
10,3,224,48,249,368,19,77,63,1048,866,1914,9,5.4,201837
10,4,308,42,476,498,22,84,1,1431,1280,2711,12,4.333333333,201837
11,1,284,58,231,351,38,47,4,1013,915,1928,6,5.666666667,201837
11,2,307,39,304,285,26,57,8,1026,929,1955,7,6,201837
11,3,179,35,251,278,15,60,82,900,858,1758,3,6,201837
11,4,277,52,219,304,17,70,0,939,726,1665,8,4.5,201837
11,5,325,69,467,541,20,103,14,1539,1411,2950,7,6,201837
11,6,187,52,397,335,41,68,27,1107,1026,2133,7,5.666666667,201837
11,7,322,60,342,602,22,57,0,1405,1043,2448,9,5.5,201837
11,8,242,54,376,478,32,55,18,1255,1157,2412,9,5.75,201837
11,9,366,89,452,543,20,88,32,1590,1489,3079,10,5.666666667,201837
11,10,254,73,326,383,46,70,57,1209,1114,2323,10,5.6,201837
11,11,199,88,270,310,13,39,0,919,838,1757,5,6,201837
11,12,297,66,493,566,17,77,0,1516,1355,2871,7,6,201837
11,13,335,56,283,263,37,52,59,1085,1030,2115,8,5.5,201837
11,14,265,42,348,333,29,50,0,1067,968,2035,8,5.5,201837
11,15,155,41,200,215,6,58,1,676,740,1416,8,6,201837
12,1,192,33,300,127,49,47,7,755,675,1430,10,5,201837
12,2,282,43,313,431,33,76,0,1178,1111,2289,10,5.5,201837
12,3,279,55,320,395,36,74,0,1159,1275,2434,11,5.2,201837
12,4,240,38,388,554,28,37,0,1285,1129,2414,9,5.666666667,201837
12,5,393,34,247,310,1,52,7,1044,940,1984,10,5.25,201837
12,6,290,23,186,405,16,29,7,956,827,1783,10,5.25,201837
12,7,368,31,362,427,12,71,35,1306,1147,2453,6,5.5,201837
12,8,285,27,261,269,10,28,0,880,661,1541,9,5.25,201837
12,9,244,29,291,501,16,44,4,1129,1129,2258,9,5.666666667,201837
13,1,312,58,260,574,187,76,43,1510,1077,2587,9,5.333333333,201837
13,2,189,37,155,257,100,44,50,832,588,1420,6,5.333333333,201837
13,3,245,36,322,386,120,82,2,1193,969,2162,12,5.25,201837
13,4,143,17,294,274,43,40,0,811,806,1617,5,6,201837
13,7,261,74,692,679,82,99,32,1919,1776,3695,10,5.6,201837
13,5,287,42,522,389,124,133,74,1571,1341,2912,9,5.75,201837
13,6,313,74,901,1024,67,109,0,2488,2517,5005,13,5.5,201837
14,1,202,48,168,209,33,41,24,725,616,1341,6,5,201837
14,2,218,35,264,163,28,75,5,788,817,1605,5,5.666666667,201837
14,3,331,52,392,323,27,107,25,1257,1135,2392,8,5.4,201837
14,4,215,29,244,443,15,74,22,1042,955,1997,11,6,201837
14,5,194,20,423,296,35,59,6,1033,1168,2201,9,5.5,201837
14,6,250,31,560,329,12,59,0,1241,1225,2466,11,6,201837
14,7,162,15,275,178,0,36,0,666,563,1229,6,6,201837
14,8,397,72,853,1062,23,144,9,2560,2341,4901,10,4.8,201837
14,9,106,28,176,248,17,34,0,609,474,1083,12,6,201837
14,10,241,25,459,386,15,76,4,1206,1100,2306,7,6,201837
14,11,143,37,183,244,33,51,33,724,710,1434,4,6,201837
14,12,278,23,574,164,16,47,0,1102,1111,2213,9,5.5,201837
14,13,241,47,375,288,22,73,0,1046,923,1969,6,6,201837
14,14,197,27,316,414,21,71,30,1076,942,2018,7,6,201837
14,15,299,47,257,278,32,100,17,1030,1305,2335,10,5.6,201837
14,16,201,32,373,209,46,62,17,940,841,1781,5,6,201837
14,17,163,19,132,167,15,57,28,581,697,1278,7,4.75,201837
14,18,336,61,322,298,56,74,67,1214,807,2021,9,5.4,201837
14,19,250,50,318,347,51,73,17,1106,1005,2111,8,5.25,201837
14,20,218,22,343,192,9,65,5,854,941,1795,10,5.666666667,201837
15,1,187,28,199,155,350,48,2,969,1063,2032,7,5.333333333,201837
15,2,186,34,341,356,38,59,20,1034,968,2002,6,6,201837
15,3,365,59,405,519,163,81,2,1594,1240,2834,10,5.666666667,201837
15,4,231,22,345,399,25,82,3,1107,1090,2197,4,6,201837
15,5,206,51,362,378,15,68,9,1089,917,2006,8,5.666666667,201837
15,6,159,18,440,494,45,79,7,1242,1226,2468,7,6,201837
15,7,186,20,369,399,43,69,6,1092,1157,2249,10,6,201837
15,8,84,19,189,214,8,33,2,549,558,1107,4,6,201837
15,9,400,20,223,215,175,58,28,1119,948,2067,9,5.75,201837
15,10,161,19,292,307,73,54,6,912,901,1813,6,6,201837
15,11,164,32,389,409,36,63,2,1095,919,2014,8,6,201837
15,12,291,26,705,515,27,81,0,1645,1526,3171,8,6,201837
15,13,83,18,147,167,74,43,0,532,582,1114,8,5,201837
15,14,90,9,143,155,15,34,0,446,509,955,4,6,201837
15,15,200,62,401,469,23,91,0,1246,1143,2389,6,6,201837
15,16,276,43,491,548,21,98,18,1495,1523,3018,8,6,201837
15,17,119,27,231,252,17,81,122,849,718,1567,8,5,201837
15,18,330,51,432,528,51,95,24,1511,1339,2850,7,5.666666667,201837
15,19,240,76,532,812,9,119,23,1811,1726,3537,10,6,201837
15,20,93,12,230,355,31,49,7,777,712,1489,6,6,201837
15,21,132,10,112,195,11,46,0,506,521,1027,6,5.5,201837
15,22,324,71,563,802,26,122,83,1991,1785,3776,14,6,201837
15,23,234,29,336,455,29,93,0,1176,1049,2225,6,5.333333333,201837
15,24,179,16,323,275,37,49,4,883,862,1745,4,6,201837
15,25,215,23,420,365,29,73,25,1150,1083,2233,6,6,201837
15,26,139,13,241,232,30,57,1,713,663,1376,9,5.5,201837
15,27,276,29,421,574,14,86,31,1431,1371,2802,9,5.666666667,201837
15,28,271,32,638,372,75,89,35,1512,1445,2957,9,5.666666667,201837
15,29,207,49,479,640,11,110,8,1504,1376,2880,8,6,201837
15,30,287,40,518,424,50,84,15,1418,1773,3191,16,5.5,201837
15,31,147,54,269,317,11,53,0,851,810,1661,6,6,201837
15,32,184,25,327,458,33,75,2,1104,1168,2272,9,6,201837
15,33,264,17,389,456,17,75,0,1218,717,1935,4,6,201837
15,34,169,19,275,460,27,64,5,1019,934,1953,8,6,201837
15,35,412,43,341,462,24,111,1,1394,1155,2549,9,5.666666667,201837
15,36,270,27,305,269,108,43,2,1024,939,1963,9,5.5,201837
15,37,228,25,362,446,46,81,20,1208,1161,2369,7,6,201837
15,38,214,43,350,486,10,66,0,1169,1170,2339,6,5.5,201837
15,39,180,43,381,402,27,63,6,1102,1150,2252,4,6,201837
15,40,310,27,336,423,81,79,0,1256,1179,2435,9,6,201837
15,41,285,30,707,605,30,67,23,1747,1586,3333,11,6,201837
16,1,229,27,284,289,26,58,6,919,868,1787,7,5.333333333,201837
16,2,192,56,220,279,20,59,0,826,742,1568,9,5.25,201837
16,3,202,33,174,281,34,44,0,768,829,1597,10,5.25,201837
16,4,265,26,313,268,41,89,0,1002,1008,2010,8,5.5,201837
16,5,289,50,262,283,42,91,12,1029,1045,2074,10,5.666666667,201837
16,6,266,41,233,200,28,36,0,804,747,1551,12,5.5,201837
16,7,253,33,248,252,34,59,1,880,923,1803,9,5.5,201837
16,8,285,56,688,579,10,106,29,1753,1571,3324,12,6,201837
16,9,301,28,363,340,17,75,0,1124,1062,2186,9,6,201837
16,10,177,23,298,363,3,74,0,938,918,1856,7,6.5,201837
16,11,261,38,249,155,113,75,5,896,756,1652,10,5.4,201837
16,12,218,22,285,163,20,52,2,762,879,1641,10,5.25,201837
17,1,213,16,407,405,25,62,15,1143,1126,2269,9,3.5,201837
17,2,206,17,308,316,21,54,15,937,1068,2005,8,5.666666667,201837
17,3,345,35,428,466,12,67,0,1353,1178,2531,8,5.5,201837
17,4,320,36,371,474,29,77,1,1308,1100,2408,10,5.666666667,201837
17,5,125,18,167,194,22,36,1,563,401,964,5,5.5,201837
18,1,188,29,185,235,24,51,6,718,694,1412,7,5.25,201837
18,2,245,47,469,409,69,78,0,1317,1256,2573,8,6,201837
18,3,232,34,440,326,19,46,0,1097,946,2043,8,5.5,201837
19,1,226,38,459,480,31,101,39,1374,1173,2547,9,6,201837
19,2,269,17,762,207,43,68,0,1366,1574,2940,9,6,201837
19,3,285,34,706,432,29,93,14,1593,1530,3123,7,6,201837
19,4,125,27,238,164,79,46,156,835,706,1541,5,6,201837
19,5,361,56,531,639,14,116,64,1781,1651,3432,8,6,201837
19,6,87,26,240,424,21,55,37,890,695,1585,5,6,201837
19,7,219,16,523,256,8,51,4,1077,1173,2250,10,5.5,201837
19,8,59,10,121,91,0,20,0,301,296,597,7,6,201837
19,9,307,37,344,380,47,70,24,1209,444,1653,9,5.25,201837
19,10,144,17,282,392,8,59,60,962,830,1792,5,3,201837
19,11,459,77,748,1087,18,165,8,2562,2244,4806,13,6,201837
19,12,205,15,600,254,14,45,14,1147,925,2072,8,5.666666667,201837
20,1,288,36,279,240,122,91,38,1094,1091,2185,7,5.5,201837
20,2,236,27,188,303,54,37,0,845,639,1484,6,5.333333333,201837
20,3,172,27,224,287,89,50,2,851,725,1576,6,5.333333333,201837
20,4,192,28,153,227,95,53,21,769,759,1528,6,5.333333333,201837
20,5,179,31,260,368,42,61,3,944,943,1887,11,5.25,201837
20,6,222,26,172,327,188,43,1,979,891,1870,8,5.25,201837
20,7,236,24,220,330,16,50,0,876,716,1592,7,5.75,201837
20,8,551,71,690,993,34,172,178,2689,2183,4872,14,4.333333333,201837
20,9,403,27,280,308,105,62,50,1235,1171,2406,8,5.666666667,201837
20,10,366,29,235,540,12,61,0,1243,872,2115,9,5.25,201837
21,1,275,24,221,401,27,62,0,1010,879,1889,9,5.4,201837
21,2,193,13,253,257,67,50,4,837,612,1449,9,5.2,201837
21,3,308,21,344,211,98,104,73,1159,1004,2163,8,5.5,201837
21,4,322,13,175,115,73,63,46,807,570,1377,6,5.25,201837
21,5,269,20,341,308,18,73,20,1049,1115,2164,8,5.666666667,201837
21,6,237,24,425,494,44,84,113,1421,1361,2782,6,6,201837
21,7,395,17,335,341,67,87,4,1246,1213,2459,9,5.666666667,201837
21,8,270,17,399,353,109,76,16,1240,812,2052,9,5.2,201837
21,9,268,25,490,452,59,107,48,1449,1398,2847,9,6,201837
21,10,294,24,475,392,46,88,78,1397,1409,2806,7,5.5,201837
21,11,77,4,154,107,16,16,6,380,338,718,4,6,201837
21,12,395,41,924,912,75,157,29,2533,2399,4932,15,4,201837
21,13,302,22,317,405,44,88,15,1193,1178,2371,8,5.666666667,201837
21,14,295,16,266,248,78,59,8,970,560,1530,12,5.333333333,201837
21,15,348,25,408,293,52,80,34,1240,1191,2431,7,5.5,201837
22,1,277,46,261,301,32,45,0,962,840,1802,11,5.2,201837
22,2,176,29,391,291,29,49,10,975,931,1906,7,5.5,201837
22,3,249,50,824,596,29,82,5,1835,1786,3621,9,5.666666667,201837
22,4,216,60,682,533,33,77,5,1606,1430,3036,10,4.666666667,201837
22,5,176,36,402,243,82,48,4,991,1021,2012,10,5.5,201837
23,1,362,11,1385,317,9,35,17,2136,2025,4161,14,5.6,201837
23,2,214,27,417,436,11,49,0,1154,1331,2485,8,5.25,201837
23,3,312,6,1110,486,36,55,1,2006,1917,3923,15,6,201837
23,4,174,10,777,367,26,35,0,1389,947,2336,8,5.666666667,201837
24,1,201,68,209,294,30,31,2,835,678,1513,10,5.2,201837
24,2,173,26,213,157,20,44,3,636,612,1248,6,5.5,201837
24,3,249,32,236,271,78,52,1,919,796,1715,8,5.25,201837
24,4,178,43,231,219,41,67,85,864,801,1665,5,5.5,201837
24,5,281,39,434,492,16,73,0,1335,1261,2596,9,6,201837
24,6,324,67,629,587,33,103,7,1750,1682,3432,9,6,201837
24,7,331,27,356,340,38,66,0,1158,724,1882,9,5.25,201837
25,1,163,25,242,378,37,48,43,936,827,1763,13,5.75,201837
25,2,246,32,391,509,22,70,0,1270,1284,2554,7,5.5,201837
25,3,270,19,292,395,51,52,33,1112,1332,2444,8,5.6,201837
25,4,215,38,223,394,34,65,56,1025,886,1911,8,5.333333333,201837
25,5,245,26,403,599,24,92,0,1389,1209,2598,8,5.666666667,201837
25,6,247,23,415,416,84,83,19,1287,1224,2511,8,5.75,201837
25,7,270,16,348,547,7,97,0,1285,1159,2444,6,6,201837
26,1,279,19,434,330,24,82,0,1168,1197,2365,9,5.5,201837
26,2,269,20,489,455,6,89,0,1328,1330,2658,12,5.4,201837
26,3,315,23,518,633,16,201,19,1725,1575,3300,13,6,201837
26,4,180,25,220,318,22,56,19,840,678,1518,9,5.2,201837
26,5,83,19,124,152,6,52,0,436,352,788,3,5.5,201837
26,6,219,27,356,496,6,108,0,1212,1144,2356,10,5.333333333,201837
26,7,215,20,224,299,52,60,0,870,649,1519,10,5.5,201837
27,1,206,15,243,293,32,49,2,840,635,1475,8,5.5,201837
27,2,302,44,299,418,19,51,1,1134,1123,2257,8,5.666666667,201837
27,3,237,34,192,408,9,49,0,929,780,1709,7,5.666666667,201837
27,4,306,29,338,684,18,57,44,1476,1234,2710,8,4,201837
27,5,131,4,130,244,9,21,3,542,410,952,6,5.333333333,201837
27,6,196,43,244,489,13,54,0,1039,894,1933,7,5.5,201837
28,1,232,32,530,476,8,79,0,1357,1175,2532,13,6,201837
28,2,302,44,584,338,33,80,240,1621,1514,3135,13,5.75,201837
28,3,183,29,227,360,7,48,0,854,446,1300,7,5.333333333,201837
28,4,312,38,587,488,36,90,123,1674,1533,3207,15,6,201837
28,5,217,38,280,461,30,58,57,1141,1238,2379,10,4.4,201837
28,6,179,28,240,317,53,42,35,894,582,1476,13,5.166666667,201837
28,7,250,34,518,500,67,90,0,1459,1394,2853,6,6,201837
28,8,141,28,294,384,56,61,8,972,899,1871,9,6,201837
28,9,167,23,341,198,24,43,92,888,831,1719,11,5.75,201837
29,1,247,35,412,326,74,49,0,1143,1198,2341,7,5.5,201837
29,2,280,52,294,518,27,69,81,1321,1203,2524,12,4.8,201837
29,3,164,43,187,356,26,55,0,831,686,1517,5,5.666666667,201837
30,1,179,32,248,435,53,49,52,1048,613,1661,7,5.333333333,201837
30,2,251,40,207,132,62,48,366,1106,892,1998,8,5.25,201837
30,3,250,22,439,181,137,76,248,1353,1204,2557,6,5.666666667,201837
30,4,133,6,213,202,41,53,1,649,793,1442,8,6,201837
30,5,144,27,229,387,5,56,0,848,781,1629,7,5.5,201837
30,6,226,32,265,286,35,48,0,892,808,1700,9,5.333333333,201837
30,7,282,43,292,333,65,82,51,1148,1044,2192,11,5.25,201837
30,8,254,33,438,440,72,91,21,1349,1316,2665,11,5.4,201837
30,9,282,24,253,204,88,74,138,1063,1038,2101,8,5.5,201837
30,10,218,30,417,402,43,84,84,1278,1322,2600,6,6,201837
30,11,175,19,388,436,9,77,0,1104,1195,2299,6,5.5,201837
30,12,232,30,540,713,28,123,0,1666,1459,3125,10,6,201837
30,13,294,24,249,383,66,64,139,1219,1100,2319,10,5.4,201837
30,14,229,36,307,285,87,100,75,1119,1000,2119,8,5.5,201837
30,15,349,17,264,307,59,106,195,1297,1175,2472,11,5.666666667,201837
30,16,227,25,357,335,64,77,78,1163,1162,2325,10,5.333333333,201837
30,17,289,41,247,329,38,86,21,1051,1119,2170,8,5.5,201837
30,18,272,25,171,289,7,55,44,863,951,1814,8,5.25,201837
30,19,258,17,269,336,38,64,2,984,813,1797,13,5.6,201837
30,20,233,15,261,346,77,61,0,993,931,1924,10,5.4,201837
31,1,204,17,243,288,16,45,0,813,485,1298,8,5.5,201837
31,2,77,12,162,25,317,25,0,618,448,1066,6,5.333333333,201837
31,3,416,62,967,850,140,156,0,2591,2271,4862,20,6,201837
31,4,102,23,365,324,70,41,0,925,756,1681,3,6,201837
31,5,123,15,151,316,33,32,0,670,348,1018,5,5.333333333,201837
32,1,237,50,266,236,60,63,88,1000,1006,2006,12,5.2,201837
32,2,325,94,349,253,169,62,99,1351,1306,2657,13,5.142857143,201837
32,3,194,71,266,340,15,44,20,950,769,1719,13,5.4,201837
32,4,339,107,322,334,57,85,86,1330,1282,2612,13,4.5,201837
1,1,285,70,388,335,65,53,9,1205,1070,2275,13,5.5,201838
1,2,238,57,601,428,88,79,29,1520,1544,3064,10,4.75,201838
1,3,175,71,564,452,32,96,0,1390,1410,2800,9,6,201838
2,1,185,19,397,408,13,64,6,1092,1047,2139,11,6,201838
2,2,239,27,474,742,11,105,0,1598,1475,3073,7,6,201838
2,3,340,34,643,488,16,111,4,1636,1614,3250,11,4.25,201838
2,4,229,15,647,224,33,39,0,1187,1171,2358,9,6,201838
2,5,458,50,1083,675,124,169,13,2572,2469,5041,13,6,201838
2,6,242,27,700,422,27,60,0,1478,1375,2853,7,6,201838
2,7,316,36,625,485,39,89,11,1601,1716,3317,12,5.75,201838
2,8,249,17,734,563,21,78,3,1665,1622,3287,8,6,201838
3,1,225,26,376,389,23,89,0,1128,981,2109,12,5.666666667,201838
3,2,160,19,472,223,14,34,0,922,922,1844,9,5.666666667,201838
4,1,269,25,273,530,12,48,8,1165,1084,2249,11,5.25,201838
4,2,259,31,371,398,19,73,2,1153,1415,2568,14,5.2,201838
5,1,283,23,539,360,38,81,0,1324,1371,2695,9,5.666666667,201838
5,2,148,23,234,252,10,30,1,698,649,1347,10,5.2,201838
5,3,178,28,295,338,47,78,64,1028,1007,2035,9,5.5,201838
5,4,260,37,542,392,22,83,137,1473,1439,2912,9,5.666666667,201838
5,5,235,24,438,550,24,50,16,1337,1208,2545,8,6,201838
5,6,142,18,261,312,7,32,22,794,785,1579,11,5.5,201838
5,7,169,27,292,325,11,41,8,873,871,1744,10,5.5,201838
6,1,154,34,353,327,21,56,54,999,1027,2026,11,4.833333333,201838
6,2,182,25,380,216,104,57,19,983,808,1791,9,5.666666667,201838
7,1,306,18,160,281,5,28,8,806,902,1708,9,5.25,201838
7,2,228,12,214,319,20,36,0,829,920,1749,9,5.25,201838
7,3,465,15,275,397,171,44,0,1367,1191,2558,7,5.333333333,201838
7,4,212,20,187,262,13,52,40,786,834,1620,11,5.4,201838
7,5,395,12,194,644,18,61,1,1325,1550,2875,11,5.666666667,201838
7,6,284,13,335,418,23,89,36,1198,1389,2587,8,4,201838
7,7,346,30,318,495,32,74,1,1296,1279,2575,8,5.5,201838
7,8,341,21,228,502,18,50,0,1160,1385,2545,12,5.25,201838
7,9,254,41,389,428,18,81,0,1211,1249,2460,9,5.666666667,201838
7,10,219,20,243,503,16,38,0,1039,971,2010,9,5.5,201838
7,11,170,9,113,151,12,19,1,475,601,1076,6,5.333333333,201838
7,12,360,9,381,576,13,59,0,1398,1447,2845,9,5.5,201838
7,13,207,15,150,352,2,36,0,762,170,932,9,5.25,201838
8,1,162,14,468,270,16,43,4,977,899,1876,4,6,201838
8,2,284,37,677,436,34,77,17,1562,1557,3119,16,5.5,201838
8,3,199,35,401,421,22,72,2,1152,1157,2309,4,6,201838
8,4,157,35,474,373,27,89,23,1178,1191,2369,9,6,201838
8,5,207,39,300,308,27,73,0,954,948,1902,10,5.25,201838
8,6,230,38,468,494,54,93,54,1431,1414,2845,6,4,201838
8,7,264,53,299,352,17,73,0,1058,915,1973,7,5.25,201838
8,8,215,58,416,432,16,81,18,1236,1298,2534,10,6,201838
8,9,265,52,223,393,37,72,0,1042,957,1999,10,5.2,201838
9,1,121,15,240,150,77,60,23,686,702,1388,5,6,201838
9,2,301,109,892,1126,75,156,46,2705,2798,5503,12,6,201838
9,3,119,53,451,484,41,96,51,1295,1303,2598,7,6,201838
9,4,209,35,440,617,66,88,14,1469,1499,2968,11,6,201838
9,5,152,27,358,418,62,62,1,1080,1064,2144,7,6,201838
9,6,111,28,247,200,63,62,31,742,747,1489,7,6,201838
9,7,117,26,385,446,4,70,1,1049,953,2002,9,6,201838
9,8,91,23,284,301,19,64,56,838,937,1775,5,6,201838
9,9,140,20,266,306,42,44,12,830,884,1714,5,6,201838
9,10,134,19,404,451,33,70,2,1113,1055,2168,6,6,201838
9,11,228,38,533,567,56,123,2,1547,1568,3115,7,6,201838
9,12,130,54,545,561,38,107,63,1498,1488,2986,11,6,201838
9,13,132,35,335,403,49,67,83,1104,1076,2180,4,6,201838
9,14,123,18,225,237,58,42,30,733,706,1439,5,6,201838
9,15,211,55,966,1071,37,126,34,2500,2635,5135,9,4.333333333,201838
9,16,295,91,581,755,84,128,5,1939,1894,3833,15,6,201838
9,17,157,13,294,319,23,67,0,873,959,1832,6,6,201838
9,18,203,38,424,707,36,98,1,1507,1521,3028,12,6,201838
9,19,212,60,377,416,130,79,27,1301,1343,2644,5,6,201838
9,20,49,8,89,113,8,16,6,289,284,573,5,6,201838
9,21,118,13,206,261,40,47,0,685,710,1395,3,6,201838
9,22,164,28,321,322,108,66,33,1042,1055,2097,5,6,201838
9,23,148,19,393,502,70,59,22,1213,1207,2420,6,6,201838
9,24,298,67,668,846,93,140,27,2139,2230,4369,12,6,201838
10,1,288,35,318,296,65,68,51,1121,1018,2139,12,5,201838
10,2,269,50,433,460,50,66,107,1435,1187,2622,9,5.25,201838
10,3,220,42,264,372,23,59,84,1064,902,1966,11,5.4,201838
10,4,313,44,493,533,16,76,0,1475,1339,2814,12,4.333333333,201838
11,1,299,39,218,264,14,54,14,902,903,1805,6,5.666666667,201838
11,2,271,49,295,313,40,43,10,1021,992,2013,7,6,201838
11,3,182,42,267,261,20,53,75,900,859,1759,3,6,201838
11,4,190,44,216,276,17,51,0,794,840,1634,8,4.5,201838
11,5,294,81,447,588,23,103,11,1547,1504,3051,7,6,201838
11,6,205,47,393,315,49,42,32,1083,1133,2216,7,5.666666667,201838
11,7,298,52,433,564,25,55,0,1427,942,2369,9,5.5,201838
11,8,243,69,374,418,27,46,28,1205,1118,2323,9,5.75,201838
11,9,306,85,417,498,12,75,37,1430,1460,2890,10,5.333333333,201838
11,10,302,103,351,424,45,76,81,1382,1084,2466,10,5.6,201838
11,11,219,75,290,352,20,43,0,999,926,1925,5,6,201838
11,12,310,50,500,562,5,63,0,1490,1477,2967,7,6,201838
11,13,259,73,320,260,33,43,95,1083,918,2001,8,5.5,201838
11,14,240,57,327,373,31,57,1,1086,1014,2100,8,5.25,201838
11,15,187,45,258,311,4,40,2,847,724,1571,8,6,201838
12,1,260,42,341,138,66,42,15,904,701,1605,10,5.2,201838
12,2,294,43,303,404,24,61,0,1129,1179,2308,10,5.5,201838
12,3,268,42,335,381,15,58,0,1099,946,2045,11,5.2,201838
12,4,220,35,380,512,28,63,1,1239,1266,2505,9,5.666666667,201838
12,5,394,38,240,346,3,37,31,1089,580,1669,10,5.25,201838
12,6,338,27,207,420,26,19,1,1038,537,1575,10,5.25,201838
12,7,343,24,355,400,23,59,46,1250,1047,2297,6,5.5,201838
12,8,404,32,288,329,20,38,0,1111,1013,2124,9,5.25,201838
12,9,257,32,302,506,19,48,0,1164,1046,2210,9,5.666666667,201838
13,1,253,48,193,484,107,65,6,1156,1186,2342,9,5.333333333,201838
13,2,202,52,211,285,156,61,18,985,719,1704,6,5.333333333,201838
13,3,209,35,267,320,102,66,2,1001,1043,2044,12,5.25,201838
13,4,165,9,273,223,38,51,20,779,767,1546,5,6,201838
13,7,320,82,663,593,102,88,26,1874,1842,3716,10,5.6,201838
13,5,228,36,478,393,103,93,39,1370,1465,2835,9,5.75,201838
13,6,325,62,838,943,76,99,0,2343,2401,4744,13,5.5,201838
14,1,202,51,202,179,51,63,99,847,506,1353,6,5.5,201838
14,2,200,25,254,194,36,74,8,791,791,1582,5,5.666666667,201838
14,3,308,56,440,373,34,112,49,1372,1147,2519,8,5.4,201838
14,4,192,25,254,444,23,58,14,1010,1018,2028,11,6,201838
14,5,245,19,542,338,29,80,4,1257,1110,2367,9,5.5,201838
14,6,233,22,540,344,12,51,0,1202,1140,2342,11,6,201838
14,7,138,15,228,179,0,31,0,591,614,1205,6,6,201838
14,8,302,86,820,1040,33,130,13,2424,2257,4681,11,5,201838
14,9,126,31,171,274,19,29,0,650,551,1201,12,6,201838
14,10,186,31,464,402,16,80,10,1189,1149,2338,7,6,201838
14,11,129,34,154,255,20,36,20,648,649,1297,4,6,201838
14,12,306,29,589,203,15,56,0,1198,1075,2273,9,5.5,201838
14,13,226,26,374,257,15,78,2,978,905,1883,6,6,201838
14,14,148,25,274,423,8,84,13,975,1049,2024,7,6,201838
14,15,275,68,248,278,41,90,18,1018,1056,2074,10,5.6,201838
14,16,183,37,348,299,47,87,21,1022,867,1889,5,6,201838
14,17,181,47,191,236,36,64,21,776,957,1733,7,5.25,201838
14,18,240,55,327,296,35,67,61,1081,1142,2223,9,5.4,201838
14,19,270,63,329,379,45,64,2,1152,1148,2300,8,5.25,201838
14,20,198,27,312,161,8,48,0,754,840,1594,10,5.666666667,201838
15,1,291,38,347,174,412,54,10,1326,1117,2443,7,5.333333333,201838
15,2,177,17,322,368,31,53,24,992,961,1953,6,6,201838
15,3,316,63,368,494,157,81,17,1496,1426,2922,10,5.666666667,201838
15,4,225,39,310,389,25,65,0,1053,1112,2165,4,6,201838
15,5,158,27,277,324,16,60,2,864,999,1863,8,5.666666667,201838
15,6,171,30,433,493,61,81,19,1288,1201,2489,7,6,201838
15,7,185,32,366,419,51,66,4,1123,1111,2234,10,6,201838
15,8,80,23,157,255,7,33,0,555,581,1136,4,6,201838
15,9,336,31,192,226,161,42,40,1028,1011,2039,9,5.75,201838
15,10,147,25,287,301,80,62,17,919,904,1823,6,6,201838
15,11,235,72,257,335,137,168,0,1204,1267,2471,8,6,201838
15,12,268,19,699,510,25,84,0,1605,1668,3273,8,6,201838
15,13,92,23,233,226,72,37,0,683,553,1236,8,6,201838
15,14,77,20,130,156,14,24,0,421,461,882,4,6,201838
15,15,198,89,387,469,39,79,0,1261,1165,2426,6,6,201838
15,16,209,39,469,721,17,78,8,1541,1643,3184,8,6,201838
15,17,138,29,239,358,24,85,78,951,954,1905,8,6,201838
15,18,272,36,419,504,32,78,18,1359,1373,2732,7,5.666666667,201838
15,19,239,74,570,943,27,99,15,1967,1873,3840,10,6,201838
15,20,68,26,241,299,30,32,20,716,703,1419,6,6,201838
15,21,169,21,185,228,41,55,0,699,395,1094,6,5.5,201838
15,22,262,75,490,612,36,72,91,1638,1676,3314,14,6,201838
15,23,223,39,279,485,34,66,0,1126,1242,2368,6,5.333333333,201838
15,24,168,32,293,316,40,37,4,890,948,1838,4,6,201838
15,25,167,25,311,279,16,45,15,858,1025,1883,6,6,201838
15,26,161,10,303,244,58,44,0,820,792,1612,8,3,201838
15,27,287,37,421,544,15,72,85,1461,1281,2742,9,5.666666667,201838
15,28,250,40,626,428,69,74,7,1494,1403,2897,9,5.666666667,201838
15,29,235,44,476,665,13,105,4,1542,1444,2986,8,6,201838
15,30,266,30,508,499,48,64,15,1430,1584,3014,16,5.5,201838
15,31,149,57,256,351,15,53,0,881,866,1747,6,6,201838
15,32,205,12,343,453,34,66,4,1117,1117,2234,9,6,201838
15,33,243,11,404,381,27,57,0,1123,1013,2136,7,6,201838
15,34,143,11,234,421,13,50,0,872,982,1854,8,6,201838
15,35,346,26,286,377,22,71,0,1128,1299,2427,9,5.333333333,201838
15,36,315,38,303,361,135,63,3,1218,967,2185,9,5.5,201838
15,37,173,50,373,438,74,78,51,1237,1238,2475,7,6,201838
15,38,217,39,289,521,19,74,1,1160,1124,2284,6,5.5,201838
15,39,194,41,351,406,35,47,5,1079,915,1994,4,6,201838
15,40,370,41,408,524,134,93,0,1570,1552,3122,9,5.666666667,201838
15,41,243,35,702,632,46,76,25,1759,1770,3529,11,6,201838
16,1,173,26,265,200,8,50,2,724,729,1453,7,5.333333333,201838
16,2,167,41,188,235,32,39,0,702,604,1306,9,5.25,201838
16,3,235,37,284,305,25,37,18,941,941,1882,10,5.25,201838
16,4,226,26,287,258,52,56,0,905,954,1859,8,5.5,201838
16,5,242,52,266,272,39,75,20,966,897,1863,10,5.666666667,201838
16,6,280,50,268,264,44,49,0,955,934,1889,12,5.5,201838
16,7,269,53,255,269,55,46,0,947,800,1747,9,5.5,201838
16,8,353,52,608,585,13,96,18,1725,1674,3399,12,6,201838
16,9,293,44,310,343,31,85,17,1123,1059,2182,9,6,201838
16,10,171,29,373,346,13,54,0,986,941,1927,7,6.5,201838
16,11,289,39,338,200,150,78,8,1102,930,2032,10,5.4,201838
16,12,232,28,257,205,27,51,1,801,922,1723,10,5.25,201838
17,1,213,21,357,410,30,82,14,1127,1053,2180,9,3.5,201838
17,2,183,26,342,348,16,39,13,967,881,1848,8,5.666666667,201838
17,3,295,34,424,466,22,69,0,1310,1202,2512,8,5.5,201838
17,4,283,28,392,452,34,70,6,1265,1293,2558,10,5.666666667,201838
17,5,124,12,171,185,20,38,2,552,498,1050,5,5.5,201838
18,1,170,26,173,259,50,34,7,719,864,1583,7,5.25,201838
18,2,282,46,431,425,75,61,0,1320,1290,2610,8,6,201838
18,3,193,36,414,293,23,49,0,1008,726,1734,8,5.5,201838
19,1,206,45,444,501,28,78,0,1302,1215,2517,9,6,201838
19,2,318,23,743,202,39,72,0,1397,1505,2902,9,6,201838
19,3,324,47,721,474,30,84,15,1695,1525,3220,7,6,201838
19,4,115,25,215,148,81,48,142,774,813,1587,5,6,201838
19,5,295,44,558,704,26,101,97,1825,1663,3488,8,6,201838
19,6,105,16,260,344,23,48,70,866,759,1625,5,6,201838
19,7,195,23,512,296,3,47,5,1081,977,2058,10,5.5,201838
19,8,52,7,130,114,0,20,0,323,288,611,7,6,201838
19,9,161,27,193,275,38,47,26,767,791,1558,9,5.25,201838
19,10,138,26,256,406,3,79,53,961,901,1862,6,3.5,201838
19,11,434,73,751,1131,48,166,0,2603,2420,5023,13,6,201838
19,12,244,8,645,244,15,55,15,1226,1158,2384,8,5.666666667,201838
20,1,240,16,265,285,67,66,42,981,980,1961,7,5.5,201838
20,2,186,18,189,200,19,32,0,644,202,846,6,5.333333333,201838
20,3,209,18,321,380,98,67,11,1104,571,1675,6,5.333333333,201838
20,4,151,31,158,252,51,64,30,737,342,1079,6,5.333333333,201838
20,5,222,29,245,506,134,73,0,1209,588,1797,11,5.25,201838
20,6,244,18,229,314,158,51,0,1014,355,1369,8,5.25,201838
20,7,237,32,224,359,27,43,0,922,804,1726,7,5.75,201838
20,8,488,59,642,1002,38,152,200,2581,2414,4995,13,4,201838
20,9,389,31,261,293,109,88,65,1236,1233,2469,8,5.666666667,201838
20,10,312,23,245,506,30,45,0,1161,617,1778,9,5.25,201838
21,1,256,18,236,393,11,41,0,955,854,1809,9,5.4,201838
21,2,249,15,248,259,152,53,0,976,864,1840,9,5.2,201838
21,3,340,21,377,259,136,83,51,1267,935,2202,8,5.5,201838
21,4,212,10,193,117,84,41,51,708,314,1022,6,5.25,201838
21,5,300,18,418,320,25,94,26,1201,945,2146,8,5.666666667,201838
21,6,231,24,342,454,43,58,121,1273,1387,2660,6,6,201838
21,7,388,18,316,378,41,101,9,1251,1200,2451,9,5.666666667,201838
21,8,328,24,427,294,88,64,17,1242,1494,2736,9,5.2,201838
21,9,255,25,487,470,47,85,59,1428,1403,2831,9,6,201838
21,10,242,18,439,366,57,96,82,1300,1081,2381,7,5.5,201838
21,11,75,1,149,88,22,18,3,356,369,725,4,6,201838
21,12,401,47,900,954,82,148,50,2582,2376,4958,16,4.333333333,201838
21,13,275,23,310,357,63,97,13,1138,934,2072,8,5.666666667,201838
21,14,325,31,303,302,112,67,11,1151,563,1714,12,5.333333333,201838
21,15,393,17,429,298,50,71,19,1277,1136,2413,7,5.5,201838
22,1,233,46,246,328,42,41,0,936,885,1821,11,5.2,201838
22,2,190,29,382,247,41,35,0,924,842,1766,7,5.5,201838
22,3,335,94,858,614,43,79,2,2025,1983,4008,9,5.666666667,201838
22,4,253,53,678,556,35,73,7,1655,1509,3164,10,4.666666667,201838
22,5,197,32,447,251,85,45,10,1067,999,2066,10,5.5,201838
23,1,305,12,1446,348,13,52,18,2194,1907,4101,14,5.6,201838
23,2,222,56,386,478,13,41,0,1196,777,1973,8,5.25,201838
23,3,318,17,1035,465,32,49,1,1917,2073,3990,12,6,201838
23,4,159,15,713,293,25,37,0,1242,1063,2305,8,4.666666667,201838
24,1,178,64,162,260,25,31,21,741,527,1268,10,5.2,201838
24,2,143,31,186,202,6,29,0,597,832,1429,6,5.5,201838
24,3,214,44,238,292,32,50,0,870,826,1696,8,5.25,201838
24,4,223,50,245,213,55,57,101,944,796,1740,5,5.5,201838
24,5,230,47,415,441,6,69,0,1208,1301,2509,9,6,201838
24,6,313,70,558,556,34,94,6,1631,1684,3315,9,6,201838
24,7,263,52,271,280,121,64,0,1051,962,2013,9,5.25,201838
25,1,168,46,245,436,63,52,35,1045,967,2012,13,5.75,201838
25,2,283,39,379,531,29,86,0,1347,1234,2581,7,5.5,201838
25,3,225,24,279,421,39,56,16,1060,1168,2228,8,5.6,201838
25,4,188,41,215,362,22,72,99,999,892,1891,8,5.333333333,201838
25,5,273,44,364,644,25,79,0,1429,1346,2775,8,5.666666667,201838
25,6,255,37,354,445,97,84,9,1281,1137,2418,8,5.75,201838
25,7,274,36,322,497,9,102,0,1240,1170,2410,6,6,201838
26,1,250,33,350,347,16,100,0,1096,1094,2190,9,5.5,201838
26,2,257,21,427,470,0,86,0,1261,1324,2585,12,5.4,201838
26,3,285,49,446,653,19,129,41,1622,1617,3239,13,6,201838
26,4,185,24,241,358,26,64,0,898,705,1603,9,5.2,201838
26,5,119,23,148,186,15,49,0,540,515,1055,3,5.5,201838
26,6,196,26,446,457,14,77,0,1216,1176,2392,10,5.333333333,201838
26,7,192,20,220,348,27,51,1,859,762,1621,10,5.5,201838
27,1,318,47,295,462,54,58,1,1235,609,1844,8,5.5,201838
27,2,288,29,289,417,26,48,0,1097,995,2092,8,5.666666667,201838
27,3,255,28,192,453,14,47,0,989,798,1787,7,5.666666667,201838
27,4,271,20,378,648,16,64,34,1431,1392,2823,8,4,201838
27,5,160,5,150,305,13,30,6,669,451,1120,6,5.333333333,201838
27,6,200,27,258,472,9,43,0,1009,822,1831,7,5.5,201838
28,1,244,32,471,465,17,68,0,1297,1271,2568,13,6,201838
28,2,273,44,572,418,32,73,152,1564,1457,3021,13,5.75,201838
28,3,141,33,200,307,10,39,0,730,864,1594,7,5.333333333,201838
28,4,334,41,579,496,55,94,134,1733,1666,3399,15,6,201838
28,5,167,40,335,460,32,70,26,1130,1131,2261,9,4.4,201838
28,6,184,48,258,328,50,45,42,955,951,1906,13,4.666666667,201838
28,7,227,38,481,502,80,75,0,1403,1365,2768,6,6,201838
28,8,147,38,295,339,75,48,50,992,947,1939,9,6,201838
28,9,150,24,387,212,30,39,97,939,909,1848,11,5.75,201838
29,1,236,39,337,331,58,49,0,1050,975,2025,7,5.5,201838
29,2,238,32,307,483,38,70,101,1269,1366,2635,12,4.8,201838
29,3,160,24,203,349,34,50,0,820,813,1633,5,5.666666667,201838
30,1,141,23,252,359,50,34,36,895,755,1650,7,5.333333333,201838
30,2,226,38,187,135,80,38,367,1071,923,1994,8,5.25,201838
30,3,214,30,365,196,191,65,283,1344,1181,2525,6,5.666666667,201838
30,4,115,12,219,247,31,47,0,671,694,1365,8,6,201838
30,5,201,47,208,357,11,54,0,878,849,1727,7,5.5,201838
30,6,215,20,267,275,41,59,0,877,949,1826,9,5.333333333,201838
30,7,163,28,217,234,44,43,53,782,853,1635,11,5.25,201838
30,8,211,37,327,426,57,74,18,1150,1196,2346,11,5.4,201838
30,9,272,23,241,231,75,76,146,1064,1137,2201,8,5.5,201838
30,10,207,37,390,437,38,84,101,1294,1259,2553,6,6,201838
30,11,164,27,377,441,13,56,0,1078,1074,2152,5,5.5,201838
30,12,264,33,610,687,16,123,1,1734,1515,3249,10,6,201838
30,13,323,38,285,330,111,89,165,1341,1088,2429,10,5.4,201838
30,14,275,43,352,252,82,96,59,1159,1000,2159,8,5.5,201838
30,15,366,34,272,296,75,117,223,1383,1349,2732,11,5.666666667,201838
30,16,225,23,366,431,68,61,83,1257,1241,2498,10,5.333333333,201838
30,17,225,53,258,349,32,62,10,989,1026,2015,8,5.5,201838
30,18,264,32,166,317,26,55,40,900,906,1806,8,5.25,201838
30,19,218,18,238,320,38,53,0,885,845,1730,13,5.6,201838
30,20,225,24,270,388,91,56,0,1054,993,2047,10,5.4,201838
31,1,265,26,189,344,20,33,0,877,528,1405,8,5.5,201838
31,2,88,13,132,11,326,19,0,589,371,960,6,5.333333333,201838
31,3,420,74,1041,924,136,131,0,2726,2514,5240,20,6,201838
31,4,113,18,330,322,72,41,0,896,851,1747,3,6,201838
31,5,111,28,128,332,62,35,0,696,269,965,5,5.333333333,201838
32,1,242,83,302,225,63,41,86,1042,965,2007,12,5.2,201838
32,2,288,101,398,298,192,57,94,1428,1242,2670,13,5.142857143,201838
32,3,232,97,316,396,18,58,19,1136,879,2015,13,5.4,201838
32,4,281,176,343,422,52,85,108,1467,885,2352,12,4.333333333,201838
1,1,244,71,331,340,70,47,25,1128,1285,2413,13,5.5,201839
1,2,209,51,659,405,78,64,20,1486,1346,2832,10,4.75,201839
1,3,207,76,583,489,38,96,16,1505,1382,2887,9,6,201839
2,1,185,22,404,369,15,65,6,1066,1066,2132,11,6,201839
2,2,243,29,486,726,16,96,0,1596,1395,2991,7,6,201839
2,3,330,26,618,538,22,103,3,1640,1523,3163,12,4.5,201839
2,4,194,12,637,243,35,48,4,1173,1135,2308,9,6,201839
2,5,442,38,1054,657,144,141,12,2488,2461,4949,13,6,201839
2,6,251,37,619,424,28,78,0,1437,1371,2808,7,6,201839
2,7,322,24,603,502,27,91,8,1577,1539,3116,12,5.75,201839
2,8,291,22,748,549,15,90,5,1720,1664,3384,8,6,201839
3,1,195,36,381,355,23,82,14,1086,1057,2143,12,5.666666667,201839
3,2,151,9,436,237,27,33,0,893,858,1751,9,5.666666667,201839
4,1,183,36,237,437,18,48,12,971,954,1925,11,5.25,201839
4,2,290,27,490,366,17,48,0,1238,1320,2558,14,5.2,201839
5,1,285,29,494,406,63,70,29,1376,1320,2696,9,5.666666667,201839
5,2,257,32,371,416,37,55,4,1172,1013,2185,10,5.2,201839
5,3,188,34,260,306,29,83,104,1004,983,1987,9,5.5,201839
5,4,226,33,567,389,19,85,71,1390,1444,2834,9,5.666666667,201839
5,5,220,32,430,511,27,61,10,1291,1199,2490,8,6,201839
5,6,111,23,224,274,17,28,39,716,902,1618,11,5.5,201839
5,7,212,33,309,361,7,40,4,966,886,1852,10,5.5,201839
6,1,151,35,324,299,16,51,73,949,904,1853,12,5,201839
6,2,172,27,379,224,69,56,14,941,882,1823,9,5.666666667,201839
7,1,329,11,192,392,16,34,8,982,1010,1992,9,5.25,201839
7,2,231,9,112,303,22,26,0,703,1809,2512,9,5.25,201839
7,3,333,14,206,273,136,52,2,1016,1175,2191,7,5.333333333,201839
7,4,139,10,126,274,4,31,20,604,916,1520,11,5.4,201839
7,5,381,13,184,664,16,57,2,1317,1132,2449,11,5.666666667,201839
7,6,364,37,397,591,46,77,58,1570,1290,2860,9,4.25,201839
7,7,264,42,328,414,24,62,0,1134,1335,2469,8,5.5,201839
7,8,363,20,226,494,7,60,0,1170,1381,2551,12,5.25,201839
7,9,240,26,295,484,22,61,16,1144,1245,2389,9,5.666666667,201839
7,10,197,19,189,399,27,28,0,859,1164,2023,9,5.5,201839
7,11,142,2,100,110,24,9,0,387,548,935,6,5.333333333,201839
7,12,338,25,327,609,8,55,0,1362,1436,2798,9,5.5,201839
7,13,177,15,158,285,1,32,0,668,1657,2325,9,5.25,201839
8,1,176,15,509,259,19,40,5,1023,940,1963,4,6,201839
8,2,298,60,655,465,20,76,4,1578,1691,3269,16,5.5,201839
8,3,214,47,395,426,16,62,4,1164,1154,2318,4,6,201839
8,4,193,31,439,353,31,85,32,1164,1113,2277,9,6,201839
8,5,213,39,430,380,40,67,0,1169,1206,2375,10,5.25,201839
8,6,201,40,485,506,41,83,87,1443,1304,2747,7,4.333333333,201839
8,7,266,71,248,435,24,87,0,1131,870,2001,7,5.25,201839
8,8,187,51,377,531,7,70,16,1239,1251,2490,10,6,201839
8,9,223,42,215,323,28,67,23,921,994,1915,10,5.2,201839
9,1,98,15,230,140,77,44,21,625,667,1292,5,6,201839
9,2,280,139,893,1160,78,138,44,2732,2666,5398,12,6,201839
9,3,139,75,433,519,53,83,47,1349,1312,2661,7,6,201839
9,4,207,26,429,597,61,81,21,1422,1379,2801,11,6,201839
9,5,137,38,314,371,60,57,0,977,1015,1992,7,6,201839
9,6,90,27,208,171,80,46,31,653,747,1400,7,6,201839
9,7,114,13,374,546,3,61,1,1112,1034,2146,9,6,201839
9,8,88,20,340,347,26,61,49,931,785,1716,5,6,201839
9,9,167,18,237,305,37,47,16,827,812,1639,5,6,201839
9,10,106,28,364,446,30,61,0,1035,1054,2089,6,6,201839
9,11,220,32,528,615,62,102,0,1559,1526,3085,7,6,201839
9,12,132,66,689,635,34,84,60,1700,1468,3168,11,6,201839
9,13,141,30,305,397,72,45,80,1070,1012,2082,4,6,201839
9,14,128,11,202,245,86,50,21,743,706,1449,5,6,201839
9,15,213,55,1016,1108,38,157,57,2644,2616,5260,9,4.333333333,201839
9,16,267,87,545,729,104,96,6,1834,1823,3657,15,6,201839
9,17,124,20,298,353,12,47,0,854,850,1704,6,6,201839
9,18,186,52,403,781,37,79,0,1538,1517,3055,12,6,201839
9,19,199,65,373,445,124,76,14,1296,1236,2532,5,6,201839
9,20,47,18,94,97,9,13,4,282,259,541,5,6,201839
9,21,110,14,213,252,44,34,9,676,676,1352,3,6,201839
9,22,158,15,307,270,88,52,45,935,1025,1960,5,6,201839
9,23,151,23,377,489,73,58,20,1191,1142,2333,6,6,201839
9,24,307,36,686,925,78,108,18,2158,2130,4288,12,6,201839
10,1,196,32,238,314,20,36,66,902,1024,1926,12,4.833333333,201839
10,2,228,45,369,403,50,76,86,1257,1284,2541,9,5.25,201839
10,3,180,50,215,339,16,71,77,948,950,1898,11,5.4,201839
10,4,274,46,389,519,10,61,2,1301,1397,2698,11,4,201839
11,1,269,40,248,261,41,46,18,923,894,1817,6,5.666666667,201839
11,2,245,33,275,301,38,52,10,954,988,1942,7,6,201839
11,3,180,38,276,232,22,42,96,886,902,1788,3,6,201839
11,4,226,59,237,274,15,37,0,848,862,1710,8,4.5,201839
11,5,292,107,449,520,16,73,13,1470,1471,2941,7,6,201839
11,6,214,62,377,345,39,56,27,1120,1094,2214,7,5.666666667,201839
11,7,262,47,307,386,18,63,0,1083,1331,2414,9,5.5,201839
11,8,206,57,310,490,40,36,52,1191,1190,2381,9,5.75,201839
11,9,308,93,373,528,14,67,16,1399,1526,2925,10,5.666666667,201839
11,10,253,81,364,403,41,56,93,1291,1178,2469,10,5.6,201839
11,11,234,66,273,271,20,48,0,912,908,1820,5,6,201839
11,12,262,60,507,592,13,47,2,1483,1453,2936,7,6,201839
11,13,300,84,311,311,34,31,72,1143,1174,2317,8,5.5,201839
11,14,245,70,342,387,43,41,0,1128,1045,2173,8,5.5,201839
11,15,172,48,231,310,6,41,1,809,801,1610,8,6,201839
12,1,194,46,237,98,107,31,12,725,717,1442,10,4.4,201839
12,2,279,38,248,381,19,56,0,1021,1065,2086,10,5,201839
12,3,252,48,283,435,25,46,0,1089,1202,2291,11,4.4,201839
12,4,240,38,347,576,22,48,0,1271,1178,2449,9,5.333333333,201839
12,5,261,23,151,244,1,16,25,721,741,1462,10,4.25,201839
12,6,239,20,158,375,20,24,7,843,732,1575,10,4.75,201839
12,7,320,35,309,400,25,54,58,1201,1285,2486,6,5.5,201839
12,8,247,19,221,196,12,25,0,720,722,1442,9,4.25,201839
12,9,266,41,340,479,18,41,8,1193,1052,2245,9,5.666666667,201839
13,1,291,52,205,518,98,75,40,1279,1563,2842,9,5.333333333,201839
13,2,201,29,142,299,147,64,31,913,891,1804,6,5.333333333,201839
13,3,213,25,234,293,114,68,0,947,1024,1971,12,5.25,201839
13,4,168,18,231,246,39,45,17,764,808,1572,5,6,201839
13,7,267,99,583,435,73,73,30,1560,1759,3319,10,5.6,201839
13,5,245,46,410,411,164,77,50,1403,1365,2768,9,5.75,201839
13,6,293,86,849,947,66,97,1,2339,2331,4670,13,5.5,201839
14,1,206,54,189,133,48,65,104,799,590,1389,6,5.5,201839
14,2,253,22,249,209,19,90,4,846,807,1653,5,5.666666667,201839
14,3,305,39,472,326,48,104,19,1313,1348,2661,8,5.4,201839
14,4,176,27,273,495,24,44,15,1054,966,2020,11,6,201839
14,5,163,33,434,269,34,58,11,1002,1036,2038,9,5.5,201839
14,6,216,28,506,335,11,48,0,1144,1186,2330,11,6,201839
14,7,143,15,235,165,0,38,0,596,591,1187,6,6,201839
14,8,359,74,822,1136,25,127,31,2574,2411,4985,11,4.8,201839
14,9,126,36,259,330,36,29,1,817,626,1443,12,7,201839
14,10,174,33,359,374,11,72,0,1023,1070,2093,7,5.5,201839
14,11,93,20,112,189,19,24,25,482,581,1063,4,5,201839
14,12,284,29,552,221,20,39,2,1147,1164,2311,9,5.5,201839
14,13,182,26,352,282,26,52,10,930,921,1851,6,6,201839
14,14,160,43,287,494,8,50,9,1051,937,1988,7,6,201839
14,15,291,58,243,372,34,72,27,1097,1157,2254,10,5.6,201839
14,16,203,33,347,257,43,60,39,982,921,1903,5,6,201839
14,17,216,50,250,256,22,55,34,883,871,1754,7,5.25,201839
14,18,258,50,325,255,41,50,57,1036,1136,2172,9,5.2,201839
14,19,236,61,333,395,40,63,0,1128,956,2084,8,5.25,201839
14,20,192,32,312,220,7,47,0,810,820,1630,10,5.666666667,201839
15,1,233,40,331,160,351,54,7,1176,1127,2303,7,5.333333333,201839
15,2,157,14,286,366,38,43,33,937,997,1934,6,6,201839
15,3,311,63,415,524,134,70,41,1558,1409,2967,10,5.666666667,201839
15,4,242,25,346,384,33,65,64,1159,1004,2163,4,6,201839
15,5,193,43,344,338,23,53,12,1006,957,1963,8,5.666666667,201839
15,6,152,29,348,550,56,54,24,1213,1126,2339,7,6,201839
15,7,178,32,342,405,35,64,10,1066,1030,2096,10,6,201839
15,8,99,21,153,247,11,31,14,576,537,1113,4,6,201839
15,9,316,26,212,232,172,42,41,1041,1001,2042,9,5.75,201839
15,10,136,22,259,279,62,65,21,844,886,1730,6,6,201839
15,11,171,43,344,516,38,65,8,1185,996,2181,8,6,201839
15,12,258,22,555,441,29,63,3,1371,1531,2902,8,6,201839
15,13,98,13,197,237,92,62,0,699,637,1336,8,6,201839
15,14,72,18,124,210,30,38,0,492,406,898,4,6,201839
15,15,206,85,344,493,18,70,0,1216,1177,2393,6,6,201839
15,16,243,52,452,632,15,67,8,1469,1451,2920,8,6,201839
15,17,116,35,207,328,22,67,96,871,867,1738,8,6,201839
15,18,284,26,391,482,41,71,9,1304,1273,2577,7,5.666666667,201839
15,19,253,93,533,943,17,80,8,1927,1790,3717,10,6,201839
15,20,78,32,215,325,17,33,13,713,728,1441,6,6,201839
15,21,107,15,105,222,20,39,0,508,569,1077,6,5.5,201839
15,22,259,68,576,745,35,102,126,1911,1755,3666,14,6,201839
15,23,231,41,270,524,48,67,0,1181,1197,2378,6,5.333333333,201839
15,24,175,34,245,313,20,36,9,832,802,1634,4,6,201839
15,25,179,51,337,341,21,58,10,997,1061,2058,6,6,201839
15,26,165,15,229,281,48,45,0,783,708,1491,9,3.5,201839
15,27,227,52,365,559,6,72,54,1335,1453,2788,9,5.666666667,201839
15,28,242,27,526,384,94,78,51,1402,1455,2857,9,5.666666667,201839
15,29,209,33,456,688,19,85,8,1498,1522,3020,8,6,201839
15,30,266,42,443,441,52,59,25,1328,1281,2609,16,6,201839
15,31,144,63,288,415,10,56,0,976,853,1829,6,6,201839
15,32,189,22,314,452,26,61,2,1066,988,2054,9,6,201839
15,33,194,17,360,386,22,60,0,1039,1729,2768,7,6,201839
15,34,151,30,262,473,14,46,0,976,922,1898,8,6,201839
15,35,341,49,269,440,15,83,0,1197,1191,2388,9,5.666666667,201839
15,36,291,26,304,368,161,59,4,1213,1015,2228,9,5.5,201839
15,37,225,42,362,468,55,62,30,1244,1169,2413,7,6,201839
15,38,227,39,333,463,11,67,0,1140,1062,2202,6,5.5,201839
15,39,156,52,314,415,48,40,16,1041,973,2014,4,6,201839
15,40,355,39,396,514,101,102,0,1507,1374,2881,9,6,201839
15,41,307,47,627,638,37,49,26,1731,1574,3305,11,6,201839
16,1,229,35,284,298,17,58,2,923,879,1802,7,5.333333333,201839
16,2,174,39,156,264,14,36,0,683,805,1488,9,5.25,201839
16,3,200,33,159,276,32,46,2,748,653,1401,10,5.25,201839
16,4,269,41,268,289,59,78,0,1004,941,1945,8,5.5,201839
16,5,252,59,251,306,29,68,9,974,1031,2005,10,5.666666667,201839
16,6,237,36,244,200,37,41,0,795,733,1528,12,5.5,201839
16,7,205,38,214,239,50,40,0,786,927,1713,9,5.5,201839
16,8,287,51,619,646,19,86,20,1728,1713,3441,12,6,201839
16,9,250,44,329,326,26,79,8,1062,1051,2113,9,6,201839
16,10,148,24,313,323,10,50,0,868,874,1742,7,6.5,201839
16,11,272,41,248,178,158,80,5,982,843,1825,10,5.4,201839
16,12,203,29,237,157,31,51,14,722,730,1452,10,5.25,201839
17,1,171,26,403,410,33,64,9,1116,1072,2188,9,3.5,201839
17,2,201,18,352,343,26,29,20,989,911,1900,8,5.666666667,201839
17,3,295,29,364,480,24,60,0,1252,1363,2615,8,5.5,201839
17,4,274,27,374,502,17,63,4,1261,1324,2585,10,5.666666667,201839
17,5,89,13,147,187,17,24,1,478,609,1087,5,5.5,201839
18,1,186,30,173,229,51,42,17,728,586,1314,7,5.25,201839
18,2,216,63,468,451,67,59,0,1324,1305,2629,8,6,201839
18,3,199,36,448,328,15,35,0,1061,801,1862,8,5.5,201839
19,1,196,27,419,513,21,83,7,1266,1249,2515,9,6,201839
19,2,331,30,832,370,12,81,0,1656,1335,2991,9,6,201839
19,3,291,25,612,500,24,94,20,1566,1549,3115,7,6,201839
19,4,119,21,201,146,77,52,205,821,768,1589,5,6,201839
19,5,347,56,584,661,22,96,123,1889,1816,3705,8,6,201839
19,6,82,32,238,483,19,42,4,900,827,1727,5,6,201839
19,7,218,27,501,325,11,41,11,1134,1004,2138,10,5.5,201839
19,8,49,6,167,114,2,16,0,354,326,680,7,6,201839
19,9,208,47,278,451,62,69,27,1142,1018,2160,9,5.25,201839
19,10,131,22,253,422,12,59,99,998,945,1943,6,3.5,201839
19,11,397,102,730,1258,33,119,0,2639,2478,5117,13,6,201839
19,12,183,20,530,278,15,47,11,1084,1182,2266,8,5.666666667,201839
20,1,250,38,289,219,67,53,59,975,1021,1996,7,5.5,201839
20,2,134,17,119,197,8,24,0,499,483,982,6,5.333333333,201839
20,3,141,28,209,292,71,39,29,809,962,1771,6,5.333333333,201839
20,4,182,24,183,300,106,51,24,870,759,1629,6,5.333333333,201839
20,5,154,10,207,404,35,39,0,849,881,1730,11,5.25,201839
20,6,185,18,159,277,92,36,1,768,846,1614,8,5.25,201839
20,7,218,30,197,329,15,50,1,840,781,1621,7,5.75,201839
20,8,508,48,678,1033,42,144,180,2633,2474,5107,13,4,201839
20,9,324,30,227,270,90,69,58,1068,1015,2083,8,5.666666667,201839
20,10,257,20,215,455,18,64,0,1029,891,1920,9,5.25,201839
21,1,256,21,225,370,9,57,1,939,1008,1947,9,5.4,201839
21,2,291,43,334,290,121,63,1,1143,1173,2316,9,5.2,201839
21,3,261,15,339,242,93,88,48,1086,864,1950,8,5.5,201839
21,4,204,12,175,114,123,76,61,765,688,1453,6,5.25,201839
21,5,262,22,392,352,9,58,3,1098,964,2062,8,5.666666667,201839
21,6,222,25,381,453,52,83,147,1363,1258,2621,6,6,201839
21,7,284,12,296,310,49,73,13,1037,1158,2195,9,5.666666667,201839
21,8,236,15,345,247,100,60,16,1019,1339,2358,9,5.2,201839
21,9,210,27,463,478,58,62,87,1385,1387,2772,9,6,201839
21,10,269,24,426,309,55,78,109,1270,1266,2536,7,5.5,201839
21,11,60,5,125,88,26,29,4,337,365,702,4,6,201839
21,12,353,36,860,966,82,122,61,2480,2476,4956,16,4.333333333,201839
21,13,298,24,342,398,73,78,7,1220,965,2185,8,5.666666667,201839
21,14,320,36,279,261,94,64,54,1108,827,1935,12,5.333333333,201839
21,15,318,27,375,329,55,59,29,1192,1226,2418,7,5.5,201839
22,1,211,54,249,346,44,39,0,943,945,1888,11,5.2,201839
22,2,166,43,327,243,58,32,27,896,886,1782,7,5.5,201839
22,3,295,79,815,667,15,75,0,1946,1813,3759,9,5.666666667,201839
22,4,222,50,624,580,50,47,4,1577,1596,3173,10,4.666666667,201839
22,5,192,35,378,246,88,39,10,988,1019,2007,10,5.5,201839
23,1,363,12,1404,373,15,50,16,2233,2043,4276,14,5.6,201839
23,2,225,32,428,433,9,36,0,1163,1170,2333,8,5.25,201839
23,3,302,13,1026,491,37,44,0,1913,1682,3595,12,6,201839
23,4,152,8,710,273,18,26,0,1187,1155,2342,8,3,201839
24,1,200,60,188,238,32,22,22,762,756,1518,10,5.2,201839
24,2,112,42,201,203,18,37,0,613,555,1168,6,5.5,201839
24,3,214,45,223,293,49,36,0,860,857,1717,8,5.25,201839
24,4,182,53,209,215,61,65,107,892,849,1741,5,5.5,201839
24,5,226,48,385,494,21,81,0,1255,1287,2542,10,4.75,201839
24,6,267,83,583,597,22,89,4,1645,1654,3299,9,6,201839
24,7,263,34,289,403,49,42,0,1080,1195,2275,9,5.25,201839
25,1,168,39,233,409,37,42,27,955,880,1835,13,5.75,201839
25,2,235,29,367,558,19,63,0,1271,1197,2468,7,5.5,201839
25,3,252,32,322,417,60,45,22,1150,1125,2275,8,5.6,201839
25,4,234,31,237,420,32,58,108,1120,1060,2180,8,5.333333333,201839
25,5,256,26,346,684,29,83,0,1424,1370,2794,8,5.666666667,201839
25,6,287,38,382,496,117,93,17,1430,1309,2739,8,5.75,201839
25,7,253,22,335,538,7,80,1,1236,1184,2420,6,6,201839
26,1,237,29,321,370,15,87,0,1059,1065,2124,9,5.5,201839
26,2,259,18,462,433,11,85,0,1268,1301,2569,12,5.4,201839
26,3,304,42,468,710,15,164,22,1725,1629,3354,13,6,201839
26,4,158,26,223,379,21,67,0,874,770,1644,9,5.2,201839
26,5,144,17,136,129,12,43,0,481,576,1057,3,5.5,201839
26,6,205,22,403,495,10,82,0,1217,1151,2368,10,5.333333333,201839
26,7,176,15,212,287,36,52,0,778,863,1641,10,5.5,201839
27,1,220,25,221,344,34,37,0,881,824,1705,8,5.5,201839
27,2,235,30,271,384,28,49,0,997,1098,2095,8,5.666666667,201839
27,3,189,16,184,389,11,33,0,822,940,1762,7,5.666666667,201839
27,4,195,18,322,571,23,60,43,1232,1486,2718,8,4,201839
27,5,131,6,153,328,19,31,7,675,567,1242,6,5.333333333,201839
27,6,154,28,232,509,13,45,0,981,1058,2039,7,5.5,201839
28,1,195,35,497,444,6,59,0,1236,1249,2485,13,6,201839
28,2,240,51,630,431,30,70,162,1614,1425,3039,13,5.75,201839
28,3,145,40,184,304,19,37,0,729,930,1659,7,5.333333333,201839
28,4,289,41,533,438,60,67,246,1674,1595,3269,15,6,201839
28,5,155,45,315,489,17,57,33,1111,1137,2248,10,5.2,201839
28,6,121,32,200,264,44,35,31,727,845,1572,13,5,201839
28,7,217,27,489,545,73,56,0,1407,1440,2847,6,6,201839
28,8,122,32,309,408,58,56,51,1036,988,2024,9,6,201839
28,9,180,22,362,180,22,34,102,902,904,1806,11,5.75,201839
29,1,261,47,357,365,80,55,0,1165,1143,2308,7,5.5,201839
29,2,210,41,317,528,24,72,57,1249,1272,2521,12,4.8,201839
29,3,153,38,191,338,18,44,0,782,805,1587,5,5.666666667,201839
30,1,154,41,255,449,103,50,28,1080,1203,2283,7,5.333333333,201839
30,2,198,43,227,107,70,41,514,1200,1174,2374,8,5.25,201839
30,3,225,29,382,175,188,62,245,1306,1299,2605,6,5.666666667,201839
30,4,102,12,296,283,46,55,0,794,615,1409,8,6,201839
30,5,175,32,229,394,14,58,0,902,862,1764,7,5.5,201839
30,6,190,27,264,297,63,44,1,886,789,1675,9,5.333333333,201839
30,7,209,35,272,303,44,64,68,995,1051,2046,11,5.25,201839
30,8,196,31,361,373,93,58,40,1152,1364,2516,11,5.4,201839
30,9,232,16,288,229,70,61,98,994,930,1924,8,5.5,201839
30,10,177,38,426,423,66,67,87,1284,1265,2549,6,6,201839
30,11,156,22,338,354,18,57,0,945,1107,2052,5,5.5,201839
30,12,249,24,518,731,21,109,0,1652,1661,3313,10,6,201839
30,13,264,37,204,353,75,66,154,1153,1248,2401,10,5.4,201839
30,14,230,37,284,265,127,72,71,1086,1050,2136,8,5.5,201839
30,15,253,23,302,244,51,76,193,1142,1229,2371,11,5.666666667,201839
30,16,210,16,301,411,64,92,113,1207,1157,2364,10,5.333333333,201839
30,17,261,44,230,330,46,79,43,1033,918,1951,8,5.5,201839
30,18,228,28,161,295,11,42,53,818,820,1638,8,5.25,201839
30,19,207,20,252,395,43,57,0,974,1017,1991,13,5.6,201839
30,20,190,22,251,346,79,51,0,939,874,1813,10,5,201839
31,1,220,25,221,345,14,35,0,860,720,1580,8,5.5,201839
31,2,103,29,156,31,317,20,0,656,541,1197,6,5.333333333,201839
31,3,410,67,1030,933,113,133,1,2687,2553,5240,20,6,201839
31,4,100,20,291,355,59,46,0,871,882,1753,3,6,201839
31,5,151,16,211,422,10,36,0,846,659,1505,5,5.333333333,201839
32,1,206,69,276,241,66,54,101,1013,980,1993,12,5.2,201839
32,2,230,112,333,282,151,69,122,1299,1253,2552,13,5.142857143,201839
32,3,223,61,260,342,17,47,40,990,923,1913,13,5.4,201839
32,4,249,150,345,386,57,72,49,1308,1507,2815,13,4.5,201839
1,1,179,41,274,252,76,40,6,868,881,1749,13,5.333333333,201840
1,2,221,55,568,436,89,73,23,1465,1520,2985,10,5,201840
1,3,203,78,606,482,35,88,4,1496,1472,2968,9,6.333333333,201840
2,1,193,9,374,383,15,60,7,1041,1054,2095,11,6,201840
2,2,234,31,418,754,15,115,0,1567,1566,3133,7,4,201840
2,3,361,32,637,553,25,112,1,1721,1691,3412,12,6,201840
2,4,200,16,647,229,44,51,4,1191,1107,2298,9,6,201840
2,5,462,54,1176,671,153,161,16,2693,2525,5218,13,6.333333333,201840
2,6,246,22,589,442,35,85,0,1419,1413,2832,7,6,201840
2,7,293,14,570,494,24,68,10,1473,1463,2936,12,5.5,201840
2,8,278,20,813,603,17,86,5,1822,1610,3432,8,6,201840
3,1,208,20,349,351,18,80,23,1049,983,2032,12,5.666666667,201840
3,2,185,5,514,222,20,38,0,984,910,1894,9,6,201840
4,1,230,25,266,469,21,47,0,1058,1098,2156,11,5.5,201840
4,2,252,25,415,395,31,59,9,1186,1020,2206,14,5.4,201840
5,1,237,24,446,304,57,66,27,1161,1301,2462,9,5.666666667,201840
5,2,158,28,292,317,22,33,0,850,764,1614,10,5.2,201840
5,3,214,27,275,380,44,67,74,1081,1036,2117,9,5.5,201840
5,4,261,38,521,387,18,82,106,1413,1300,2713,9,6,201840
5,5,200,41,399,502,19,45,47,1253,1301,2554,8,6,201840
5,6,117,13,233,284,8,30,43,728,772,1500,11,5.5,201840
5,7,168,27,278,335,8,40,7,863,896,1759,10,5.5,201840
6,1,148,27,354,289,14,62,74,968,1035,2003,12,6.2,201840
6,2,201,21,407,238,73,58,18,1016,976,1992,9,5.666666667,201840
7,1,384,18,250,454,11,67,58,1242,1380,2622,9,5.25,201840
7,2,209,14,147,707,20,22,0,1119,851,1970,9,5.25,201840
7,3,324,6,188,287,150,50,10,1015,1720,2735,7,5.333333333,201840
7,4,220,19,211,410,8,55,47,970,1065,2035,11,5.4,201840
7,5,345,14,199,576,30,37,1,1202,1310,2512,11,5.666666667,201840
7,6,227,24,268,357,20,52,35,983,951,1934,8,5.666666667,201840
7,7,367,43,344,419,43,65,0,1281,1204,2485,8,5.5,201840
7,8,378,20,295,583,28,89,0,1393,1189,2582,12,5.25,201840
7,9,267,27,315,444,34,77,19,1183,1111,2294,9,4.25,201840
7,10,218,11,244,404,17,36,0,930,825,1755,9,5.5,201840
7,11,241,8,110,211,17,24,0,611,639,1250,6,5.333333333,201840
7,12,301,16,290,524,6,52,0,1189,1372,2561,9,5.5,201840
7,13,98,13,117,254,3,22,0,507,313,820,9,4.75,201840
8,1,175,10,431,270,29,41,8,964,944,1908,4,6,201840
8,2,253,26,606,443,21,74,12,1435,1422,2857,16,5.75,201840
8,3,175,36,456,417,17,41,4,1146,1111,2257,4,6,201840
8,4,146,27,410,402,33,75,64,1157,1092,2249,9,6,201840
8,5,198,61,359,341,23,68,0,1050,1360,2410,10,5,201840
8,6,193,35,424,479,62,93,40,1326,1245,2571,7,7.5,201840
8,7,206,39,271,407,9,60,0,992,953,1945,7,5.25,201840
8,8,172,29,314,397,10,57,1,980,907,1887,10,3,201840
8,9,115,34,182,292,35,45,2,705,605,1310,10,4.6,201840
9,1,49,11,102,84,40,25,5,316,357,673,5,4,201840
9,2,285,102,838,1022,79,124,57,2507,2384,4891,12,6,201840
9,3,123,59,345,390,38,65,39,1059,924,1983,7,5,201840
9,4,159,23,289,471,50,54,15,1061,1192,2253,11,6,201840
9,5,138,23,311,403,53,54,0,982,1039,2021,7,6,201840
9,6,105,16,197,198,85,56,32,689,674,1363,7,6,201840
9,7,101,23,366,535,4,51,1,1081,1014,2095,9,6,201840
9,8,90,14,315,318,29,46,52,864,809,1673,5,6,201840
9,9,114,19,280,345,44,37,9,848,819,1667,5,6,201840
9,10,107,22,355,435,15,58,0,992,1016,2008,6,6,201840
9,11,161,25,590,614,66,94,7,1557,1479,3036,7,7,201840
9,12,144,55,555,598,50,77,96,1575,1502,3077,11,6,201840
9,13,117,23,301,410,77,58,70,1056,1054,2110,4,6,201840
9,14,134,19,222,303,90,58,47,873,717,1590,5,6,201840
9,15,228,39,1052,1097,37,149,65,2667,2984,5651,8,3,201840
9,16,242,39,552,780,117,110,9,1849,1847,3696,15,7,201840
9,17,131,16,285,347,23,55,0,857,842,1699,6,6,201840
9,18,173,45,427,725,60,86,1,1517,1482,2999,12,6,201840
9,19,186,53,367,426,125,92,24,1273,1283,2556,5,6,201840
9,20,34,11,69,112,9,13,0,248,259,507,5,6,201840
9,21,97,21,187,224,46,43,26,644,653,1297,3,6,201840
9,22,135,15,259,249,68,47,25,798,728,1526,5,6,201840
9,23,115,22,328,400,58,52,27,1002,1020,2022,6,6,201840
9,24,276,53,672,975,115,115,38,2244,2024,4268,12,6,201840
10,1,278,41,267,333,60,56,98,1133,933,2066,12,5,201840
10,2,226,53,395,427,33,62,68,1264,1338,2602,9,5.5,201840
10,3,197,51,235,367,20,62,55,987,885,1872,11,5.4,201840
10,4,294,42,427,509,14,69,1,1356,1312,2668,12,7,201840
11,1,225,44,217,243,45,40,7,821,787,1608,6,5,201840
11,2,240,27,258,291,32,31,22,901,929,1830,7,6,201840
11,3,181,48,258,288,31,46,108,960,860,1820,3,6,201840
11,4,174,39,199,257,8,34,0,711,738,1449,7,4.25,201840
11,5,297,93,433,559,19,77,27,1505,1538,3043,7,6.5,201840
11,6,163,31,258,244,44,36,31,807,799,1606,7,13,201840
11,7,242,53,308,351,17,39,0,1010,1323,2333,9,5.5,201840
11,8,196,40,325,331,25,52,23,992,984,1976,9,4.75,201840
11,9,265,91,399,542,18,70,8,1393,1365,2758,10,5.666666667,201840
11,10,223,79,308,332,49,39,71,1101,1172,2273,10,5.6,201840
11,11,218,73,232,299,13,52,0,887,929,1816,5,6,201840
11,12,266,57,509,561,10,73,6,1482,1479,2961,7,6.5,201840
11,13,248,57,270,256,37,45,78,991,1035,2026,8,5.5,201840
11,14,213,66,281,388,28,47,0,1023,1026,2049,8,5.5,201840
11,15,154,59,224,236,8,28,3,712,656,1368,8,5,201840
12,1,199,39,264,121,106,46,10,785,881,1666,10,5,201840
12,2,254,35,307,468,19,46,1,1130,980,2110,10,5.5,201840
12,3,148,32,247,298,24,29,1,779,1087,1866,11,5.2,201840
12,4,192,25,387,528,32,34,1,1199,1269,2468,9,5.666666667,201840
12,5,215,22,165,251,8,31,14,706,895,1601,10,5.25,201840
12,6,300,37,171,398,35,17,4,962,971,1933,10,5.25,201840
12,7,302,25,325,494,21,71,16,1254,1260,2514,6,5.5,201840
12,8,259,29,220,259,7,26,0,800,809,1609,9,5,201840
12,9,257,32,310,507,17,48,7,1178,1233,2411,9,5.666666667,201840
13,1,267,59,217,500,78,77,28,1226,1135,2361,9,5.333333333,201840
13,2,258,51,165,372,173,69,53,1141,938,2079,6,5.333333333,201840
13,3,259,47,273,331,95,68,1,1074,1211,2285,12,5.25,201840
13,4,157,9,281,261,40,43,11,802,692,1494,5,6,201840
13,7,279,67,616,501,87,70,46,1666,1659,3325,10,5.8,201840
13,5,257,34,476,412,117,83,91,1470,1410,2880,9,5.75,201840
13,6,341,73,793,961,85,116,0,2369,2445,4814,13,5.75,201840
14,1,190,65,157,180,57,40,115,804,1208,2012,6,5.5,201840
14,2,212,36,249,242,41,72,3,855,802,1657,5,5.666666667,201840
14,3,265,71,398,320,50,78,46,1228,1247,2475,8,5.4,201840
14,4,162,28,268,491,10,52,24,1035,967,2002,16,6,201840
14,5,189,38,478,333,50,43,7,1138,1031,2169,9,5.5,201840
14,6,197,25,528,318,30,51,10,1159,1125,2284,11,6,201840
14,7,120,22,297,167,0,30,0,636,579,1215,6,6,201840
14,8,326,64,802,1111,32,126,24,2485,2373,4858,11,5,201840
14,9,112,30,223,349,30,28,1,773,876,1649,12,8,201840
14,10,185,36,415,429,5,71,1,1142,1040,2182,7,6.5,201840
14,11,121,39,174,259,30,51,37,711,629,1340,4,6,201840
14,12,225,23,563,203,20,45,2,1081,1172,2253,9,5.5,201840
14,13,221,28,377,268,28,50,0,972,931,1903,6,6,201840
14,14,153,43,298,459,16,32,38,1039,839,1878,7,6,201840
14,15,263,52,246,383,30,80,19,1073,963,2036,10,5.6,201840
14,16,211,30,297,241,66,55,37,937,838,1775,5,6,201840
14,17,201,41,246,241,29,55,42,855,839,1694,7,5.25,201840
14,18,229,44,300,268,66,52,97,1056,1164,2220,9,5.4,201840
14,19,234,39,341,357,43,65,18,1097,1229,2326,8,5.25,201840
14,20,177,25,288,145,10,41,19,705,784,1489,10,5.666666667,201840
15,1,175,14,315,124,422,51,4,1105,1239,2344,7,5.333333333,201840
15,2,155,20,297,384,34,60,35,985,937,1922,6,6,201840
15,3,354,47,436,511,128,83,39,1598,1531,3129,10,5.666666667,201840
15,4,223,31,310,418,33,76,65,1156,1073,2229,4,6,201840
15,5,190,39,292,334,22,50,19,946,923,1869,8,5.666666667,201840
15,6,164,14,329,489,48,79,32,1155,1173,2328,7,6.5,201840
15,7,169,23,336,396,47,49,22,1042,1053,2095,10,6,201840
15,8,77,20,123,268,10,31,13,542,513,1055,4,6,201840
15,9,327,25,179,209,252,37,58,1087,924,2011,9,5.75,201840
15,10,136,16,231,289,58,48,15,793,843,1636,6,6,201840
15,11,215,28,363,473,33,43,28,1183,1151,2334,8,6,201840
15,12,285,32,538,552,31,64,3,1505,1474,2979,8,6,201840
15,13,112,17,205,263,98,56,0,751,603,1354,8,6,201840
15,14,68,12,127,189,32,30,0,458,459,917,4,6,201840
15,15,172,73,359,517,28,60,6,1215,1208,2423,6,6,201840
15,16,244,42,434,627,11,64,4,1426,1403,2829,8,6,201840
15,17,75,22,185,245,9,55,116,707,727,1434,8,5,201840
15,18,251,40,375,519,26,74,13,1298,1288,2586,7,5.666666667,201840
15,19,226,73,515,867,15,90,4,1790,1895,3685,10,6,201840
15,20,85,13,218,341,11,43,6,717,645,1362,6,6,201840
15,21,121,11,149,175,18,38,0,512,628,1140,6,5.5,201840
15,22,276,60,542,800,30,85,110,1903,1774,3677,14,6,201840
15,23,228,27,289,404,24,68,0,1040,1200,2240,6,5.333333333,201840
15,24,131,22,227,349,16,26,9,780,821,1601,4,6,201840
15,25,217,36,326,338,30,58,24,1029,860,1889,6,6,201840
15,26,144,24,275,246,58,36,5,788,749,1537,9,3.5,201840
15,27,244,33,397,565,15,89,40,1383,1388,2771,9,5.666666667,201840
15,28,244,28,565,445,85,64,34,1465,1457,2922,9,5.666666667,201840
15,29,201,41,443,635,29,93,20,1462,1455,2917,8,6,201840
15,30,246,46,436,422,54,38,20,1262,1343,2605,16,6,201840
15,31,143,56,257,351,12,41,0,860,852,1712,6,6,201840
15,32,183,23,277,467,47,70,4,1071,1023,2094,9,6,201840
15,33,187,11,315,376,15,51,0,955,1145,2100,7,6,201840
15,34,158,21,225,498,20,65,11,998,927,1925,8,6,201840
15,35,332,35,233,393,23,52,0,1068,1064,2132,9,5.333333333,201840
15,36,287,42,314,362,87,62,0,1154,1139,2293,9,5.5,201840
15,37,189,30,344,478,57,48,35,1181,1032,2213,7,6,201840
15,38,191,33,278,444,13,55,0,1014,1156,2170,6,5.5,201840
15,39,148,38,286,374,38,43,3,930,1003,1933,4,6,201840
15,40,368,47,362,466,92,72,0,1407,1347,2754,9,6,201840
15,41,241,33,593,589,33,59,30,1578,1652,3230,11,6,201840
16,1,138,12,261,210,8,44,2,675,713,1388,7,5.333333333,201840
16,2,155,35,163,193,18,37,0,601,649,1250,9,5.25,201840
16,3,239,38,235,251,31,40,11,845,643,1488,10,5.25,201840
16,4,201,46,286,272,42,73,0,920,981,1901,8,5.5,201840
16,5,221,48,248,221,31,80,36,885,902,1787,10,5.666666667,201840
16,6,238,41,234,276,53,43,0,885,974,1859,12,5.5,201840
16,7,211,33,207,257,51,69,1,829,869,1698,9,5.5,201840
16,8,315,59,577,591,23,93,16,1674,1643,3317,12,6,201840
16,9,267,43,355,346,20,79,7,1117,1121,2238,9,6.5,201840
16,10,178,20,276,340,12,46,0,872,955,1827,6,4,201840
16,11,239,46,239,198,180,54,12,968,935,1903,10,5.4,201840
16,12,190,32,216,187,37,45,6,713,756,1469,10,5.25,201840
17,1,202,30,372,414,33,52,35,1138,1040,2178,8,3.5,201840
17,2,174,18,323,370,19,50,19,973,851,1824,8,5.666666667,201840
17,3,242,32,359,484,19,54,0,1190,1264,2454,8,5.5,201840
17,4,254,32,323,454,16,65,9,1153,1177,2330,10,5.666666667,201840
17,5,118,12,146,212,21,23,1,533,488,1021,5,5.5,201840
18,1,113,28,155,238,40,34,12,620,683,1303,7,4.5,201840
18,2,221,49,483,420,65,68,0,1306,1320,2626,8,6.666666667,201840
18,3,127,20,311,218,6,32,0,714,1019,1733,8,5.5,201840
19,1,171,31,338,397,32,77,66,1112,1133,2245,9,5.5,201840
19,2,339,24,824,417,9,87,2,1702,1444,3146,9,6,201840
19,3,290,29,654,470,31,72,28,1574,1544,3118,7,6,201840
19,4,108,28,191,148,85,45,229,834,750,1584,5,6,201840
19,5,369,51,564,713,31,98,115,1941,1786,3727,8,6,201840
19,6,79,23,255,547,4,59,0,967,843,1810,5,6,201840
19,7,187,21,443,303,12,36,0,1002,927,1929,10,5.25,201840
19,8,77,9,137,114,3,16,0,356,304,660,7,6,201840
19,9,198,42,339,505,59,59,26,1228,1170,2398,9,5,201840
19,10,150,21,204,418,5,63,132,993,878,1871,5,2,201840
19,11,439,97,733,1300,52,124,0,2745,2439,5184,13,6.333333333,201840
19,12,205,33,534,307,15,41,11,1146,1127,2273,8,5.666666667,201840
20,1,239,38,267,271,70,68,76,1029,996,2025,7,5.5,201840
20,2,180,25,191,258,41,43,0,738,561,1299,6,5.333333333,201840
20,3,135,20,217,225,60,36,22,715,1215,1930,6,5.333333333,201840
20,4,102,18,103,162,48,37,37,507,721,1228,6,5.333333333,201840
20,5,105,16,178,227,45,38,0,609,1059,1668,11,5.25,201840
20,6,120,10,175,221,68,28,4,626,959,1585,8,5.25,201840
20,7,207,18,215,329,16,40,5,830,887,1717,7,5.75,201840
20,8,487,78,654,1035,38,129,224,2645,2501,5146,13,4.333333333,201840
20,9,283,29,252,301,117,76,38,1096,1274,2370,8,5.666666667,201840
20,10,206,18,148,360,20,28,1,781,1125,1906,9,4.75,201840
21,1,262,23,247,387,15,43,0,977,954,1931,9,5.4,201840
21,2,204,24,266,272,98,47,2,913,935,1848,9,5.2,201840
21,3,289,30,356,265,144,85,70,1239,1187,2426,8,5.5,201840
21,4,196,12,208,115,48,44,46,669,867,1536,6,5.25,201840
21,5,264,13,378,303,28,59,6,1051,1207,2258,8,5.666666667,201840
21,6,223,22,324,411,57,57,174,1268,1263,2531,6,6,201840
21,7,327,17,247,322,36,54,15,1018,1092,2110,9,5.666666667,201840
21,8,239,20,317,360,117,65,11,1129,1268,2397,9,5.2,201840
21,9,228,22,460,434,64,76,108,1392,1318,2710,9,6,201840
21,10,252,21,403,389,54,58,91,1268,1171,2439,7,6,201840
21,11,64,3,135,104,6,15,4,331,369,700,4,6,201840
21,12,385,31,808,906,90,130,97,2447,2455,4902,16,7,201840
21,13,323,21,302,361,67,78,25,1177,1055,2232,8,5.666666667,201840
21,14,267,25,259,205,110,63,82,1011,998,2009,12,5.333333333,201840
21,15,341,17,438,317,44,61,26,1244,1123,2367,7,5.5,201840
22,1,220,50,267,348,41,32,15,973,896,1869,11,5,201840
22,2,124,36,302,218,30,33,25,768,766,1534,7,5.5,201840
22,3,317,86,807,632,39,87,0,1968,1964,3932,9,6,201840
22,4,221,48,598,574,44,61,8,1554,1533,3087,10,7,201840
22,5,155,30,411,249,73,40,12,970,920,1890,10,5.5,201840
23,1,259,12,1458,390,10,46,18,2193,2173,4366,14,5.6,201840
23,2,176,23,370,330,12,40,0,951,1117,2068,9,5.5,201840
23,3,326,10,964,491,34,39,0,1864,1788,3652,15,7,201840
23,4,179,12,738,409,19,33,0,1390,1366,2756,8,5,201840
24,1,201,52,199,304,39,36,10,841,834,1675,10,5.2,201840
24,2,171,49,219,269,32,48,0,788,570,1358,6,5.5,201840
24,3,198,30,194,268,74,45,0,809,905,1714,8,5.25,201840
24,4,160,51,192,237,66,62,92,860,924,1784,5,5.5,201840
24,5,279,53,492,577,12,60,0,1473,1147,2620,9,6.333333333,201840
24,6,182,57,363,460,29,66,12,1169,946,2115,12,4,201840
24,7,286,35,340,333,53,45,0,1092,1020,2112,15,5.25,201840
25,1,198,26,264,405,53,55,47,1048,1055,2103,17,6,201840
25,2,237,36,317,534,25,51,0,1200,1312,2512,7,5.5,201840
25,3,201,29,296,441,60,35,8,1070,1042,2112,12,5.6,201840
25,4,196,47,187,390,11,54,121,1006,1061,2067,10,5.333333333,201840
25,5,231,22,358,687,29,68,0,1395,1292,2687,8,5.666666667,201840
25,6,225,27,400,411,85,79,30,1257,1269,2526,10,5.75,201840
25,7,267,26,318,511,14,68,0,1204,1200,2404,8,6,201840
26,1,223,28,381,330,15,59,0,1036,976,2012,14,5.5,201840
26,2,279,27,489,526,12,104,0,1437,1396,2833,21,5.4,201840
26,3,294,33,430,669,7,125,30,1588,1651,3239,14,6.5,201840
26,4,156,27,256,368,22,63,32,924,1023,1947,9,5.2,201840
26,5,100,10,132,204,11,51,0,508,407,915,8,5.5,201840
26,6,158,24,354,545,10,75,0,1166,1157,2323,13,5.333333333,201840
26,7,159,19,198,264,28,43,0,711,814,1525,10,5.5,201840
27,1,234,20,251,340,22,50,1,918,1044,1962,10,5,201840
27,2,250,28,250,390,27,61,1,1007,1066,2073,9,5.666666667,201840
27,3,195,11,164,381,9,27,0,787,886,1673,10,5.666666667,201840
27,4,248,23,372,639,24,43,62,1411,1205,2616,9,4.333333333,201840
27,5,139,12,110,235,11,30,6,543,815,1358,9,5.333333333,201840
27,6,126,16,185,391,8,41,0,767,828,1595,11,5.5,201840
28,1,211,21,493,349,14,34,1,1123,1066,2189,18,6,201840
28,2,260,48,535,373,43,65,170,1494,1735,3229,14,6,201840
28,3,134,29,226,302,8,43,0,742,751,1493,12,5.333333333,201840
28,4,278,41,516,361,41,80,196,1513,1579,3092,17,6,201840
28,5,195,41,237,427,15,74,36,1025,1052,2077,13,5.25,201840
28,6,187,37,285,281,70,52,71,983,941,1924,13,5.166666667,201840
28,7,225,37,472,467,67,58,0,1326,1320,2646,9,6,201840
28,8,166,38,276,323,83,58,51,995,931,1926,10,6,201840
28,9,151,18,328,217,18,29,74,835,845,1680,12,5.75,201840
29,1,208,35,376,372,55,43,0,1089,1093,2182,11,5.5,201840
29,2,221,26,280,456,26,70,101,1180,1168,2348,13,7.333333333,201840
29,3,146,31,158,336,18,43,0,732,870,1602,6,5.666666667,201840
30,1,132,41,267,391,150,35,29,1045,918,1963,7,5.333333333,201840
30,2,238,48,191,121,74,40,473,1185,1087,2272,8,5.25,201840
30,3,191,37,358,175,274,44,253,1332,1422,2754,9,5.666666667,201840
30,4,125,12,256,255,39,52,0,739,678,1417,10,6,201840
30,5,159,27,218,395,9,76,0,884,832,1716,10,5.5,201840
30,6,243,38,238,308,31,43,0,901,950,1851,12,5.333333333,201840
30,7,232,28,293,405,46,65,51,1120,917,2037,12,5.25,201840
30,8,171,20,318,371,51,55,14,1000,1190,2190,11,5.4,201840
30,9,255,19,263,160,74,84,163,1018,1094,2112,10,5.5,201840
30,10,167,26,370,390,48,80,92,1173,1053,2226,7,6.5,201840
30,11,161,22,360,417,12,53,0,1025,840,1865,6,5.5,201840
30,12,245,27,514,729,34,105,0,1654,1795,3449,11,6.25,201840
30,13,278,44,258,379,85,76,244,1364,1401,2765,10,5.4,201840
30,14,174,21,288,179,108,64,112,946,797,1743,13,5.5,201840
30,15,305,23,253,265,69,81,170,1166,1192,2358,15,5.666666667,201840
30,16,171,21,319,349,72,75,104,1111,1198,2309,10,5.333333333,201840
30,17,220,36,234,338,25,57,6,916,1109,2025,8,5.5,201840
30,18,191,25,156,256,18,44,81,771,963,1734,11,5.25,201840
30,19,183,20,297,353,46,40,6,945,986,1931,13,5.6,201840
30,20,184,24,226,357,88,54,0,933,1067,2000,10,5.4,201840
31,1,246,23,238,384,13,34,0,938,780,1718,8,5.5,201840
31,2,105,21,183,38,370,32,0,749,684,1433,9,5.333333333,201840
31,3,421,80,1025,976,79,98,2,2681,2619,5300,26,6.666666667,201840
31,4,125,15,307,351,36,35,0,869,854,1723,3,6,201840
31,5,115,45,174,565,27,39,0,965,671,1636,8,5.333333333,201840
32,1,219,75,236,227,60,64,101,982,940,1922,12,5.2,201840
32,2,262,108,386,304,230,74,132,1496,1574,3070,17,5.142857143,201840
32,3,201,77,287,373,19,64,32,1053,1099,2152,15,5.6,201840
32,4,229,142,330,371,48,74,76,1270,1287,2557,13,5.4,201840
1,1,301,49,308,311,84,60,17,1130,1043,2173,13,5,201842
1,2,296,47,510,364,68,64,15,1364,967,2331,10,5.25,201842
1,3,427,74,566,521,50,67,11,1716,1383,3099,11,5.25,201842
2,1,305,21,407,440,13,66,11,1263,1009,2272,11,5.666666667,201842
2,2,376,41,358,754,5,102,0,1636,1476,3112,9,5.333333333,201842
2,3,402,25,575,482,31,108,4,1627,1401,3028,12,5.333333333,201842
2,4,243,14,587,192,43,36,5,1120,1101,2221,9,5.5,201842
2,5,452,36,934,515,99,130,16,2182,2118,4300,13,4.666666667,201842
2,6,267,21,607,482,25,89,0,1491,1376,2867,7,5.5,201842
2,7,367,33,703,507,22,100,18,1750,1723,3473,12,5.75,201842
2,8,291,33,750,570,13,89,8,1754,1715,3469,8,6,201842
3,1,125,13,319,331,13,64,15,880,850,1730,14,4.428571429,201842
3,2,131,8,437,209,14,28,0,827,869,1696,9,5,201842
4,1,190,24,272,450,19,28,0,983,913,1896,14,4.666666667,201842
4,2,189,19,379,370,61,43,22,1083,919,2002,14,4.4,201842
5,1,227,27,429,360,43,80,17,1183,1089,2272,9,5.666666667,201842
5,2,162,25,334,350,30,51,1,953,945,1898,10,5.2,201842
5,3,178,32,270,408,67,71,99,1125,966,2091,9,5.5,201842
5,4,197,36,516,376,13,79,125,1342,1258,2600,11,5.5,201842
5,5,164,27,387,570,21,49,31,1249,1126,2375,8,6,201842
5,6,52,21,68,106,3,2,17,269,197,466,2,2.5,201842
5,7,146,22,273,368,8,40,0,857,726,1583,10,5,201842
6,1,149,33,343,349,25,66,78,1043,873,1916,14,5.666666667,201842
6,2,147,29,437,248,73,54,23,1011,864,1875,9,5.666666667,201842
7,1,254,15,175,359,6,57,15,881,1271,2152,9,5.25,201842
7,2,214,12,117,427,16,23,0,809,516,1325,9,4.25,201842
7,3,399,13,241,335,147,51,9,1195,587,1782,7,5,201842
7,4,156,23,140,215,3,40,58,635,319,954,11,4.4,201842
7,5,309,16,188,677,24,46,12,1272,1214,2486,11,5,201842
7,6,309,29,351,510,29,82,40,1350,1274,2624,8,5.666666667,201842
7,7,213,34,269,391,10,51,0,968,988,1956,8,4.5,201842
7,8,259,6,164,507,12,47,0,995,1062,2057,12,5,201842
7,9,218,22,314,502,24,58,20,1158,1098,2256,11,5.5,201842
7,10,198,16,198,547,118,36,0,1113,513,1626,9,5,201842
7,11,142,7,95,173,18,14,0,449,459,908,6,5.333333333,201842
7,12,270,15,291,555,3,43,0,1177,965,2142,9,5,201842
7,13,153,10,123,351,6,21,0,664,208,872,9,5,201842
8,1,185,11,498,325,15,43,1,1078,942,2020,4,6,201842
8,2,100,20,163,163,14,22,3,485,354,839,5,3.5,201842
8,3,209,35,481,338,18,55,8,1144,1153,2297,4,4.5,201842
8,4,154,30,487,216,40,79,56,1062,1046,2108,9,5,201842
8,5,155,38,285,288,27,64,0,857,1148,2005,10,4.5,201842
8,6,209,51,454,555,68,99,67,1503,1514,3017,7,8.5,201842
8,7,191,51,243,347,10,57,1,900,780,1680,7,5.25,201842
8,8,206,39,433,585,30,93,24,1410,1421,2831,10,3.5,201842
8,9,155,46,223,295,40,47,3,809,717,1526,10,4,201842
9,1,90,31,164,180,68,25,33,591,788,1379,5,6,201842
9,2,278,80,793,1102,67,142,44,2506,2717,5223,12,5.5,201842
9,3,140,59,493,528,49,69,83,1421,1551,2972,7,6,201842
9,4,211,31,407,571,66,87,56,1429,1412,2841,11,6,201842
9,5,122,27,351,371,39,54,11,975,969,1944,7,5,201842
9,6,102,22,236,198,77,50,51,736,708,1444,7,5,201842
9,7,81,13,292,361,1,47,5,800,1028,1828,9,5,201842
9,8,72,11,265,250,26,52,47,723,739,1462,5,6,201842
9,9,118,14,253,300,31,39,7,762,706,1468,5,5,201842
9,10,91,35,296,361,26,49,0,858,798,1656,6,6,201842
9,11,162,18,462,559,33,85,1,1320,1432,2752,7,7,201842
9,12,147,43,629,673,30,88,103,1713,1533,3246,11,5.5,201842
9,13,107,21,312,347,74,53,79,993,903,1896,4,5,201842
9,14,116,19,232,238,88,45,36,774,770,1544,5,5,201842
9,15,216,39,915,919,38,127,166,2420,2603,5023,11,5.25,201842
9,16,212,43,589,676,49,84,3,1656,1566,3222,15,7,201842
9,17,126,15,276,339,25,52,4,837,825,1662,6,6,201842
9,18,197,59,496,826,46,103,7,1734,1511,3245,12,6,201842
9,19,212,53,387,442,111,71,15,1291,1273,2564,5,6,201842
9,20,44,14,67,96,11,11,2,245,272,517,5,6,201842
9,21,93,14,170,275,42,42,30,666,673,1339,3,6,201842
9,22,157,17,284,289,116,70,63,996,1061,2057,5,6,201842
9,23,153,25,392,536,68,53,26,1253,1298,2551,6,7,201842
9,24,295,38,659,889,94,103,46,2124,2140,4264,12,6,201842
10,1,243,29,234,221,98,55,65,945,701,1646,10,3.833333333,201842
10,2,280,42,334,351,33,45,121,1206,1266,2472,9,5.5,201842
10,3,212,62,207,424,27,51,34,1017,707,1724,11,5.4,201842
10,4,465,47,483,498,10,69,0,1572,1260,2832,14,6.333333333,201842
11,1,202,62,234,255,94,43,16,906,1036,1942,6,5.666666667,201842
11,2,231,38,272,268,37,41,23,910,924,1834,7,6,201842
11,3,156,46,260,259,27,34,152,934,890,1824,3,6,201842
11,4,133,35,187,231,3,29,0,618,591,1209,10,3.8,201842
11,5,228,78,318,525,19,70,22,1260,1368,2628,7,5.5,201842
11,6,98,29,211,223,21,22,28,632,795,1427,6,9,201842
11,7,225,49,289,314,24,36,0,937,879,1816,9,4.75,201842
11,8,228,50,318,408,27,42,54,1127,1281,2408,9,5.75,201842
11,9,229,103,482,450,22,66,54,1406,1118,2524,10,4.666666667,201842
11,10,201,88,342,403,35,47,89,1205,1160,2365,10,5.6,201842
11,11,176,81,307,376,7,44,0,991,836,1827,5,6,201842
11,12,210,56,418,473,16,72,10,1255,1395,2650,7,5.5,201842
11,13,186,62,293,235,37,37,108,958,851,1809,8,4.5,201842
11,14,200,58,259,365,26,39,0,947,888,1835,8,5.25,201842
11,15,129,52,197,311,7,38,0,734,858,1592,9,6,201842
12,1,175,39,293,141,110,40,24,822,533,1355,10,5.2,201842
12,2,206,66,228,441,23,55,0,1019,928,1947,10,5,201842
12,3,173,41,258,375,24,36,1,908,711,1619,11,4.2,201842
12,4,182,41,349,494,36,54,3,1159,1177,2336,9,6,201842
12,5,228,20,191,242,4,27,20,732,477,1209,10,4.25,201842
12,6,188,35,119,337,23,22,0,724,391,1115,10,4.25,201842
12,7,57,10,93,107,8,12,20,307,790,1097,6,3.5,201842
12,8,267,13,147,232,7,26,0,692,649,1341,9,4.25,201842
12,9,183,25,278,509,10,48,5,1058,1058,2116,9,5.333333333,201842
13,1,183,41,247,510,102,62,29,1174,1008,2182,9,5,201842
13,2,103,30,103,285,62,34,19,636,770,1406,6,4.333333333,201842
13,3,98,16,135,191,89,32,0,561,575,1136,12,4.25,201842
13,4,190,21,255,253,94,58,41,912,888,1800,9,5,201842
13,5,144,35,343,313,137,57,63,1092,1026,2118,9,4.75,201842
13,6,227,59,680,711,38,85,2,1802,1769,3571,13,5.25,201842
13,7,124,33,418,362,49,35,4,1025,1148,2173,6,5,201842
14,1,154,46,203,170,81,41,89,784,733,1517,6,5,201842
14,2,173,24,218,221,30,46,6,718,662,1380,5,4.666666667,201842
14,3,240,49,319,339,36,82,15,1080,964,2044,8,4.8,201842
14,4,148,27,346,332,25,33,15,926,927,1853,14,5,201842
14,5,174,27,440,267,32,49,10,999,750,1749,9,4.5,201842
14,6,176,23,464,323,31,46,1,1064,1014,2078,11,5,201842
14,7,92,9,140,136,0,27,0,404,568,972,6,5,201842
14,8,231,50,717,633,33,94,32,1790,1916,3706,11,4.6,201842
14,9,119,32,253,324,30,21,6,785,578,1363,12,10,201842
14,10,188,42,474,500,16,69,1,1290,1086,2376,7,6.5,201842
14,11,148,32,185,313,28,38,56,800,598,1398,4,5,201842
14,12,176,20,363,151,9,36,6,761,860,1621,9,4.5,201842
14,13,192,27,383,369,10,47,7,1035,890,1925,6,6,201842
14,14,106,215,174,290,7,30,36,858,596,1454,7,5,201842
14,15,224,51,229,301,33,67,15,920,841,1761,10,5,201842
14,16,200,29,359,266,49,46,51,1000,919,1919,5,6,201842
14,17,105,23,129,129,26,19,27,458,422,880,5,3.25,201842
14,18,164,41,241,223,33,51,74,827,874,1701,9,3.8,201842
14,19,190,46,294,308,38,45,11,932,930,1862,8,5.25,201842
14,20,191,32,352,211,20,56,31,893,708,1601,10,5.666666667,201842
15,1,151,30,264,232,271,51,7,1006,1024,2030,7,4.666666667,201842
15,2,130,18,208,320,44,45,19,784,765,1549,6,6,201842
15,3,235,35,310,296,137,61,51,1125,1050,2175,10,5,201842
15,4,186,39,295,432,58,62,54,1126,1128,2254,4,6,201842
15,5,173,40,315,362,24,38,24,976,859,1835,8,5.666666667,201842
15,6,123,23,233,414,57,46,24,920,814,1734,7,5,201842
15,7,120,23,271,397,38,63,18,930,960,1890,10,6,201842
15,8,47,6,136,208,13,32,12,454,382,836,4,6,201842
15,9,254,14,180,235,188,46,71,988,907,1895,9,5.75,201842
15,10,130,22,263,321,72,45,19,872,792,1664,6,6,201842
15,11,141,21,212,383,30,36,0,823,816,1639,8,4,201842
15,12,221,26,641,525,34,59,17,1523,1448,2971,8,6,201842
15,13,93,28,177,285,126,51,0,760,721,1481,8,6,201842
15,14,83,24,166,260,23,34,0,590,467,1057,4,6,201842
15,15,169,65,334,551,25,63,0,1207,1244,2451,6,6,201842
15,16,204,29,386,662,13,51,7,1352,1344,2696,8,5.5,201842
15,17,109,25,239,289,16,74,167,919,950,1869,8,6,201842
15,18,213,39,296,438,34,59,52,1131,1095,2226,7,5.666666667,201842
15,19,231,83,566,1006,3,91,13,1993,1862,3855,10,6,201842
15,20,81,28,228,377,31,49,19,813,704,1517,6,6,201842
15,21,99,13,128,253,21,32,0,546,502,1048,6,5.5,201842
15,22,205,55,465,596,39,88,142,1590,1437,3027,14,5,201842
15,23,136,21,189,378,34,35,0,793,932,1725,6,5.333333333,201842
15,24,107,24,223,261,25,36,15,691,746,1437,4,6,201842
15,25,213,32,321,326,37,62,29,1020,1017,2037,6,6,201842
15,26,173,11,313,333,45,56,5,936,777,1713,11,5.333333333,201842
15,27,213,31,411,575,16,83,76,1405,1259,2664,9,5.666666667,201842
15,28,201,38,452,349,48,55,28,1171,1276,2447,9,5.333333333,201842
15,29,169,36,316,510,14,79,27,1151,1086,2237,8,4,201842
15,30,205,33,437,459,53,60,17,1264,1340,2604,16,6,201842
15,31,178,69,310,447,13,47,1,1065,933,1998,6,6,201842
15,32,147,20,248,395,27,55,8,900,960,1860,9,5,201842
15,33,201,16,337,383,23,59,0,1019,1044,2063,7,6,201842
15,34,130,9,211,431,8,30,22,841,876,1717,8,6,201842
15,35,278,24,306,434,9,75,0,1126,1137,2263,9,5.666666667,201842
15,36,273,29,307,403,124,43,3,1182,954,2136,9,5.5,201842
15,37,177,35,317,430,57,55,37,1108,1162,2270,7,6,201842
15,38,164,43,280,460,7,51,0,1005,1025,2030,6,5.5,201842
15,39,128,25,252,281,19,36,1,742,755,1497,4,5,201842
15,40,280,24,357,480,90,80,1,1312,1392,2704,9,6,201842
15,41,215,38,537,568,35,66,46,1505,1496,3001,11,6,201842
16,1,126,19,233,194,18,37,1,628,493,1121,7,5,201842
16,2,177,54,201,383,13,58,0,886,575,1461,9,5,201842
16,3,159,26,165,223,25,38,19,655,711,1366,10,5.25,201842
16,4,203,32,313,276,34,63,0,921,811,1732,8,5.5,201842
16,5,197,60,308,318,31,60,21,995,955,1950,10,5.666666667,201842
16,6,166,45,206,220,31,41,0,709,763,1472,12,5.5,201842
16,7,167,23,180,220,36,44,0,670,623,1293,9,5.5,201842
16,8,279,51,705,551,7,73,16,1682,1739,3421,12,6,201842
16,9,188,36,158,280,118,31,24,835,996,1831,9,6,201842
16,10,163,29,326,370,11,34,4,937,793,1730,8,5,201842
16,11,194,30,231,156,93,53,12,769,808,1577,10,5.2,201842
16,12,184,27,229,193,22,51,5,711,648,1359,10,5.25,201842
17,1,165,21,444,458,26,47,20,1181,1163,2344,11,6.5,201842
17,2,128,13,312,343,5,27,17,845,856,1701,8,5,201842
17,3,247,31,440,554,11,65,1,1349,1187,2536,8,5.5,201842
17,4,215,43,392,480,30,40,9,1209,1134,2343,10,5.666666667,201842
17,5,101,16,149,204,38,32,1,541,318,859,5,5,201842
18,1,153,32,167,234,68,33,16,703,540,1243,7,5.25,201842
18,2,198,44,576,253,31,46,0,1148,1224,2372,10,6.25,201842
18,3,151,44,418,323,24,45,0,1005,707,1712,8,5.25,201842
19,1,185,34,404,485,34,81,54,1277,1119,2396,9,5,201842
19,2,211,21,654,347,35,47,0,1315,1278,2593,9,5,201842
19,3,180,24,473,330,28,42,12,1089,1250,2339,7,4,201842
19,4,88,14,146,111,60,32,179,630,641,1271,5,4,201842
19,5,308,48,602,789,18,86,140,1991,1862,3853,8,6,201842
19,6,52,6,177,296,6,29,43,609,634,1243,5,5,201842
19,7,198,21,549,367,16,48,13,1212,976,2188,10,5,201842
19,8,51,7,122,144,7,17,1,349,281,630,7,5,201842
19,9,111,15,186,183,17,27,32,571,568,1139,9,3.25,201842
19,10,175,22,209,392,9,42,194,1043,909,1952,8,4.666666667,201842
19,11,392,76,703,1427,27,133,0,2758,2470,5228,13,5.333333333,201842
19,12,120,13,366,253,13,44,11,820,666,1486,8,4.666666667,201842
20,1,168,26,213,189,41,39,34,710,642,1352,7,4.5,201842
20,2,135,23,175,242,22,17,0,614,361,975,6,4,201842
20,3,125,24,157,156,300,26,3,791,328,1119,6,4.666666667,201842
20,4,142,26,130,341,67,51,19,776,350,1126,6,4.333333333,201842
20,5,154,21,252,370,60,36,0,893,641,1534,11,4,201842
20,6,303,14,216,246,352,38,0,1169,562,1731,8,5,201842
20,7,174,27,210,349,11,39,13,823,681,1504,8,4.75,201842
20,8,322,56,493,779,20,99,185,1954,2177,4131,15,4,201842
20,9,295,23,269,298,102,84,41,1112,962,2074,8,5,201842
20,10,234,28,233,371,44,36,0,946,618,1564,9,4,201842
21,1,185,18,223,362,12,40,0,840,741,1581,10,5,201842
21,2,164,20,263,229,123,36,1,836,774,1610,10,5,201842
21,3,207,13,330,191,126,51,47,965,854,1819,9,5,201842
21,4,167,5,210,108,70,38,9,607,493,1100,8,5,201842
21,5,233,24,339,303,37,70,12,1018,932,1950,8,5.666666667,201842
21,6,162,24,292,442,56,44,145,1165,1293,2458,6,5,201842
21,7,212,23,243,317,57,56,0,908,955,1863,9,5.666666667,201842
21,8,177,28,267,262,62,45,21,862,724,1586,10,5,201842
21,9,185,17,388,452,59,69,126,1296,1285,2581,9,5,201842
21,10,179,22,337,347,52,57,111,1105,999,2104,7,5.5,201842
21,11,69,5,148,88,15,15,6,346,325,671,6,3,201842
21,12,307,44,750,956,54,96,78,2285,2384,4669,16,6.5,201842
21,13,276,21,277,365,63,69,20,1091,1079,2170,8,5.666666667,201842
21,14,184,19,240,223,55,50,27,798,613,1411,12,5,201842
21,15,266,15,402,314,65,79,37,1178,1075,2253,7,5.5,201842
22,1,196,52,215,352,44,26,5,890,792,1682,11,5,201842
22,2,185,36,443,240,37,40,14,995,838,1833,7,5.5,201842
22,3,258,65,705,556,29,62,12,1687,1779,3466,9,5.666666667,201842
22,4,216,51,645,529,48,64,24,1577,1503,3080,12,6.333333333,201842
22,5,169,45,402,205,105,40,35,1001,981,1982,10,5.5,201842
23,1,279,14,1378,345,20,55,23,2114,1947,4061,14,5.4,201842
23,2,213,29,388,416,8,44,0,1098,1168,2266,10,5.25,201842
23,3,314,14,950,464,30,34,0,1806,1714,3520,15,6,201842
23,4,172,6,761,342,23,36,0,1340,1105,2445,8,5,201842
24,1,99,53,159,268,22,30,4,635,512,1147,10,4.2,201842
24,2,155,42,255,265,26,42,0,785,735,1520,6,5.5,201842
24,3,134,25,203,280,131,35,3,811,607,1418,8,4.25,201842
24,4,117,32,219,164,37,46,134,749,741,1490,5,5,201842
24,5,223,42,415,469,13,69,0,1231,1052,2283,9,5,201842
24,6,192,65,383,436,45,61,21,1203,1660,2863,9,4.5,201842
24,7,195,43,339,535,79,30,0,1221,749,1970,9,4.25,201842
25,1,122,33,231,365,46,44,54,895,897,1792,13,5.25,201842
25,2,194,27,330,573,30,66,0,1220,1082,2302,7,5,201842
25,3,204,31,292,409,54,38,11,1039,1038,2077,8,5.6,201842
25,4,121,57,206,442,34,69,54,983,927,1910,8,5.333333333,201842
25,5,223,27,329,647,26,54,0,1306,1250,2556,10,4.75,201842
25,6,211,43,427,479,108,72,56,1396,1270,2666,8,5.75,201842
25,7,222,23,314,499,9,81,0,1148,1171,2319,6,6,201842
26,1,200,18,302,310,10,67,0,907,970,1877,9,5,201842
26,2,184,22,358,432,5,67,0,1068,1028,2096,12,5,201842
26,3,243,33,449,457,40,91,9,1322,1532,2854,17,4.75,201842
26,4,125,26,159,346,31,54,14,755,657,1412,9,5,201842
26,5,74,25,103,67,48,21,0,338,348,686,3,5.5,201842
26,6,147,20,306,449,13,66,0,1001,928,1929,10,5,201842
26,7,126,16,178,290,25,33,0,668,737,1405,10,5,201842
27,1,142,19,246,509,60,41,0,1017,576,1593,8,5.5,201842
27,2,260,33,209,427,15,36,0,980,809,1789,8,4.666666667,201842
27,3,191,15,127,404,13,18,0,768,712,1480,7,4.666666667,201842
27,4,246,22,312,615,21,45,45,1306,1098,2404,10,4,201842
27,5,98,4,68,225,5,19,1,420,208,628,6,4.333333333,201842
27,6,164,32,223,459,5,38,0,921,962,1883,7,5.5,201842
28,1,199,24,455,392,7,51,1,1129,1081,2210,13,5.8,201842
28,2,252,36,453,389,21,59,117,1327,1316,2643,13,5,201842
28,3,101,21,157,199,5,20,1,504,439,943,7,3.666666667,201842
28,4,248,26,360,255,56,75,190,1210,1298,2508,15,5,201842
28,5,137,47,263,543,11,48,1,1050,878,1928,11,4.4,201842
28,6,100,38,190,241,49,27,79,724,536,1260,13,4.333333333,201842
28,7,159,36,395,513,52,57,0,1212,1193,2405,6,5.333333333,201842
28,8,97,30,189,287,59,31,16,709,825,1534,9,4.5,201842
28,9,131,15,312,194,10,22,63,747,832,1579,11,4.5,201842
29,1,214,45,415,435,57,46,0,1212,973,2185,7,5.25,201842
29,2,178,31,230,486,29,43,129,1126,1111,2237,14,5.75,201842
29,3,126,22,150,307,12,45,0,662,522,1184,5,4.666666667,201842
30,1,94,27,266,345,98,26,36,892,717,1609,7,5,201842
30,2,171,45,220,95,78,21,438,1068,688,1756,8,5,201842
30,3,129,22,241,118,137,31,221,899,856,1755,6,4,201842
30,4,80,14,206,261,42,25,0,628,741,1369,8,5,201842
30,5,143,34,194,369,10,42,0,792,736,1528,7,5,201842
30,6,163,24,253,268,65,37,0,810,654,1464,9,5,201842
30,7,142,25,319,182,71,42,69,850,552,1402,11,4.75,201842
30,8,199,33,442,480,84,82,11,1331,822,2153,11,5,201842
30,9,194,12,184,144,79,62,150,825,896,1721,8,5,201842
30,10,170,26,344,412,51,67,95,1165,1062,2227,9,4.75,201842
30,11,102,23,270,479,14,41,0,929,790,1719,5,4.5,201842
30,12,207,28,594,764,36,97,0,1726,1722,3448,10,6.25,201842
30,13,156,32,183,286,69,38,144,908,750,1658,10,4.4,201842
30,14,143,28,348,143,136,55,138,991,742,1733,8,4.5,201842
30,15,251,24,261,296,106,92,182,1212,998,2210,11,5,201842
30,16,175,23,321,321,114,80,183,1217,964,2181,10,5,201842
30,17,212,60,304,380,73,76,48,1153,799,1952,8,5,201842
30,18,232,30,215,336,20,67,57,957,641,1598,8,5,201842
30,19,168,26,264,419,36,45,4,962,600,1562,13,4.4,201842
30,20,211,24,258,464,116,62,0,1135,788,1923,10,5,201842
31,1,144,26,208,398,19,38,0,833,964,1797,8,5,201842
31,2,66,17,188,26,429,36,0,762,458,1220,6,5,201842
31,3,300,57,868,878,71,85,1,2260,2062,4322,20,5.333333333,201842
31,4,83,14,308,374,39,32,8,858,698,1556,5,3,201842
31,5,170,23,208,472,26,44,0,943,756,1699,5,5.333333333,201842
32,1,202,61,229,224,100,51,88,955,848,1803,12,5,201842
32,2,135,96,295,249,185,42,110,1112,942,2054,13,5.142857143,201842
32,3,207,78,309,438,22,58,27,1139,803,1942,15,5.5,201842
32,4,286,148,346,383,51,75,90,1379,1146,2525,12,5.2,201842
1,1,353,58,295,290,67,37,8,1108,894,2002,13,5.5,201843
1,2,420,64,515,385,71,49,33,1537,2158,3695,10,5.75,201843
1,3,405,78,586,527,62,60,19,1737,1613,3350,11,5.75,201843
2,1,297,15,352,357,11,62,0,1094,865,1959,11,5.333333333,201843
2,2,500,32,310,617,9,84,0,1552,1444,2996,9,5.666666667,201843
2,3,413,30,528,491,29,77,1,1569,1636,3205,12,5,201843
2,4,270,10,538,210,35,34,6,1103,1143,2246,9,5.5,201843
2,5,417,31,825,491,106,112,9,1991,2479,4470,13,6,201843
2,6,267,15,534,352,22,73,0,1263,1407,2670,7,5.5,201843
2,7,369,16,535,390,14,64,8,1396,1332,2728,12,5.25,201843
2,8,306,10,597,451,19,65,5,1453,1695,3148,8,5.5,201843
3,1,140,21,319,358,17,71,10,936,974,1910,14,5.571428571,201843
3,2,164,15,522,252,19,43,0,1015,865,1880,9,5.666666667,201843
4,1,214,25,300,543,30,59,0,1171,933,2104,14,4.666666667,201843
4,2,194,28,376,384,27,40,15,1064,920,1984,14,5.2,201843
5,1,191,18,368,333,26,57,43,1036,1058,2094,9,5.666666667,201843
5,2,137,18,225,279,37,30,0,726,757,1483,10,5.2,201843
5,3,156,21,269,320,34,66,52,918,926,1844,9,5,201843
5,4,207,47,546,506,21,94,68,1489,1478,2967,11,5.5,201843
5,5,230,24,428,625,12,71,36,1426,1416,2842,8,6,201843
5,6,47,14,113,90,1,5,9,279,190,469,2,2.5,201843
5,7,136,35,293,399,24,40,10,937,905,1842,10,5.5,201843
6,1,154,34,315,298,18,52,79,950,977,1927,14,5.5,201843
6,2,151,20,390,245,69,47,19,941,895,1836,9,5.666666667,201843
7,1,269,18,189,317,4,19,17,833,762,1595,9,5.25,201843
7,2,67,3,36,117,4,9,0,236,432,668,9,2.75,201843
7,3,313,7,275,135,205,35,4,974,591,1565,7,5.333333333,201843
7,4,103,12,90,176,12,22,20,435,349,784,11,5.4,201843
7,5,348,12,169,610,25,40,15,1219,1277,2496,11,5.666666667,201843
7,6,227,33,297,467,27,71,13,1135,854,1989,9,5.666666667,201843
7,7,267,44,347,499,6,74,3,1240,1138,2378,8,5.5,201843
7,8,198,16,169,412,14,37,0,846,1033,1879,12,5.25,201843
7,9,189,18,320,444,22,50,5,1048,979,2027,11,5,201843
7,10,224,14,232,490,27,25,0,1012,754,1766,9,5.5,201843
7,11,137,6,59,161,11,12,0,386,346,732,6,5.333333333,201843
7,12,220,15,262,543,7,34,0,1081,1255,2336,9,5.5,201843
7,13,98,6,92,214,2,16,0,428,555,983,9,4,201843
8,1,102,6,263,155,16,17,10,569,698,1267,4,3,201843
8,2,322,36,693,557,28,97,12,1745,1900,3645,16,4.5,201843
8,3,206,49,543,469,43,78,15,1403,1063,2466,4,6,201843
8,4,166,38,473,413,31,74,92,1287,1059,2346,9,6,201843
8,5,139,28,338,320,30,52,0,907,812,1719,10,5.25,201843
8,6,204,41,459,516,70,91,78,1459,1346,2805,7,6.5,201843
8,7,145,37,180,272,18,57,0,709,852,1561,7,5.25,201843
8,8,214,45,429,564,19,73,30,1374,1154,2528,12,5.5,201843
8,9,136,42,215,306,48,53,0,800,913,1713,10,4.2,201843
9,1,82,18,162,154,88,29,22,555,372,927,5,5,201843
9,2,253,75,811,1096,90,118,61,2504,2401,4905,12,6,201843
9,3,110,38,433,462,62,80,88,1273,1110,2383,7,6,201843
9,4,165,31,424,531,69,52,54,1326,1178,2504,11,6,201843
9,5,118,15,354,470,18,59,12,1046,939,1985,7,6,201843
9,6,74,22,222,234,75,40,39,706,642,1348,7,6,201843
9,7,85,18,272,459,1,43,11,889,912,1801,9,6,201843
9,8,61,14,289,269,27,44,68,772,804,1576,5,6,201843
9,9,131,20,240,313,34,31,33,802,864,1666,5,6,201843
9,10,108,22,319,418,30,56,7,960,1049,2009,6,6,201843
9,11,156,21,522,594,55,85,0,1433,1274,2707,7,6,201843
9,12,103,39,534,589,40,75,102,1482,1641,3123,11,6,201843
9,13,89,30,271,406,50,52,84,982,1057,2039,4,6,201843
9,14,96,23,231,246,94,55,89,834,814,1648,5,6,201843
9,15,166,54,952,1038,51,124,212,2597,2865,5462,11,5.5,201843
9,16,222,72,623,773,69,87,7,1853,1868,3721,15,6,201843
9,17,127,18,296,391,14,40,5,891,933,1824,6,6,201843
9,18,139,35,346,686,36,59,1,1302,1434,2736,12,6,201843
9,19,151,32,296,355,77,65,28,1004,1161,2165,5,5,201843
9,20,19,9,52,71,5,6,0,162,145,307,5,6,201843
9,21,81,11,159,201,30,32,14,528,595,1123,3,6,201843
9,22,151,19,247,285,105,57,39,903,859,1762,5,6,201843
9,23,124,18,316,504,68,52,41,1123,1048,2171,6,6,201843
9,24,282,53,632,925,71,89,42,2094,1994,4088,12,5.5,201843
10,1,228,36,221,294,79,53,47,958,929,1887,8,2.833333333,201843
10,2,244,41,284,354,20,46,46,1035,934,1969,9,4.25,201843
10,3,270,41,177,356,20,56,54,974,758,1732,11,4.4,201843
10,4,594,46,369,444,18,51,0,1522,1349,2871,14,5.333333333,201843
11,1,173,44,173,219,44,30,17,700,689,1389,6,4.666666667,201843
11,2,152,33,237,201,24,27,22,696,711,1407,7,5,201843
11,3,115,45,146,168,21,31,95,621,822,1443,3,5,201843
11,4,166,31,135,225,3,26,0,586,784,1370,10,4,201843
11,5,219,78,348,548,10,88,5,1296,1163,2459,7,5,201843
11,6,91,27,209,245,23,35,21,651,919,1570,10,11,201843
11,7,188,45,224,328,14,39,0,838,954,1792,9,3.75,201843
11,8,134,38,274,380,17,30,44,917,917,1834,9,4.75,201843
11,9,208,89,376,368,21,41,56,1159,1321,2480,10,4.666666667,201843
11,10,153,65,208,274,20,38,56,814,855,1669,10,3.4,201843
11,11,101,43,131,160,8,14,0,457,210,667,5,4,201843
11,12,175,48,375,453,4,35,2,1092,1178,2270,7,5,201843
11,13,164,77,244,232,39,42,89,887,933,1820,8,4.5,201843
11,14,126,42,223,258,21,30,2,702,740,1442,8,4,201843
11,15,107,59,198,279,4,32,0,679,569,1248,9,5,201843
12,1,155,41,270,141,100,44,22,773,667,1440,10,5.2,201843
12,2,194,42,318,474,35,51,56,1170,1108,2278,10,5.5,201843
12,3,166,41,281,407,41,39,0,975,801,1776,11,5.2,201843
12,4,168,36,332,519,37,39,3,1134,1028,2162,9,5.666666667,201843
12,5,263,42,272,338,4,25,10,954,795,1749,10,5.25,201843
12,6,258,21,189,374,25,17,0,884,720,1604,10,5.25,201843
12,7,247,38,359,480,18,64,35,1241,1020,2261,8,4,201843
12,8,248,25,269,286,4,18,0,850,894,1744,9,5.25,201843
12,9,193,30,272,446,9,54,8,1012,937,1949,9,5.666666667,201843
13,1,123,36,143,422,56,52,15,847,1160,2007,9,5.333333333,201843
13,2,148,32,132,358,82,39,4,795,983,1778,6,5.333333333,201843
13,3,195,39,262,388,111,56,0,1051,998,2049,12,5.25,201843
13,4,165,31,283,271,95,62,74,981,1146,2127,9,5.666666667,201843
13,5,161,40,464,353,105,55,35,1213,1464,2677,9,5.5,201843
13,6,234,57,669,810,53,83,1,1907,2334,4241,13,5.5,201843
13,7,153,37,442,415,42,34,13,1136,1191,2327,8,5.25,201843
14,1,114,56,139,126,35,44,93,607,564,1171,6,5.5,201843
14,2,137,42,254,248,17,48,8,754,963,1717,5,5.666666667,201843
14,3,169,31,267,216,50,65,61,859,860,1719,8,4.2,201843
14,4,205,41,342,452,22,41,26,1129,982,2111,14,6,201843
14,5,154,19,445,250,43,52,15,978,1183,2161,9,5.5,201843
14,6,200,22,451,387,34,61,4,1159,1156,2315,11,6,201843
14,7,123,19,262,204,0,33,0,641,489,1130,6,6,201843
14,8,344,80,1029,890,56,175,51,2625,2169,4794,13,5.666666667,201843
14,9,75,64,174,211,29,28,5,586,632,1218,12,6,201843
14,10,140,14,326,360,10,47,2,899,1061,1960,7,5,201843
14,11,186,36,268,397,55,43,97,1082,748,1830,4,6,201843
14,12,254,15,482,211,6,52,5,1025,872,1897,9,5.5,201843
14,13,146,26,297,256,13,43,12,793,949,1742,6,5,201843
14,14,165,691,58,65,13,10,14,1016,699,1715,7,6,201843
14,15,230,48,254,320,42,64,43,1001,987,1988,10,5.6,201843
14,16,151,31,236,216,48,34,57,773,862,1635,5,5,201843
14,17,139,31,159,151,25,32,34,571,631,1202,7,4,201843
14,18,116,24,160,155,18,35,91,599,501,1100,4,2,201843
14,19,103,19,119,175,14,27,1,458,524,982,6,2.25,201843
14,20,146,36,312,173,13,41,8,729,682,1411,10,4.666666667,201843
15,1,165,32,291,122,416,36,9,1071,922,1993,7,5.333333333,201843
15,2,107,15,243,347,31,24,33,800,967,1767,6,6,201843
15,3,183,33,181,349,111,57,53,967,1374,2341,10,5.666666667,201843
15,4,166,24,198,383,46,50,31,898,1033,1931,4,5,201843
15,5,117,25,232,286,17,40,12,729,790,1519,8,5,201843
15,6,157,22,365,555,65,57,19,1240,1408,2648,7,6,201843
15,7,133,26,277,437,58,48,15,994,1091,2085,10,6,201843
15,8,77,19,157,256,23,29,22,583,657,1240,4,6,201843
15,9,174,11,136,138,146,32,33,670,806,1476,9,4.75,201843
15,10,100,19,213,298,48,37,12,727,755,1482,6,6,201843
15,11,163,25,294,484,41,59,1,1067,1433,2500,8,6,201843
15,12,215,25,463,438,24,35,5,1205,1383,2588,8,5.333333333,201843
15,13,54,23,133,187,109,37,0,543,615,1158,8,5,201843
15,14,34,11,71,147,7,18,0,288,336,624,4,4,201843
15,15,96,36,183,324,12,41,0,692,863,1555,6,6,201843
15,16,157,38,351,626,16,49,11,1248,1502,2750,8,6,201843
15,17,92,21,201,283,18,53,149,817,711,1528,8,6,201843
15,18,184,37,328,430,44,64,36,1123,1259,2382,7,5.666666667,201843
15,19,101,35,234,433,5,31,0,839,1220,2059,10,6,201843
15,20,74,14,162,265,19,33,15,582,628,1210,6,5,201843
15,21,77,8,95,174,11,21,0,386,342,728,6,5,201843
15,22,247,72,516,786,19,80,179,1899,2010,3909,14,6,201843
15,23,193,26,216,458,39,58,0,990,1137,2127,6,5.333333333,201843
15,24,134,35,262,279,29,49,24,812,798,1610,4,6,201843
15,25,135,24,272,266,18,44,20,779,913,1692,6,6,201843
15,26,112,11,238,261,40,26,4,692,702,1394,11,5.333333333,201843
15,27,138,21,250,410,9,59,72,959,1077,2036,9,4.333333333,201843
15,28,166,30,397,297,44,48,24,1006,1394,2400,9,4.666666667,201843
15,29,192,45,476,680,20,84,33,1530,1724,3254,8,6,201843
15,30,138,30,273,293,36,37,14,821,1070,1891,16,4.5,201843
15,31,114,63,231,432,11,45,9,905,876,1781,6,6,201843
15,32,157,15,263,403,29,42,11,920,1055,1975,9,6,201843
15,33,169,10,247,328,18,52,5,829,941,1770,7,6,201843
15,34,97,15,143,329,7,28,9,628,895,1523,8,5,201843
15,35,247,31,241,408,15,60,0,1002,895,1897,9,5.333333333,201843
15,36,192,17,224,258,61,46,0,798,1009,1807,9,5.5,201843
15,37,161,26,263,395,63,50,48,1006,1099,2105,7,6,201843
15,38,136,43,267,444,8,40,6,944,979,1923,6,5.5,201843
15,39,122,35,276,373,21,43,28,898,1134,2032,4,6,201843
15,40,136,11,169,215,58,41,1,631,897,1528,9,3.666666667,201843
15,41,225,30,450,503,32,50,25,1315,1381,2696,11,5.25,201843
16,1,140,32,221,299,9,43,2,746,821,1567,7,5.333333333,201843
16,2,121,39,159,260,20,22,0,621,479,1100,9,5.25,201843
16,3,161,23,163,239,29,37,20,672,900,1572,10,5.25,201843
16,4,144,36,269,227,33,51,1,761,601,1362,8,5,201843
16,5,153,44,217,212,31,62,43,762,752,1514,10,5.666666667,201843
16,6,153,45,171,239,44,29,0,681,593,1274,12,5.5,201843
16,7,221,24,269,216,53,42,0,825,728,1553,9,5.5,201843
16,8,222,36,492,458,5,61,8,1282,1407,2689,12,5,201843
16,9,176,27,280,305,13,75,9,885,892,1777,9,6,201843
16,10,167,23,352,386,14,37,6,985,797,1782,8,5.666666667,201843
16,11,204,40,227,232,164,59,12,938,952,1890,10,5.4,201843
16,12,178,31,220,153,40,41,6,669,608,1277,10,5.25,201843
17,1,161,23,350,473,20,43,10,1080,1021,2101,10,5.5,201843
17,2,151,14,373,400,17,35,14,1004,896,1900,8,5.666666667,201843
17,3,198,22,301,487,13,56,0,1077,1043,2120,8,5,201843
17,4,176,19,325,406,23,49,8,1006,932,1938,10,5,201843
17,5,88,11,151,197,18,30,1,496,508,1004,5,5.5,201843
18,1,123,34,177,114,191,31,14,684,583,1267,7,5.25,201843
18,2,197,63,485,325,54,40,2,1166,1164,2330,10,5.75,201843
18,3,158,30,473,229,8,29,2,929,840,1769,8,5.5,201843
19,1,153,34,342,478,26,69,37,1139,1199,2338,9,5,201843
19,2,261,35,829,423,48,79,1,1676,1757,3433,9,6,201843
19,3,218,29,559,477,31,76,5,1395,1613,3008,7,6,201843
19,4,99,31,175,149,83,43,266,846,899,1745,5,6,201843
19,5,235,49,452,591,29,73,91,1520,1822,3342,8,5,201843
19,6,90,17,255,548,6,46,32,994,1062,2056,5,6,201843
19,7,185,16,475,257,23,31,10,997,1004,2001,10,5,201843
19,8,41,4,110,132,2,29,0,318,372,690,7,5,201843
19,9,125,35,239,385,21,38,43,886,720,1606,9,5.25,201843
19,10,142,26,243,398,10,42,210,1071,984,2055,7,3,201843
19,11,322,71,593,1212,27,114,0,2339,2629,4968,13,5,201843
19,12,132,10,429,256,14,45,15,901,1039,1940,8,3.666666667,201843
20,1,185,37,268,244,44,48,48,874,1032,1906,7,5.5,201843
20,2,51,20,79,115,6,4,0,275,224,499,6,4.666666667,201843
20,3,111,10,92,204,77,20,4,518,381,899,6,4,201843
20,4,124,44,131,228,53,48,26,654,526,1180,6,4,201843
20,5,147,35,241,382,106,38,1,950,703,1653,11,5,201843
20,6,238,20,195,235,184,38,1,911,570,1481,8,4.5,201843
20,7,170,27,230,420,23,44,11,925,734,1659,8,5.75,201843
20,8,411,60,549,917,31,121,310,2399,2266,4665,15,5.666666667,201843
20,9,126,15,88,143,35,20,22,449,518,967,8,3.333333333,201843
20,10,256,18,205,487,26,41,0,1033,841,1874,9,5.25,201843
21,1,162,18,233,395,24,32,0,864,776,1640,10,5.4,201843
21,2,157,14,183,232,109,21,1,717,525,1242,10,5,201843
21,3,254,14,317,217,125,66,58,1051,1105,2156,9,5.5,201843
21,4,171,9,150,98,72,37,2,539,512,1051,8,5.25,201843
21,5,142,11,302,208,21,46,3,733,1043,1776,8,5,201843
21,6,165,26,318,452,38,67,141,1207,1105,2312,6,6,201843
21,7,201,16,191,241,58,40,0,747,804,1551,9,5,201843
21,8,169,15,276,248,136,37,15,896,861,1757,10,5.2,201843
21,9,158,36,417,455,45,59,103,1273,1227,2500,9,6,201843
21,10,140,19,333,217,31,42,68,850,1047,1897,7,5,201843
21,11,60,1,131,111,10,29,0,342,286,628,6,5.5,201843
21,12,280,30,668,796,58,92,79,2003,2181,4184,16,6,201843
21,13,163,13,237,246,42,36,3,740,954,1694,8,5,201843
21,14,125,5,184,119,75,33,28,569,525,1094,12,4.666666667,201843
21,15,208,17,423,236,67,39,46,1036,1074,2110,7,5,201843
22,1,191,55,230,319,41,29,18,883,791,1674,11,5.2,201843
22,2,170,33,440,269,37,40,39,1028,827,1855,7,5.5,201843
22,3,268,91,720,551,65,63,9,1767,1702,3469,9,5.333333333,201843
22,4,192,47,589,587,25,50,20,1510,1503,3013,11,6,201843
22,5,109,31,365,154,97,29,16,801,912,1713,10,5,201843
23,1,172,8,825,208,15,25,18,1271,1784,3055,14,4.4,201843
23,2,235,23,425,473,3,16,0,1175,683,1858,10,5,201843
23,3,213,10,710,420,20,32,0,1405,1688,3093,15,5,201843
23,4,252,12,646,342,40,37,3,1332,1356,2688,10,5.5,201843
24,1,163,82,171,190,42,26,1,675,744,1419,10,5.2,201843
24,2,91,22,166,214,13,34,0,540,653,1193,6,5,201843
24,3,193,48,194,362,144,35,3,979,726,1705,8,5,201843
24,4,188,48,217,239,70,49,187,998,736,1734,5,5.5,201843
24,5,201,54,441,547,10,65,0,1318,1490,2808,9,6,201843
24,6,190,76,392,375,35,50,8,1126,1427,2553,9,4,201843
24,7,233,42,286,425,65,26,0,1077,952,2029,9,5.25,201843
25,1,137,30,240,439,32,49,40,967,840,1807,13,5.5,201843
25,2,170,41,329,572,28,75,1,1216,1213,2429,7,5.5,201843
25,3,165,14,235,357,46,51,13,881,986,1867,8,5.6,201843
25,4,115,44,196,375,22,46,64,862,868,1730,8,5,201843
25,5,199,26,292,550,26,71,0,1164,1331,2495,10,4.25,201843
25,6,192,31,378,383,97,59,52,1192,1271,2463,8,5,201843
25,7,180,19,307,447,6,54,0,1013,1118,2131,6,5,201843
26,1,168,23,306,366,14,66,0,943,1113,2056,9,5.5,201843
26,2,207,17,423,373,5,70,0,1095,1316,2411,12,5.2,201843
26,3,299,36,509,792,15,119,38,1808,1407,3215,17,5.25,201843
26,4,136,28,208,332,37,53,29,823,883,1706,9,5.2,201843
26,5,94,13,120,165,22,33,2,449,555,1004,4,6,201843
26,6,170,23,337,574,18,84,0,1206,1160,2366,10,5.333333333,201843
26,7,122,8,177,272,23,45,0,647,608,1255,10,5.5,201843
27,1,161,14,288,450,39,30,0,982,743,1725,8,5.5,201843
27,2,254,29,288,483,7,38,1,1100,759,1859,8,5.666666667,201843
27,3,159,14,168,427,7,24,0,799,705,1504,7,5.666666667,201843
27,4,213,20,317,734,12,36,44,1376,1065,2441,10,5.25,201843
27,5,105,10,85,306,7,29,5,547,187,734,6,5.333333333,201843
27,6,188,23,200,500,25,30,0,966,771,1737,7,5.5,201843
28,1,191,16,300,303,4,28,0,842,970,1812,13,6,201843
28,2,243,42,534,407,36,48,146,1456,1298,2754,13,5.75,201843
28,3,127,14,182,269,8,25,0,625,776,1401,7,5,201843
28,4,284,44,456,330,47,64,203,1428,1409,2837,15,5,201843
28,5,216,39,266,539,18,50,11,1139,938,2077,11,5.2,201843
28,6,160,31,248,320,60,26,72,917,817,1734,13,5.166666667,201843
28,7,251,43,460,563,47,63,0,1427,1421,2848,6,6,201843
28,8,153,55,280,442,76,52,0,1058,851,1909,9,6,201843
28,9,145,21,282,177,28,29,76,758,750,1508,11,5.75,201843
29,1,214,36,338,392,67,36,1,1084,1030,2114,7,4.75,201843
29,2,167,23,218,407,43,48,86,992,1109,2101,13,6,201843
29,3,117,23,144,297,13,32,0,626,631,1257,5,5,201843
30,1,106,25,188,243,42,22,133,759,1047,1806,7,5,201843
30,2,94,32,216,77,91,18,389,917,882,1799,8,4.5,201843
30,3,157,32,374,127,170,52,251,1163,1253,2416,6,5,201843
30,4,93,6,205,221,29,22,0,576,625,1201,8,6,201843
30,5,113,23,149,346,8,42,0,681,766,1447,7,5,201843
30,6,107,18,180,270,16,29,0,620,678,1298,9,4,201843
30,7,172,33,284,341,87,63,60,1040,1212,2252,11,5.25,201843
30,8,160,33,345,407,94,61,50,1150,1168,2318,11,5.4,201843
30,9,189,23,235,163,97,53,167,927,984,1911,8,5.25,201843
30,10,170,28,343,357,43,61,105,1107,1310,2417,9,4.75,201843
30,11,119,19,282,443,9,53,0,925,1064,1989,5,4.5,201843
30,12,248,30,531,721,41,80,3,1654,1567,3221,10,6,201843
30,13,190,23,189,391,80,61,191,1125,1362,2487,10,5.4,201843
30,14,145,22,281,141,82,20,115,806,1285,2091,8,4,201843
30,15,157,9,197,197,55,51,140,806,1125,1931,11,5.333333333,201843
30,16,165,17,314,322,81,82,195,1176,1087,2263,10,5,201843
30,17,68,11,81,137,12,16,0,325,785,1110,8,4.25,201843
30,18,39,9,78,84,16,12,49,287,418,705,8,3.5,201843
30,19,98,7,123,190,27,17,6,468,811,1279,13,4.8,201843
30,20,144,19,150,316,79,36,0,744,963,1707,10,5.4,201843
31,1,98,14,155,336,28,25,0,656,772,1428,8,5,201843
31,2,94,16,177,23,402,29,0,741,540,1281,6,5.333333333,201843
31,3,360,56,1045,1012,120,118,0,2711,2698,5409,20,6,201843
31,4,73,14,226,206,165,36,29,749,858,1607,5,3,201843
31,5,141,25,142,574,37,34,0,953,1096,2049,5,5.333333333,201843
32,1,187,68,213,260,58,41,78,905,1019,1924,12,5.2,201843
32,2,195,97,254,145,235,50,132,1108,1159,2267,13,5,201843
32,3,146,77,209,355,25,31,16,859,853,1712,15,5.166666667,201843
32,4,166,139,275,393,38,61,51,1123,864,1987,13,5,201843
1,1,397,66,382,375,70,49,9,1348,1152,2500,13,5.5,201844
1,2,483,64,549,490,76,57,39,1758,1260,3018,10,6,201844
1,3,613,85,684,601,29,88,41,2141,1809,3950,12,6.25,201844
2,1,340,17,400,457,18,62,0,1294,1453,2747,11,6,201844
2,2,375,31,412,770,20,89,0,1697,1462,3159,9,5.666666667,201844
2,3,340,31,528,523,38,79,6,1545,1733,3278,12,6,201844
2,4,279,13,532,213,50,41,4,1132,1237,2369,9,6,201844
2,5,600,47,1102,722,127,120,16,2734,2199,4933,13,6.333333333,201844
2,6,265,19,600,394,24,64,0,1366,1427,2793,7,6,201844
2,7,407,28,656,515,20,72,23,1721,1630,3351,12,5.75,201844
2,8,347,14,587,459,9,70,0,1486,1616,3102,8,6,201844
3,1,132,11,337,377,21,72,11,961,979,1940,14,5.285714286,201844
3,2,129,6,413,209,10,23,0,790,866,1656,9,4.333333333,201844
4,1,211,30,317,547,49,41,0,1195,1076,2271,14,5.333333333,201844
4,2,245,27,504,457,43,39,21,1336,1372,2708,14,5.4,201844
5,1,237,30,473,439,44,57,20,1300,1302,2602,9,5.666666667,201844
5,2,139,26,271,398,35,32,14,915,741,1656,10,5.2,201844
5,3,146,28,303,428,47,53,78,1083,1009,2092,9,5.5,201844
5,4,204,58,578,498,21,102,103,1564,1430,2994,11,5.75,201844
5,5,253,33,534,731,24,57,40,1672,1291,2963,8,6,201844
5,6,78,16,220,202,20,19,44,599,710,1309,11,5,201844
5,7,175,23,322,368,9,47,15,959,928,1887,11,6,201844
6,1,150,35,342,324,27,50,101,1029,999,2028,13,5.833333333,201844
6,2,153,20,427,262,90,39,7,998,1032,2030,9,5.666666667,201844
7,1,295,23,229,485,7,70,46,1155,896,2051,9,5.25,201844
7,2,245,4,209,445,18,15,1,937,1360,2297,9,5.25,201844
7,3,232,5,178,321,143,38,14,931,1171,2102,7,5.333333333,201844
7,4,161,33,166,376,6,33,82,857,927,1784,11,5.4,201844
7,5,369,13,173,586,16,42,2,1201,1475,2676,11,5.666666667,201844
7,6,236,25,281,578,36,64,18,1238,802,2040,9,6,201844
7,7,234,31,357,570,39,54,0,1285,1135,2420,8,5.5,201844
7,8,286,22,211,544,9,53,0,1125,1178,2303,12,5.25,201844
7,9,191,34,339,562,37,70,20,1253,1167,2420,11,5.5,201844
7,10,188,35,212,813,7,36,0,1291,590,1881,9,5.5,201844
7,11,119,6,75,115,16,8,1,340,521,861,6,5.333333333,201844
7,12,237,16,296,579,9,38,0,1175,1141,2316,9,5.5,201844
7,13,138,24,171,474,2,35,0,844,543,1387,9,5.25,201844
8,1,180,21,540,285,25,43,25,1119,1004,2123,4,6,201844
8,2,289,35,681,451,55,82,30,1623,1252,2875,16,5.75,201844
8,3,239,22,482,572,28,63,21,1427,1236,2663,4,6,201844
8,4,205,47,539,401,42,83,159,1476,1174,2650,9,6,201844
8,5,201,46,347,422,41,66,0,1123,1015,2138,10,5.25,201844
8,6,209,51,472,570,91,94,109,1596,1518,3114,6,6,201844
8,7,233,56,274,430,25,80,0,1098,954,2052,7,5.25,201844
8,8,230,35,492,637,26,65,44,1529,1319,2848,12,6,201844
8,9,137,38,223,296,35,62,29,820,687,1507,10,5.2,201844
9,1,99,14,191,203,80,25,45,657,631,1288,5,6,201844
9,2,283,69,827,1259,107,113,156,2814,2727,5541,12,6,201844
9,3,117,34,443,524,65,74,146,1403,1393,2796,7,6,201844
9,4,194,40,485,667,74,57,21,1538,1440,2978,11,6,201844
9,5,156,32,439,570,45,69,27,1338,1118,2456,7,6,201844
9,6,121,30,281,250,106,48,55,891,815,1706,7,6,201844
9,7,99,18,348,573,4,41,5,1088,1011,2099,9,6,201844
9,8,88,9,326,310,27,44,97,901,833,1734,5,6,201844
9,9,118,15,251,391,54,35,34,898,860,1758,5,6,201844
9,10,91,24,342,455,32,57,10,1011,959,1970,6,6,201844
9,11,160,24,596,688,61,88,6,1623,1651,3274,7,7,201844
9,12,129,59,552,741,29,112,128,1750,1663,3413,11,6,201844
9,13,106,35,328,393,99,55,121,1137,1120,2257,4,6,201844
9,14,126,18,267,279,119,68,134,1011,789,1800,5,6,201844
9,15,173,57,958,1088,50,120,220,2666,2605,5271,11,5.5,201844
9,16,276,72,765,1017,93,124,17,2364,1914,4278,15,7,201844
9,17,154,23,350,443,24,56,8,1058,935,1993,6,6,201844
9,18,170,38,469,886,47,94,12,1716,1489,3205,12,6,201844
9,19,172,50,402,468,130,59,32,1313,1228,2541,5,6,201844
9,20,27,5,77,112,3,15,5,244,310,554,5,6,201844
9,21,82,11,194,284,28,28,24,651,624,1275,3,6,201844
9,22,139,16,276,274,130,45,86,966,992,1958,5,6,201844
9,23,127,36,351,533,62,65,57,1231,1237,2468,6,7,201844
9,24,280,46,771,1078,105,106,59,2445,2241,4686,12,6,201844
10,1,275,50,229,337,11,56,51,1009,632,1641,12,4.666666667,201844
10,2,312,38,402,411,32,56,104,1355,1351,2706,9,5.5,201844
10,3,190,63,235,382,33,57,49,1009,1094,2103,11,5.4,201844
10,4,560,51,469,594,16,62,1,1753,1503,3256,14,6.333333333,201844
11,1,225,55,229,283,58,48,30,928,948,1876,6,5.666666667,201844
11,2,210,44,322,311,40,40,20,987,1030,2017,7,6,201844
11,3,144,56,269,316,20,43,164,1012,856,1868,3,6,201844
11,4,201,51,244,328,20,22,0,866,601,1467,10,5.4,201844
11,5,288,102,502,623,23,84,30,1652,1561,3213,7,6.5,201844
11,6,116,39,228,234,37,34,45,733,826,1559,10,9,201844
11,7,241,43,275,347,13,35,0,954,1059,2013,9,5,201844
11,8,179,50,348,533,18,43,31,1202,1086,2288,9,5.75,201844
11,9,248,84,438,495,24,78,78,1445,1496,2941,10,5.666666667,201844
11,10,185,120,310,223,123,53,78,1092,1367,2459,10,5.6,201844
11,11,167,89,286,359,18,27,0,946,926,1872,5,6,201844
11,12,190,59,455,630,14,50,16,1414,1391,2805,7,6.5,201844
11,13,244,89,337,307,42,45,78,1142,1097,2239,8,5.5,201844
11,14,221,74,305,413,34,37,5,1089,1239,2328,8,5.5,201844
11,15,137,82,239,331,5,28,0,822,861,1683,9,6,201844
12,1,185,44,269,105,134,40,7,784,895,1679,10,5.2,201844
12,2,203,41,247,436,21,50,5,1003,1084,2087,10,5.5,201844
12,3,181,37,288,387,42,46,0,981,974,1955,11,5.2,201844
12,4,193,33,379,661,29,51,1,1347,1258,2605,9,6,201844
12,5,225,20,205,252,2,26,33,763,684,1447,10,5.25,201844
12,6,206,31,116,310,32,25,3,723,800,1523,10,5.25,201844
12,7,218,38,320,494,9,41,17,1137,864,2001,8,4,201844
12,8,203,22,252,310,6,29,0,822,875,1697,9,5.25,201844
12,9,182,35,257,454,11,31,8,978,1148,2126,9,5.666666667,201844
13,1,156,20,164,448,72,41,12,913,1061,1974,9,5.333333333,201844
13,2,136,27,147,333,83,38,4,768,721,1489,6,5.333333333,201844
13,3,129,19,175,272,122,41,0,758,714,1472,12,5.25,201844
13,4,227,30,307,322,78,45,42,1051,997,2048,9,5.666666667,201844
13,5,197,40,440,390,142,77,91,1377,1245,2622,9,5.75,201844
13,6,260,74,735,898,46,92,2,2107,2107,4214,13,5.75,201844
13,7,144,31,423,426,43,51,5,1123,1121,2244,8,5.25,201844
14,1,154,56,155,139,72,31,111,718,800,1518,6,5.5,201844
14,2,176,33,291,285,29,51,0,865,749,1614,5,5.666666667,201844
14,3,231,55,399,365,41,90,66,1247,1089,2336,8,5.2,201844
14,4,175,38,323,539,15,53,32,1175,999,2174,14,6,201844
14,5,191,28,436,325,61,46,13,1100,1169,2269,9,5.5,201844
14,6,199,31,628,373,43,47,10,1331,1136,2467,11,6,201844
14,7,139,14,228,193,0,23,0,597,612,1209,6,6,201844
14,8,341,85,1102,941,109,83,35,2696,1975,4671,13,5.666666667,201844
14,9,131,35,227,376,45,39,2,855,954,1809,12,7,201844
14,10,203,54,378,445,19,60,3,1162,1172,2334,7,6.5,201844
14,11,201,42,253,444,61,47,119,1167,998,2165,4,6,201844
14,12,241,17,477,207,13,44,3,1002,991,1993,9,5.5,201844
14,13,210,23,404,377,7,60,4,1085,930,2015,6,6,201844
14,14,123,694,33,41,4,17,13,925,889,1814,7,6,201844
14,15,219,68,251,324,62,58,22,1004,956,1960,10,5.6,201844
14,16,202,40,339,266,54,36,78,1015,914,1929,5,6,201844
14,17,176,59,234,222,41,52,65,849,633,1482,7,5.25,201844
14,18,264,45,364,345,68,51,82,1219,885,2104,9,5.4,201844
14,19,195,38,261,392,30,38,21,975,924,1899,8,5.25,201844
14,20,181,25,365,199,18,48,13,849,1005,1854,10,5.666666667,201844
15,1,201,49,288,248,454,47,12,1299,941,2240,7,5.333333333,201844
15,2,133,14,348,386,49,49,36,1015,855,1870,6,6,201844
15,3,271,58,342,535,230,79,63,1578,1357,2935,10,5.666666667,201844
15,4,187,34,300,469,49,71,52,1162,1127,2289,4,6,201844
15,5,157,25,285,373,26,46,16,928,831,1759,8,5.666666667,201844
15,6,160,25,378,608,40,39,42,1292,1178,2470,7,6.5,201844
15,7,140,20,298,525,41,47,19,1090,991,2081,10,6,201844
15,8,64,23,187,297,19,33,40,663,544,1207,4,6,201844
15,9,253,26,232,194,253,42,44,1044,1070,2114,9,5.75,201844
15,10,136,24,250,387,54,55,24,930,950,1880,6,6,201844
15,11,176,29,352,587,59,43,7,1253,947,2200,8,6,201844
15,12,220,27,582,539,28,49,11,1456,1460,2916,8,6,201844
15,13,64,17,141,265,77,27,0,591,590,1181,8,5,201844
15,14,91,25,181,347,24,34,0,702,514,1216,4,6,201844
15,15,174,73,325,604,34,69,0,1279,1280,2559,6,6,201844
15,16,222,39,390,723,15,65,8,1462,1410,2872,8,6,201844
15,17,110,30,189,268,22,35,217,871,946,1817,8,6,201844
15,18,217,46,379,589,32,63,36,1362,1223,2585,7,5.666666667,201844
15,19,222,119,480,1040,13,57,17,1948,1763,3711,10,6,201844
15,20,83,23,216,393,19,42,11,787,755,1542,6,6,201844
15,21,87,19,103,246,22,26,0,503,583,1086,6,5.5,201844
15,22,261,68,568,897,36,105,243,2178,1894,4072,14,6,201844
15,23,182,25,246,486,50,58,0,1047,951,1998,6,5.333333333,201844
15,24,131,26,262,351,32,31,14,847,796,1643,4,6,201844
15,25,191,37,327,321,31,48,36,991,996,1987,6,6,201844
15,26,113,10,247,309,40,41,2,762,876,1638,11,5.333333333,201844
15,27,226,48,377,625,15,81,115,1487,1445,2932,9,5.666666667,201844
15,28,258,42,584,478,95,63,64,1584,1229,2813,9,5.666666667,201844
15,29,197,43,459,723,23,87,12,1544,1387,2931,8,6,201844
15,30,218,31,373,492,47,44,20,1225,1225,2450,16,6,201844
15,31,183,57,317,537,9,63,4,1170,1043,2213,6,6,201844
15,32,168,18,280,442,33,36,12,989,976,1965,9,6,201844
15,33,181,11,300,470,12,48,6,1028,1007,2035,7,6,201844
15,34,157,20,221,460,12,47,50,967,859,1826,8,6,201844
15,35,280,36,287,467,31,73,0,1174,1022,2196,9,5.666666667,201844
15,36,298,31,304,381,107,53,0,1174,1290,2464,9,5.5,201844
15,37,161,31,320,493,49,50,91,1195,1157,2352,7,6,201844
15,38,144,45,309,472,9,38,0,1017,1031,2048,6,5.5,201844
15,39,154,28,275,326,22,32,31,868,877,1745,4,6,201844
15,40,302,35,428,581,131,90,5,1572,1458,3030,9,6,201844
15,41,254,42,605,610,48,67,71,1697,1625,3322,11,6,201844
16,1,135,26,232,206,17,36,3,655,608,1263,7,5.333333333,201844
16,2,133,38,210,306,25,34,0,746,887,1633,9,5.25,201844
16,3,176,39,215,292,26,45,21,814,775,1589,10,5.25,201844
16,4,181,50,337,226,38,59,0,891,1084,1975,8,5.5,201844
16,5,223,52,279,333,36,73,13,1009,1076,2085,10,5.666666667,201844
16,6,185,61,191,265,36,42,0,780,753,1533,12,5.5,201844
16,7,201,45,252,301,43,61,0,903,719,1622,9,5.5,201844
16,8,307,56,630,649,9,79,18,1748,1754,3502,12,6,201844
16,9,238,37,330,358,20,75,8,1066,1025,2091,9,6.5,201844
16,10,141,21,318,387,12,58,4,941,995,1936,8,5.666666667,201844
16,11,246,36,311,204,154,70,17,1038,927,1965,10,5.4,201844
16,12,184,31,254,190,24,42,9,734,684,1418,10,5.25,201844
17,1,179,30,410,507,50,58,28,1262,1197,2459,11,6.5,201844
17,2,137,16,346,399,12,33,13,956,958,1914,8,5.666666667,201844
17,3,214,36,440,602,9,72,0,1373,1145,2518,8,5.5,201844
17,4,201,30,365,504,17,63,6,1186,1160,2346,10,5.666666667,201844
17,5,88,17,106,176,18,22,0,427,588,1015,5,5.5,201844
18,1,158,16,137,198,39,29,4,581,712,1293,7,5.25,201844
18,2,221,50,423,479,62,58,1,1294,1208,2502,8,5,201844
18,3,143,35,399,271,10,38,3,899,1154,2053,8,5.75,201844
19,1,206,45,513,686,32,84,79,1645,1516,3161,9,6,201844
19,2,285,38,775,466,37,70,0,1671,1591,3262,9,6,201844
19,3,289,32,666,602,32,86,10,1717,1335,3052,7,6,201844
19,4,87,31,218,160,111,34,230,871,768,1639,5,6,201844
19,5,314,48,570,758,29,77,138,1934,1789,3723,8,6,201844
19,6,89,19,254,589,14,39,39,1043,806,1849,5,6,201844
19,7,174,30,544,406,25,42,1,1222,1459,2681,10,5.5,201844
19,8,45,8,125,136,1,18,0,333,325,658,7,6,201844
19,9,185,56,279,647,60,43,31,1301,1306,2607,9,5.25,201844
19,10,258,46,396,703,18,66,161,1648,1069,2717,7,3.666666667,201844
19,11,439,122,847,1848,41,155,0,3452,2732,6184,13,6.333333333,201844
19,12,180,21,454,294,20,45,21,1035,1056,2091,8,5.333333333,201844
20,1,161,21,214,224,59,41,30,750,906,1656,7,5.5,201844
20,2,148,23,163,341,20,25,0,720,652,1372,6,5.333333333,201844
20,3,116,20,182,226,65,37,32,678,1051,1729,6,5.333333333,201844
20,4,167,21,205,287,63,57,64,864,921,1785,6,5.333333333,201844
20,5,175,33,307,593,115,38,0,1261,951,2212,11,5.25,201844
20,6,216,16,163,307,290,52,0,1044,630,1674,8,5.25,201844
20,7,181,21,216,467,26,35,5,951,958,1909,8,5.75,201844
20,8,416,58,556,977,44,124,319,2494,2532,5026,15,5.333333333,201844
20,9,270,23,240,260,182,64,67,1106,1062,2168,8,5.666666667,201844
20,10,219,19,264,480,15,37,0,1034,1080,2114,9,5.25,201844
21,1,181,17,218,426,14,25,1,882,862,1744,10,5.4,201844
21,2,157,28,189,261,110,36,1,782,951,1733,10,5.2,201844
21,3,231,16,367,265,134,59,43,1115,1140,2255,9,5.5,201844
21,4,155,10,209,124,81,19,16,614,398,1012,8,5.25,201844
21,5,182,16,392,356,26,54,24,1050,1021,2071,8,5.666666667,201844
21,6,204,25,333,496,43,62,171,1334,1337,2671,6,6,201844
21,7,258,10,255,358,58,73,15,1027,889,1916,9,5.666666667,201844
21,8,215,13,385,214,117,54,8,1006,797,1803,10,5.2,201844
21,9,199,36,508,494,49,72,120,1478,1482,2960,9,6,201844
21,10,212,25,347,363,36,52,94,1129,1136,2265,7,6,201844
21,11,87,4,154,102,12,22,9,390,368,758,6,5.5,201844
21,12,378,52,835,1087,78,131,106,2667,2361,5028,16,7,201844
21,13,231,19,229,398,66,62,1,1006,1062,2068,8,5.666666667,201844
21,14,253,19,260,211,144,60,67,1014,891,1905,12,5.333333333,201844
21,15,246,29,387,355,55,59,35,1166,1096,2262,7,5.5,201844
22,1,205,73,239,359,59,29,14,978,1013,1991,11,5.2,201844
22,2,207,53,474,334,30,52,23,1173,847,2020,7,5.5,201844
22,3,257,58,847,635,53,73,17,1940,1927,3867,9,6,201844
22,4,214,58,666,642,43,55,28,1706,1588,3294,10,5.666666667,201844
22,5,127,36,451,236,158,42,17,1067,929,1996,10,5.5,201844
23,1,254,11,1201,345,24,38,34,1907,1721,3628,14,5.6,201844
23,2,262,30,345,517,9,31,0,1194,1099,2293,10,5.25,201844
23,3,305,15,950,498,27,46,1,1842,1908,3750,15,7,201844
23,4,188,10,894,364,28,34,1,1519,1422,2941,10,5.5,201844
24,1,129,35,200,298,37,24,3,726,618,1344,10,5.2,201844
24,2,141,57,230,268,31,49,0,776,771,1547,6,5.5,201844
24,3,184,39,196,356,201,31,2,1009,883,1892,9,5.25,201844
24,4,151,54,223,206,63,46,147,890,761,1651,5,5.5,201844
24,5,233,51,447,641,10,80,0,1462,1330,2792,9,6.333333333,201844
24,6,183,57,388,536,40,70,15,1289,1242,2531,9,5,201844
24,7,180,38,264,448,56,34,0,1020,1174,2194,9,5,201844
25,1,158,34,247,509,77,47,32,1104,884,1988,13,6,201844
25,2,95,10,171,320,9,30,0,635,862,1497,7,3.5,201844
25,3,165,21,263,341,45,45,22,902,907,1809,8,5.6,201844
25,4,160,40,178,325,24,32,96,855,891,1746,8,5.333333333,201844
25,5,149,22,217,456,24,51,0,919,948,1867,10,3.5,201844
25,6,167,26,411,417,102,56,27,1206,1095,2301,8,5.75,201844
25,7,156,17,254,435,7,50,0,919,892,1811,6,6,201844
26,1,182,17,284,373,13,49,0,918,1033,1951,9,5.5,201844
26,2,218,10,396,487,3,58,0,1172,1152,2324,12,5.4,201844
26,3,342,35,504,798,16,130,74,1899,1669,3568,17,5.25,201844
26,4,130,24,151,358,32,37,39,771,719,1490,9,5.2,201844
26,5,67,10,119,170,17,33,0,416,514,930,4,6,201844
26,6,139,22,348,463,15,44,0,1031,941,1972,10,5.333333333,201844
26,7,119,18,155,283,18,44,0,637,780,1417,10,5.5,201844
27,1,128,12,141,351,25,24,2,683,925,1608,8,5.5,201844
27,2,186,25,231,466,14,29,0,951,843,1794,8,5.666666667,201844
27,3,155,21,143,413,9,35,4,780,768,1548,7,5.666666667,201844
27,4,180,22,303,733,11,40,51,1340,1246,2586,10,5.25,201844
27,5,107,6,106,317,6,23,16,581,607,1188,6,5.333333333,201844
27,6,168,26,212,566,10,25,0,1007,1017,2024,7,5.5,201844
28,1,174,35,364,372,17,37,0,999,1083,2082,13,6,201844
28,2,264,45,522,423,45,62,206,1567,1618,3185,13,6,201844
28,3,168,41,227,414,19,32,0,901,644,1545,7,5.333333333,201844
28,4,313,49,501,474,59,71,210,1677,1483,3160,15,6,201844
28,5,176,45,330,607,29,47,48,1282,1200,2482,11,5.2,201844
28,6,160,36,220,294,70,33,108,921,871,1792,13,5.166666667,201844
28,7,211,45,429,583,74,49,0,1391,1340,2731,6,6,201844
28,8,144,44,324,389,74,49,27,1051,1008,2059,9,6,201844
28,9,192,30,339,228,22,25,92,928,850,1778,11,5.75,201844
29,1,206,29,372,426,72,42,0,1147,1229,2376,7,5.5,201844
29,2,214,36,241,578,32,54,140,1295,1066,2361,12,6,201844
29,3,109,23,171,305,26,39,0,673,756,1429,5,5.666666667,201844
30,1,92,41,167,348,74,23,167,912,781,1693,7,5.333333333,201844
30,2,160,38,240,102,70,38,417,1065,1409,2474,8,5.25,201844
30,3,185,25,415,167,200,54,256,1302,1062,2364,6,5.666666667,201844
30,4,118,13,277,298,32,36,0,774,653,1427,8,6,201844
30,5,144,31,189,427,5,38,0,834,831,1665,7,5.5,201844
30,6,168,20,251,330,36,27,0,832,786,1618,9,5.333333333,201844
30,7,159,19,260,260,55,44,60,857,1027,1884,11,5.25,201844
30,8,199,34,382,481,96,79,28,1299,1245,2544,11,5.4,201844
30,9,201,27,160,168,78,45,147,826,893,1719,8,5.5,201844
30,10,185,36,393,423,71,81,126,1315,1356,2671,9,5,201844
30,11,121,24,293,489,15,56,0,998,1167,2165,5,5.5,201844
30,12,230,26,572,889,41,91,4,1853,1805,3658,10,6.25,201844
30,13,175,16,209,304,80,32,148,964,1111,2075,10,5.4,201844
30,14,178,34,367,167,109,54,123,1032,1187,2219,8,5.5,201844
30,15,248,27,306,262,136,89,279,1347,1230,2577,11,5.666666667,201844
30,16,175,31,274,305,95,51,189,1120,1208,2328,10,5.333333333,201844
30,17,213,53,261,438,73,65,55,1158,1159,2317,8,5.5,201844
30,18,221,19,181,335,10,52,63,881,987,1868,8,5.25,201844
30,19,195,27,308,473,50,52,11,1116,921,2037,13,5.6,201844
30,20,198,24,210,465,123,54,0,1074,1049,2123,10,5.2,201844
31,1,199,28,229,384,22,32,0,894,723,1617,8,5.5,201844
31,2,90,49,221,46,398,39,0,843,564,1407,6,5.333333333,201844
31,3,356,71,1108,1026,132,111,11,2815,2624,5439,21,6.666666667,201844
31,4,107,15,345,161,125,40,129,922,784,1706,5,5.5,201844
31,5,157,23,174,486,24,44,0,908,851,1759,5,5.333333333,201844
32,1,172,60,273,212,58,29,100,904,946,1850,12,5.2,201844
32,2,140,93,249,128,185,51,114,960,1158,2118,13,5.142857143,201844
32,3,153,68,286,482,17,63,8,1077,1210,2287,15,5.5,201844
32,4,223,113,304,362,49,67,78,1196,1343,2539,12,5.2,201844
1,1,372,46,292,306,43,37,11,1107,1188,2295,13,5.5,201845
1,2,427,50,512,449,91,53,27,1609,1732,3341,10,6,201845
1,3,571,69,583,550,51,63,34,1921,1701,3622,11,6,201845
2,1,311,14,352,417,14,47,0,1155,862,2017,11,6,201845
2,2,348,37,365,645,18,76,0,1489,1454,2943,9,5.666666667,201845
2,3,369,39,562,499,19,83,15,1586,1703,3289,11,5.666666667,201845
2,4,287,9,538,220,45,31,1,1131,1120,2251,9,6,201845
2,5,564,42,1064,675,171,124,7,2647,2366,5013,13,6.333333333,201845
2,6,321,19,527,406,26,65,0,1364,1351,2715,7,6,201845
2,7,352,22,545,491,16,68,22,1516,1545,3061,12,5.75,201845
2,8,280,14,646,477,8,58,6,1489,1548,3037,8,6,201845
3,1,201,18,388,422,27,55,11,1122,870,1992,14,5.571428571,201845
3,2,166,15,531,263,6,29,0,1010,771,1781,8,4.333333333,201845
4,1,223,17,256,521,22,42,0,1081,1086,2167,14,5.166666667,201845
4,2,239,40,423,473,36,47,17,1275,1410,2685,14,5.4,201845
5,1,268,38,414,514,61,68,28,1391,1104,2495,9,5.666666667,201845
5,2,126,7,202,337,31,37,1,741,605,1346,10,5.2,201845
5,3,252,32,337,459,69,48,122,1319,1209,2528,9,5.5,201845
5,4,250,41,551,465,16,105,90,1518,1441,2959,11,5.75,201845
5,5,173,26,415,540,12,41,57,1264,1322,2586,8,6,201845
5,6,99,15,153,183,2,25,22,499,502,1001,11,5,201845
5,7,181,18,264,359,49,43,14,928,869,1797,11,6,201845
6,1,163,33,329,308,19,58,116,1026,939,1965,13,5.833333333,201845
6,2,149,16,382,208,90,50,20,915,976,1891,9,5.666666667,201845
7,1,270,17,164,382,5,37,10,885,885,1770,9,5.25,201845
7,2,305,10,131,686,12,28,2,1174,634,1808,9,5.25,201845
7,3,279,10,194,321,157,59,7,1027,1112,2139,7,5.333333333,201845
7,4,201,23,181,424,20,54,64,967,679,1646,11,5.4,201845
7,5,305,7,168,551,15,46,2,1094,1176,2270,11,5.666666667,201845
7,6,196,28,319,469,38,68,32,1150,1063,2213,9,6,201845
7,7,248,35,277,419,23,62,0,1064,1562,2626,8,5.5,201845
7,8,309,17,246,609,27,76,0,1284,1476,2760,12,5.25,201845
7,9,220,31,356,540,17,46,19,1229,1171,2400,11,5.5,201845
7,10,266,15,310,614,13,44,0,1262,522,1784,9,5.5,201845
7,11,72,6,45,121,8,10,0,262,450,712,6,5.333333333,201845
7,12,201,13,244,475,7,34,0,974,1130,2104,9,5.5,201845
7,13,202,30,167,417,0,42,0,858,1064,1922,9,5.25,201845
8,1,183,7,483,275,15,37,33,1033,1026,2059,4,6,201845
8,2,263,37,714,501,44,82,19,1660,1465,3125,16,5.75,201845
8,3,219,35,554,564,21,74,8,1475,1304,2779,4,6,201845
8,4,196,51,516,428,40,89,165,1485,1247,2732,9,6,201845
8,5,204,40,329,378,46,55,0,1052,1217,2269,10,5.25,201845
8,6,233,37,465,599,56,92,105,1587,1430,3017,6,6,201845
8,7,230,65,250,503,10,54,0,1112,930,2042,7,5.25,201845
8,8,241,53,447,591,14,53,21,1420,1340,2760,12,6,201845
8,9,170,36,277,368,58,54,10,973,762,1735,10,5,201845
9,1,99,13,201,185,90,46,37,671,585,1256,5,6,201845
9,2,292,69,937,1160,100,123,159,2840,2569,5409,12,6,201845
9,3,151,62,456,537,49,75,157,1487,1282,2769,7,6,201845
9,4,206,35,429,618,46,64,55,1453,1354,2807,11,6,201845
9,5,146,24,382,578,72,54,12,1268,1040,2308,7,6,201845
9,6,95,34,194,281,112,38,45,799,701,1500,7,6,201845
9,7,99,23,326,585,10,39,2,1084,898,1982,9,6,201845
9,8,102,17,299,333,23,66,96,936,800,1736,5,6,201845
9,9,123,10,231,334,49,39,22,808,813,1621,5,6,201845
9,10,100,26,373,489,22,29,0,1039,909,1948,6,6,201845
9,11,170,37,519,701,54,83,12,1576,1372,2948,7,7,201845
9,12,140,47,620,723,54,72,127,1783,1532,3315,11,6,201845
9,13,112,31,296,406,97,49,128,1119,929,2048,4,6,201845
9,14,96,17,206,211,89,36,101,756,642,1398,5,4,201845
9,15,184,45,987,1032,40,145,245,2678,2535,5213,11,5.5,201845
9,16,265,81,726,1009,105,112,13,2311,1818,4129,15,7,201845
9,17,141,24,331,451,18,61,17,1043,916,1959,6,6,201845
9,18,174,57,496,931,72,99,10,1839,1550,3389,12,6,201845
9,19,202,34,348,433,138,60,21,1236,1148,2384,5,6,201845
9,20,30,8,56,89,8,8,0,199,192,391,5,6,201845
9,21,112,12,191,289,34,25,21,684,599,1283,3,6,201845
9,22,148,18,272,315,81,48,89,971,888,1859,5,6,201845
9,23,131,22,401,574,60,49,56,1293,1123,2416,6,7,201845
9,24,333,56,742,1047,104,107,52,2441,2165,4606,12,6,201845
10,1,307,46,214,320,7,50,51,995,690,1685,10,4,201845
10,2,336,51,302,407,37,63,77,1273,1035,2308,9,5.5,201845
10,3,286,49,188,413,29,49,38,1052,1027,2079,11,5.4,201845
10,4,556,36,442,539,6,46,1,1626,1462,3088,14,6.333333333,201845
11,1,187,45,192,273,61,24,21,803,784,1587,6,5.666666667,201845
11,2,191,37,233,301,40,30,30,862,764,1626,7,6,201845
11,3,193,58,303,291,26,47,139,1057,844,1901,3,6,201845
11,4,170,33,183,263,4,35,0,688,533,1221,10,4.6,201845
11,5,282,87,476,656,22,80,24,1627,1316,2943,7,6.5,201845
11,6,126,40,245,234,28,47,41,761,736,1497,9,7,201845
11,7,243,52,244,388,24,39,0,990,854,1844,9,5.5,201845
11,8,205,49,308,539,21,38,25,1185,1092,2277,9,5.75,201845
11,9,242,79,396,506,17,63,31,1334,1300,2634,10,5.666666667,201845
11,10,215,87,335,372,46,41,91,1187,1020,2207,10,5.6,201845
11,11,200,83,282,348,18,36,0,967,668,1635,5,6,201845
11,12,222,61,442,523,7,35,9,1299,1259,2558,7,6.5,201845
11,13,188,92,295,335,38,33,79,1060,983,2043,8,5.5,201845
11,14,186,72,285,398,45,43,0,1029,810,1839,8,5.5,201845
11,15,128,69,236,315,4,47,1,800,740,1540,9,6,201845
12,1,175,40,313,127,73,36,10,774,743,1517,10,5,201845
12,2,203,43,263,390,18,50,12,979,1100,2079,10,5.5,201845
12,3,218,33,299,395,18,36,0,999,962,1961,11,5.2,201845
12,4,156,24,326,482,23,33,0,1044,1239,2283,9,6,201845
12,5,218,21,212,238,3,21,7,720,925,1645,10,5.25,201845
12,6,240,29,158,428,29,21,4,909,1005,1914,10,5.25,201845
12,7,228,18,292,465,6,49,7,1065,1112,2177,8,5,201845
12,8,264,17,275,305,3,26,0,890,802,1692,9,5.25,201845
12,9,187,25,244,429,10,30,7,932,949,1881,9,5.666666667,201845
13,1,203,21,181,401,85,34,24,949,1020,1969,9,5.333333333,201845
13,2,184,21,121,378,71,48,12,835,861,1696,6,5.333333333,201845
13,3,159,24,190,325,95,58,0,851,939,1790,12,5.25,201845
13,4,244,36,316,306,107,57,81,1147,948,2095,9,5.666666667,201845
13,5,210,29,574,341,131,75,96,1456,1322,2778,9,5.75,201845
13,6,267,79,778,951,83,79,1,2238,2004,4242,13,5.75,201845
13,7,162,47,421,468,43,39,9,1189,1086,2275,8,5.5,201845
14,1,123,43,163,161,60,35,93,678,728,1406,6,5.5,201845
14,2,180,30,264,289,37,45,0,845,747,1592,5,5.666666667,201845
14,3,251,54,402,390,52,70,52,1271,946,2217,8,5.4,201845
14,4,210,36,260,556,22,44,34,1162,1183,2345,10,6,201845
14,5,165,25,436,297,53,36,13,1025,1095,2120,9,5.5,201845
14,6,221,22,498,373,32,62,5,1213,1147,2360,11,6,201845
14,7,115,18,295,214,0,29,0,671,557,1228,6,6,201845
14,8,324,78,1016,896,71,77,27,2489,2227,4716,13,5.5,201845
14,9,119,26,201,349,44,28,4,771,867,1638,12,7,201845
14,10,176,39,361,424,6,52,9,1067,903,1970,5,6.5,201845
14,11,215,30,263,453,49,37,84,1131,1028,2159,4,6,201845
14,12,271,20,549,268,7,59,2,1176,909,2085,9,5.5,201845
14,13,193,23,401,398,25,58,19,1117,969,2086,6,6,201845
14,14,159,729,74,1,7,25,0,995,1020,2015,7,6,201845
14,15,231,63,233,373,42,70,24,1036,1049,2085,10,5.6,201845
14,16,175,36,331,265,79,43,80,1009,896,1905,5,6,201845
14,17,163,42,242,239,33,56,77,852,612,1464,7,5.25,201845
14,18,270,61,387,418,41,62,76,1315,1241,2556,9,5.4,201845
14,19,219,42,276,365,35,43,34,1014,875,1889,8,5.25,201845
14,20,182,28,329,187,20,34,16,796,697,1493,10,5.666666667,201845
15,1,185,45,310,164,463,44,7,1218,1041,2259,7,5.333333333,201845
15,2,159,18,269,384,41,46,45,962,881,1843,6,6,201845
15,3,288,54,270,470,284,73,74,1513,1434,2947,10,5.666666667,201845
15,4,170,35,313,465,47,54,60,1144,981,2125,4,6,201845
15,5,181,30,323,385,11,50,27,1007,889,1896,8,5.666666667,201845
15,6,147,29,356,547,64,46,52,1241,1134,2375,7,6.5,201845
15,7,125,37,295,499,43,45,33,1077,1023,2100,10,6,201845
15,8,67,24,148,295,28,33,32,627,573,1200,4,6,201845
15,9,278,30,220,177,221,34,55,1015,851,1866,9,5.75,201845
15,10,129,28,243,350,74,47,33,904,799,1703,6,6,201845
15,11,200,35,327,533,65,50,34,1244,1476,2720,8,6,201845
15,12,196,23,563,500,33,50,8,1373,1323,2696,8,6,201845
15,13,83,36,204,300,119,36,0,778,724,1502,8,6,201845
15,14,80,26,172,320,24,41,1,664,583,1247,4,6,201845
15,15,140,56,335,586,32,67,4,1220,977,2197,6,6,201845
15,16,188,44,401,653,10,62,17,1375,1272,2647,8,6,201845
15,17,109,22,179,264,15,51,190,830,822,1652,8,6,201845
15,18,245,37,366,620,44,62,34,1408,1248,2656,7,5.666666667,201845
15,19,204,109,472,983,21,46,16,1851,1175,3026,10,6,201845
15,20,78,14,199,366,28,44,15,744,717,1461,6,6,201845
15,21,79,8,91,255,14,35,0,482,472,954,6,5.5,201845
15,22,269,63,536,874,36,107,245,2130,1943,4073,14,6,201845
15,23,222,40,250,521,38,73,0,1144,1009,2153,6,5.333333333,201845
15,24,116,32,226,316,24,37,13,764,763,1527,4,6,201845
15,25,198,32,361,380,20,55,39,1085,886,1971,6,6,201845
15,26,157,8,318,370,50,52,3,958,736,1694,11,5.333333333,201845
15,27,191,36,375,597,13,67,106,1385,1264,2649,9,5.666666667,201845
15,28,245,42,561,421,79,63,62,1473,1271,2744,9,5.666666667,201845
15,29,231,48,381,748,20,87,1,1516,1426,2942,8,6,201845
15,30,225,28,426,439,39,47,13,1217,1115,2332,16,6,201845
15,31,177,65,336,555,7,44,0,1184,941,2125,6,6,201845
15,32,159,19,265,422,23,55,9,952,925,1877,9,6,201845
15,33,160,17,292,409,13,55,12,958,943,1901,7,6,201845
15,34,111,14,203,391,14,41,67,841,788,1629,8,6,201845
15,35,296,28,268,473,25,57,0,1147,1171,2318,9,5.666666667,201845
15,36,229,22,289,342,112,42,4,1040,1043,2083,9,5.5,201845
15,37,162,31,318,491,53,64,59,1178,1066,2244,7,6,201845
15,38,183,38,281,499,5,46,0,1052,1034,2086,6,5.5,201845
15,39,131,30,277,369,27,29,13,876,851,1727,4,6,201845
15,40,290,38,391,494,103,85,3,1404,1222,2626,9,6,201845
15,41,216,33,582,546,40,57,43,1517,1483,3000,11,6,201845
16,1,139,18,256,172,23,29,0,637,659,1296,7,5.333333333,201845
16,2,133,46,171,226,40,49,0,665,630,1295,9,5.25,201845
16,3,206,39,256,307,32,41,36,917,722,1639,10,5.25,201845
16,4,208,49,373,263,42,62,0,997,762,1759,8,5.5,201845
16,5,213,44,255,276,41,61,36,926,778,1704,10,5.666666667,201845
16,6,191,49,256,279,41,28,0,844,672,1516,12,5.5,201845
16,7,187,41,213,216,35,51,0,743,661,1404,9,5.5,201845
16,8,263,48,612,586,10,73,23,1615,1450,3065,12,6,201845
16,9,259,39,330,330,21,53,8,1040,928,1968,9,6.5,201845
16,10,140,25,284,357,10,48,2,866,1000,1866,8,5.666666667,201845
16,11,266,26,311,218,127,56,19,1023,785,1808,10,5.4,201845
16,12,227,26,257,206,46,42,4,808,876,1684,10,5.25,201845
17,1,193,30,416,598,46,74,22,1379,1092,2471,10,6,201845
17,2,148,19,371,419,19,46,16,1038,973,2011,8,5.666666667,201845
17,3,251,25,378,523,9,57,0,1243,1337,2580,8,5.5,201845
17,4,242,42,399,489,16,50,15,1253,1099,2352,10,5.666666667,201845
17,5,83,11,147,183,11,18,4,457,490,947,5,5.5,201845
18,1,155,23,162,225,30,37,11,643,724,1367,7,5.25,201845
18,2,218,56,399,478,62,50,0,1263,1236,2499,10,6.25,201845
18,3,162,38,387,341,14,44,0,986,1070,2056,8,5.75,201845
19,1,203,38,424,668,36,81,35,1485,1220,2705,9,6,201845
19,2,266,29,690,472,45,64,0,1566,1596,3162,9,6,201845
19,3,309,33,640,554,20,72,22,1650,1479,3129,7,6,201845
19,4,81,32,190,143,116,46,208,816,784,1600,5,6,201845
19,5,271,55,482,676,20,68,171,1743,1765,3508,8,6,201845
19,6,83,11,227,522,4,43,3,893,940,1833,5,6,201845
19,7,176,14,496,228,19,13,7,953,927,1880,10,5.25,201845
19,8,45,2,110,98,1,13,0,269,327,596,7,6,201845
19,9,185,19,311,402,48,40,35,1040,937,1977,9,5.25,201845
19,10,192,19,328,385,12,83,305,1324,1232,2556,7,3.666666667,201845
19,11,404,101,752,1631,47,152,0,3087,2862,5949,13,6.333333333,201845
19,12,175,13,578,307,14,37,16,1140,1002,2142,8,5.666666667,201845
20,1,212,25,194,211,38,43,32,755,869,1624,7,5.5,201845
20,2,147,42,149,295,28,37,0,698,379,1077,6,5.333333333,201845
20,3,118,14,147,159,140,28,16,622,520,1142,6,5.333333333,201845
20,4,122,26,118,258,53,36,18,631,534,1165,6,5.333333333,201845
20,5,126,17,206,436,40,32,0,857,935,1792,11,5.25,201845
20,6,191,9,130,231,173,26,0,760,924,1684,8,5.25,201845
20,7,184,25,163,366,14,46,4,802,764,1566,8,5.75,201845
20,8,480,38,571,957,41,148,285,2520,2304,4824,15,6,201845
20,9,328,28,228,313,135,61,95,1188,860,2048,8,5.666666667,201845
20,10,329,20,253,509,36,49,0,1196,1064,2260,9,5.25,201845
21,1,192,18,262,455,11,45,0,983,880,1863,10,5.4,201845
21,2,142,24,219,217,134,36,2,774,939,1713,10,5.2,201845
21,3,237,23,354,249,109,44,40,1056,1062,2118,9,5.5,201845
21,4,167,16,96,110,164,32,10,595,698,1293,8,5.25,201845
21,5,177,17,277,350,18,57,11,907,826,1733,8,5.666666667,201845
21,6,175,16,289,454,39,67,187,1227,1233,2460,6,6,201845
21,7,259,16,267,350,58,49,14,1013,849,1862,9,5.666666667,201845
21,8,151,8,334,186,34,46,0,759,1033,1792,10,5.2,201845
21,9,213,20,462,485,52,74,80,1386,1267,2653,9,6,201845
21,10,183,21,392,410,30,53,118,1207,1008,2215,7,5.5,201845
21,11,82,1,155,100,34,13,3,388,286,674,6,5.5,201845
21,12,381,34,858,1037,57,111,144,2622,2252,4874,15,6.5,201845
21,13,224,17,264,366,42,62,7,982,918,1900,8,5.666666667,201845
21,14,230,20,202,223,77,58,118,928,883,1811,12,5.333333333,201845
21,15,235,20,401,323,52,50,29,1110,1225,2335,7,5.5,201845
22,1,224,69,312,407,40,29,10,1091,973,2064,11,5.2,201845
22,2,167,33,444,270,26,44,33,1017,1016,2033,7,5.5,201845
22,3,309,63,776,622,59,67,16,1912,1752,3664,9,6,201845
22,4,225,67,618,585,30,70,25,1620,1417,3037,10,5.666666667,201845
22,5,133,27,390,188,92,30,13,873,856,1729,10,5.5,201845
23,1,293,11,1392,306,20,30,38,2090,1914,4004,14,5.6,201845
23,2,257,24,368,339,14,27,0,1029,1502,2531,10,5.25,201845
23,3,261,5,836,461,27,39,1,1630,1739,3369,15,7,201845
23,4,192,17,664,395,19,33,8,1328,1408,2736,10,5.5,201845
24,1,153,41,184,319,50,17,7,771,847,1618,10,5.2,201845
24,2,115,33,223,241,12,38,2,664,539,1203,6,5.5,201845
24,3,173,49,230,347,209,32,3,1043,1167,2210,9,5.25,201845
24,4,161,61,226,217,53,52,187,957,980,1937,5,5.5,201845
24,5,229,43,477,672,9,63,0,1493,1366,2859,9,6.333333333,201845
24,6,208,53,377,510,39,68,18,1273,1171,2444,9,5.5,201845
24,7,190,35,316,474,90,21,0,1126,1206,2332,9,5.25,201845
25,1,127,23,243,345,19,37,50,844,892,1736,13,6,201845
25,2,179,43,286,518,29,44,0,1099,1223,2322,7,5.5,201845
25,3,183,16,279,399,43,31,22,973,925,1898,8,5.6,201845
25,4,141,29,155,322,41,37,90,815,725,1540,8,5.333333333,201845
25,5,169,21,283,678,16,60,7,1234,1361,2595,8,4.25,201845
25,6,222,33,403,476,111,74,32,1351,1395,2746,8,5.75,201845
25,7,175,14,260,522,9,63,0,1043,1195,2238,6,6,201845
26,1,210,25,351,369,12,62,0,1029,951,1980,9,5.5,201845
26,2,240,18,410,513,3,72,0,1256,1172,2428,12,5.4,201845
26,3,381,29,522,811,13,139,67,1962,1903,3865,17,5.75,201845
26,4,114,30,185,333,35,68,21,786,826,1612,9,5.2,201845
26,5,98,11,122,215,13,30,1,490,443,933,4,6,201845
26,6,216,25,360,542,21,47,0,1211,1268,2479,10,5.333333333,201845
26,7,168,10,178,293,18,39,0,706,652,1358,10,5.5,201845
27,1,148,20,174,378,25,32,0,777,804,1581,8,5.5,201845
27,2,238,24,254,465,20,38,1,1040,856,1896,8,5.666666667,201845
27,3,221,10,155,344,10,23,2,765,800,1565,7,5.666666667,201845
27,4,228,22,253,646,13,39,55,1256,1298,2554,10,5.25,201845
27,5,101,6,95,259,3,18,1,483,526,1009,6,5.333333333,201845
27,6,169,24,232,486,6,33,0,950,922,1872,7,5.5,201845
28,1,249,26,435,463,14,32,0,1219,910,2129,13,6,201845
28,2,281,51,553,427,42,68,179,1601,1465,3066,13,6,201845
28,3,152,20,222,389,11,28,1,823,839,1662,7,5.333333333,201845
28,4,272,38,450,398,47,52,223,1480,1424,2904,15,6,201845
28,5,282,39,232,446,33,54,53,1139,1089,2228,11,5.2,201845
28,6,163,20,221,333,35,26,45,843,854,1697,13,5.166666667,201845
28,7,227,37,503,549,83,53,0,1452,1406,2858,6,6,201845
28,8,176,43,266,434,63,31,20,1033,966,1999,9,6,201845
28,9,179,16,330,234,14,36,103,912,836,1748,11,5.75,201845
29,1,192,53,368,452,75,40,0,1180,1185,2365,7,5.5,201845
29,2,184,35,217,465,40,42,84,1067,1250,2317,12,6,201845
29,3,120,34,142,356,20,39,0,711,680,1391,5,5.666666667,201845
30,1,129,28,157,344,89,33,62,842,900,1742,7,5.333333333,201845
30,2,150,31,255,111,91,32,502,1172,1082,2254,8,5.25,201845
30,3,190,40,389,196,277,50,307,1449,1296,2745,6,5.666666667,201845
30,4,103,6,227,241,47,31,0,655,692,1347,8,6,201845
30,5,151,34,191,480,21,56,0,933,790,1723,7,5.5,201845
30,6,200,24,248,363,53,43,0,931,800,1731,9,5.333333333,201845
30,7,206,38,422,364,54,52,52,1188,1068,2256,11,5.25,201845
30,8,201,33,386,405,115,52,83,1275,1303,2578,11,5.4,201845
30,9,189,25,238,163,99,62,172,948,886,1834,8,5.5,201845
30,10,194,18,349,414,35,65,107,1182,1305,2487,9,5.25,201845
30,11,176,51,363,627,23,63,0,1303,992,2295,5,5.5,201845
30,12,219,23,472,730,29,72,3,1548,1721,3269,10,6.25,201845
30,13,204,14,211,335,69,49,216,1098,1139,2237,10,5.4,201845
30,14,175,44,283,158,101,60,179,1000,875,1875,8,5.5,201845
30,15,244,31,277,294,83,96,254,1279,1057,2336,11,5.666666667,201845
30,16,165,16,287,339,100,56,134,1097,1192,2289,10,5.333333333,201845
30,17,225,37,288,394,127,66,57,1194,782,1976,8,5.5,201845
30,18,190,21,139,338,19,37,54,798,690,1488,8,5.25,201845
30,19,198,19,296,427,27,60,11,1038,863,1901,13,5.6,201845
30,20,183,26,216,421,124,43,0,1013,1017,2030,10,5.4,201845
31,1,196,23,220,424,16,42,0,921,853,1774,8,5.5,201845
31,2,87,20,154,31,408,9,0,709,627,1336,6,5.333333333,201845
31,3,370,62,1089,1032,107,101,2,2763,2676,5439,20,6.333333333,201845
31,4,104,13,283,202,103,38,177,920,809,1729,5,5.5,201845
31,5,152,28,152,562,30,32,0,956,878,1834,5,5.333333333,201845
32,1,196,66,247,239,50,42,82,922,915,1837,12,5.2,201845
32,2,200,97,297,168,250,44,171,1227,1189,2416,14,5.142857143,201845
32,3,192,57,281,415,17,55,6,1023,939,1962,15,5.333333333,201845
32,4,183,130,291,349,32,58,63,1106,1275,2381,12,5.2,201845
1,1,312,54,275,290,74,38,12,1055,1095,2150,13,5.5,201846
1,2,431,59,563,456,80,59,28,1676,1557,3233,10,6,201846
1,3,329,73,611,569,41,63,28,1714,1999,3713,11,6,201846
2,1,236,14,352,398,16,60,2,1078,957,2035,11,6,201846
2,2,274,30,274,612,16,77,0,1283,1716,2999,9,5.666666667,201846
2,3,341,31,514,446,19,85,0,1436,1492,2928,11,5.666666667,201846
2,4,298,16,494,213,37,39,7,1104,1070,2174,9,6,201846
2,5,599,51,1063,664,198,120,28,2723,2534,5257,13,6.333333333,201846
2,6,289,20,532,379,32,35,0,1287,1250,2537,7,6,201846
2,7,346,18,543,465,19,64,1,1456,1504,2960,12,5.75,201846
2,8,311,15,648,504,12,72,2,1564,1436,3000,8,6,201846
3,1,181,24,320,439,32,79,17,1092,1046,2138,14,5.428571429,201846
3,2,148,12,492,255,13,21,0,941,951,1892,9,4.666666667,201846
4,1,192,28,286,555,49,39,0,1149,1160,2309,14,5.166666667,201846
4,2,225,28,446,443,29,31,8,1210,1052,2262,14,5.4,201846
5,1,240,23,404,369,65,52,33,1186,1143,2329,9,5.666666667,201846
5,2,183,20,305,359,37,34,0,938,758,1696,10,5.2,201846
5,3,195,25,248,344,38,50,69,969,986,1955,9,5.5,201846
5,4,251,29,550,474,21,90,57,1472,1568,3040,11,5.75,201846
5,5,268,28,446,635,18,64,34,1493,1617,3110,8,6,201846
5,6,107,13,257,240,20,21,42,700,797,1497,11,5.5,201846
5,7,158,26,251,370,15,30,17,867,1051,1918,10,5.5,201846
6,1,146,28,294,316,23,50,73,930,1050,1980,14,6,201846
6,2,165,35,349,233,77,46,29,934,1032,1966,9,5.666666667,201846
7,1,286,16,196,429,16,30,12,985,564,1549,11,5.25,201846
7,2,317,9,170,549,42,52,0,1139,538,1677,12,5.25,201846
7,3,230,10,246,611,272,29,9,1407,995,2402,9,5.333333333,201846
7,4,206,28,200,444,35,57,112,1082,751,1833,13,5.4,201846
7,5,315,18,197,608,27,31,6,1202,1069,2271,11,5.666666667,201846
7,6,237,21,323,530,32,62,25,1230,1042,2272,11,6,201846
7,7,237,34,320,455,16,63,0,1125,1004,2129,8,5.5,201846
7,8,258,10,195,573,9,46,0,1091,1021,2112,12,5.25,201846
7,9,234,27,348,588,35,48,11,1291,1165,2456,11,5.5,201846
7,10,186,13,228,465,34,26,0,952,1244,2196,10,5.5,201846
7,11,144,5,95,107,17,11,2,381,478,859,6,5.333333333,201846
7,12,229,14,268,534,6,30,0,1081,1221,2302,9,5.5,201846
7,13,100,23,111,378,5,19,0,636,372,1008,9,5,201846
8,1,203,13,511,283,15,30,22,1077,1038,2115,4,6,201846
8,2,273,34,640,449,24,69,39,1528,1640,3168,16,5.75,201846
8,3,242,32,539,501,26,65,12,1417,1524,2941,4,6,201846
8,4,221,39,521,400,27,68,156,1432,1113,2545,9,6,201846
8,5,197,55,340,394,40,58,0,1084,956,2040,10,5.25,201846
8,6,244,53,467,549,72,81,102,1568,1563,3131,7,6.5,201846
8,7,184,41,300,442,12,42,0,1021,1045,2066,7,5.25,201846
8,8,215,48,374,552,21,42,31,1283,1551,2834,12,6,201846
8,9,200,58,234,410,54,60,6,1022,982,2004,10,5.2,201846
9,1,88,26,189,205,99,39,43,689,648,1337,5,6,201846
9,2,304,90,800,1265,101,113,126,2799,2768,5567,12,6,201846
9,3,136,56,422,528,61,58,169,1430,1435,2865,7,6,201846
9,4,190,26,459,593,86,64,67,1485,1482,2967,11,6,201846
9,5,132,28,387,546,59,63,18,1233,1262,2495,7,6,201846
9,6,115,34,274,288,99,53,72,935,847,1782,7,6,201846
9,7,106,20,317,506,9,35,7,1000,1074,2074,9,6,201846
9,8,79,20,326,292,34,51,87,889,905,1794,5,6,201846
9,9,129,16,259,321,54,38,25,842,826,1668,5,6,201846
9,10,105,21,328,523,25,48,0,1050,1001,2051,6,6,201846
9,11,161,28,460,695,64,88,22,1518,1634,3152,7,7,201846
9,12,140,44,652,723,31,84,122,1796,1690,3486,11,6,201846
9,13,115,25,302,396,89,38,110,1075,1151,2226,4,6,201846
9,14,65,10,160,138,78,35,125,611,526,1137,5,5,201846
9,15,213,47,941,1071,36,107,258,2673,2617,5290,11,5.5,201846
9,16,277,80,761,979,103,107,6,2313,2227,4540,15,7,201846
9,17,134,24,331,456,41,47,11,1044,948,1992,6,6,201846
9,18,179,33,420,872,45,69,16,1634,1703,3337,12,6,201846
9,19,160,54,380,511,123,78,22,1328,1274,2602,5,6,201846
9,20,31,9,61,91,10,11,8,221,189,410,5,6,201846
9,21,87,7,191,247,28,30,20,610,627,1237,3,6,201846
9,22,129,24,253,307,88,57,50,908,981,1889,5,6,201846
9,23,130,29,362,571,94,49,89,1324,1148,2472,6,7,201846
9,24,264,61,665,1076,129,119,74,2388,2291,4679,12,6,201846
10,1,282,46,248,293,23,44,58,994,860,1854,12,4.5,201846
10,2,335,45,393,387,42,51,104,1357,1430,2787,9,5.5,201846
10,3,218,44,202,311,24,29,25,853,934,1787,11,5.4,201846
10,4,531,41,383,596,11,74,2,1638,1567,3205,14,6.333333333,201846
11,1,235,47,200,303,32,45,31,893,866,1759,6,5.666666667,201846
11,2,201,30,280,277,30,39,23,880,915,1795,7,6,201846
11,3,161,60,289,305,26,52,123,1016,987,2003,3,6,201846
11,4,202,50,251,345,22,38,2,910,908,1818,10,5.2,201846
11,5,282,90,419,683,23,78,33,1608,1615,3223,7,6.5,201846
11,6,125,34,253,237,28,35,43,755,741,1496,9,7,201846
11,7,249,41,319,350,18,34,0,1011,949,1960,9,5.5,201846
11,8,173,45,306,502,23,43,36,1128,1097,2225,9,5.75,201846
11,9,248,79,348,491,10,57,64,1297,1440,2737,10,5.666666667,201846
11,10,199,89,278,369,49,42,95,1121,1193,2314,10,5.6,201846
11,11,185,85,246,362,22,40,0,940,760,1700,5,6,201846
11,12,210,61,439,583,11,49,9,1362,1312,2674,7,6.5,201846
11,13,186,74,241,264,41,42,111,959,1035,1994,8,5.5,201846
11,14,193,70,317,489,50,42,0,1161,1035,2196,8,5.5,201846
11,15,147,40,232,280,2,32,2,735,813,1548,9,6,201846
12,1,133,42,287,129,111,25,4,731,758,1489,10,5.2,201846
12,2,234,54,289,526,27,44,34,1208,963,2171,10,5.5,201846
12,3,190,30,306,392,81,42,0,1041,779,1820,11,5.2,201846
12,4,169,42,335,579,25,36,1,1187,1149,2336,9,5.666666667,201846
12,5,167,21,164,258,2,30,54,696,717,1413,10,5.25,201846
12,6,262,24,278,553,53,26,0,1196,671,1867,10,5.25,201846
12,7,241,25,305,424,13,43,20,1071,976,2047,8,4.666666667,201846
12,8,249,42,286,369,7,39,0,992,936,1928,9,5.25,201846
12,9,208,26,281,540,14,45,8,1122,966,2088,9,5.666666667,201846
13,1,191,25,140,425,54,43,5,883,939,1822,9,5.333333333,201846
13,2,156,37,121,427,80,47,27,895,843,1738,6,5.333333333,201846
13,3,194,30,211,366,133,59,0,993,742,1735,12,5.25,201846
13,4,211,26,314,278,83,55,45,1012,1039,2051,9,5.666666667,201846
13,5,213,39,494,385,128,76,84,1419,1303,2722,9,5.75,201846
13,6,250,59,715,917,58,80,5,2084,2026,4110,13,5.75,201846
13,7,149,35,472,366,31,37,1,1091,1132,2223,8,5.5,201846
14,1,142,42,159,191,76,37,119,766,639,1405,7,5.5,201846
14,2,206,26,300,246,41,61,10,890,837,1727,5,5.666666667,201846
14,3,268,54,388,268,49,85,63,1175,1191,2366,8,5.2,201846
14,4,196,39,268,536,22,59,29,1149,1150,2299,10,6,201846
14,5,192,22,478,329,41,48,7,1117,1005,2122,9,5.5,201846
14,6,188,27,497,351,49,54,13,1179,1301,2480,11,6,201846
14,7,119,8,253,179,0,28,0,587,641,1228,6,6,201846
14,8,387,72,818,1381,38,96,66,2858,2453,5311,13,5.666666667,201846
14,9,111,23,221,324,35,34,5,753,853,1606,9,7,201846
14,10,189,24,405,507,15,50,5,1195,1116,2311,5,6.5,201846
14,11,165,34,221,485,39,45,58,1047,1108,2155,4,6,201846
14,12,240,18,504,239,8,41,3,1053,1016,2069,9,5.5,201846
14,13,219,25,416,363,19,51,11,1104,1123,2227,6,6,201846
14,14,162,173,240,442,7,56,22,1102,421,1523,7,6,201846
14,15,225,72,255,300,61,52,22,987,1036,2023,10,5.6,201846
14,16,159,30,321,255,86,43,63,957,1017,1974,5,6,201846
14,17,166,34,185,244,36,35,45,745,472,1217,7,5.25,201846
14,18,245,77,324,415,31,42,124,1258,1019,2277,9,5.4,201846
14,19,225,27,264,415,31,45,14,1021,970,1991,8,5.25,201846
14,20,160,18,285,205,21,36,14,739,867,1606,10,5.666666667,201846
15,1,148,39,298,184,426,40,13,1148,1196,2344,7,5.333333333,201846
15,2,162,15,291,398,50,43,36,995,984,1979,6,6,201846
15,3,250,61,243,464,261,59,53,1391,1417,2808,10,5.666666667,201846
15,4,214,40,294,471,60,69,95,1243,1118,2361,4,6,201846
15,5,149,42,271,382,27,39,34,944,889,1833,8,5.666666667,201846
15,6,160,32,299,578,65,50,34,1218,1280,2498,7,6.5,201846
15,7,135,30,293,504,51,36,43,1092,1045,2137,10,6,201846
15,8,90,18,175,303,22,26,38,672,614,1286,4,6,201846
15,9,284,16,251,224,306,29,44,1154,1064,2218,9,5.75,201846
15,10,128,19,283,359,50,36,28,903,858,1761,6,6,201846
15,11,199,33,306,576,58,58,13,1243,1201,2444,8,6,201846
15,12,240,21,557,541,26,51,7,1443,1471,2914,8,6,201846
15,13,97,27,220,335,166,43,0,888,644,1532,8,6,201846
15,14,82,24,184,288,21,44,0,643,619,1262,4,6,201846
15,15,140,76,341,587,40,54,19,1257,1179,2436,6,6,201846
15,16,240,28,369,675,12,55,5,1384,1408,2792,8,6,201846
15,17,99,39,168,297,18,50,187,858,867,1725,8,6,201846
15,18,222,32,312,518,36,50,48,1218,1290,2508,7,5.666666667,201846
15,19,220,88,461,1007,16,52,27,1871,2082,3953,10,6,201846
15,20,103,22,215,371,34,31,17,793,755,1548,6,6,201846
15,21,115,16,111,241,28,38,6,555,501,1056,6,5.5,201846
15,22,246,65,535,943,39,90,288,2206,2068,4274,14,6,201846
15,23,150,22,261,471,29,41,0,974,994,1968,6,5.333333333,201846
15,24,126,20,222,364,33,34,8,807,811,1618,4,6,201846
15,25,194,23,321,352,29,47,48,1014,1036,2050,6,6,201846
15,26,150,10,259,346,77,52,8,902,876,1778,11,5.333333333,201846
15,27,204,46,365,595,18,68,97,1393,1402,2795,9,5.666666667,201846
15,28,235,39,580,436,66,80,62,1498,1403,2901,9,5.666666667,201846
15,29,219,58,402,679,19,67,32,1476,1528,3004,8,6,201846
15,30,233,31,427,518,47,64,26,1346,1157,2503,16,6,201846
15,31,172,64,328,516,9,56,29,1174,1091,2265,6,6,201846
15,32,156,18,266,431,31,61,16,979,1030,2009,9,6,201846
15,33,177,22,329,458,20,55,6,1067,1007,2074,7,6,201846
15,34,148,20,211,472,10,37,48,946,897,1843,8,6,201846
15,35,267,33,295,499,20,59,1,1174,1086,2260,9,5.666666667,201846
15,36,222,37,286,353,77,35,3,1013,1055,2068,9,5.5,201846
15,37,189,31,340,466,65,61,76,1228,1166,2394,7,6,201846
15,38,141,26,223,447,8,38,3,886,873,1759,6,5.5,201846
15,39,151,31,262,364,17,27,12,864,866,1730,4,6,201846
15,40,280,39,375,586,127,85,2,1494,1479,2973,9,6,201846
15,41,240,33,559,596,41,59,60,1588,1550,3138,11,6,201846
16,1,156,31,293,297,16,33,4,830,618,1448,7,5.333333333,201846
16,2,125,36,172,265,53,36,0,687,825,1512,9,5.25,201846
16,3,203,47,231,314,25,29,20,869,738,1607,10,5.25,201846
16,4,258,38,329,289,58,63,0,1035,936,1971,8,5.5,201846
16,5,239,73,255,257,53,62,46,985,999,1984,10,5.666666667,201846
16,6,163,37,205,235,38,31,0,709,748,1457,12,5.5,201846
16,7,185,32,240,237,42,33,0,769,777,1546,9,5.5,201846
16,8,274,52,637,585,16,69,19,1652,1577,3229,12,6,201846
16,9,229,26,305,311,20,73,18,982,1040,2022,9,6.5,201846
16,10,148,22,322,357,9,37,8,903,907,1810,8,5.666666667,201846
16,11,155,37,248,220,111,52,25,848,907,1755,10,5.4,201846
16,12,193,39,277,240,39,52,6,846,620,1466,10,5.25,201846
17,1,188,45,428,571,45,55,30,1362,1260,2622,11,6.5,201846
17,2,138,17,371,423,16,36,32,1033,965,1998,8,5.666666667,201846
17,3,197,26,406,533,27,53,0,1242,1299,2541,8,5.5,201846
17,4,232,31,338,513,34,69,20,1237,1168,2405,10,5.666666667,201846
17,5,85,8,120,166,17,27,0,423,413,836,5,5.5,201846
18,1,113,33,144,186,18,43,42,579,546,1125,7,5,201846
18,2,211,43,415,490,51,58,0,1268,1205,2473,10,6.25,201846
18,3,131,39,356,400,14,23,0,963,777,1740,8,5.5,201846
19,1,207,35,413,699,29,57,60,1500,1525,3025,9,6,201846
19,2,262,29,747,478,42,75,0,1633,1598,3231,9,6,201846
19,3,301,30,703,569,39,90,30,1762,1653,3415,7,6,201846
19,4,109,28,203,145,108,30,219,842,804,1646,5,6,201846
19,5,291,48,511,805,26,82,122,1885,1841,3726,8,6,201846
19,6,83,18,239,424,11,34,71,880,959,1839,5,6,201846
19,7,203,17,551,407,25,31,0,1234,1119,2353,10,5.5,201846
19,8,55,5,104,111,1,13,1,290,341,631,7,6,201846
19,9,114,33,194,331,39,42,65,818,737,1555,9,5.25,201846
19,10,143,23,302,562,12,62,205,1309,1384,2693,8,5.333333333,201846
19,11,431,92,824,1664,47,148,0,3206,3184,6390,13,6.333333333,201846
19,12,188,24,574,310,20,45,15,1176,1115,2291,8,5.666666667,201846
20,1,162,15,196,217,44,45,44,723,722,1445,7,5.5,201846
20,2,83,10,101,147,27,17,1,386,627,1013,6,5.333333333,201846
20,3,116,8,170,226,50,34,21,625,637,1262,6,5.333333333,201846
20,4,129,24,104,224,39,43,43,606,709,1315,6,5.333333333,201846
20,5,128,31,186,540,51,35,0,971,779,1750,11,5.25,201846
20,6,212,25,189,345,238,31,0,1040,1151,2191,8,5.25,201846
20,7,214,19,254,455,12,44,6,1004,880,1884,8,5.75,201846
20,8,443,58,545,1000,41,125,267,2479,2593,5072,16,6.333333333,201846
20,9,237,33,202,251,100,49,101,973,1101,2074,8,5.666666667,201846
20,10,182,15,128,379,15,24,0,743,837,1580,9,5.25,201846
21,1,265,27,274,522,21,44,0,1153,772,1925,10,5.4,201846
21,2,167,25,264,339,112,46,0,953,713,1666,10,5.2,201846
21,3,185,26,345,275,93,61,67,1052,1035,2087,9,5.5,201846
21,4,186,14,189,140,189,24,37,779,566,1345,7,5.25,201846
21,5,181,18,336,356,23,54,10,978,890,1868,8,5.666666667,201846
21,6,179,26,331,485,39,57,145,1262,1232,2494,6,6,201846
21,7,244,16,265,367,60,62,13,1027,1015,2042,9,5.666666667,201846
21,8,190,15,305,302,63,60,15,950,928,1878,10,5.2,201846
21,9,173,29,430,408,63,76,66,1245,1462,2707,9,6,201846
21,10,194,17,345,410,36,43,122,1167,1149,2316,7,6,201846
21,11,59,4,162,116,18,21,5,385,385,770,6,5,201846
21,12,312,23,814,974,63,93,147,2426,2473,4899,16,7,201846
21,13,228,14,223,352,60,64,16,957,940,1897,8,5.666666667,201846
21,14,188,18,239,172,118,43,87,865,988,1853,12,5.333333333,201846
21,15,236,15,427,305,72,57,38,1150,1137,2287,7,5.5,201846
22,1,174,49,185,340,38,25,18,829,790,1619,11,5.2,201846
22,2,177,28,428,356,31,36,26,1082,1185,2267,7,5.5,201846
22,3,273,75,812,643,65,66,17,1951,1889,3840,9,6,201846
22,4,199,59,563,593,28,51,36,1529,1556,3085,11,6,201846
22,5,129,26,430,179,86,30,16,896,995,1891,10,5.5,201846
23,1,285,9,1257,338,37,38,20,1984,1984,3968,14,5.6,201846
23,2,275,40,344,564,14,34,0,1271,1242,2513,10,5.25,201846
23,3,322,6,887,496,43,46,0,1800,1540,3340,5,7,201846
23,4,188,6,753,331,22,40,13,1353,1304,2657,10,5.5,201846
24,1,112,41,180,345,29,28,1,736,561,1297,10,5.2,201846
24,2,137,51,212,285,33,41,2,761,648,1409,6,5.5,201846
24,3,170,37,206,425,142,30,0,1010,1007,2017,9,5.25,201846
24,4,141,41,198,186,65,37,158,826,904,1730,5,5.5,201846
24,5,230,73,460,659,18,62,0,1502,1423,2925,9,6.333333333,201846
24,6,193,59,386,514,46,44,0,1242,1233,2475,9,5,201846
24,7,213,44,309,506,95,24,0,1191,915,2106,9,5.25,201846
25,1,158,32,225,363,69,42,75,964,1163,2127,13,6,201846
25,2,228,34,361,593,27,52,0,1295,1056,2351,7,5.5,201846
25,3,181,33,332,455,74,38,34,1147,930,2077,8,5.6,201846
25,4,148,31,152,326,22,39,77,795,770,1565,8,5.333333333,201846
25,5,196,18,309,746,29,66,23,1387,1125,2512,10,5,201846
25,6,203,34,377,411,97,46,34,1202,1192,2394,8,5.75,201846
25,7,189,17,322,533,6,46,0,1113,1023,2136,6,6,201846
26,1,194,11,264,313,10,60,0,852,839,1691,9,5.5,201846
26,2,200,8,394,432,0,56,0,1090,1071,2161,12,5.4,201846
26,3,362,39,500,748,10,143,96,1898,1853,3751,17,5.75,201846
26,4,157,39,172,426,33,61,46,934,741,1675,9,5.2,201846
26,5,87,9,118,201,15,24,0,454,418,872,4,4,201846
26,6,180,21,373,509,10,61,0,1154,1119,2273,10,5.333333333,201846
26,7,182,14,205,328,29,41,0,799,693,1492,10,5.5,201846
27,1,176,11,210,403,27,32,0,859,823,1682,8,5.5,201846
27,2,240,29,198,448,8,37,0,960,1163,2123,8,5.666666667,201846
27,3,217,14,138,357,12,27,4,769,707,1476,7,5.666666667,201846
27,4,188,17,242,655,10,52,75,1239,1424,2663,10,5.25,201846
27,5,94,5,73,214,3,12,3,404,385,789,6,5.333333333,201846
27,6,160,31,190,500,9,36,0,926,1059,1985,8,5.5,201846
28,1,263,22,403,450,11,39,0,1188,1028,2216,13,6,201846
28,2,266,42,559,450,35,54,172,1578,1599,3177,13,6,201846
28,3,0,0,0,0,0,0,0,0,0,0,0,0,201846
28,4,342,37,512,403,62,68,257,1681,1555,3236,15,6,201846
28,5,225,59,269,535,28,53,39,1208,1274,2482,11,5.2,201846
28,6,177,30,205,303,60,34,114,923,940,1863,13,5,201846
28,7,273,50,558,647,76,61,0,1665,1448,3113,6,6,201846
28,8,182,54,294,438,59,42,13,1082,1028,2110,9,6,201846
28,9,171,28,382,214,19,34,110,958,858,1816,11,5.75,201846
29,1,192,39,337,427,69,35,0,1099,1190,2289,7,5.5,201846
29,2,184,23,274,504,24,46,112,1167,1161,2328,14,6.25,201846
29,3,128,30,149,336,13,47,0,703,776,1479,5,5.666666667,201846
30,1,103,33,153,312,66,24,97,788,909,1697,7,5.333333333,201846
30,2,179,43,199,106,69,37,402,1035,1024,2059,8,5.25,201846
30,3,177,21,375,175,207,57,261,1273,1408,2681,6,5.666666667,201846
30,4,104,9,228,256,50,24,0,671,720,1391,8,6,201846
30,5,124,20,164,439,12,48,0,807,853,1660,7,5.5,201846
30,6,165,38,238,360,25,33,0,859,876,1735,9,5.333333333,201846
30,7,159,25,213,262,26,33,82,800,954,1754,11,5.25,201846
30,8,165,26,338,480,68,59,36,1172,1154,2326,11,5.4,201846
30,9,220,24,213,198,83,53,180,971,850,1821,8,5.5,201846
30,10,147,24,365,428,52,61,143,1220,1125,2345,9,5.25,201846
30,11,133,18,302,516,19,38,0,1026,849,1875,5,5.5,201846
30,12,220,41,486,805,33,73,1,1659,1657,3316,10,6.25,201846
30,13,193,26,196,278,104,53,210,1060,923,1983,10,5.4,201846
30,14,160,36,353,140,115,48,153,1005,1010,2015,8,5.5,201846
30,15,277,36,275,299,114,82,276,1359,1307,2666,11,5.666666667,201846
30,16,185,22,343,400,115,64,171,1300,1110,2410,10,5.333333333,201846
30,17,189,56,246,446,48,50,64,1099,830,1929,8,5.5,201846
30,18,170,18,139,258,37,29,55,706,785,1491,8,5.25,201846
30,19,148,22,285,378,31,42,2,908,1136,2044,13,5.6,201846
30,20,158,23,173,391,113,33,0,891,1011,1902,10,5.4,201846
31,1,160,37,205,487,41,36,0,966,1026,1992,8,5.5,201846
31,2,94,19,145,28,248,34,0,568,534,1102,6,5.333333333,201846
31,3,409,72,1064,1077,72,102,0,2796,2761,5557,20,6.333333333,201846
31,4,110,34,279,171,126,40,115,875,863,1738,5,5.5,201846
31,5,146,24,174,531,26,36,0,937,1018,1955,5,5.333333333,201846
32,1,180,78,296,306,71,45,134,1110,841,1951,12,5.2,201846
32,2,215,110,315,156,274,45,156,1271,883,2154,14,5.142857143,201846
32,3,179,89,257,485,21,55,7,1093,944,2037,15,5.5,201846
32,4,217,137,334,420,46,66,62,1282,1132,2414,13,6.2,201846
1,1,318,60,286,338,50,34,12,1098,945,2043,13,5.5,201847
1,2,352,63,551,443,81,57,30,1577,1527,3104,10,6,201847
1,3,297,67,521,508,53,60,26,1532,1869,3401,11,6,201847
2,1,286,29,401,406,26,54,4,1206,1373,2579,11,6,201847
2,2,446,33,386,745,21,90,0,1721,1296,3017,9,5.666666667,201847
2,3,413,42,559,522,37,73,0,1646,1418,3064,11,5.666666667,201847
2,4,299,9,529,214,33,38,2,1124,1112,2236,9,6,201847
2,5,562,59,1030,653,154,110,24,2592,2710,5302,13,6.333333333,201847
2,6,272,22,514,410,30,66,0,1314,1351,2665,7,6,201847
2,7,416,25,536,506,19,46,12,1560,1522,3082,12,5.75,201847
2,8,335,23,636,471,11,56,3,1535,1537,3072,8,6,201847
3,1,150,29,326,380,28,58,14,985,984,1969,14,5,201847
3,2,148,14,584,257,15,36,0,1054,1023,2077,9,6,201847
4,1,217,33,314,548,42,44,0,1198,1107,2305,14,5.166666667,201847
4,2,235,36,416,456,52,50,11,1256,1326,2582,14,5.4,201847
5,1,218,24,367,361,20,60,15,1065,1300,2365,9,5.666666667,201847
5,2,155,22,258,442,33,45,0,955,701,1656,10,5.2,201847
5,3,167,23,301,366,35,64,94,1050,1107,2157,9,5.5,201847
5,4,225,43,535,509,11,106,67,1496,1473,2969,11,5.75,201847
5,5,242,32,522,616,17,42,57,1528,1373,2901,8,6,201847
5,6,123,16,231,287,13,37,38,745,621,1366,11,5.5,201847
5,7,164,33,290,384,5,38,17,931,952,1883,11,6,201847
6,1,161,33,340,291,25,49,150,1049,929,1978,14,6,201847
6,2,172,24,373,271,86,53,20,999,901,1900,9,5.666666667,201847
7,1,279,21,222,471,8,65,54,1120,1134,2254,11,5.25,201847
7,2,393,25,395,409,120,41,0,1383,554,1937,12,5.25,201847
7,3,231,4,216,320,129,42,17,959,881,1840,9,5.333333333,201847
7,4,175,27,208,351,13,55,72,901,493,1394,13,5.8,201847
7,5,242,16,165,622,22,35,6,1108,1149,2257,11,5.666666667,201847
7,6,233,24,354,559,23,82,28,1303,1451,2754,11,6,201847
7,7,219,34,286,490,25,54,0,1108,1332,2440,8,5.5,201847
7,8,234,14,192,532,19,57,0,1048,922,1970,12,5.25,201847
7,9,228,25,312,576,34,74,16,1265,1147,2412,11,5.5,201847
7,10,235,15,265,479,14,37,0,1045,1084,2129,10,5.5,201847
7,11,190,4,109,221,15,22,31,592,530,1122,6,5.333333333,201847
7,12,239,9,284,568,3,43,0,1146,1024,2170,9,5.5,201847
7,13,117,21,112,356,6,34,0,646,643,1289,9,5.25,201847
8,1,158,6,455,237,22,33,25,936,1045,1981,4,6,201847
8,2,239,28,597,385,28,87,14,1378,1449,2827,16,5.75,201847
8,3,177,28,430,478,19,55,5,1192,1330,2522,4,6,201847
8,4,154,29,417,310,24,64,124,1122,1635,2757,9,6,201847
8,5,175,35,298,349,50,44,0,951,954,1905,10,5.25,201847
8,6,220,28,479,540,57,79,84,1487,1572,3059,7,6.5,201847
8,7,166,52,234,399,11,55,0,917,885,1802,7,5.25,201847
8,8,183,48,371,557,9,36,21,1225,1239,2464,12,6,201847
8,9,176,38,210,341,54,59,19,897,869,1766,10,5.2,201847
9,1,102,19,206,212,102,36,34,711,685,1396,5,6,201847
9,2,287,68,777,1153,118,120,124,2647,2696,5343,12,6,201847
9,3,144,52,416,515,58,61,164,1410,1527,2937,7,6,201847
9,4,147,38,421,592,63,52,69,1382,1458,2840,11,6,201847
9,5,112,26,388,587,50,56,26,1245,1268,2513,7,6,201847
9,6,115,21,231,258,105,70,85,885,890,1775,7,6,201847
9,7,91,15,307,518,8,38,15,992,1002,1994,9,6,201847
9,8,74,18,262,301,24,45,99,823,913,1736,5,6,201847
9,9,116,14,239,370,53,39,20,851,768,1619,5,6,201847
9,10,92,25,367,558,28,47,1,1118,998,2116,6,6,201847
9,11,162,59,473,713,69,73,18,1567,1444,3011,7,7,201847
9,12,125,44,638,719,50,88,135,1799,1778,3577,11,6,201847
9,13,115,30,266,359,83,40,155,1048,1061,2109,4,6,201847
9,14,93,19,261,212,99,55,131,870,982,1852,5,6,201847
9,15,180,54,949,1086,44,116,279,2708,2566,5274,11,5.5,201847
9,16,254,82,731,1040,120,113,5,2345,2273,4618,15,7,201847
9,17,113,28,291,431,15,41,15,934,1036,1970,6,6,201847
9,18,152,42,436,827,56,83,15,1611,1717,3328,12,6,201847
9,19,179,46,371,485,128,68,29,1306,1264,2570,5,6,201847
9,20,32,9,65,82,17,10,1,216,221,437,5,6,201847
9,21,82,11,179,275,34,35,32,648,661,1309,3,6,201847
9,22,149,15,265,314,85,40,78,946,934,1880,5,6,201847
9,23,136,31,344,532,82,37,76,1238,1322,2560,6,7,201847
9,24,256,52,685,984,116,99,34,2226,2482,4708,12,6,201847
10,1,255,43,239,304,14,47,148,1050,915,1965,12,4.666666667,201847
10,2,352,39,363,425,59,58,74,1370,1242,2612,9,5.5,201847
10,3,258,85,226,514,27,49,101,1260,903,2163,11,5.4,201847
10,4,416,44,401,547,13,61,3,1485,1716,3201,14,6.333333333,201847
11,1,215,42,218,276,44,42,17,854,780,1634,6,5.666666667,201847
11,2,221,50,266,301,38,30,26,932,848,1780,7,6,201847
11,3,155,47,291,250,35,43,158,979,943,1922,3,6,201847
11,4,211,30,241,365,11,32,0,890,737,1627,10,5,201847
11,5,262,83,468,639,23,80,22,1577,1644,3221,7,6.5,201847
11,6,117,29,222,233,30,38,26,695,769,1464,9,7,201847
11,7,189,49,260,332,20,42,0,892,878,1770,9,5.5,201847
11,8,193,41,319,496,28,37,46,1160,1135,2295,9,5.75,201847
11,9,270,79,402,508,26,49,62,1396,1277,2673,10,5.666666667,201847
11,10,192,87,301,397,54,44,118,1193,1119,2312,10,5.6,201847
11,11,157,82,297,357,23,30,0,946,920,1866,5,6,201847
11,12,221,65,467,554,15,43,16,1381,1268,2649,7,6.5,201847
11,13,199,84,245,339,45,31,132,1075,1000,2075,8,5.5,201847
11,14,170,60,269,408,30,25,1,963,1135,2098,8,5.5,201847
11,15,145,49,212,314,10,31,1,762,748,1510,9,6,201847
12,1,197,49,325,170,102,36,2,881,847,1728,10,5.2,201847
12,2,205,38,274,455,28,40,4,1044,1014,2058,10,5.5,201847
12,3,187,33,302,460,43,46,0,1071,940,2011,11,5.2,201847
12,4,156,33,304,594,29,46,0,1162,1105,2267,9,6,201847
12,5,219,15,204,242,9,24,56,769,649,1418,10,5.25,201847
12,6,201,26,183,386,16,20,3,835,1082,1917,10,5.25,201847
12,7,267,38,265,478,28,37,43,1156,1067,2223,8,5.333333333,201847
12,8,230,21,271,296,13,32,0,863,960,1823,9,5.25,201847
12,9,185,25,258,467,5,43,3,986,981,1967,9,5.666666667,201847
13,1,187,45,180,399,93,43,14,961,934,1895,9,5.333333333,201847
13,2,131,37,127,346,79,20,23,763,726,1489,6,5.333333333,201847
13,3,148,37,212,301,107,46,0,851,817,1668,12,5.25,201847
13,4,220,41,303,301,149,57,103,1174,1178,2352,9,5.666666667,201847
13,5,220,41,484,353,171,69,115,1453,1312,2765,9,5.75,201847
13,6,271,66,643,872,59,59,2,1972,2126,4098,13,5.75,201847
13,7,186,45,434,419,33,44,14,1175,1104,2279,8,5.5,201847
14,1,151,61,180,140,61,41,103,737,684,1421,7,5.5,201847
14,2,179,45,293,282,40,54,5,898,821,1719,5,5.666666667,201847
14,3,266,62,457,367,56,78,48,1334,1542,2876,8,5.4,201847
14,4,164,24,286,436,15,58,34,1017,1082,2099,10,6,201847
14,5,173,18,476,304,48,38,3,1060,920,1980,9,5.5,201847
14,6,171,21,480,336,33,44,10,1095,1164,2259,11,6,201847
14,7,130,11,234,208,0,21,0,604,589,1193,6,6,201847
14,8,324,62,773,1113,47,93,52,2464,2468,4932,13,5.333333333,201847
14,9,92,35,209,219,17,16,6,594,701,1295,9,7,201847
14,10,183,33,390,500,10,41,25,1182,1135,2317,5,6.5,201847
14,11,186,32,268,531,40,55,44,1156,1018,2174,4,6,201847
14,12,204,21,491,211,6,33,9,975,1193,2168,9,5.5,201847
14,13,252,22,375,385,20,39,23,1116,1015,2131,6,6,201847
14,14,135,42,276,590,10,37,21,1111,832,1943,7,6,201847
14,15,262,68,255,390,53,51,22,1101,1006,2107,10,5.6,201847
14,16,187,37,334,202,74,36,91,961,884,1845,5,6,201847
14,17,174,37,242,304,30,48,34,869,596,1465,7,5.25,201847
14,18,244,62,401,370,50,56,94,1277,1131,2408,9,5.4,201847
14,19,225,55,345,389,44,54,30,1142,940,2082,8,5.25,201847
14,20,186,26,343,199,18,39,21,832,672,1504,10,5.666666667,201847
15,1,193,45,269,275,485,61,6,1334,1344,2678,7,5.333333333,201847
15,2,147,18,242,340,52,32,56,887,943,1830,6,6,201847
15,3,281,52,287,461,364,53,69,1567,1456,3023,10,5.666666667,201847
15,4,181,27,360,446,38,57,71,1180,1153,2333,4,6,201847
15,5,150,42,199,344,41,39,94,909,888,1797,8,5.666666667,201847
15,6,158,25,285,544,65,49,84,1210,1265,2475,7,6.5,201847
15,7,139,27,287,527,49,45,19,1093,1102,2195,10,6,201847
15,8,89,14,147,270,17,25,10,572,642,1214,4,6,201847
15,9,254,19,248,176,277,43,57,1074,1015,2089,9,5.75,201847
15,10,125,20,268,343,45,33,28,862,920,1782,6,6,201847
15,11,191,31,322,520,50,56,13,1183,1239,2422,8,6,201847
15,12,250,18,521,549,40,48,12,1438,1441,2879,8,6,201847
15,13,98,32,205,299,165,45,0,844,785,1629,8,6,201847
15,14,80,24,138,329,19,39,0,629,614,1243,4,6,201847
15,15,159,48,303,529,31,48,38,1156,1171,2327,6,6,201847
15,16,215,33,362,655,19,59,23,1366,1419,2785,8,6,201847
15,17,101,31,202,275,17,62,199,887,814,1701,8,6,201847
15,18,214,47,363,586,35,57,71,1373,1300,2673,7,5.666666667,201847
15,19,203,77,491,1041,12,56,37,1917,1857,3774,10,6,201847
15,20,73,20,171,332,22,17,24,659,727,1386,6,6,201847
15,21,128,13,116,277,33,34,11,612,511,1123,6,5.5,201847
15,22,242,77,543,890,41,103,239,2135,2123,4258,14,6,201847
15,23,164,22,267,557,26,43,0,1079,1061,2140,6,5.333333333,201847
15,24,132,25,239,330,25,34,21,806,781,1587,4,6,201847
15,25,194,37,359,338,52,47,39,1066,1038,2104,6,6,201847
15,26,154,18,252,350,73,52,1,900,926,1826,11,5.333333333,201847
15,27,204,32,373,513,17,52,191,1382,1459,2841,9,5.666666667,201847
15,28,239,39,531,438,84,58,56,1445,1444,2889,9,5.666666667,201847
15,29,188,43,357,659,19,66,29,1361,1507,2868,8,6,201847
15,30,238,35,388,455,56,49,12,1233,1248,2481,16,6,201847
15,31,185,78,294,577,24,46,0,1204,1216,2420,6,6,201847
15,32,168,21,267,434,27,51,17,985,931,1916,9,6,201847
15,33,198,16,271,416,21,38,6,966,957,1923,7,6,201847
15,34,133,16,212,442,14,32,44,893,851,1744,8,6,201847
15,35,273,29,283,528,26,58,8,1205,1164,2369,9,5.666666667,201847
15,36,291,25,307,341,129,33,2,1128,1222,2350,9,5.5,201847
15,37,168,31,311,485,56,57,94,1202,1117,2319,7,6,201847
15,38,175,42,269,543,2,49,8,1088,1104,2192,6,5.5,201847
15,39,142,37,310,343,6,30,16,884,875,1759,4,6,201847
15,40,294,44,438,545,128,66,1,1516,1416,2932,9,6,201847
15,41,237,33,471,600,33,51,62,1487,1573,3060,11,6,201847
16,1,158,28,249,284,15,36,4,774,652,1426,7,5.333333333,201847
16,2,142,37,214,335,43,54,2,827,646,1473,9,5.25,201847
16,3,178,32,210,318,28,42,13,821,816,1637,10,5.25,201847
16,4,191,45,380,243,46,65,0,970,855,1825,8,5.5,201847
16,5,195,51,274,300,49,66,50,985,926,1911,10,5.666666667,201847
16,6,171,47,228,284,24,38,0,792,750,1542,12,5.25,201847
16,7,221,41,260,300,51,51,0,924,830,1754,9,5.5,201847
16,8,267,59,613,616,18,69,17,1659,1628,3287,12,6,201847
16,9,219,37,307,343,16,52,20,994,998,1992,9,6.5,201847
16,10,168,29,316,395,14,41,6,969,807,1776,8,5.666666667,201847
16,11,220,35,254,236,166,63,27,1001,1006,2007,10,5.4,201847
16,12,160,36,242,160,40,35,3,676,734,1410,10,5.25,201847
17,1,178,29,409,569,51,52,36,1324,1333,2657,11,6.5,201847
17,2,141,16,349,427,16,37,39,1025,1026,2051,8,5.666666667,201847
17,3,182,34,376,483,11,47,0,1133,1247,2380,8,5.5,201847
17,4,232,36,345,467,25,64,18,1187,1248,2435,10,5.333333333,201847
17,5,92,15,158,250,25,21,2,563,495,1058,5,5.5,201847
18,1,156,33,123,192,38,42,27,611,570,1181,7,5.25,201847
18,2,227,35,443,479,64,49,0,1297,1325,2622,10,6.25,201847
18,3,190,41,399,417,13,42,0,1102,883,1985,8,5.5,201847
19,1,208,39,450,588,29,54,65,1433,1415,2848,9,6,201847
19,2,282,21,685,458,50,67,1,1564,1628,3192,9,6,201847
19,3,292,36,655,573,36,77,43,1712,1638,3350,7,6,201847
19,4,106,31,175,164,106,36,233,851,864,1715,5,6,201847
19,5,281,47,477,774,17,69,120,1785,1801,3586,8,6,201847
19,6,78,18,211,539,12,33,17,908,871,1779,5,6,201847
19,7,175,23,510,297,17,33,2,1057,1144,2201,10,5.5,201847
19,8,48,4,112,129,5,10,1,309,290,599,7,6,201847
19,9,140,38,224,505,57,41,56,1061,1126,2187,9,5.25,201847
19,10,211,26,292,649,11,62,114,1365,1174,2539,8,5.333333333,201847
19,11,423,102,728,1592,32,136,66,3079,2995,6074,13,6.333333333,201847
19,12,186,21,512,284,14,39,21,1077,1102,2179,8,5.666666667,201847
20,1,171,19,245,202,53,60,90,840,753,1593,7,5.5,201847
20,2,134,26,166,327,22,30,0,705,629,1334,6,5.333333333,201847
20,3,162,14,229,276,204,40,8,933,374,1307,6,5.333333333,201847
20,4,86,25,81,186,41,21,37,477,342,819,6,5.333333333,201847
20,5,188,34,225,699,79,47,0,1272,739,2011,11,5.25,201847
20,6,219,11,265,338,184,37,3,1057,462,1519,8,5.25,201847
20,7,159,23,234,387,18,30,7,858,793,1651,8,5.75,201847
20,8,359,48,559,965,38,130,298,2397,2475,4872,16,6.333333333,201847
20,9,207,29,232,217,96,53,117,951,1026,1977,8,5.666666667,201847
20,10,131,15,176,253,14,18,0,607,644,1251,9,4,201847
21,1,194,27,197,498,28,47,1,992,998,1990,10,5.4,201847
21,2,147,19,246,268,119,33,1,833,664,1497,10,5.2,201847
21,3,185,25,349,272,114,44,71,1060,1001,2061,9,5.5,201847
21,4,151,22,139,153,229,37,18,749,594,1343,7,5.25,201847
21,5,171,15,354,314,16,43,24,937,1056,1993,8,5.666666667,201847
21,6,160,19,293,419,35,41,165,1132,1208,2340,6,6,201847
21,7,255,16,275,407,46,55,56,1110,980,2090,9,5.666666667,201847
21,8,165,18,407,272,160,33,32,1087,968,2055,10,5.2,201847
21,9,181,25,470,399,67,57,112,1311,1337,2648,9,6,201847
21,10,195,18,316,361,32,53,118,1093,1225,2318,7,6,201847
21,11,50,1,121,92,22,9,6,301,332,633,6,5.5,201847
21,12,306,32,806,1079,76,116,76,2491,2461,4952,16,7,201847
21,13,221,23,237,281,56,50,53,921,884,1805,8,5.666666667,201847
21,14,197,19,241,154,107,35,97,850,967,1817,12,5.333333333,201847
21,15,186,14,348,275,63,54,34,974,1114,2088,7,5.5,201847
22,1,247,53,271,388,48,28,21,1056,1007,2063,11,5.2,201847
22,2,165,37,423,350,27,33,35,1070,937,2007,7,5.5,201847
22,3,258,70,789,629,35,81,17,1879,1906,3785,9,6,201847
22,4,198,59,553,556,36,55,32,1489,1639,3128,11,6,201847
22,5,162,28,498,197,98,42,20,1045,893,1938,10,5.5,201847
23,1,238,11,990,272,25,31,38,1605,1830,3435,14,5.6,201847
23,2,254,24,386,402,19,24,17,1126,886,2012,10,5.25,201847
23,3,262,13,843,471,16,36,0,1641,1648,3289,15,7,201847
23,4,174,16,688,300,34,31,14,1257,1506,2763,10,5.25,201847
24,1,149,60,184,271,37,22,7,730,887,1617,9,5,201847
24,2,108,38,214,244,27,40,0,671,711,1382,6,5.5,201847
24,3,176,43,243,427,135,32,2,1058,854,1912,9,5.25,201847
24,4,171,48,222,204,53,39,182,919,874,1793,5,5.5,201847
24,5,232,64,427,623,15,66,0,1427,1410,2837,10,6.666666667,201847
24,6,199,54,368,448,46,50,22,1187,1292,2479,8,4,201847
24,7,234,38,326,428,63,24,0,1113,1260,2373,9,5.25,201847
25,1,145,30,221,344,41,29,79,889,890,1779,13,6,201847
25,2,238,46,391,602,19,55,0,1351,1110,2461,7,5.5,201847
25,3,199,29,316,408,47,36,34,1069,982,2051,8,5.6,201847
25,4,156,47,157,377,33,40,111,921,798,1719,8,5.333333333,201847
25,5,209,21,317,757,16,74,20,1414,1246,2660,10,5,201847
25,6,200,38,413,446,129,53,30,1309,1345,2654,8,5.75,201847
25,7,233,20,337,555,16,59,0,1220,1049,2269,6,6,201847
26,1,212,19,338,325,6,60,0,960,960,1920,9,5.5,201847
26,2,241,14,389,449,6,71,0,1170,1244,2414,12,5.4,201847
26,3,268,29,397,678,12,110,46,1540,1672,3212,17,5.5,201847
26,4,109,22,154,300,29,34,25,673,595,1268,9,4.6,201847
26,5,56,8,73,153,5,17,0,312,358,670,11,5.333333333,201847
26,6,153,15,348,437,7,46,0,1006,999,2005,10,5.333333333,201847
26,7,109,11,154,257,31,41,0,603,581,1184,10,5.25,201847
27,1,191,24,239,386,51,33,2,926,868,1794,8,5.5,201847
27,2,231,20,239,401,16,32,0,939,958,1897,8,5.666666667,201847
27,3,174,17,168,508,11,27,1,906,818,1724,7,5.666666667,201847
27,4,222,24,342,749,18,57,66,1478,1313,2791,10,5.5,201847
27,5,123,10,95,267,15,27,4,541,376,917,6,5.333333333,201847
27,6,169,23,244,518,13,41,0,1008,1100,2108,8,5.5,201847
28,1,249,33,431,427,15,39,0,1194,1172,2366,13,6,201847
28,2,267,41,537,416,39,60,178,1538,1531,3069,13,6,201847
28,3,336,75,499,923,36,63,0,1932,1492,3424,7,5.333333333,201847
28,4,328,46,508,381,71,67,224,1625,1575,3200,15,6,201847
28,5,257,37,224,491,32,40,53,1134,1093,2227,12,5.4,201847
28,6,195,45,237,315,49,28,82,951,761,1712,14,5.166666667,201847
28,7,287,45,531,592,70,54,0,1579,1465,3044,6,6,201847
28,8,175,51,299,437,89,33,23,1107,1024,2131,9,6,201847
28,9,191,20,351,233,23,34,99,951,944,1895,11,5.75,201847
29,1,212,43,371,423,61,44,0,1154,1065,2219,7,5.5,201847
29,2,208,26,218,465,27,33,102,1079,1015,2094,14,6.25,201847
29,3,153,38,132,402,13,34,0,772,670,1442,5,5.666666667,201847
30,1,129,33,209,390,54,39,141,995,920,1915,7,5.333333333,201847
30,2,160,41,230,92,82,31,557,1193,1288,2481,8,5.25,201847
30,3,168,27,417,167,212,44,313,1348,1360,2708,6,5.666666667,201847
30,4,96,6,280,247,47,35,0,711,650,1361,8,6,201847
30,5,133,30,220,463,22,62,0,930,925,1855,7,5.5,201847
30,6,128,28,210,338,31,36,1,772,795,1567,9,5.333333333,201847
30,7,197,19,263,277,67,52,105,980,949,1929,11,5.25,201847
30,8,162,45,371,391,116,47,183,1315,1307,2622,11,5.4,201847
30,9,169,21,215,182,66,46,186,885,866,1751,8,5.5,201847
30,10,164,34,353,411,55,55,167,1239,1161,2400,9,5.25,201847
30,11,129,27,323,570,15,54,0,1118,1211,2329,5,5.5,201847
30,12,216,28,531,867,24,87,2,1755,1507,3262,10,6.25,201847
30,13,199,23,192,266,84,33,232,1029,1130,2159,10,5.4,201847
30,14,172,28,316,151,106,44,122,939,858,1797,8,5.5,201847
30,15,264,30,307,285,107,87,303,1383,1217,2600,11,5.666666667,201847
30,16,170,18,274,345,99,59,167,1132,1066,2198,10,5.333333333,201847
30,17,193,41,263,369,76,50,71,1063,1018,2081,8,5.5,201847
30,18,184,15,181,283,47,29,35,774,808,1582,8,5.25,201847
30,19,186,26,271,434,37,42,8,1004,910,1914,13,5.6,201847
30,20,120,16,165,308,105,31,0,745,920,1665,10,5.4,201847
31,1,131,36,180,366,16,18,0,747,767,1514,8,4.75,201847
31,2,72,23,208,25,495,32,0,855,824,1679,6,5.333333333,201847
31,3,451,74,1145,1002,106,98,0,2876,2787,5663,20,6.333333333,201847
31,4,118,13,362,167,191,39,103,993,852,1845,5,5.5,201847
31,5,100,32,148,511,28,29,0,848,843,1691,5,5.333333333,201847
32,1,166,87,266,300,75,57,126,1077,1073,2150,12,5.2,201847
32,2,171,96,282,177,218,38,197,1179,1194,2373,14,5.142857143,201847
32,3,228,89,317,548,18,51,14,1265,968,2233,15,5.5,201847
32,4,233,128,303,420,48,75,61,1268,1124,2392,12,5.2,201847
1,1,238,45,287,319,85,36,6,1016,1052,2068,13,5.5,201848
1,2,323,51,540,399,72,42,39,1466,1694,3160,10,6,201848
1,3,259,77,543,533,40,46,24,1522,1670,3192,11,6,201848
2,1,274,16,361,421,36,53,3,1164,1220,2384,11,6,201848
2,2,340,25,336,659,12,77,0,1449,1431,2880,9,5.666666667,201848
2,3,346,35,589,539,18,74,4,1605,1612,3217,12,6,201848
2,4,237,15,576,222,48,30,5,1133,1097,2230,9,6,201848
2,5,565,56,1076,614,148,114,19,2592,2622,5214,13,6.333333333,201848
2,6,294,23,497,452,35,59,0,1360,1280,2640,7,6,201848
2,7,353,31,542,458,12,52,32,1480,1596,3076,12,5.75,201848
2,8,269,16,647,497,12,44,7,1492,1590,3082,8,6,201848
3,1,165,27,383,476,16,71,12,1150,1019,2169,14,5.571428571,201848
3,2,123,11,505,314,10,25,0,988,1042,2030,9,6,201848
4,1,186,20,282,551,49,34,0,1122,1175,2297,14,5.333333333,201848
4,2,164,33,438,425,25,40,10,1135,1156,2291,14,5.4,201848
5,1,170,18,330,342,32,47,31,970,1260,2230,9,5.666666667,201848
5,2,133,23,197,314,44,27,0,738,1029,1767,10,5.2,201848
5,3,189,24,235,363,64,48,83,1006,1172,2178,9,5.5,201848
5,4,227,30,455,419,13,81,49,1274,1406,2680,11,5.75,201848
5,5,230,31,365,595,17,59,33,1330,1480,2810,8,6,201848
5,6,112,17,205,249,3,22,35,643,814,1457,11,5.5,201848
5,7,161,14,250,349,12,30,13,829,811,1640,10,5.5,201848
6,1,184,19,330,348,17,44,90,1032,992,2024,13,5.833333333,201848
6,2,166,21,382,238,63,47,32,949,840,1789,9,5.666666667,201848
7,1,205,9,149,279,13,30,28,713,991,1704,11,5.25,201848
7,2,362,18,204,804,23,40,0,1451,563,2014,12,5.25,201848
7,3,268,7,437,197,78,72,17,1076,531,1607,9,5.333333333,201848
7,4,116,14,154,329,5,40,30,688,1192,1880,13,5.4,201848
7,5,297,13,199,614,12,36,6,1177,1255,2432,11,5.666666667,201848
7,6,220,26,324,481,14,62,29,1156,1172,2328,10,5.666666667,201848
7,7,203,42,314,459,25,61,0,1104,1273,2377,8,5.5,201848
7,8,293,13,297,616,22,63,0,1304,1264,2568,12,5.25,201848
7,9,193,25,314,508,14,55,24,1133,1306,2439,11,5.5,201848
7,10,192,12,200,602,17,22,0,1045,1774,2819,10,5.5,201848
7,11,142,6,69,158,21,11,43,450,487,937,6,5.333333333,201848
7,12,256,15,322,590,9,37,0,1229,1124,2353,9,5.5,201848
7,13,159,20,188,338,4,41,0,750,1028,1778,9,5.25,201848
8,1,142,8,407,254,21,17,19,868,992,1860,4,6,201848
8,2,264,22,507,359,33,48,15,1248,1487,2735,16,5.75,201848
8,3,180,23,403,451,12,50,14,1133,1379,2512,4,6,201848
8,4,154,26,348,329,22,70,118,1067,1500,2567,9,6,201848
8,5,147,27,275,313,35,43,0,840,970,1810,10,5.25,201848
8,6,190,40,400,453,50,49,66,1248,1450,2698,7,6.5,201848
8,7,180,37,257,411,12,51,0,948,878,1826,7,5.25,201848
8,8,174,40,363,454,7,36,21,1095,1224,2319,12,6,201848
8,9,180,36,176,333,38,59,6,828,808,1636,10,5.2,201848
9,1,84,20,188,183,82,32,55,644,684,1328,5,6,201848
9,2,274,92,759,1129,93,96,121,2564,2660,5224,12,6,201848
9,3,120,52,395,564,71,58,172,1432,1356,2788,7,6,201848
9,4,167,27,409,586,54,65,56,1364,1413,2777,11,6,201848
9,5,141,28,358,543,67,34,26,1197,1156,2353,7,6,201848
9,6,103,27,228,244,117,40,113,872,873,1745,7,6,201848
9,7,98,19,325,614,1,27,1,1085,960,2045,9,6,201848
9,8,72,15,299,296,26,37,91,836,773,1609,5,6,201848
9,9,111,18,246,329,53,32,28,817,837,1654,5,6,201848
9,10,90,27,359,468,19,47,3,1013,1051,2064,6,6,201848
9,11,169,28,473,699,81,87,24,1561,1504,3065,7,7,201848
9,12,120,27,576,639,53,78,158,1651,1752,3403,11,6,201848
9,13,108,29,271,379,62,48,132,1029,1033,2062,4,6,201848
9,14,110,12,233,238,109,38,112,852,903,1755,5,6,201848
9,15,148,53,1006,1067,43,124,265,2706,2647,5353,11,5.5,201848
9,16,250,72,700,1010,82,96,8,2218,2247,4465,15,7,201848
9,17,140,18,298,428,22,46,6,958,980,1938,6,6,201848
9,18,136,56,385,756,45,78,26,1482,1591,3073,12,6,201848
9,19,167,33,360,482,122,81,35,1280,1238,2518,5,6,201848
9,20,18,4,66,90,12,8,15,213,218,431,5,6,201848
9,21,89,13,178,299,35,25,38,677,614,1291,3,6,201848
9,22,138,23,261,309,118,36,106,991,951,1942,5,6,201848
9,23,117,28,315,500,82,49,57,1148,1295,2443,6,7,201848
9,24,272,39,664,1054,109,90,36,2264,2319,4583,12,6,201848
10,1,191,33,185,293,22,40,108,872,868,1740,10,3.333333333,201848
10,2,313,32,312,349,17,45,67,1135,1337,2472,9,5.5,201848
10,3,213,44,196,360,31,36,100,980,838,1818,11,5.4,201848
10,4,371,35,411,536,8,44,0,1405,1619,3024,14,6.333333333,201848
11,1,205,41,205,288,56,33,25,853,896,1749,6,5.666666667,201848
11,2,211,45,258,318,29,44,26,931,977,1908,7,6,201848
11,3,163,59,293,273,30,39,141,998,1008,2006,3,6,201848
11,4,164,32,210,340,2,30,0,778,818,1596,10,5.2,201848
11,5,267,99,430,630,22,76,24,1548,1523,3071,7,6.5,201848
11,6,96,36,216,223,39,27,39,676,741,1417,9,7,201848
11,7,212,53,308,339,11,44,0,967,1092,2059,9,5.5,201848
11,8,193,50,317,469,21,35,33,1118,1206,2324,9,5.75,201848
11,9,216,86,347,481,24,65,52,1271,1285,2556,10,5.666666667,201848
11,10,179,110,307,402,44,28,96,1166,1125,2291,10,5.6,201848
11,11,163,79,299,369,12,43,0,965,941,1906,5,6,201848
11,12,201,56,440,532,14,50,7,1300,1355,2655,7,6.5,201848
11,13,172,56,320,262,42,33,105,990,1004,1994,8,5.5,201848
11,14,207,53,264,386,35,39,5,989,1074,2063,8,5.5,201848
11,15,111,53,195,287,5,33,0,684,714,1398,9,6,201848
12,1,156,38,291,151,106,30,8,780,781,1561,10,5,201848
12,2,197,45,289,427,27,39,7,1031,1244,2275,10,5.5,201848
12,3,144,32,261,350,34,26,0,847,1187,2034,11,5.2,201848
12,4,133,29,324,572,15,50,0,1123,1124,2247,9,6,201848
12,5,231,25,223,269,1,28,46,823,867,1690,10,5.25,201848
12,6,199,18,149,295,29,19,4,713,1140,1853,10,5.25,201848
12,7,220,32,539,391,31,44,37,1294,1103,2397,8,4.666666667,201848
12,8,253,29,317,339,12,26,0,976,917,1893,9,5.25,201848
12,9,181,26,300,466,15,43,4,1035,1072,2107,9,5.666666667,201848
13,1,125,31,112,339,49,31,2,689,791,1480,9,5.333333333,201848
13,2,113,34,139,415,61,29,4,795,888,1683,6,5.333333333,201848
13,3,138,41,238,425,104,52,0,998,1025,2023,12,5.25,201848
13,4,230,31,296,276,145,71,97,1146,932,2078,9,5.666666667,201848
13,5,194,36,438,330,112,74,115,1299,1439,2738,9,5.75,201848
13,6,218,64,609,795,63,65,0,1814,1998,3812,13,5.75,201848
13,7,166,40,436,397,23,43,29,1134,1117,2251,8,5.5,201848
14,1,157,56,191,147,65,37,140,793,694,1487,7,5.5,201848
14,2,194,34,270,251,28,48,13,838,873,1711,5,5.666666667,201848
14,3,223,63,466,336,47,77,75,1287,1416,2703,8,5.4,201848
14,4,170,20,302,541,27,43,42,1145,1169,2314,10,6,201848
14,5,167,23,468,332,54,41,3,1088,1119,2207,9,5.5,201848
14,6,201,24,490,378,27,47,21,1188,1241,2429,11,6,201848
14,7,97,15,216,197,0,21,0,546,614,1160,6,6,201848
14,8,298,77,850,1271,28,79,52,2655,3225,5880,13,5.666666667,201848
14,9,91,27,177,289,41,23,5,653,583,1236,9,6,201848
14,10,177,28,411,525,16,49,0,1206,1298,2504,5,6.5,201848
14,11,175,37,287,477,45,48,65,1134,1082,2216,4,6,201848
14,12,223,20,502,247,1,44,7,1044,1035,2079,9,5.5,201848
14,13,195,31,418,356,34,38,18,1090,1158,2248,6,6,201848
14,14,151,50,268,539,11,43,51,1113,1874,2987,7,6,201848
14,15,177,63,256,339,58,64,16,973,978,1951,10,5.6,201848
14,16,186,31,390,266,57,41,87,1058,988,2046,5,6,201848
14,17,188,43,246,280,26,33,46,862,846,1708,7,5.25,201848
14,18,226,64,377,370,39,48,130,1254,1093,2347,9,5.4,201848
14,19,222,40,316,393,41,39,19,1070,988,2058,8,5.25,201848
14,20,160,29,384,233,22,40,17,885,760,1645,10,5.666666667,201848
15,1,159,33,265,172,527,29,3,1188,1048,2236,7,5.333333333,201848
15,2,110,24,263,299,43,39,42,820,874,1694,6,5.5,201848
15,3,267,71,251,493,335,51,51,1519,1435,2954,10,5.666666667,201848
15,4,184,25,300,393,54,53,99,1108,1179,2287,4,6,201848
15,5,158,41,281,368,33,33,108,1022,895,1917,8,5.666666667,201848
15,6,141,18,314,537,60,55,60,1185,1153,2338,7,6.5,201848
15,7,139,33,287,531,47,47,27,1111,1044,2155,10,6,201848
15,8,78,26,154,261,22,31,36,608,623,1231,4,6,201848
15,9,248,23,246,200,235,33,47,1032,1008,2040,9,5.75,201848
15,10,108,19,209,348,67,41,31,823,876,1699,6,6,201848
15,11,159,28,346,519,52,47,16,1167,1210,2377,8,6,201848
15,12,199,24,535,554,27,39,14,1392,1406,2798,8,6,201848
15,13,92,14,195,326,146,36,0,809,856,1665,8,6,201848
15,14,84,16,160,266,17,37,0,580,665,1245,4,6,201848
15,15,155,41,274,470,34,74,87,1135,1227,2362,6,6,201848
15,16,210,48,322,653,12,41,15,1301,1397,2698,8,6,201848
15,17,87,26,214,253,19,43,200,842,855,1697,8,6,201848
15,18,201,30,295,520,47,55,77,1225,1240,2465,7,5.666666667,201848
15,19,190,87,481,1018,9,59,12,1856,1980,3836,10,6,201848
15,20,73,26,219,397,27,30,0,772,773,1545,6,6,201848
15,21,98,20,114,292,23,26,9,582,592,1174,6,5.5,201848
15,22,227,74,570,941,46,83,261,2202,2094,4296,14,6,201848
15,23,147,18,234,456,31,47,0,933,1064,1997,6,5.333333333,201848
15,24,120,17,229,296,25,33,12,732,790,1522,4,6,201848
15,25,201,14,281,346,38,65,40,985,976,1961,6,6,201848
15,26,143,13,222,368,74,37,15,872,886,1758,11,5.333333333,201848
15,27,181,36,362,453,25,45,209,1311,1230,2541,9,5.666666667,201848
15,28,225,29,584,442,85,64,58,1487,1509,2996,9,5.666666667,201848
15,29,200,39,384,610,22,64,30,1349,1403,2752,8,6,201848
15,30,188,20,365,431,42,49,19,1114,1273,2387,16,6,201848
15,31,183,67,308,507,17,44,6,1132,1147,2279,6,6,201848
15,32,160,14,269,443,24,43,28,981,1023,2004,9,6,201848
15,33,162,16,277,425,27,39,1,947,1046,1993,7,6,201848
15,34,128,17,204,418,12,32,83,894,910,1804,8,6,201848
15,35,278,47,281,544,24,60,0,1234,1199,2433,9,5.666666667,201848
15,36,208,32,294,398,104,39,10,1085,989,2074,9,5.5,201848
15,37,156,15,288,453,47,59,88,1106,1131,2237,7,6,201848
15,38,157,24,190,379,6,37,9,802,905,1707,6,5.5,201848
15,39,130,38,251,365,22,35,30,871,846,1717,4,6,201848
15,40,296,44,390,517,108,65,1,1421,1473,2894,9,6,201848
15,41,225,27,464,535,30,41,86,1408,1547,2955,11,6,201848
16,1,176,25,300,281,36,31,9,858,708,1566,7,5.333333333,201848
16,2,129,41,226,291,38,31,0,756,623,1379,9,5.25,201848
16,3,178,33,281,326,24,41,17,900,881,1781,10,5.25,201848
16,4,215,52,287,320,86,46,0,1006,1082,2088,8,5.5,201848
16,5,217,56,228,247,60,47,44,899,917,1816,10,5.666666667,201848
16,6,192,46,211,295,43,42,0,829,819,1648,12,5.5,201848
16,7,178,48,225,315,39,41,0,846,727,1573,9,5.5,201848
16,8,281,51,549,639,17,71,33,1641,1647,3288,12,6,201848
16,9,241,26,323,348,19,50,16,1023,948,1971,9,6.5,201848
16,10,176,24,350,366,13,25,4,958,891,1849,8,5.666666667,201848
16,11,207,45,306,279,154,63,15,1069,898,1967,10,5.4,201848
16,12,178,30,281,186,63,43,10,791,793,1584,10,5.25,201848
17,1,180,33,423,559,35,46,41,1317,1335,2652,11,6.5,201848
17,2,129,20,349,419,16,21,23,977,1023,2000,8,5.666666667,201848
17,3,191,22,380,531,11,38,0,1173,1140,2313,8,5.5,201848
17,4,224,29,374,524,30,45,9,1235,1231,2466,10,5.666666667,201848
17,5,62,15,98,188,15,30,3,411,440,851,5,5.5,201848
18,1,107,33,181,266,26,33,48,694,687,1381,7,5.25,201848
18,2,275,46,419,532,63,50,0,1385,1270,2655,10,6.25,201848
18,3,162,39,369,362,19,24,1,976,855,1831,8,5.5,201848
19,1,174,38,373,532,24,53,37,1231,1424,2655,9,6,201848
19,2,215,13,564,393,46,50,0,1281,1454,2735,9,6,201848
19,3,276,36,572,479,23,62,35,1483,1685,3168,7,6,201848
19,4,100,23,183,133,115,31,204,789,803,1592,5,6,201848
19,5,264,40,406,649,20,56,98,1533,1776,3309,8,6,201848
19,6,63,11,225,418,4,39,0,760,799,1559,5,6,201848
19,7,150,21,409,264,24,36,9,913,1073,1986,10,5.5,201848
19,8,39,4,81,102,2,11,0,239,278,517,7,6,201848
19,9,195,49,263,520,62,37,35,1161,1306,2467,9,5.25,201848
19,10,161,28,316,490,14,49,148,1206,1400,2606,8,5.333333333,201848
19,11,342,73,657,1262,29,126,106,2595,2968,5563,13,6.333333333,201848
19,12,158,18,440,230,9,42,15,912,1124,2036,8,5.666666667,201848
20,1,153,17,222,165,50,42,77,726,737,1463,7,5.5,201848
20,2,173,28,181,327,11,27,0,747,842,1589,6,5.333333333,201848
20,3,116,20,232,270,67,39,33,777,751,1528,6,5.333333333,201848
20,4,135,23,83,170,42,27,62,542,280,822,6,5.333333333,201848
20,5,160,28,176,396,29,28,0,817,827,1644,11,5.25,201848
20,6,255,21,327,411,198,49,7,1268,750,2018,8,5.25,201848
20,7,188,31,226,503,15,38,7,1008,834,1842,8,5.75,201848
20,8,424,53,484,904,33,105,234,2237,2424,4661,16,6.333333333,201848
20,9,229,27,243,242,85,42,106,974,1075,2049,8,5.666666667,201848
20,10,184,15,204,389,34,40,1,867,838,1705,9,5.25,201848
21,1,178,19,206,407,24,31,1,866,1168,2034,10,5.4,201848
21,2,107,10,172,235,101,17,3,645,836,1481,10,5.2,201848
21,3,184,22,294,236,102,46,87,971,1095,2066,9,5.5,201848
21,4,174,11,131,143,116,34,45,654,714,1368,7,5.25,201848
21,5,140,21,287,270,16,36,19,789,875,1664,8,5.666666667,201848
21,6,184,27,301,409,46,48,205,1220,1205,2425,6,6,201848
21,7,218,17,261,354,53,51,42,996,916,1912,9,5.666666667,201848
21,8,154,12,331,197,89,31,37,851,1006,1857,10,5.2,201848
21,9,156,26,457,432,68,44,80,1263,1267,2530,9,6,201848
21,10,200,12,320,337,47,38,124,1078,1164,2242,7,6,201848
21,11,54,4,132,109,8,12,11,330,382,712,6,5.5,201848
21,12,311,32,736,1028,57,79,144,2387,2481,4868,16,7,201848
21,13,181,12,263,278,56,63,51,904,821,1725,8,5.666666667,201848
21,14,192,12,279,168,103,29,92,875,1060,1935,12,5.333333333,201848
21,15,215,27,389,271,68,55,31,1056,1046,2102,7,5.5,201848
22,1,204,41,252,324,28,18,18,885,934,1819,11,5.2,201848
22,2,173,42,431,325,41,31,64,1107,987,2094,7,5.5,201848
22,3,260,72,726,683,46,51,14,1852,1812,3664,9,5.666666667,201848
22,4,189,53,584,560,41,49,27,1503,1509,3012,11,6,201848
22,5,151,32,432,214,69,38,35,971,845,1816,10,5.5,201848
23,1,261,12,1016,288,12,19,32,1640,1757,3397,14,5.6,201848
23,2,211,24,303,447,15,18,16,1034,1063,2097,11,5.5,201848
23,3,286,12,782,560,16,32,0,1688,1753,3441,15,7,201848
23,4,241,11,730,335,30,26,7,1380,1267,2647,10,5.5,201848
24,1,125,45,135,310,33,20,6,674,777,1451,10,5.2,201848
24,2,153,55,263,277,25,49,1,823,762,1585,6,5.5,201848
24,3,176,42,197,339,106,15,3,878,1028,1906,9,5.25,201848
24,4,149,47,220,215,80,32,169,912,806,1718,5,5.5,201848
24,5,240,45,463,656,13,59,0,1476,1518,2994,9,6.333333333,201848
24,6,190,44,370,413,33,52,8,1110,1278,2388,8,4.5,201848
24,7,195,26,242,321,77,28,1,890,1008,1898,9,5.25,201848
25,1,126,30,203,334,50,48,77,868,879,1747,13,6,201848
25,2,188,42,383,651,38,72,0,1374,1303,2677,7,5.5,201848
25,3,182,24,333,466,88,46,26,1165,1125,2290,8,5.6,201848
25,4,166,35,221,472,33,47,93,1067,1025,2092,8,5.333333333,201848
25,5,209,26,316,717,28,55,13,1364,1296,2660,10,4.75,201848
25,6,232,29,408,475,75,66,55,1340,1217,2557,8,5.75,201848
25,7,229,22,312,534,11,47,0,1155,1107,2262,6,6,201848
26,1,191,15,313,388,10,56,0,973,942,1915,9,5.5,201848
26,2,193,15,380,439,1,61,0,1089,1097,2186,12,5.4,201848
26,3,305,46,458,769,8,120,62,1768,1967,3735,17,5.75,201848
26,4,129,27,174,315,25,53,33,756,901,1657,9,5.2,201848
26,5,97,9,141,232,9,46,0,534,453,987,11,5.333333333,201848
26,6,173,25,374,497,7,59,0,1135,1283,2418,10,5.333333333,201848
26,7,145,15,201,317,27,28,0,733,839,1572,10,5.5,201848
27,1,196,27,251,394,36,31,0,935,1013,1948,8,5.5,201848
27,2,188,19,178,403,17,19,0,824,1021,1845,8,5.666666667,201848
27,3,168,13,139,420,14,25,1,780,755,1535,7,5.666666667,201848
27,4,219,23,339,710,12,37,62,1402,1387,2789,10,5.5,201848
27,5,135,13,156,322,32,22,8,688,401,1089,6,5.333333333,201848
27,6,170,23,224,474,8,32,0,931,753,1684,8,5.5,201848
28,1,220,16,297,333,6,25,0,897,1030,1927,13,6,201848
28,2,244,29,505,403,44,41,139,1405,1573,2978,13,6,201848
28,3,116,30,186,323,16,32,0,703,573,1276,7,5.333333333,201848
28,4,300,23,471,345,38,53,205,1435,1607,3042,15,6,201848
28,5,260,36,238,495,9,35,33,1106,1160,2266,12,5.4,201848
28,6,177,30,228,269,62,38,81,885,991,1876,14,5.166666667,201848
28,7,273,43,477,560,43,47,0,1443,1541,2984,6,6,201848
28,8,184,36,272,413,64,40,14,1023,1069,2092,9,6,201848
28,9,135,20,284,203,24,21,54,741,917,1658,11,5.75,201848
29,1,204,41,344,439,87,35,0,1150,1167,2317,7,5.5,201848
29,2,220,46,265,559,43,61,173,1367,1261,2628,13,6,201848
29,3,141,27,183,410,23,37,0,821,576,1397,5,5.666666667,201848
30,1,84,26,166,349,37,25,50,737,766,1503,7,5.333333333,201848
30,2,148,33,185,97,83,22,335,903,867,1770,8,5.25,201848
30,3,139,19,327,166,190,34,210,1085,1203,2288,6,5.666666667,201848
30,4,78,7,226,234,59,32,0,636,654,1290,8,6,201848
30,5,130,19,152,388,16,36,0,741,736,1477,7,5.5,201848
30,6,148,16,252,322,27,28,0,793,831,1624,9,5.333333333,201848
30,7,135,21,339,284,25,45,83,932,964,1896,11,5.25,201848
30,8,195,40,368,380,95,54,64,1196,1170,2366,11,5.4,201848
30,9,186,23,212,174,80,44,207,926,962,1888,8,5.5,201848
30,10,172,22,346,338,61,47,172,1158,1187,2345,9,5,201848
30,11,117,29,296,467,11,42,0,962,1062,2024,5,5.5,201848
30,12,209,26,492,829,20,75,2,1653,1669,3322,10,6.25,201848
30,13,185,19,217,316,96,45,250,1128,1118,2246,10,5.4,201848
30,14,141,35,288,143,100,46,120,873,968,1841,8,5.5,201848
30,15,264,27,261,279,127,82,258,1298,1327,2625,11,5.666666667,201848
30,16,154,17,250,362,139,64,199,1185,1179,2364,10,5.333333333,201848
30,17,147,33,223,289,82,48,79,901,1136,2037,8,5.5,201848
30,18,127,13,136,308,20,40,74,718,699,1417,8,5.25,201848
30,19,128,10,213,313,44,43,11,762,876,1638,13,5.6,201848
30,20,136,16,130,347,104,38,0,771,865,1636,10,5.4,201848
31,1,207,39,258,330,135,44,0,1013,1168,2181,8,5.5,201848
31,2,69,33,164,17,421,23,0,727,722,1449,6,5.333333333,201848
31,3,387,53,1056,1060,107,95,2,2760,2731,5491,21,6.666666667,201848
31,4,84,14,318,142,145,25,130,858,913,1771,5,5.5,201848
31,5,111,26,136,563,45,26,0,907,827,1734,5,5.333333333,201848
32,1,195,63,260,202,57,43,142,962,1008,1970,12,5.2,201848
32,2,193,89,296,141,246,48,139,1152,1301,2453,14,5.142857143,201848
32,3,169,66,284,368,17,51,15,970,957,1927,15,5.5,201848
32,4,217,106,297,329,42,64,85,1140,1497,2637,13,6.2,201848
1,1,278,46,299,402,61,36,6,1128,1126,2254,13,5.5,201849
1,2,257,58,527,431,54,51,39,1417,1494,2911,10,6,201849
1,3,272,72,528,475,28,55,35,1465,1507,2972,11,6,201849
2,1,224,22,425,420,20,56,3,1170,1248,2418,11,6,201849
2,2,281,23,332,727,12,65,0,1440,1521,2961,9,5.666666667,201849
2,3,354,33,589,519,18,86,2,1601,1515,3116,11,5.666666667,201849
2,4,234,19,534,232,46,33,6,1104,1114,2218,9,6,201849
2,5,501,56,991,597,206,106,36,2493,2581,5074,13,6.333333333,201849
2,6,247,21,467,450,31,56,0,1272,1383,2655,7,6,201849
2,7,321,26,590,493,15,67,27,1539,1505,3044,12,5.75,201849
2,8,294,17,688,545,10,71,9,1634,1527,3161,8,6,201849
3,1,179,29,364,422,24,68,24,1110,1014,2124,14,5.571428571,201849
3,2,142,6,531,306,16,48,0,1049,1018,2067,9,6,201849
4,1,165,19,296,477,42,40,1,1040,1130,2170,14,5.333333333,201849
4,2,215,21,470,450,54,39,7,1256,896,2152,14,4.6,201849
5,1,230,21,348,392,34,54,23,1102,1005,2107,9,5.666666667,201849
5,2,188,33,280,354,26,27,0,908,759,1667,10,5.2,201849
5,3,148,22,199,315,35,40,64,823,816,1639,9,5.5,201849
5,4,203,22,435,465,10,92,78,1305,1255,2560,11,5.75,201849
5,5,178,28,338,587,15,36,29,1211,1399,2610,8,6,201849
5,6,89,9,178,226,10,31,29,572,627,1199,11,5.5,201849
5,7,149,18,238,360,9,20,7,801,849,1650,11,6,201849
6,1,138,31,293,259,11,48,99,879,958,1837,13,5.666666667,201849
6,2,136,12,313,189,47,23,39,759,934,1693,9,5.666666667,201849
7,1,294,17,201,416,8,28,17,981,782,1763,11,5.25,201849
7,2,336,11,235,596,82,28,0,1288,1056,2344,12,5.25,201849
7,3,323,6,267,457,107,33,19,1212,906,2118,9,5.333333333,201849
7,4,150,17,182,302,12,42,93,798,568,1366,13,5.4,201849
7,5,382,10,219,644,12,32,1,1300,1064,2364,11,5.666666667,201849
7,6,211,20,273,482,16,60,21,1083,1152,2235,11,6,201849
7,7,248,31,385,528,23,49,5,1269,1096,2365,8,5.5,201849
7,8,287,24,278,545,22,63,0,1219,1104,2323,12,5.25,201849
7,9,194,31,329,474,24,52,11,1115,1259,2374,11,5.5,201849
7,10,221,11,249,587,42,34,0,1144,676,1820,10,5.5,201849
7,11,168,11,186,177,24,19,8,593,650,1243,6,5.333333333,201849
7,12,248,12,277,528,4,47,0,1116,1216,2332,9,5.5,201849
7,13,123,16,112,514,13,37,0,815,267,1082,9,5.25,201849
8,1,201,13,531,260,40,38,33,1116,857,1973,4,6,201849
8,2,268,32,639,470,33,57,14,1513,1434,2947,16,5.75,201849
8,3,238,33,395,564,22,51,21,1324,1186,2510,4,6,201849
8,4,183,36,465,379,28,75,143,1309,1103,2412,9,6,201849
8,5,181,35,291,340,27,44,0,918,1070,1988,10,5.25,201849
8,6,221,31,447,579,58,61,85,1482,1419,2901,6,6,201849
8,7,230,49,237,464,22,41,0,1043,1119,2162,7,5.25,201849
8,8,162,46,398,527,11,47,22,1213,1205,2418,12,6,201849
8,9,217,65,330,459,59,88,15,1233,1057,2290,10,5.2,201849
9,1,100,25,209,180,90,27,75,706,665,1371,5,6,201849
9,2,267,65,721,1203,113,80,131,2580,2651,5231,12,6,201849
9,3,111,44,417,507,56,62,195,1392,1389,2781,7,6,201849
9,4,138,30,361,567,72,52,65,1285,1413,2698,11,6,201849
9,5,110,16,339,551,62,61,28,1167,1266,2433,7,6,201849
9,6,82,31,245,239,107,48,122,874,843,1717,7,6,201849
9,7,82,22,292,605,5,36,2,1044,972,2016,9,6,201849
9,8,70,16,263,288,31,46,82,796,845,1641,5,6,201849
9,9,90,13,224,317,56,22,36,758,801,1559,5,6,201849
9,10,87,30,345,504,18,45,2,1031,1082,2113,6,6,201849
9,11,159,34,519,732,83,83,28,1638,1526,3164,7,7,201849
9,12,141,39,574,625,50,80,187,1696,1753,3449,11,6,201849
9,13,82,33,258,358,101,36,121,989,976,1965,4,6,201849
9,14,111,13,240,254,107,40,109,874,868,1742,5,6,201849
9,15,165,41,862,1127,40,91,244,2570,2756,5326,11,5.5,201849
9,16,228,50,711,1091,89,76,4,2249,2231,4480,15,7,201849
9,17,123,20,267,437,20,36,28,931,923,1854,6,6,201849
9,18,143,49,418,833,58,78,30,1609,1570,3179,12,6,201849
9,19,155,30,340,491,108,62,21,1207,1257,2464,5,6,201849
9,20,28,5,54,90,6,10,14,207,216,423,5,6,201849
9,21,90,10,172,269,35,22,33,631,677,1308,3,6,201849
9,22,118,18,228,321,112,54,114,965,959,1924,5,6,201849
9,23,127,29,324,549,69,48,100,1246,1177,2423,6,7,201849
9,24,270,49,656,1034,73,80,62,2224,2282,4506,12,6,201849
10,1,158,28,200,257,53,39,58,793,848,1641,8,3.5,201849
10,2,258,26,297,348,32,44,69,1074,1211,2285,9,5.5,201849
10,3,232,53,223,415,22,35,43,1023,1206,2229,11,5.4,201849
10,4,355,40,332,475,12,45,3,1262,1457,2719,13,6,201849
11,1,209,32,223,268,34,31,20,817,793,1610,6,5.666666667,201849
11,2,225,34,270,329,32,42,47,979,876,1855,6,6,201849
11,3,136,50,266,270,34,44,140,940,968,1908,3,6,201849
11,4,170,34,202,316,8,27,0,757,801,1558,10,4.6,201849
11,5,232,90,371,618,31,58,35,1435,1495,2930,7,6.5,201849
11,6,113,45,215,261,43,33,33,743,646,1389,9,7,201849
11,7,178,49,307,431,17,21,0,1003,795,1798,9,5.5,201849
11,8,161,50,336,473,32,44,32,1128,1163,2291,9,5.75,201849
11,9,205,110,352,486,17,59,51,1280,1293,2573,10,5.666666667,201849
11,10,197,110,316,352,44,40,64,1123,973,2096,10,5.6,201849
11,11,174,56,273,384,14,24,0,925,886,1811,5,6,201849
11,12,204,76,384,597,12,50,20,1343,1302,2645,7,6.5,201849
11,13,173,63,242,302,44,36,105,965,1032,1997,8,5.5,201849
11,14,195,52,307,367,51,40,14,1026,861,1887,8,5.5,201849
11,15,115,46,181,287,2,41,1,673,713,1386,9,6,201849
12,1,204,47,350,149,94,42,20,906,656,1562,10,5.2,201849
12,2,238,51,332,522,24,40,30,1237,1012,2249,10,5.5,201849
12,3,202,42,369,584,33,49,0,1279,1111,2390,11,5.2,201849
12,4,144,26,345,588,17,36,0,1156,1170,2326,9,6,201849
12,5,257,19,216,291,4,37,40,864,728,1592,10,5.25,201849
12,6,281,35,203,378,26,21,5,949,817,1766,10,5.25,201849
12,7,223,47,324,403,24,38,60,1119,1042,2161,8,5.333333333,201849
12,8,229,29,316,346,20,31,0,971,793,1764,9,5.25,201849
12,9,190,24,274,513,19,25,2,1047,981,2028,9,5.666666667,201849
13,1,173,25,142,367,53,40,19,819,913,1732,9,5.333333333,201849
13,2,139,29,139,357,98,36,19,817,837,1654,6,5.333333333,201849
13,3,164,21,212,243,115,47,0,802,898,1700,12,5.25,201849
13,4,194,26,338,283,82,38,50,1011,899,1910,9,5.666666667,201849
13,5,221,43,393,359,196,55,140,1407,1391,2798,9,5.75,201849
13,6,234,69,586,805,68,76,42,1880,1933,3813,13,5.75,201849
13,7,136,36,386,363,37,44,44,1046,1100,2146,8,5.5,201849
14,1,123,61,157,134,82,38,113,708,741,1449,7,5.5,201849
14,2,164,45,340,256,38,48,22,913,906,1819,5,5.666666667,201849
14,3,238,49,502,404,65,75,59,1392,1322,2714,8,5.4,201849
14,4,162,34,299,536,17,43,49,1140,1061,2201,10,6,201849
14,5,95,13,304,201,59,17,10,699,830,1529,9,5,201849
14,6,168,18,443,343,32,34,9,1047,1075,2122,11,6,201849
14,7,142,12,217,201,0,28,0,600,563,1163,6,6,201849
14,8,272,71,851,1337,28,100,34,2693,2813,5506,13,5.5,201849
14,9,80,21,153,272,41,19,11,597,471,1068,8,4,201849
14,10,182,37,400,479,12,57,2,1169,1136,2305,5,6.5,201849
14,11,208,40,301,520,47,42,92,1250,1122,2372,4,6,201849
14,12,238,27,471,242,12,46,18,1054,1060,2114,9,5.5,201849
14,13,213,27,375,367,21,46,40,1089,1063,2152,6,6,201849
14,14,121,34,315,479,16,40,93,1098,1284,2382,7,6,201849
14,15,233,46,296,414,74,57,11,1131,962,2093,10,5.6,201849
14,16,195,33,338,266,64,48,116,1060,954,2014,5,6,201849
14,17,140,49,238,207,38,41,46,759,1232,1991,7,5.25,201849
14,18,190,55,349,304,43,53,108,1102,1525,2627,9,5.4,201849
14,19,161,57,283,359,43,49,20,972,977,1949,8,5.25,201849
14,20,156,34,359,238,6,37,27,857,758,1615,10,5.666666667,201849
15,1,168,41,280,278,411,36,21,1235,1337,2572,7,5.333333333,201849
15,2,143,22,280,347,32,37,86,947,835,1782,6,6,201849
15,3,201,62,253,447,360,56,74,1453,1460,2913,10,5.666666667,201849
15,4,182,34,309,440,46,38,72,1121,1152,2273,4,6,201849
15,5,169,53,247,343,37,35,149,1033,1009,2042,8,5.666666667,201849
15,6,133,20,338,522,78,47,58,1196,1205,2401,7,6.5,201849
15,7,139,28,275,497,47,49,29,1064,1127,2191,10,6,201849
15,8,80,18,143,263,12,28,25,569,587,1156,4,6,201849
15,9,226,23,220,153,285,33,42,982,1010,1992,9,5.75,201849
15,10,111,21,197,358,60,30,55,832,791,1623,6,6,201849
15,11,155,23,312,521,63,37,6,1117,1192,2309,8,6,201849
15,12,183,26,569,507,27,46,15,1373,1406,2779,8,6,201849
15,13,84,28,196,358,111,36,0,813,820,1633,8,6,201849
15,14,88,30,173,327,19,35,2,674,585,1259,4,6,201849
15,15,154,52,236,495,25,49,127,1138,1119,2257,6,6,201849
15,16,175,40,356,706,13,44,20,1354,1332,2686,8,6,201849
15,17,89,28,164,265,19,37,196,798,913,1711,8,6,201849
15,18,189,48,295,571,47,52,78,1280,1265,2545,7,5.666666667,201849
15,19,175,87,482,1044,9,60,19,1876,1920,3796,10,6,201849
15,20,71,18,179,369,28,26,0,691,689,1380,6,6,201849
15,21,112,12,115,283,40,24,18,604,610,1214,6,5.5,201849
15,22,232,72,482,868,31,74,273,2032,2137,4169,14,6,201849
15,23,136,27,180,470,23,59,0,895,957,1852,6,5.333333333,201849
15,24,122,19,217,356,32,24,12,782,791,1573,4,6,201849
15,25,174,35,311,311,31,50,36,948,1050,1998,6,6,201849
15,26,140,13,222,332,74,34,24,839,848,1687,11,5.333333333,201849
15,27,189,45,342,479,29,55,203,1342,1471,2813,9,5.666666667,201849
15,28,205,41,515,403,93,54,58,1369,1423,2792,9,5.666666667,201849
15,29,183,37,391,712,8,72,29,1432,1362,2794,8,6,201849
15,30,202,27,377,444,45,37,28,1160,1193,2353,16,6,201849
15,31,157,58,283,560,12,43,0,1113,1181,2294,6,6,201849
15,32,153,17,232,444,35,38,19,938,881,1819,9,6,201849
15,33,173,16,252,425,18,53,3,940,984,1924,7,6,201849
15,34,136,18,199,420,12,30,80,895,884,1779,8,6,201849
15,35,245,28,279,486,16,47,5,1106,1156,2262,9,5.666666667,201849
15,36,214,30,338,340,140,35,7,1104,1132,2236,9,5.5,201849
15,37,159,16,290,419,61,50,118,1113,1070,2183,7,6,201849
15,38,135,32,264,434,8,30,13,916,941,1857,6,5.5,201849
15,39,147,26,254,375,13,28,10,853,874,1727,4,6,201849
15,40,253,53,387,502,118,69,14,1396,1461,2857,9,6,201849
15,41,223,34,476,586,34,50,54,1457,1415,2872,11,6,201849
16,1,179,20,272,232,45,37,0,785,607,1392,7,5.333333333,201849
16,2,124,40,166,313,26,33,0,702,808,1510,9,5.25,201849
16,3,182,38,259,311,39,36,19,884,814,1698,10,5.25,201849
16,4,183,45,358,279,80,61,0,1006,892,1898,8,5.5,201849
16,5,192,53,277,317,41,66,57,1003,926,1929,10,5.666666667,201849
16,6,199,47,240,249,35,40,0,810,775,1585,12,5.5,201849
16,7,241,37,238,237,56,51,0,860,845,1705,9,5.5,201849
16,8,248,47,496,547,19,47,14,1418,1574,2992,12,6,201849
16,9,201,27,290,348,20,43,23,952,989,1941,9,6.5,201849
16,10,148,19,276,375,15,43,1,877,915,1792,8,5.666666667,201849
16,11,197,36,214,164,140,32,29,812,889,1701,10,5.4,201849
16,12,139,25,182,183,29,41,7,606,778,1384,10,5.25,201849
17,1,176,33,417,563,33,58,44,1324,1293,2617,11,6.5,201849
17,2,144,20,368,387,21,38,29,1007,1066,2073,8,5.666666667,201849
17,3,172,33,354,496,12,43,1,1111,1185,2296,8,5.5,201849
17,4,199,38,373,525,30,51,18,1234,1193,2427,10,5.666666667,201849
17,5,81,15,156,205,25,26,5,513,544,1057,5,5.5,201849
18,1,17,0,28,35,1,2,0,83,157,240,2,1.5,201849
18,2,194,38,326,416,62,45,1,1082,1230,2312,11,6.5,201849
18,3,97,19,244,244,17,10,0,631,711,1342,8,5.25,201849
19,1,194,30,378,505,22,60,68,1257,1312,2569,9,6,201849
19,2,234,20,576,482,28,54,13,1407,1461,2868,9,6,201849
19,3,259,40,591,600,36,64,33,1623,1688,3311,7,6,201849
19,4,102,22,207,128,107,29,192,787,821,1608,5,6,201849
19,5,259,45,449,685,23,68,123,1652,1672,3324,8,6,201849
19,6,92,17,206,462,11,29,3,820,840,1660,5,6,201849
19,7,190,23,517,335,9,22,3,1099,1067,2166,10,5.5,201849
19,8,39,6,72,113,1,4,0,235,264,499,7,6,201849
19,9,153,36,206,302,51,35,42,825,865,1690,9,5.25,201849
19,10,185,29,291,576,10,62,135,1288,1268,2556,8,5.333333333,201849
19,11,353,73,675,1416,40,137,109,2803,2805,5608,13,6.333333333,201849
19,12,186,19,493,326,9,45,21,1099,1076,2175,8,5.666666667,201849
20,1,158,17,163,182,37,25,84,666,780,1446,7,5.5,201849
20,2,152,23,174,275,21,33,0,678,742,1420,6,5.333333333,201849
20,3,124,10,124,185,87,21,13,564,923,1487,6,5.333333333,201849
20,4,114,26,119,97,33,27,55,471,472,943,6,5.333333333,201849
20,5,132,32,245,536,34,27,0,1006,1221,2227,11,5.25,201849
20,6,151,6,194,282,139,25,4,801,995,1796,8,5.25,201849
20,7,192,24,215,486,18,35,16,986,928,1914,8,5.75,201849
20,8,402,41,509,974,21,112,238,2297,2371,4668,16,6.333333333,201849
20,9,213,22,218,265,121,59,101,999,940,1939,8,5.666666667,201849
20,10,159,11,179,247,18,18,0,632,763,1395,9,5.25,201849
21,1,162,16,197,440,20,30,0,865,795,1660,10,5.4,201849
21,2,105,15,243,278,156,23,28,848,974,1822,10,5.2,201849
21,3,163,14,322,219,105,42,93,958,1056,2014,9,5.5,201849
21,4,152,11,132,126,155,35,24,635,857,1492,7,5.25,201849
21,5,141,12,365,332,17,47,16,930,818,1748,8,5.666666667,201849
21,6,182,25,335,416,42,42,214,1256,1128,2384,6,6,201849
21,7,223,13,242,329,64,43,48,962,1199,2161,9,5.666666667,201849
21,8,150,11,381,236,78,50,28,934,963,1897,10,5.2,201849
21,9,176,20,436,434,68,68,98,1300,1253,2553,9,6,201849
21,10,166,13,322,357,26,38,112,1034,1050,2084,7,6,201849
21,11,77,4,169,161,24,16,10,461,344,805,6,5.5,201849
21,12,307,25,758,983,55,88,150,2366,2401,4767,16,7,201849
21,13,204,16,303,361,59,30,50,1023,1061,2084,8,5.666666667,201849
21,14,190,18,277,177,100,33,95,890,834,1724,12,5.333333333,201849
21,15,206,15,346,308,59,43,40,1017,962,1979,7,5.5,201849
22,1,186,62,258,400,31,17,27,981,1015,1996,11,5.2,201849
22,2,118,28,403,269,13,40,19,890,999,1889,7,5.5,201849
22,3,260,80,700,665,40,58,21,1824,1807,3631,9,6,201849
22,4,177,57,562,582,24,50,47,1499,1585,3084,11,6,201849
22,5,137,27,481,212,94,31,25,1007,1101,2108,10,5.5,201849
23,1,272,8,1097,335,20,32,31,1795,1932,3727,14,5.6,201849
23,2,240,33,359,569,11,28,0,1240,948,2188,11,5.5,201849
23,3,261,7,887,529,28,33,0,1745,1708,3453,15,7,201849
23,4,218,11,715,336,38,31,7,1356,1209,2565,10,5.5,201849
24,1,144,57,139,294,36,25,2,697,620,1317,10,5.2,201849
24,2,148,47,262,257,27,33,0,774,662,1436,6,5.5,201849
24,3,140,43,257,426,173,24,1,1064,971,2035,9,5.25,201849
24,4,129,36,210,204,78,30,157,844,793,1637,5,5.5,201849
24,5,250,36,456,530,11,65,39,1387,1417,2804,9,6.333333333,201849
24,6,155,52,384,489,40,55,0,1175,1186,2361,8,4.5,201849
24,7,192,52,371,636,58,37,0,1346,1089,2435,9,5.25,201849
25,1,103,17,190,227,28,30,36,631,787,1418,13,4.75,201849
25,2,193,33,369,563,20,61,0,1239,1281,2520,7,5.5,201849
25,3,187,18,291,365,45,30,30,966,1059,2025,8,5.6,201849
25,4,185,41,218,349,16,27,139,975,1130,2105,8,5.333333333,201849
25,5,252,23,280,654,24,63,4,1300,1276,2576,10,5.25,201849
25,6,175,20,280,344,67,34,36,956,1123,2079,8,5,201849
25,7,202,14,335,562,5,55,0,1173,1146,2319,6,6,201849
26,1,191,13,321,438,11,56,0,1030,928,1958,9,5.5,201849
26,2,213,17,411,404,1,55,4,1105,1170,2275,12,5.4,201849
26,3,277,36,501,714,13,106,54,1701,1593,3294,17,5.75,201849
26,4,166,21,171,406,38,56,51,909,726,1635,9,5.2,201849
26,5,74,9,173,263,12,35,0,566,418,984,11,5.333333333,201849
26,6,163,34,372,516,12,54,0,1151,1058,2209,10,5.333333333,201849
26,7,145,10,197,269,18,39,0,678,577,1255,10,5.5,201849
27,1,215,33,298,500,51,41,0,1138,1092,2230,8,5.5,201849
27,2,253,21,256,471,23,40,0,1064,956,2020,8,5.666666667,201849
27,3,162,16,179,458,8,27,1,851,803,1654,7,5.666666667,201849
27,4,226,25,347,754,11,39,68,1470,1371,2841,10,5.5,201849
27,5,142,15,157,366,20,14,13,727,444,1171,6,5.333333333,201849
27,6,172,26,242,497,12,33,0,982,913,1895,8,5.5,201849
28,1,232,18,408,394,17,30,0,1099,961,2060,13,6,201849
28,2,229,41,491,370,43,49,157,1380,1408,2788,13,6,201849
28,3,127,33,211,444,17,23,0,855,1042,1897,7,5.333333333,201849
28,4,329,46,478,392,59,60,222,1586,1581,3167,15,6,201849
28,5,218,33,249,515,15,24,33,1087,1208,2295,12,5.4,201849
28,6,217,35,220,319,57,27,63,938,931,1869,14,5.166666667,201849
28,7,310,31,526,574,75,59,0,1575,1528,3103,6,6,201849
28,8,164,46,295,408,93,44,15,1065,1070,2135,9,6,201849
28,9,150,19,302,190,20,26,103,810,850,1660,11,5.75,201849
29,1,193,40,340,394,61,38,1,1067,1063,2130,7,5.5,201849
29,2,175,26,263,434,40,55,145,1138,1179,2317,13,6,201849
29,3,106,43,196,389,15,27,0,776,873,1649,5,5.666666667,201849
30,1,108,45,252,418,32,27,47,929,932,1861,7,5.333333333,201849
30,2,150,36,193,88,87,19,350,923,1147,2070,8,5.25,201849
30,3,125,17,318,152,126,29,218,985,1228,2213,6,5.666666667,201849
30,4,100,9,260,270,55,41,1,736,675,1411,8,6,201849
30,5,128,37,226,517,13,44,0,965,819,1784,7,5.5,201849
30,6,193,30,298,388,35,44,0,988,855,1843,9,5.333333333,201849
30,7,146,26,216,262,23,31,101,805,817,1622,12,5.25,201849
30,8,169,45,402,457,89,58,148,1368,1258,2626,11,5.4,201849
30,9,183,22,228,186,71,25,176,891,834,1725,8,5.5,201849
30,10,131,24,343,311,50,37,175,1071,1025,2096,9,5.25,201849
30,11,110,24,309,463,10,43,0,959,1190,2149,5,5.5,201849
30,12,234,27,507,882,25,69,7,1751,1718,3469,10,6.25,201849
30,13,157,20,225,263,111,60,199,1035,911,1946,10,5.4,201849
30,14,120,30,269,186,127,41,152,925,941,1866,8,5.5,201849
30,15,226,23,281,284,128,81,252,1275,1337,2612,11,5.666666667,201849
30,16,178,22,241,334,109,77,210,1171,1193,2364,10,5.333333333,201849
30,17,165,36,191,323,89,39,28,871,853,1724,8,5.25,201849
30,18,181,16,166,260,42,44,36,745,742,1487,8,5.25,201849
30,19,139,22,257,410,45,34,15,922,873,1795,13,4.8,201849
30,20,207,17,267,396,178,49,1,1115,739,1854,10,5.4,201849
31,1,202,42,219,128,323,49,0,963,896,1859,8,5.5,201849
31,2,92,69,224,6,514,41,0,946,839,1785,6,5.333333333,201849
31,3,391,40,1050,1004,113,71,0,2669,2757,5426,21,6.666666667,201849
31,4,98,21,318,169,109,23,138,876,1043,1919,6,5.5,201849
31,5,109,26,149,474,24,31,0,813,752,1565,6,5.333333333,201849
32,1,138,81,263,226,42,58,150,958,971,1929,12,5.2,201849
32,2,191,102,285,116,253,48,172,1167,974,2141,14,5.142857143,201849
32,3,188,82,278,464,21,39,19,1091,1301,2392,15,5.5,201849
32,4,184,131,282,387,40,58,82,1164,1040,2204,13,5.4,201849
1,1,192,33,199,247,44,24,10,749,809,1558,13,4.5,201850
1,2,209,32,400,321,43,38,42,1085,1189,2274,10,5,201850
1,3,217,57,419,393,30,49,28,1193,1249,2442,11,5,201850
2,1,159,10,304,300,16,38,0,827,907,1734,11,5,201850
2,2,239,26,359,600,18,72,0,1314,1356,2670,9,4.666666667,201850
2,3,259,22,438,402,41,61,47,1270,1283,2553,12,5,201850
2,4,190,13,403,195,47,26,7,881,905,1786,9,5,201850
2,5,368,47,831,500,145,93,17,2001,2219,4220,13,5.333333333,201850
2,6,193,9,393,358,27,33,0,1013,1105,2118,7,5,201850
2,7,226,21,438,317,15,48,38,1103,1217,2320,12,4.75,201850
2,8,222,10,550,440,10,34,3,1269,1197,2466,8,5,201850
3,1,120,19,290,358,14,55,9,865,860,1725,14,4.142857143,201850
3,2,129,8,367,238,15,19,0,776,865,1641,9,5,201850
4,1,132,9,198,312,44,23,2,720,860,1580,14,4.333333333,201850
4,2,160,22,366,323,25,19,6,921,1018,1939,14,4.4,201850
5,1,179,20,275,291,37,55,37,894,871,1765,9,4.666666667,201850
5,2,90,8,131,193,11,8,0,441,616,1057,10,4.2,201850
5,3,142,18,191,263,19,37,63,733,746,1479,9,4.5,201850
5,4,175,28,374,374,13,68,70,1102,1269,2371,11,4.75,201850
5,5,184,18,309,496,15,41,22,1085,1067,2152,8,5,201850
5,6,116,13,144,236,7,23,46,585,619,1204,11,4.5,201850
5,7,129,24,237,267,69,28,10,764,646,1410,10,4.5,201850
6,1,110,20,226,254,20,27,71,728,771,1499,14,4.833333333,201850
6,2,124,21,266,186,63,24,23,707,691,1398,9,4.666666667,201850
7,1,153,12,167,222,2,30,28,614,1066,1680,11,4.25,201850
7,2,223,12,129,287,8,31,0,690,416,1106,12,4.25,201850
7,3,233,8,217,253,69,49,18,847,616,1463,9,4.333333333,201850
7,4,101,8,109,234,1,29,7,489,619,1108,13,4.4,201850
7,5,292,11,205,395,42,26,0,971,733,1704,11,4.666666667,201850
7,6,173,15,202,358,29,42,19,838,930,1768,10,4.666666667,201850
7,7,161,25,240,363,25,45,4,863,753,1616,8,4.5,201850
7,8,196,16,128,486,9,23,0,858,716,1574,12,4.25,201850
7,9,128,12,195,336,17,29,0,717,869,1586,11,4.5,201850
7,10,120,6,139,434,16,21,0,736,657,1393,10,4.5,201850
7,11,55,5,31,47,9,4,2,153,280,433,6,4.333333333,201850
7,12,149,8,189,410,5,29,0,790,913,1703,9,4.5,201850
7,13,111,23,103,351,6,30,0,624,539,1163,9,4.25,201850
8,1,163,9,385,231,21,19,16,844,866,1710,4,5,201850
8,2,224,22,490,311,15,47,18,1127,1159,2286,16,4.75,201850
8,3,146,29,372,411,13,33,10,1014,1068,2082,4,5,201850
8,4,110,24,337,316,26,49,93,955,867,1822,9,5,201850
8,5,136,19,260,236,27,40,0,718,779,1497,10,4.25,201850
8,6,146,22,373,428,40,57,54,1120,1126,2246,7,5.5,201850
8,7,173,45,182,355,7,34,0,796,896,1692,7,4.25,201850
8,8,158,25,326,471,12,35,16,1043,928,1971,12,4.5,201850
8,9,141,30,170,227,33,46,14,661,700,1361,10,4.2,201850
9,1,71,19,115,106,92,18,65,486,533,1019,5,5,201850
9,2,160,53,428,755,82,54,93,1625,1514,3139,12,4,201850
9,3,94,35,340,418,46,38,135,1106,1045,2151,7,5,201850
9,4,94,19,235,409,26,24,49,856,995,1851,11,5,201850
9,5,84,16,224,405,43,45,10,827,860,1687,7,5,201850
9,6,54,9,172,177,61,20,67,560,660,1220,7,5,201850
9,7,73,13,187,454,3,33,1,764,793,1557,9,5,201850
9,8,45,6,152,209,7,27,74,520,632,1152,5,5,201850
9,9,74,7,152,255,30,24,29,571,581,1152,5,5,201850
9,10,74,18,228,358,25,43,4,750,723,1473,6,5,201850
9,11,114,25,319,573,43,61,24,1159,1098,2257,7,6,201850
9,12,86,27,433,458,33,53,144,1234,1214,2448,11,5,201850
9,13,53,15,170,256,61,31,73,659,781,1440,4,5,201850
9,14,75,9,173,187,76,29,81,630,672,1302,5,5,201850
9,15,106,30,462,571,19,58,145,1391,1421,2812,11,3.75,201850
9,16,170,49,474,763,65,60,2,1583,1743,3326,15,6,201850
9,17,70,14,139,280,16,16,16,551,712,1263,6,5,201850
9,18,97,34,265,600,24,35,23,1078,1081,2159,12,5,201850
9,19,84,12,147,248,66,27,22,606,653,1259,5,3,201850
9,20,9,3,32,52,5,4,2,107,144,251,5,4,201850
9,21,63,8,94,183,14,12,17,391,444,835,3,5,201850
9,22,105,7,152,238,56,32,70,660,691,1351,5,5,201850
9,23,90,17,223,413,39,32,46,860,915,1775,6,6,201850
9,24,172,32,438,812,81,65,50,1650,1619,3269,12,5,201850
10,1,173,45,207,246,114,29,45,859,830,1689,12,4,201850
10,2,251,29,283,313,21,31,64,992,974,1966,9,4.5,201850
10,3,167,37,170,281,20,34,53,762,939,1701,11,4.4,201850
10,4,288,37,347,465,13,40,6,1196,1159,2355,14,5.333333333,201850
11,1,139,30,188,229,42,21,22,671,728,1399,6,4.666666667,201850
11,2,136,33,178,237,28,21,18,651,789,1440,7,5,201850
11,3,135,48,218,224,18,28,110,781,869,1650,3,5,201850
11,4,172,38,200,310,11,26,0,757,735,1492,10,4.2,201850
11,5,179,80,359,432,15,51,24,1140,1285,2425,7,5.5,201850
11,6,83,27,192,215,31,33,30,611,607,1218,8,5,201850
11,7,175,34,316,340,11,32,0,908,842,1750,9,4.5,201850
11,8,141,31,254,360,16,25,19,846,866,1712,9,4.75,201850
11,9,152,53,273,348,16,34,38,914,1044,1958,10,4.666666667,201850
11,10,129,69,253,317,38,26,65,897,948,1845,10,4.6,201850
11,11,128,35,241,295,19,20,0,738,709,1447,5,5,201850
11,12,142,38,298,455,9,29,7,978,1093,2071,7,5.5,201850
11,13,136,44,194,215,30,21,82,722,805,1527,8,4.5,201850
11,14,140,65,219,346,21,23,3,817,926,1743,8,4.5,201850
11,15,87,32,126,245,2,26,1,519,548,1067,9,5,201850
12,1,148,35,353,143,85,27,17,808,694,1502,10,4.2,201850
12,2,149,37,175,310,36,25,18,750,867,1617,10,4.5,201850
12,3,120,42,219,456,21,16,0,874,557,1431,11,4.2,201850
12,4,102,22,267,405,16,27,2,841,842,1683,9,5,201850
12,5,204,16,143,246,5,18,39,671,557,1228,10,4.25,201850
12,6,166,17,98,253,11,12,7,564,472,1036,10,4.25,201850
12,7,155,20,216,346,12,26,37,812,756,1568,8,3.333333333,201850
12,8,201,19,205,244,9,18,0,696,739,1435,9,4.25,201850
12,9,147,19,179,319,9,25,4,702,716,1418,9,4.666666667,201850
13,1,98,13,85,147,70,12,2,427,499,926,9,4.333333333,201850
13,2,86,14,95,198,50,24,8,475,619,1094,6,4.333333333,201850
13,3,65,14,105,154,55,18,0,411,629,1040,12,4.25,201850
13,4,116,13,194,189,66,25,28,631,601,1232,9,4.666666667,201850
13,5,97,14,288,218,54,38,68,777,1062,1839,9,4.75,201850
13,6,140,31,426,507,33,43,36,1216,1389,2605,13,4.75,201850
13,7,101,30,247,298,47,25,46,794,851,1645,8,4.25,201850
14,1,80,37,116,133,51,29,95,541,440,981,7,4.25,201850
14,2,136,14,253,199,37,47,11,697,595,1292,5,4.666666667,201850
14,3,152,43,405,260,37,42,46,985,1010,1995,8,4.4,201850
14,4,132,22,228,445,20,24,27,898,985,1883,10,5,201850
14,5,130,15,394,281,44,38,11,913,864,1777,9,4.5,201850
14,6,174,10,423,314,30,36,16,1003,909,1912,11,5,201850
14,7,98,9,235,161,0,16,0,519,435,954,6,5,201850
14,8,267,53,676,1040,19,80,59,2194,2209,4403,13,4.666666667,201850
14,9,74,29,170,321,32,19,9,654,766,1420,8,5,201850
14,10,139,40,336,364,12,40,12,943,993,1936,5,5.5,201850
14,11,153,30,188,384,46,31,106,938,1006,1944,4,5,201850
14,12,191,27,419,220,8,35,12,912,853,1765,9,4.5,201850
14,13,132,31,276,301,14,43,42,839,905,1744,6,5,201850
14,14,109,29,276,377,36,32,52,911,794,1705,7,5,201850
14,15,189,48,215,301,53,47,13,866,959,1825,10,4.6,201850
14,16,135,32,258,214,67,31,88,825,863,1688,5,5,201850
14,17,107,39,190,174,32,27,46,615,679,1294,7,4.25,201850
14,18,171,53,312,340,30,46,107,1059,999,2058,9,4.4,201850
14,19,166,32,258,345,23,29,21,874,923,1797,8,4.25,201850
14,20,121,17,289,167,15,20,13,642,665,1307,10,4.666666667,201850
15,1,119,19,207,100,375,26,25,871,839,1710,7,4.333333333,201850
15,2,100,13,184,260,31,28,34,650,702,1352,6,5,201850
15,3,157,33,186,312,216,33,48,985,971,1956,10,4.666666667,201850
15,4,144,15,217,330,28,22,69,825,849,1674,4,5,201850
15,5,100,26,122,231,32,13,66,590,693,1283,8,4.666666667,201850
15,6,135,17,211,422,48,26,38,897,897,1794,7,5.5,201850
15,7,104,13,219,373,43,24,23,799,822,1621,10,5,201850
15,8,69,16,113,197,10,17,10,432,403,835,4,5,201850
15,9,145,16,123,123,185,19,25,636,868,1504,9,4.75,201850
15,10,75,8,146,275,41,27,28,600,665,1265,6,5,201850
15,11,118,15,231,371,45,27,10,817,871,1688,8,5,201850
15,12,120,11,301,366,21,34,11,864,1074,1938,8,5,201850
15,13,72,25,154,236,81,28,0,596,585,1181,8,5,201850
15,14,61,15,124,206,16,24,1,447,456,903,4,5,201850
15,15,98,40,188,384,21,35,56,822,891,1713,6,5,201850
15,16,133,26,181,440,12,27,19,838,1005,1843,8,5,201850
15,17,76,17,108,173,5,37,135,551,624,1175,8,5,201850
15,18,152,12,224,329,39,26,52,834,905,1739,7,4.666666667,201850
15,19,146,49,315,757,12,45,13,1337,1332,2669,10,5,201850
15,20,53,11,142,274,15,33,6,534,578,1112,6,5,201850
15,21,29,4,50,115,7,12,15,232,349,581,6,4.5,201850
15,22,156,43,333,670,31,55,211,1499,1643,3142,14,5,201850
15,23,83,11,106,284,16,27,0,527,739,1266,6,4.333333333,201850
15,24,63,10,142,216,16,18,2,467,538,1005,4,5,201850
15,25,120,13,190,209,18,32,39,621,786,1407,6,5,201850
15,26,79,4,135,228,44,26,5,521,641,1162,11,4.333333333,201850
15,27,126,14,256,311,16,33,124,880,1014,1894,9,4.666666667,201850
15,28,159,16,375,356,61,41,61,1069,1164,2233,9,4.666666667,201850
15,29,123,23,268,449,19,37,28,947,1024,1971,8,5,201850
15,30,111,15,253,313,25,34,17,768,851,1619,16,5,201850
15,31,122,31,179,351,14,32,8,737,889,1626,6,5,201850
15,32,91,6,152,288,19,27,10,593,721,1314,9,5,201850
15,33,106,7,194,294,21,30,4,656,749,1405,7,5,201850
15,34,76,15,123,289,7,24,47,581,628,1209,8,5,201850
15,35,161,32,159,307,8,32,0,699,903,1602,9,4.666666667,201850
15,36,137,13,186,271,68,26,5,706,701,1407,9,4.5,201850
15,37,111,15,191,313,34,32,71,767,894,1661,7,5,201850
15,38,109,24,169,315,9,17,6,649,731,1380,6,4.5,201850
15,39,72,20,150,246,6,18,17,529,629,1158,4,5,201850
15,40,163,18,238,293,102,44,9,867,1025,1892,9,5,201850
15,41,155,13,310,380,19,23,42,942,1105,2047,11,5,201850
16,1,122,13,171,208,14,28,0,556,903,1459,7,4.333333333,201850
16,2,99,24,166,151,19,22,0,481,542,1023,9,4.25,201850
16,3,111,13,135,188,27,25,13,512,629,1141,10,4.25,201850
16,4,175,19,251,216,45,34,0,740,758,1498,8,4.5,201850
16,5,142,37,180,215,27,49,35,685,708,1393,10,4.666666667,201850
16,6,120,22,146,154,28,14,2,486,575,1061,12,4.5,201850
16,7,147,22,158,172,34,25,0,558,597,1155,9,4.5,201850
16,8,219,32,405,486,10,41,18,1211,1194,2405,12,5,201850
16,9,136,28,209,280,11,28,19,711,803,1514,9,5.5,201850
16,10,74,14,184,248,7,25,1,553,711,1264,8,4.666666667,201850
16,11,107,20,130,129,71,29,13,499,670,1169,10,4.4,201850
16,12,117,28,188,127,54,24,5,543,640,1183,10,4.25,201850
17,1,122,23,332,368,29,35,28,937,989,1926,11,5.5,201850
17,2,83,10,221,297,12,25,18,666,778,1444,8,4.666666667,201850
17,3,138,14,238,326,8,30,0,754,929,1683,8,4.5,201850
17,4,121,13,238,332,16,22,24,766,915,1681,10,4.666666667,201850
17,5,52,3,59,111,6,11,1,243,304,547,5,4.5,201850
18,1,68,11,51,114,8,20,14,286,482,768,7,3.5,201850
18,2,230,39,291,375,46,38,0,1019,1072,2091,11,6,201850
18,3,109,34,302,309,6,26,0,786,925,1711,8,4.75,201850
19,1,151,31,325,457,25,48,49,1086,1136,2222,9,5,201850
19,2,201,15,509,473,19,40,22,1279,1187,2466,9,5,201850
19,3,222,27,529,459,33,56,37,1363,1304,2667,7,5,201850
19,4,85,24,152,123,85,28,200,697,582,1279,5,5,201850
19,5,225,48,424,586,23,55,156,1517,1333,2850,8,5,201850
19,6,69,16,180,440,4,26,18,753,639,1392,5,5,201850
19,7,113,18,369,163,5,18,2,688,779,1467,10,4.5,201850
19,8,45,4,101,88,3,13,0,254,237,491,7,5,201850
19,9,125,27,177,281,53,25,36,724,790,1514,9,4.25,201850
19,10,130,20,233,510,8,38,101,1040,1069,2109,8,4.333333333,201850
19,11,315,71,606,1297,25,85,70,2469,2323,4792,13,5.333333333,201850
19,12,127,19,399,221,30,27,10,833,780,1613,8,4.666666667,201850
20,1,129,14,136,129,30,30,47,515,527,1042,7,4.5,201850
20,2,95,7,71,138,5,11,0,327,419,746,6,4.333333333,201850
20,3,66,5,77,108,32,15,20,323,643,966,6,4.333333333,201850
20,4,71,10,41,91,23,29,25,290,387,677,6,4.333333333,201850
20,5,114,11,191,394,16,26,0,752,796,1548,11,4.25,201850
20,6,122,1,83,158,71,18,0,453,952,1405,8,4.25,201850
20,7,128,18,134,350,13,27,10,680,761,1441,8,4.75,201850
20,8,228,19,303,510,10,41,157,1268,1495,2763,15,5,201850
20,9,126,15,99,154,55,21,38,508,738,1246,8,4.666666667,201850
20,10,107,7,100,197,12,10,0,433,535,968,9,4.25,201850
21,1,116,12,142,298,8,16,0,592,641,1233,10,4.4,201850
21,2,111,12,165,173,118,24,8,611,541,1152,10,4.2,201850
21,3,103,19,168,144,82,28,39,583,786,1369,9,4.5,201850
21,4,65,6,80,75,38,18,22,304,448,752,7,4.25,201850
21,5,88,8,217,235,12,22,7,589,614,1203,8,4.666666667,201850
21,6,126,12,221,301,22,31,102,815,960,1775,6,5,201850
21,7,104,6,106,177,32,30,26,481,583,1064,9,4.666666667,201850
21,8,67,3,129,128,29,6,17,379,555,934,10,4.2,201850
21,9,91,11,281,296,38,28,62,807,907,1714,9,5,201850
21,10,124,9,238,243,19,25,69,727,803,1530,7,5,201850
21,11,34,5,91,63,8,5,1,207,263,470,6,3.5,201850
21,12,218,19,556,673,42,49,78,1635,1907,3542,15,5.5,201850
21,13,95,4,127,141,28,13,25,433,703,1136,8,4.666666667,201850
21,14,96,8,143,83,65,18,36,449,561,1010,12,4.333333333,201850
21,15,130,8,257,187,37,29,31,679,710,1389,7,4.5,201850
22,1,140,43,209,320,45,18,18,793,728,1521,11,4.2,201850
22,2,112,24,251,270,53,23,48,781,863,1644,7,4.5,201850
22,3,207,94,561,596,61,51,0,1570,1601,3171,9,5,201850
22,4,132,44,460,429,20,32,29,1146,1229,2375,11,5.333333333,201850
22,5,85,16,264,163,53,15,7,603,655,1258,10,4.5,201850
23,1,249,7,832,275,18,20,16,1417,1378,2795,14,4.6,201850
23,2,177,15,256,334,7,19,0,808,795,1603,11,4.5,201850
23,3,215,6,640,375,16,24,0,1276,1540,2816,15,6,201850
23,4,126,7,523,260,34,24,6,980,1181,2161,10,4.5,201850
24,1,132,42,103,180,27,24,2,510,530,1040,10,4.2,201850
24,2,102,39,182,242,27,35,1,628,706,1334,6,4.5,201850
24,3,122,47,165,243,59,22,1,659,840,1499,9,4.25,201850
24,4,111,36,151,141,43,29,100,611,763,1374,5,4.5,201850
24,5,164,31,325,462,13,41,38,1074,1041,2115,10,5.666666667,201850
24,6,137,38,246,351,25,27,9,833,835,1668,8,3,201850
24,7,130,17,156,279,35,18,0,635,664,1299,9,4.25,201850
25,1,100,12,142,223,14,19,61,571,655,1226,13,5,201850
25,2,201,19,273,484,21,43,0,1041,1102,2143,7,4.5,201850
25,3,131,11,168,276,36,20,13,655,775,1430,8,4.6,201850
25,4,123,25,155,326,20,33,91,773,762,1535,8,4.333333333,201850
25,5,156,26,230,513,16,41,0,982,1012,1994,10,4.25,201850
25,6,141,23,285,327,54,56,45,931,1051,1982,8,4.75,201850
25,7,175,18,227,400,5,42,0,867,906,1773,6,5,201850
26,1,147,13,244,312,3,42,0,761,709,1470,9,4.5,201850
26,2,153,13,335,375,1,46,2,925,852,1777,12,4.4,201850
26,3,220,25,333,572,12,96,55,1313,1484,2797,17,4.75,201850
26,4,101,24,156,308,16,35,43,683,617,1300,9,4.2,201850
26,5,84,9,137,207,3,35,0,475,441,916,11,4.333333333,201850
26,6,159,14,304,415,7,41,0,940,879,1819,10,4.333333333,201850
26,7,115,13,175,198,23,29,0,553,522,1075,10,4.5,201850
27,1,145,27,219,332,25,16,0,764,790,1554,8,4.5,201850
27,2,192,14,208,407,20,26,1,868,740,1608,8,4.666666667,201850
27,3,124,11,151,309,10,15,1,621,599,1220,7,4.666666667,201850
27,4,140,21,177,428,3,24,44,837,1020,1857,10,4.5,201850
27,5,107,4,85,206,16,14,7,439,479,918,6,4.333333333,201850
27,6,112,9,157,295,10,16,1,600,745,1345,8,4.5,201850
28,1,186,18,335,349,12,23,0,923,656,1579,13,5,201850
28,2,201,37,468,328,45,44,161,1284,1104,2388,13,5,201850
28,3,92,33,195,357,10,21,0,708,679,1387,7,4.333333333,201850
28,4,259,32,448,329,54,41,193,1356,1243,2599,15,5,201850
28,5,182,35,188,408,20,39,30,902,914,1816,11,4.4,201850
28,6,158,22,176,238,50,20,60,724,801,1525,14,4.166666667,201850
28,7,166,19,330,395,43,24,0,977,1031,2008,5,5,201850
28,8,132,44,236,370,82,35,13,912,744,1656,9,5,201850
28,9,138,16,250,192,27,25,78,726,680,1406,11,4.75,201850
29,1,131,16,214,248,51,17,0,677,910,1587,7,4.5,201850
29,2,120,18,171,197,45,25,42,618,934,1552,13,4.75,201850
29,3,79,18,93,215,12,24,0,441,613,1054,5,4.666666667,201850
30,1,42,16,90,239,9,13,21,430,641,1071,7,4.333333333,201850
30,2,93,19,114,63,104,10,157,560,645,1205,8,4.25,201850
30,3,120,9,261,129,115,22,103,759,679,1438,6,4.666666667,201850
30,4,70,12,204,215,36,33,1,571,559,1130,8,5,201850
30,5,113,22,140,366,16,41,0,698,587,1285,7,4.5,201850
30,6,102,11,260,235,33,17,1,659,535,1194,9,4.333333333,201850
30,7,119,16,214,141,29,16,46,581,934,1515,11,4.25,201850
30,8,135,22,241,318,42,39,45,842,677,1519,11,4.4,201850
30,9,123,13,136,125,44,27,87,555,730,1285,8,4.5,201850
30,10,88,12,184,231,31,32,90,668,963,1631,9,4,201850
30,11,96,14,230,339,15,36,2,732,749,1481,5,4.5,201850
30,12,173,32,446,604,24,49,4,1332,1266,2598,10,5.25,201850
30,13,149,17,154,257,95,22,166,860,934,1794,10,4.4,201850
30,14,120,14,221,99,87,30,75,646,558,1204,8,4.5,201850
30,15,164,17,193,211,58,43,173,859,972,1831,11,4.666666667,201850
30,16,121,17,205,200,69,34,111,757,912,1669,10,4.333333333,201850
30,17,119,24,152,210,67,29,50,651,746,1397,8,4.5,201850
30,18,72,9,72,167,12,17,28,377,578,955,8,4.25,201850
30,19,94,5,184,231,43,19,12,588,540,1128,11,3.6,201850
30,20,152,20,147,283,94,23,0,719,679,1398,10,4.4,201850
31,1,133,30,161,104,270,31,0,729,752,1481,8,4.5,201850
31,2,70,14,119,3,328,12,0,546,594,1140,6,4.333333333,201850
31,3,246,37,770,783,78,63,0,1977,2068,4045,20,5.333333333,201850
31,4,72,13,215,129,145,24,134,732,686,1418,6,4,201850
31,5,90,27,120,393,34,15,0,679,731,1410,6,4.333333333,201850
32,1,107,46,187,169,46,34,104,693,785,1478,12,4.2,201850
32,2,148,84,288,113,248,48,135,1064,914,1978,14,4.142857143,201850
32,3,123,64,239,367,17,32,17,859,628,1487,15,4.5,201850
32,4,155,112,235,331,45,37,49,964,687,1651,13,4.4,201850
1,1,273,37,281,332,64,29,7,1023,1191,2214,13,5.5,201851
1,2,282,59,582,506,70,60,66,1625,1596,3221,10,6,201851
1,3,309,86,618,520,58,50,36,1677,1524,3201,11,6,201851
2,1,166,20,381,437,19,38,10,1071,1205,2276,11,6,201851
2,2,240,33,412,807,16,62,0,1570,1550,3120,9,5.666666667,201851
2,3,398,38,639,495,41,79,97,1787,1753,3540,12,6,201851
2,4,262,13,582,272,62,32,15,1238,1350,2588,9,6,201851
2,5,489,43,1134,761,224,115,28,2794,2726,5520,13,6.333333333,201851
2,6,260,24,545,475,22,53,0,1379,1397,2776,7,6,201851
2,7,352,24,652,510,26,68,81,1713,1627,3340,12,5.75,201851
2,8,293,13,668,616,15,55,7,1667,1834,3501,8,6,201851
3,1,165,38,334,423,23,56,20,1059,1236,2295,14,5.571428571,201851
3,2,175,9,543,345,21,33,0,1126,1183,2309,9,6,201851
4,1,176,24,320,575,44,51,1,1191,1185,2376,14,4.833333333,201851
4,2,211,37,503,485,72,45,17,1370,1297,2667,14,5.4,201851
5,1,246,20,449,448,50,62,34,1309,1230,2539,9,5.666666667,201851
5,2,219,41,301,454,42,29,0,1086,1367,2453,10,5.2,201851
5,3,216,30,279,487,59,61,113,1245,1198,2443,9,5.5,201851
5,4,214,42,526,544,15,78,104,1523,1451,2974,11,5.75,201851
5,5,248,36,425,772,17,63,66,1627,1409,3036,8,6,201851
5,6,158,21,248,333,11,23,52,846,662,1508,11,5.5,201851
5,7,169,28,353,449,2,31,15,1047,1016,2063,10,5.5,201851
6,1,170,48,335,372,21,68,127,1141,1114,2255,14,5.666666667,201851
6,2,160,27,387,277,97,53,36,1037,1071,2108,9,5.666666667,201851
7,1,231,12,180,383,7,21,7,841,864,1705,11,5.25,201851
7,2,293,10,105,337,23,32,0,800,793,1593,12,5.25,201851
7,3,223,12,180,348,135,27,17,942,2042,2984,9,5.333333333,201851
7,4,171,18,156,344,7,32,113,841,851,1692,13,5.4,201851
7,5,464,15,362,683,19,31,2,1576,1494,3070,11,5.666666667,201851
7,6,250,18,339,563,24,51,36,1281,1349,2630,10,5.666666667,201851
7,7,233,38,425,595,18,56,3,1368,1291,2659,8,5.5,201851
7,8,225,14,260,576,19,33,0,1127,1189,2316,12,5.25,201851
7,9,187,30,316,636,32,58,0,1259,1373,2632,11,5.5,201851
7,10,228,19,251,588,13,29,0,1128,1357,2485,10,5.5,201851
7,11,131,2,66,147,13,6,13,378,599,977,6,5.333333333,201851
7,12,296,19,312,702,6,31,0,1366,1396,2762,9,5.5,201851
7,13,146,16,139,442,23,27,0,793,333,1126,9,5.25,201851
8,1,191,14,623,305,31,41,32,1237,1100,2337,4,6,201851
8,2,280,38,615,546,33,47,30,1589,1563,3152,16,5.75,201851
8,3,230,29,449,528,23,63,20,1342,1369,2711,4,6,201851
8,4,193,38,509,478,29,69,126,1442,1409,2851,9,6,201851
8,5,151,33,288,349,30,42,0,893,919,1812,10,5.25,201851
8,6,199,42,515,602,62,76,82,1578,1630,3208,7,6.5,201851
8,7,169,38,262,405,14,38,0,926,1001,1927,7,5,201851
8,8,195,50,437,598,16,67,36,1399,1457,2856,12,5.5,201851
8,9,163,41,199,359,57,65,30,914,802,1716,10,5,201851
9,1,77,19,208,199,110,34,93,740,746,1486,5,6,201851
9,2,276,85,775,1354,129,109,163,2891,3249,6140,12,6,201851
9,3,141,51,471,610,85,68,212,1638,1607,3245,7,6,201851
9,4,164,27,418,639,75,58,110,1491,1445,2936,11,6,201851
9,5,115,21,346,671,73,47,32,1305,1336,2641,7,6,201851
9,6,94,25,254,274,140,56,121,964,939,1903,7,6,201851
9,7,93,22,269,686,3,56,8,1137,1229,2366,9,6,201851
9,8,67,16,293,308,24,40,111,859,893,1752,5,6,201851
9,9,115,14,235,438,47,32,72,953,996,1949,5,6,201851
9,10,102,19,320,608,35,54,1,1139,1166,2305,6,6,201851
9,11,166,31,449,865,99,97,49,1756,1891,3647,7,7,201851
9,12,137,41,572,676,42,60,224,1752,1931,3683,11,6,201851
9,13,93,25,305,407,96,55,150,1131,1097,2228,4,6,201851
9,14,106,23,220,289,137,30,157,962,1006,1968,5,6,201851
9,15,195,53,961,1401,45,106,323,3084,3207,6291,11,5.5,201851
9,16,221,75,704,1181,113,99,4,2397,2454,4851,15,7,201851
9,17,104,20,270,495,19,38,13,959,1005,1964,6,6,201851
9,18,166,54,408,1018,56,62,38,1802,1795,3597,12,6,201851
9,19,179,51,349,551,193,55,65,1443,1613,3056,5,6,201851
9,20,25,7,72,115,11,10,6,246,227,473,5,6,201851
9,21,96,16,199,351,49,31,45,787,739,1526,3,6,201851
9,22,114,18,241,341,105,37,136,992,1092,2084,5,6,201851
9,23,136,33,322,646,84,52,110,1383,1390,2773,6,7,201851
9,24,246,49,685,1122,137,104,107,2450,2680,5130,12,6,201851
10,1,210,38,237,269,13,41,140,948,883,1831,12,4.666666667,201851
10,2,287,53,378,455,49,52,104,1378,1325,2703,9,5.5,201851
10,3,212,46,231,354,43,34,32,952,895,1847,11,5.4,201851
10,4,395,38,445,704,19,57,13,1671,1522,3193,14,6.333333333,201851
11,1,182,40,214,314,31,33,14,828,866,1694,7,5.666666667,201851
11,2,200,53,272,339,42,42,39,987,1031,2018,7,6,201851
11,3,143,59,266,297,22,42,165,994,960,1954,3,6,201851
11,4,184,44,231,395,14,29,0,897,881,1778,10,5.4,201851
11,5,261,81,498,733,24,60,30,1687,1599,3286,7,6.5,201851
11,6,112,59,253,284,45,38,34,825,813,1638,8,6,201851
11,7,183,41,303,394,26,48,0,995,1073,2068,9,5.5,201851
11,8,177,46,296,508,19,35,34,1115,1213,2328,9,5.5,201851
11,9,217,98,391,562,15,62,55,1400,1437,2837,10,5.666666667,201851
11,10,166,94,350,378,55,42,142,1227,1299,2526,10,5.6,201851
11,11,185,59,319,457,21,35,0,1076,1190,2266,5,6,201851
11,12,209,82,527,694,18,53,8,1591,1378,2969,7,6.5,201851
11,13,196,74,291,308,47,31,113,1060,1165,2225,8,5.5,201851
11,14,200,83,296,434,32,47,15,1107,1040,2147,8,5.5,201851
11,15,124,39,213,373,2,27,3,781,796,1577,9,6,201851
12,1,157,29,289,145,75,33,19,747,877,1624,10,5.2,201851
12,2,262,43,358,618,38,40,15,1374,1248,2622,10,5.5,201851
12,3,176,43,310,464,14,46,0,1053,1422,2475,11,5.2,201851
12,4,182,44,421,699,23,36,1,1406,1266,2672,9,6,201851
12,5,243,24,255,345,9,24,76,976,1105,2081,10,5.25,201851
12,6,198,19,247,374,49,19,4,910,1035,1945,10,5.25,201851
12,7,286,33,413,465,76,43,51,1367,1224,2591,8,4.666666667,201851
12,8,247,26,294,378,11,34,0,990,1045,2035,9,5.25,201851
12,9,177,24,303,484,16,38,7,1049,1196,2245,9,5.666666667,201851
13,1,173,32,166,446,72,39,14,942,963,1905,9,5.333333333,201851
13,2,131,20,139,343,77,31,16,757,863,1620,6,5.333333333,201851
13,3,151,29,214,310,131,42,0,877,1028,1905,12,5.25,201851
13,4,186,19,307,301,80,48,52,993,1620,2613,9,5.666666667,201851
13,5,214,35,454,396,141,66,160,1466,1314,2780,9,5.75,201851
13,6,259,55,706,959,49,74,43,2145,2087,4232,13,5.75,201851
13,7,173,39,426,404,33,44,61,1180,1159,2339,8,5.5,201851
14,1,123,55,196,188,74,46,130,812,695,1507,7,5.5,201851
14,2,151,40,305,370,30,23,43,962,1071,2033,5,5.666666667,201851
14,3,242,56,568,401,77,67,58,1469,1354,2823,8,5.4,201851
14,4,173,40,296,553,39,29,70,1200,1224,2424,10,6,201851
14,5,189,30,497,399,62,45,10,1232,972,2204,9,5.5,201851
14,6,199,23,541,408,45,36,35,1287,1352,2639,11,6,201851
14,7,111,16,297,225,0,14,0,663,630,1293,6,6,201851
14,8,295,84,835,1515,46,88,92,2955,3053,6008,13,5.666666667,201851
14,9,82,39,200,435,42,20,10,828,755,1583,8,6,201851
14,10,176,49,426,494,19,39,32,1235,1298,2533,5,6.5,201851
14,11,153,48,308,505,68,39,138,1259,1302,2561,4,6,201851
14,12,214,28,510,264,26,43,12,1097,1165,2262,9,5.5,201851
14,13,193,29,402,362,19,54,57,1116,1205,2321,6,6,201851
14,14,142,39,313,586,38,55,81,1254,1409,2663,7,6,201851
14,15,235,66,288,450,57,58,26,1180,1281,2461,10,5.6,201851
14,16,161,38,356,279,67,43,138,1082,1213,2295,5,6,201851
14,17,210,66,280,243,54,38,88,979,820,1799,7,5.25,201851
14,18,186,48,380,442,37,43,167,1303,1311,2614,9,5.4,201851
14,19,202,48,415,471,52,34,14,1236,1145,2381,8,5.25,201851
14,20,148,27,333,299,28,44,16,895,930,1825,10,5.666666667,201851
15,1,176,39,287,178,519,32,39,1270,1443,2713,7,5.333333333,201851
15,2,111,20,281,390,40,30,69,941,1052,1993,6,6,201851
15,3,216,59,260,479,368,59,90,1531,1562,3093,10,5.666666667,201851
15,4,153,30,290,456,38,46,103,1116,1286,2402,4,6,201851
15,5,174,45,241,402,52,35,128,1077,1020,2097,8,5.666666667,201851
15,6,148,30,338,541,75,34,76,1242,1379,2621,7,6.5,201851
15,7,138,25,331,546,63,48,36,1187,1179,2366,10,6,201851
15,8,115,17,144,315,21,27,15,654,741,1395,4,6,201851
15,9,210,28,181,188,296,33,49,985,1102,2087,9,5.75,201851
15,10,119,20,203,385,75,33,64,899,943,1842,6,6,201851
15,11,173,31,340,577,69,51,12,1253,1286,2539,8,6,201851
15,12,276,34,546,611,35,36,14,1552,1522,3074,8,6,201851
15,13,73,24,159,314,135,23,0,728,927,1655,8,6,201851
15,14,79,21,202,342,18,24,3,689,655,1344,4,6,201851
15,15,132,46,335,479,39,51,106,1188,1262,2450,6,6,201851
15,16,194,33,353,722,13,54,28,1397,1429,2826,8,6,201851
15,17,119,33,191,285,15,43,226,912,945,1857,8,6,201851
15,18,175,53,305,560,49,62,92,1296,1477,2773,7,5.666666667,201851
15,19,187,98,470,1138,12,68,20,1993,2192,4185,10,6,201851
15,20,61,21,223,441,31,14,18,809,849,1658,6,6,201851
15,21,97,16,100,330,35,30,66,674,627,1301,6,5.5,201851
15,22,251,79,488,982,41,78,286,2205,2335,4540,14,6,201851
15,23,138,30,241,509,27,51,0,996,965,1961,6,5.333333333,201851
15,24,116,18,240,344,27,27,19,791,867,1658,4,6,201851
15,25,170,21,263,355,36,51,88,984,1068,2052,6,6,201851
15,26,132,14,215,373,82,46,25,887,974,1861,11,5.333333333,201851
15,27,194,32,321,482,27,51,215,1322,1419,2741,9,5.666666667,201851
15,28,227,40,522,485,105,62,65,1506,1568,3074,9,5.666666667,201851
15,29,214,37,424,843,11,65,23,1617,1685,3302,8,6,201851
15,30,229,32,394,506,45,44,27,1277,1314,2591,16,6,201851
15,31,187,65,310,597,17,46,3,1225,1253,2478,6,6,201851
15,32,162,24,306,517,58,43,28,1138,1017,2155,9,6,201851
15,33,191,21,289,525,16,52,3,1097,1025,2122,7,6,201851
15,34,142,17,178,526,16,34,75,988,1020,2008,8,6,201851
15,35,292,26,310,528,17,59,3,1235,1206,2441,9,5.666666667,201851
15,36,249,19,323,409,58,37,2,1097,1088,2185,9,5.5,201851
15,37,173,31,335,496,73,54,121,1283,1335,2618,7,6,201851
15,38,139,24,219,514,16,28,32,972,915,1887,6,5.5,201851
15,39,113,23,270,436,14,35,15,906,973,1879,4,6,201851
15,40,277,38,384,543,132,83,20,1477,1566,3043,9,6,201851
15,41,224,38,527,677,60,55,68,1649,1629,3278,11,6,201851
16,1,132,27,286,307,17,38,3,810,680,1490,7,5.333333333,201851
16,2,114,40,182,296,32,30,0,694,774,1468,9,5.25,201851
16,3,148,32,273,288,25,23,13,802,1091,1893,10,5.25,201851
16,4,233,55,360,378,103,56,0,1185,1207,2392,8,5.5,201851
16,5,179,61,264,276,45,51,69,945,1103,2048,10,5.666666667,201851
16,6,188,55,231,290,61,45,0,870,778,1648,12,5.5,201851
16,7,250,49,255,324,65,54,0,997,924,1921,9,5.5,201851
16,8,323,47,564,794,17,71,15,1831,1750,3581,12,6,201851
16,9,213,37,311,380,22,76,29,1068,1043,2111,9,6.5,201851
16,10,135,12,308,374,8,34,0,871,1035,1906,8,5.666666667,201851
16,11,257,45,353,303,200,70,28,1256,1023,2279,10,5.4,201851
16,12,201,33,322,220,43,50,17,886,562,1448,10,5.25,201851
17,1,145,34,480,533,40,48,68,1348,1513,2861,10,6,201851
17,2,136,25,337,453,12,32,32,1027,970,1997,8,5.666666667,201851
17,3,200,22,365,493,14,54,0,1148,1181,2329,8,5.5,201851
17,4,193,36,384,542,47,42,32,1276,1365,2641,10,5.666666667,201851
17,5,77,9,116,203,20,21,4,450,478,928,5,5.5,201851
18,1,137,18,179,335,27,41,36,773,620,1393,7,5.25,201851
18,2,223,48,437,571,107,60,3,1449,1357,2806,10,6.25,201851
18,3,165,33,442,369,13,34,0,1056,994,2050,8,5.75,201851
19,1,186,56,431,675,20,70,98,1536,1399,2935,9,6,201851
19,2,254,22,659,444,46,60,58,1543,1631,3174,9,6,201851
19,3,320,42,673,665,48,71,43,1862,1698,3560,7,6,201851
19,4,106,48,198,152,140,26,276,946,923,1869,5,6,201851
19,5,306,56,519,913,36,67,178,2075,1943,4018,8,6,201851
19,6,80,26,230,644,9,43,11,1043,963,2006,5,6,201851
19,7,195,32,604,468,22,41,0,1362,1230,2592,10,5.5,201851
19,8,44,8,110,153,1,12,0,328,284,612,7,6,201851
19,9,178,45,279,594,76,44,41,1257,1088,2345,9,5.25,201851
19,10,199,36,397,711,10,63,183,1599,1449,3048,8,5.333333333,201851
19,11,398,101,879,1789,38,123,125,3453,3019,6472,13,6.333333333,201851
19,12,190,20,609,315,33,39,30,1236,1176,2412,8,5.666666667,201851
20,1,197,17,220,174,49,39,87,783,805,1588,7,5.5,201851
20,2,144,19,188,249,14,30,1,645,769,1414,6,5.333333333,201851
20,3,141,20,166,218,46,43,49,683,727,1410,6,5.333333333,201851
20,4,134,30,132,159,67,39,78,639,594,1233,6,5.333333333,201851
20,5,128,19,252,417,36,27,0,879,998,1877,11,5.25,201851
20,6,175,19,263,353,105,34,1,950,1231,2181,8,5.25,201851
20,7,182,24,251,435,16,36,13,957,960,1917,8,5.75,201851
20,8,451,49,568,1036,52,98,372,2626,2513,5139,15,6,201851
20,9,204,26,174,255,95,57,139,950,1023,1973,8,5.666666667,201851
20,10,168,10,173,375,11,40,0,777,865,1642,9,5.25,201851
21,1,187,12,247,415,12,21,0,894,973,1867,10,5.4,201851
21,2,166,13,214,289,133,41,7,863,872,1735,10,5.2,201851
21,3,245,20,396,272,148,46,83,1210,1067,2277,9,5.5,201851
21,4,116,12,97,129,100,31,29,514,817,1331,7,5.25,201851
21,5,152,19,389,382,36,54,4,1036,995,2031,8,5.666666667,201851
21,6,156,19,340,446,34,36,202,1233,1358,2591,6,6,201851
21,7,228,17,250,360,57,40,56,1008,1117,2125,9,5.666666667,201851
21,8,178,9,381,331,131,44,41,1115,889,2004,10,5.2,201851
21,9,201,17,461,462,67,64,129,1401,1464,2865,9,6,201851
21,10,183,21,373,388,40,53,165,1223,1141,2364,7,6,201851
21,11,60,3,127,135,17,20,12,374,501,875,6,5.5,201851
21,12,292,32,847,1087,70,104,169,2601,2550,5151,16,7,201851
21,13,211,19,304,358,65,40,89,1086,1132,2218,8,5.666666667,201851
21,14,200,21,317,199,124,34,129,1024,992,2016,12,5.333333333,201851
21,15,192,16,365,308,46,47,48,1022,1108,2130,7,5.5,201851
22,1,204,51,213,384,46,31,32,961,1101,2062,11,5.2,201851
22,2,182,44,379,369,30,30,35,1069,1163,2232,7,5.5,201851
22,3,238,90,736,816,44,45,23,1992,2069,4061,9,6,201851
22,4,207,70,620,646,51,46,39,1679,1692,3371,11,6,201851
22,5,209,46,654,260,120,32,31,1352,1034,2386,10,5.5,201851
23,1,273,7,1153,352,18,37,22,1862,1868,3730,14,5.6,201851
23,2,255,23,429,460,10,37,0,1214,1461,2675,10,5.25,201851
23,3,254,11,854,570,22,44,0,1755,1674,3429,15,7,201851
23,4,199,5,732,341,26,32,6,1341,1442,2783,8,5.5,201851
24,1,111,43,163,319,29,19,7,691,750,1441,10,5.2,201851
24,2,122,55,233,339,20,40,11,820,855,1675,6,5.5,201851
24,3,164,49,222,406,127,23,0,991,973,1964,9,5.25,201851
24,4,149,54,244,201,90,49,221,1008,999,2007,5,5.5,201851
24,5,227,54,471,675,20,63,67,1577,1631,3208,9,6.333333333,201851
24,6,148,55,370,541,59,44,18,1235,1382,2617,8,4.5,201851
24,7,221,39,345,564,76,30,0,1275,1309,2584,9,5.25,201851
25,1,150,44,229,416,69,39,100,1047,867,1914,13,6,201851
25,2,205,49,413,693,50,60,0,1470,1343,2813,7,5.5,201851
25,3,216,24,378,495,61,28,24,1226,1104,2330,8,5.6,201851
25,4,182,45,234,523,23,44,117,1168,885,2053,8,5.333333333,201851
25,5,214,18,421,728,30,65,0,1476,1337,2813,10,5.25,201851
25,6,228,39,386,513,130,63,81,1440,1281,2721,8,5.75,201851
25,7,231,21,331,627,12,58,0,1280,1308,2588,6,6,201851
26,1,222,17,388,475,13,68,0,1183,1095,2278,9,5.5,201851
26,2,246,19,505,545,1,83,4,1403,1356,2759,12,5.4,201851
26,3,314,39,492,915,7,119,64,1950,1785,3735,17,5.75,201851
26,4,144,23,192,446,40,48,38,931,716,1647,9,5.2,201851
26,5,86,14,180,269,14,40,0,603,629,1232,11,5.333333333,201851
26,6,162,20,392,539,11,52,0,1176,1251,2427,10,5.333333333,201851
26,7,159,15,262,338,48,38,0,860,728,1588,10,5.5,201851
27,1,176,40,405,530,49,33,1,1234,1258,2492,8,5.5,201851
27,2,230,27,309,455,27,40,0,1088,1086,2174,8,5.666666667,201851
27,3,180,16,196,481,8,25,5,911,1091,2002,7,5.666666667,201851
27,4,238,26,311,753,19,42,75,1464,1529,2993,10,5.5,201851
27,5,106,16,113,274,9,20,10,548,818,1366,6,5.333333333,201851
27,6,168,22,206,470,4,29,3,902,1030,1932,8,5.5,201851
28,1,316,18,488,583,21,43,0,1469,1119,2588,13,6,201851
28,2,295,37,600,462,61,77,248,1780,1739,3519,13,6,201851
28,3,152,34,258,422,8,32,0,906,959,1865,7,5.333333333,201851
28,4,358,59,610,436,90,74,367,1994,1808,3802,15,6,201851
28,5,274,51,307,609,30,41,70,1382,1161,2543,12,5.4,201851
28,6,203,39,232,370,28,16,75,963,943,1906,14,5.166666667,201851
28,7,223,38,455,543,60,49,0,1368,1603,2971,9,6.5,201851
28,8,169,56,336,505,94,47,33,1240,1338,2578,9,6,201851
28,9,180,22,353,213,37,25,108,938,886,1824,11,5.75,201851
29,1,197,39,354,411,89,37,0,1127,1152,2279,7,5.5,201851
29,2,222,28,416,492,76,50,126,1410,1265,2675,13,6,201851
29,3,124,36,173,437,26,38,0,834,868,1702,5,5.666666667,201851
30,1,130,35,273,465,33,30,68,1034,958,1992,7,5.333333333,201851
30,2,153,38,231,134,147,22,400,1125,945,2070,8,5.25,201851
30,3,133,25,397,166,180,35,352,1288,1243,2531,6,5.666666667,201851
30,4,107,10,271,314,54,27,0,783,872,1655,8,6,201851
30,5,147,31,196,566,16,35,0,991,955,1946,7,5.5,201851
30,6,170,31,334,366,57,30,0,988,1050,2038,9,5.333333333,201851
30,7,133,34,231,304,26,32,101,861,772,1633,11,5.25,201851
30,8,152,41,395,512,111,62,123,1396,1776,3172,11,5.4,201851
30,9,194,18,206,298,75,44,182,1017,931,1948,8,5.5,201851
30,10,191,36,388,461,81,57,191,1405,1117,2522,9,5.25,201851
30,11,112,24,308,537,19,38,0,1038,870,1908,5,5.5,201851
30,12,220,42,585,991,32,98,6,1974,1997,3971,10,6.25,201851
30,13,165,24,259,289,119,41,238,1135,1054,2189,10,5.4,201851
30,14,158,36,330,189,162,48,180,1103,988,2091,8,5.5,201851
30,15,246,29,315,298,140,61,344,1433,1386,2819,11,5.666666667,201851
30,16,197,27,315,348,142,65,339,1433,1303,2736,10,5.333333333,201851
30,17,178,55,256,485,83,56,77,1190,1038,2228,8,5.5,201851
30,18,187,27,173,355,52,43,49,886,819,1705,8,5.25,201851
30,19,125,16,273,370,83,43,17,927,868,1795,11,4.4,201851
30,20,177,25,266,458,176,54,9,1165,1155,2320,10,5.4,201851
31,1,140,31,196,113,293,37,0,810,752,1562,8,5.5,201851
31,2,84,21,200,13,367,35,0,720,594,1314,6,5.333333333,201851
31,3,374,62,1192,1090,175,104,1,2998,2068,5066,20,6.333333333,201851
31,4,110,35,345,201,165,31,183,1070,686,1756,6,5.5,201851
31,5,136,27,164,531,56,27,0,941,731,1672,6,5.333333333,201851
32,1,173,85,277,250,86,53,150,1074,1003,2077,12,5.2,201851
32,2,157,119,312,157,254,45,173,1217,1206,2423,14,5.142857143,201851
32,3,170,77,240,494,25,39,22,1067,1170,2237,15,5.5,201851
32,4,216,131,355,469,43,62,83,1359,1477,2836,13,5.4,201851
1,1,266,41,295,283,56,32,4,977,979,1956,13,5.5,201852
1,2,255,63,507,444,69,35,44,1417,1306,2723,10,6,201852
1,3,268,79,487,468,54,50,35,1441,1433,2874,11,6,201852
2,1,196,30,402,464,19,43,4,1158,1020,2178,11,6,201852
2,2,259,21,349,669,19,78,0,1395,1187,2582,9,5.333333333,201852
2,3,342,48,638,610,42,118,77,1875,1324,3199,12,6.666666667,201852
2,4,200,7,564,243,48,21,13,1096,1031,2127,9,6,201852
2,5,459,43,1031,660,206,104,20,2523,2233,4756,13,6.333333333,201852
2,6,261,16,508,431,28,51,0,1295,1099,2394,7,6,201852
2,7,335,26,584,488,22,57,61,1573,1311,2884,12,5.75,201852
2,8,273,18,656,524,17,48,3,1539,1401,2940,8,6,201852
3,1,166,18,325,421,22,62,22,1036,933,1969,14,5.571428571,201852
3,2,165,12,552,324,18,23,0,1094,842,1936,9,6,201852
4,1,217,27,281,548,81,27,0,1181,1085,2266,14,5,201852
4,2,186,24,349,423,33,23,10,1048,967,2015,14,5.4,201852
5,1,244,18,379,487,28,43,43,1242,1181,2423,9,5.666666667,201852
5,2,148,20,203,321,17,15,0,724,639,1363,10,5.2,201852
5,3,167,22,235,363,42,42,67,938,898,1836,9,5.5,201852
5,4,172,28,378,446,11,74,90,1199,1338,2537,11,5.75,201852
5,5,209,26,356,617,15,47,24,1294,1196,2490,8,6,201852
5,6,125,11,201,271,8,29,50,695,679,1374,11,5.5,201852
5,7,141,10,258,367,1,31,9,817,750,1567,11,6,201852
6,1,165,32,343,371,28,40,136,1115,886,2001,14,5.666666667,201852
6,2,162,30,412,270,136,42,31,1083,796,1879,9,5.666666667,201852
7,1,261,10,176,458,16,41,8,970,752,1722,11,5.25,201852
7,2,150,12,87,321,22,12,0,604,932,1536,12,5.25,201852
7,3,318,13,327,267,150,54,12,1141,1095,2236,9,5.333333333,201852
7,4,112,11,139,251,4,30,45,592,748,1340,13,5.4,201852
7,5,260,11,188,413,22,44,0,938,1348,2286,11,5.666666667,201852
7,6,330,36,354,625,28,76,42,1491,1394,2885,11,6,201852
7,7,219,36,367,508,30,47,1,1208,1155,2363,8,5.5,201852
7,8,196,18,293,623,18,41,0,1189,1095,2284,12,5.25,201852
7,9,178,33,341,653,26,50,0,1281,813,2094,11,5.5,201852
7,10,160,15,205,604,15,22,0,1021,932,1953,10,5.5,201852
7,11,276,12,102,271,25,14,60,760,224,984,6,5.333333333,201852
7,12,329,16,322,643,4,31,0,1345,1050,2395,9,5.5,201852
7,13,155,22,141,309,8,33,0,668,1022,1690,9,5.25,201852
8,1,164,9,473,280,25,33,25,1009,952,1961,4,6,201852
8,2,235,37,596,484,28,52,19,1451,1355,2806,16,5.75,201852
8,3,204,29,462,475,28,40,19,1257,1139,2396,4,6,201852
8,4,171,34,437,393,43,52,130,1260,1099,2359,9,6,201852
8,5,182,33,282,361,31,28,0,917,724,1641,10,5.25,201852
8,6,162,37,393,510,44,50,77,1273,1178,2451,7,6.5,201852
8,7,153,44,218,347,9,30,0,801,756,1557,7,5.25,201852
8,8,184,29,347,527,19,31,18,1155,1115,2270,12,6,201852
8,9,172,50,193,335,48,51,6,855,791,1646,10,4.8,201852
9,1,90,29,157,187,105,29,101,698,617,1315,5,6,201852
9,2,275,60,684,1285,87,90,180,2661,2065,4726,12,6,201852
9,3,122,44,422,572,57,68,208,1493,1246,2739,7,6,201852
9,4,170,18,348,561,76,52,108,1333,1133,2466,11,6,201852
9,5,109,30,320,543,72,59,25,1158,996,2154,7,6,201852
9,6,95,31,229,234,117,40,135,881,704,1585,7,6,201852
9,7,87,20,241,627,5,27,5,1012,859,1871,9,6,201852
9,8,84,15,250,329,24,31,90,823,640,1463,5,6,201852
9,9,107,21,237,357,42,31,60,855,704,1559,5,6,201852
9,10,90,14,314,553,13,48,0,1032,840,1872,6,6,201852
9,11,156,43,362,792,67,79,61,1560,1317,2877,7,7,201852
9,12,111,36,578,657,48,70,230,1730,1423,3153,11,6,201852
9,13,104,18,239,357,106,35,175,1034,792,1826,4,6,201852
9,14,108,28,208,285,107,36,166,938,734,1672,5,6,201852
9,15,170,37,873,1288,26,94,287,2775,2017,4792,11,5.75,201852
9,16,253,68,620,1060,85,84,9,2179,1837,4016,15,7,201852
9,17,137,12,232,415,25,50,19,890,715,1605,6,6,201852
9,18,172,46,360,935,50,63,23,1649,1352,3001,12,6,201852
9,19,161,30,307,498,139,51,72,1258,955,2213,5,6,201852
9,20,25,7,51,84,11,7,10,195,157,352,5,6,201852
9,21,82,12,179,309,39,19,43,683,482,1165,3,6,201852
9,22,139,21,219,256,85,50,146,916,764,1680,5,6,201852
9,23,126,19,296,604,73,42,145,1305,1017,2322,6,7,201852
9,24,288,40,563,1123,139,80,101,2334,1839,4173,12,6,201852
10,1,231,33,228,242,17,37,116,904,896,1800,12,4.666666667,201852
10,2,260,31,331,379,35,38,115,1189,1105,2294,9,5.5,201852
10,3,199,67,224,443,30,33,89,1085,755,1840,11,5.4,201852
10,4,357,45,371,539,22,51,9,1394,1403,2797,14,6.333333333,201852
11,1,178,57,220,339,52,37,25,908,771,1679,7,5.666666667,201852
11,2,190,39,258,347,40,30,33,937,800,1737,7,6,201852
11,3,143,55,266,312,22,37,169,1004,831,1835,3,6,201852
11,4,155,55,203,395,13,35,0,856,734,1590,10,5,201852
11,5,212,87,424,681,29,70,45,1548,1357,2905,7,6.5,201852
11,6,95,49,220,262,45,24,45,740,657,1397,8,6,201852
11,7,221,58,333,410,32,31,0,1085,1150,2235,9,5.5,201852
11,8,166,57,330,487,30,29,45,1144,954,2098,9,5.5,201852
11,9,189,99,374,532,16,43,80,1333,1135,2468,10,5.666666667,201852
11,10,189,87,317,393,52,37,114,1189,1076,2265,10,5.6,201852
11,11,170,62,309,428,24,33,0,1026,1420,2446,5,6,201852
11,12,172,67,536,653,12,41,17,1498,1236,2734,7,6.5,201852
11,13,174,65,251,242,50,19,134,935,847,1782,8,5.5,201852
11,14,180,84,371,534,42,46,12,1269,1029,2298,8,5.5,201852
11,15,101,49,204,327,4,34,0,719,582,1301,9,6,201852
12,1,156,50,361,184,116,34,21,922,963,1885,10,5.2,201852
12,2,221,44,288,546,18,51,14,1182,1042,2224,10,5.5,201852
12,3,163,37,302,483,16,41,0,1042,1006,2048,11,5.2,201852
12,4,189,44,375,669,26,49,0,1352,1094,2446,9,6,201852
12,5,325,31,406,341,0,41,70,1214,1068,2282,10,5.25,201852
12,6,210,26,207,398,36,11,4,892,661,1553,10,5.25,201852
12,7,164,29,297,510,16,33,33,1082,1029,2111,8,4.333333333,201852
12,8,248,27,332,402,8,34,0,1051,879,1930,9,5.25,201852
12,9,187,24,356,518,23,24,10,1142,906,2048,9,5.666666667,201852
13,1,146,17,180,355,80,27,4,809,705,1514,9,5.333333333,201852
13,2,161,30,123,407,94,20,26,861,759,1620,6,5.333333333,201852
13,3,147,22,154,308,107,40,0,778,584,1362,12,5.25,201852
13,4,163,19,285,257,91,53,57,925,871,1796,9,5.666666667,201852
13,5,194,33,402,310,113,53,120,1225,1135,2360,9,6,201852
13,6,269,75,620,706,50,53,131,1904,1692,3596,13,5.75,201852
13,7,92,26,376,431,31,26,0,982,720,1702,8,5.5,201852
14,1,142,57,210,206,66,41,159,881,809,1690,7,5.5,201852
14,2,191,36,364,320,60,42,40,1053,746,1799,5,5.666666667,201852
14,3,197,68,544,447,62,71,58,1447,1370,2817,8,5.4,201852
14,4,190,46,294,536,22,56,65,1209,900,2109,10,6,201852
14,5,185,37,508,335,58,36,13,1172,1116,2288,9,5.5,201852
14,6,204,23,477,398,38,39,29,1208,1037,2245,11,6,201852
14,7,130,23,291,229,0,21,0,694,585,1279,6,6,201852
14,8,322,75,821,1376,40,84,82,2800,2468,5268,13,5.666666667,201852
14,9,107,30,216,389,34,25,9,810,756,1566,8,6,201852
14,10,214,23,417,530,11,50,32,1277,1049,2326,5,6.5,201852
14,11,180,50,235,452,67,57,186,1227,1006,2233,4,6,201852
14,12,199,24,591,254,17,46,8,1139,958,2097,9,5.5,201852
14,13,185,40,342,366,30,53,51,1067,928,1995,6,6,201852
14,14,141,38,339,503,31,38,92,1182,1180,2362,7,6,201852
14,15,214,65,275,449,83,68,20,1174,1127,2301,10,5.6,201852
14,16,156,47,396,286,96,41,109,1131,872,2003,5,6,201852
14,17,156,37,279,204,53,42,77,848,803,1651,7,5.25,201852
14,18,222,56,453,355,53,48,180,1367,1150,2517,9,5.4,201852
14,19,180,50,360,444,65,46,20,1165,1076,2241,8,5.25,201852
14,20,153,22,345,270,21,50,15,876,774,1650,10,5.666666667,201852
15,1,146,38,315,148,500,34,90,1271,1083,2354,7,5.333333333,201852
15,2,120,16,230,342,40,34,80,862,751,1613,6,6,201852
15,3,197,47,243,400,334,35,100,1356,1577,2933,10,5.666666667,201852
15,4,164,27,232,412,44,28,90,997,857,1854,4,6,201852
15,5,127,40,207,322,28,27,87,838,801,1639,8,5.666666667,201852
15,6,132,26,314,486,74,39,73,1144,923,2067,7,6.5,201852
15,7,137,31,317,515,42,39,32,1113,950,2063,10,6,201852
15,8,80,14,119,304,14,26,6,563,474,1037,4,6,201852
15,9,197,18,164,179,245,32,45,880,783,1663,9,5.75,201852
15,10,96,18,180,284,73,29,64,744,706,1450,6,6,201852
15,11,162,25,262,504,43,25,14,1035,893,1928,8,6,201852
15,12,228,23,498,503,32,37,15,1336,1120,2456,8,6,201852
15,13,83,26,169,305,133,25,0,741,583,1324,8,6,201852
15,14,74,15,151,330,17,23,0,610,595,1205,4,6,201852
15,15,126,48,276,443,53,47,122,1115,927,2042,6,6,201852
15,16,157,26,291,606,9,33,10,1132,980,2112,8,6,201852
15,17,99,30,190,280,15,38,204,856,632,1488,8,6,201852
15,18,230,38,347,540,52,36,72,1315,1076,2391,7,5.666666667,201852
15,19,192,83,401,1069,9,53,18,1825,1544,3369,10,6,201852
15,20,67,16,166,394,19,27,11,700,561,1261,6,6,201852
15,21,97,9,105,290,24,33,60,618,420,1038,6,5.5,201852
15,22,235,61,482,865,38,58,275,2014,1737,3751,14,6,201852
15,23,144,22,235,529,26,52,0,1008,748,1756,6,5.333333333,201852
15,24,114,28,202,317,19,15,10,705,589,1294,4,6,201852
15,25,186,29,224,294,71,36,65,905,759,1664,6,6,201852
15,26,133,14,201,346,69,27,23,813,687,1500,11,5.333333333,201852
15,27,160,38,332,451,29,61,216,1287,1050,2337,9,5.666666667,201852
15,28,209,27,525,416,95,50,74,1396,1168,2564,9,5.666666667,201852
15,29,174,43,375,782,27,63,17,1481,1215,2696,8,6,201852
15,30,183,32,366,443,30,32,30,1116,935,2051,16,6,201852
15,31,174,48,273,582,17,32,17,1143,905,2048,6,6,201852
15,32,160,19,279,471,49,45,34,1057,832,1889,9,6,201852
15,33,160,17,238,435,19,41,3,913,816,1729,7,6,201852
15,34,124,20,206,431,18,36,44,879,760,1639,8,6,201852
15,35,198,44,283,520,23,61,6,1135,967,2102,9,5.666666667,201852
15,36,201,37,322,462,131,37,2,1192,1013,2205,9,5.5,201852
15,37,159,38,284,423,63,64,122,1153,942,2095,7,6,201852
15,38,167,33,242,527,5,26,28,1028,836,1864,6,5.5,201852
15,39,115,22,229,363,10,27,17,783,678,1461,4,6,201852
15,40,230,32,341,458,95,53,10,1219,1082,2301,9,6,201852
15,41,211,31,434,589,27,50,64,1406,1168,2574,11,6,201852
16,1,173,26,313,316,35,38,1,902,809,1711,7,5.333333333,201852
16,2,157,45,234,321,38,35,0,830,691,1521,9,5.25,201852
16,3,125,32,210,299,36,40,19,761,665,1426,10,5.25,201852
16,4,222,52,413,298,106,62,0,1153,842,1995,8,5.5,201852
16,5,201,52,274,389,54,57,64,1091,787,1878,10,5.666666667,201852
16,6,188,56,232,342,55,40,0,913,745,1658,12,5.5,201852
16,7,192,45,214,288,70,44,0,853,722,1575,9,5.5,201852
16,8,267,53,604,694,14,56,34,1722,1355,3077,12,6,201852
16,9,187,34,269,399,19,59,38,1005,832,1837,9,6.5,201852
16,10,144,13,267,317,5,33,0,779,723,1502,8,5.666666667,201852
16,11,204,29,312,287,213,60,54,1159,886,2045,10,5.4,201852
16,12,177,42,261,190,35,47,16,768,627,1395,10,5.25,201852
17,1,144,30,464,555,39,46,33,1311,1063,2374,10,6,201852
17,2,101,22,272,420,8,36,32,891,868,1759,8,5.666666667,201852
17,3,211,32,395,549,21,43,0,1251,1008,2259,8,5.5,201852
17,4,204,31,379,543,41,47,43,1288,1004,2292,10,5.666666667,201852
17,5,115,17,132,218,21,19,2,524,371,895,5,5.5,201852
18,1,169,23,191,399,50,34,24,890,526,1416,7,5.25,201852
18,2,250,46,452,557,82,45,0,1432,1205,2637,10,6.25,201852
18,3,174,35,384,362,13,28,0,996,1102,2098,8,5.75,201852
19,1,163,36,350,580,27,65,73,1294,1310,2604,9,6,201852
19,2,239,27,572,462,24,47,90,1461,1331,2792,9,6,201852
19,3,269,33,565,611,36,64,39,1617,1533,3150,7,6,201852
19,4,90,22,179,136,105,26,253,811,796,1607,5,6,201852
19,5,241,49,438,745,19,61,124,1677,1721,3398,8,6,201852
19,6,69,21,242,520,7,38,0,897,830,1727,5,6,201852
19,7,159,19,502,300,15,28,1,1024,873,1897,10,5.5,201852
19,8,35,7,102,133,3,9,0,289,298,587,7,6,201852
19,9,167,37,364,499,36,24,15,1142,984,2126,9,5.25,201852
19,10,153,16,302,393,7,45,344,1260,1213,2473,8,5.333333333,201852
19,11,350,80,691,1492,28,114,212,2967,2864,5831,13,6.333333333,201852
19,12,170,15,434,272,12,34,17,954,880,1834,8,5.666666667,201852
20,1,189,30,209,217,70,41,104,860,650,1510,7,5.5,201852
20,2,146,21,135,236,12,26,0,576,499,1075,6,5.333333333,201852
20,3,147,24,231,278,220,18,9,927,351,1278,6,5.333333333,201852
20,4,184,19,165,348,95,51,83,945,458,1403,6,5.333333333,201852
20,5,142,23,317,604,175,40,0,1301,807,2108,11,5.25,201852
20,6,276,27,277,358,222,49,1,1210,847,2057,8,5.25,201852
20,7,150,18,296,528,19,36,18,1065,841,1906,8,5.75,201852
20,8,452,50,558,969,44,105,473,2651,1908,4559,15,6,201852
20,9,255,26,223,286,120,38,159,1107,865,1972,8,5.666666667,201852
20,10,251,15,293,548,27,40,0,1174,946,2120,9,5.25,201852
21,1,117,9,169,334,8,16,0,653,790,1443,10,5.4,201852
21,2,174,37,171,263,363,27,0,1035,1237,2272,10,5,201852
21,3,197,21,347,283,125,64,65,1102,867,1969,9,5.5,201852
21,4,150,8,132,123,67,40,53,573,454,1027,7,5.25,201852
21,5,174,14,300,379,26,37,7,937,839,1776,8,5.666666667,201852
21,6,168,28,268,428,38,46,242,1218,964,2182,6,6,201852
21,7,299,26,296,420,66,82,103,1292,658,1950,9,5.666666667,201852
21,8,239,23,380,407,88,42,31,1210,700,1910,10,5.2,201852
21,9,187,28,427,425,73,53,141,1334,969,2303,9,6,201852
21,10,205,14,346,418,52,61,147,1243,987,2230,7,6,201852
21,11,46,4,139,130,20,13,8,360,322,682,6,5,201852
21,12,344,27,727,1032,49,81,138,2398,2027,4425,16,7,201852
21,13,205,8,343,393,80,61,98,1188,809,1997,8,5.666666667,201852
21,14,203,23,275,190,90,37,171,989,782,1771,12,5.333333333,201852
21,15,196,17,396,256,64,47,51,1027,875,1902,7,5.5,201852
22,1,185,61,262,330,42,22,59,961,880,1841,11,5.2,201852
22,2,157,37,370,322,38,24,36,984,814,1798,7,5.5,201852
22,3,247,97,739,674,41,54,26,1878,1680,3558,9,6,201852
22,4,188,62,528,551,41,43,40,1453,1295,2748,11,6,201852
22,5,127,34,335,239,73,35,36,879,803,1682,10,5.5,201852
23,1,265,13,1145,356,18,38,48,1883,1590,3473,14,5.6,201852
23,2,257,28,509,437,19,31,0,1281,1165,2446,10,5.25,201852
23,3,305,7,900,645,23,31,0,1911,1492,3403,15,7,201852
23,4,191,11,678,362,43,33,15,1333,1200,2533,10,5.25,201852
24,1,146,53,153,280,26,13,2,673,688,1361,10,5.2,201852
24,2,125,64,233,324,20,26,17,809,692,1501,6,5.5,201852
24,3,172,50,204,288,90,35,6,845,840,1685,9,5.25,201852
24,4,158,52,221,231,102,41,154,959,787,1746,5,5.5,201852
24,5,230,60,459,630,27,52,41,1499,1250,2749,10,6.666666667,201852
24,6,150,56,271,513,36,33,21,1080,999,2079,8,4.5,201852
24,7,206,45,311,464,92,27,0,1145,1101,2246,9,5.25,201852
25,1,175,23,241,352,53,43,103,990,771,1761,13,6,201852
25,2,250,40,396,651,27,54,0,1418,1209,2627,7,5.5,201852
25,3,174,28,317,505,54,31,29,1138,872,2010,8,5.6,201852
25,4,172,30,196,443,28,35,98,1002,882,1884,8,5.333333333,201852
25,5,241,31,369,737,37,54,0,1469,1189,2658,10,5.25,201852
25,6,246,35,353,490,90,54,82,1350,1138,2488,8,5.75,201852
25,7,215,18,351,620,15,65,0,1284,1033,2317,6,6,201852
26,1,203,20,335,441,12,53,0,1064,893,1957,9,5.5,201852
26,2,170,20,447,471,4,46,6,1164,1032,2196,12,5.4,201852
26,3,284,46,460,823,15,99,95,1822,1652,3474,17,5.75,201852
26,4,156,32,183,431,30,57,71,960,759,1719,9,5.2,201852
26,5,89,10,166,281,13,39,0,598,514,1112,11,5.333333333,201852
26,6,195,23,378,527,19,61,0,1203,1060,2263,10,5.333333333,201852
26,7,153,11,244,343,27,38,0,816,764,1580,10,5.5,201852
27,1,195,25,343,441,58,34,2,1098,905,2003,8,5.5,201852
27,2,177,17,215,398,16,24,0,847,681,1528,8,5.666666667,201852
27,3,123,8,148,351,4,19,1,654,617,1271,7,5.666666667,201852
27,4,197,18,253,705,14,29,68,1284,1245,2529,10,5.5,201852
27,5,110,9,229,221,15,17,2,603,704,1307,6,5,201852
27,6,151,24,185,484,9,30,16,899,829,1728,8,5.5,201852
28,1,268,23,361,455,15,22,0,1144,1060,2204,13,6,201852
28,2,232,43,415,343,40,53,157,1283,1436,2719,13,6,201852
28,3,171,29,236,473,11,36,0,956,1044,2000,7,5.333333333,201852
28,4,249,23,422,368,59,49,214,1384,1544,2928,15,6,201852
28,5,234,46,250,534,25,45,34,1168,1079,2247,11,5.2,201852
28,6,167,23,211,296,44,23,87,851,767,1618,14,5.166666667,201852
28,7,196,41,438,524,68,45,0,1312,1087,2399,9,6.5,201852
28,8,174,54,274,445,85,46,1,1079,897,1976,9,6,201852
28,9,140,14,277,170,38,24,71,734,799,1533,11,5.75,201852
29,1,187,30,347,337,101,33,0,1035,890,1925,7,5.5,201852
29,2,213,32,374,404,51,34,130,1238,987,2225,13,6,201852
29,3,123,31,155,383,23,40,0,755,630,1385,5,5.666666667,201852
30,1,101,26,194,441,25,24,50,861,522,1383,7,5.333333333,201852
30,2,141,24,216,82,146,19,378,1006,846,1852,8,5.25,201852
30,3,149,15,394,154,228,44,304,1288,1046,2334,6,5.666666667,201852
30,4,67,13,206,236,47,33,1,603,559,1162,8,6,201852
30,5,130,42,238,504,24,44,0,982,875,1857,7,5.5,201852
30,6,126,33,277,309,27,18,1,791,809,1600,9,5.333333333,201852
30,7,146,33,229,239,38,35,164,884,746,1630,11,5.25,201852
30,8,122,34,325,442,92,45,70,1130,1044,2174,11,5.4,201852
30,9,156,16,247,178,75,34,178,884,778,1662,8,5.5,201852
30,10,149,15,330,329,43,49,164,1079,980,2059,9,5.25,201852
30,11,145,15,257,441,11,42,0,911,923,1834,5,5.5,201852
30,12,175,20,416,831,27,88,6,1563,1503,3066,10,6.25,201852
30,13,169,14,202,302,85,44,281,1097,1002,2099,10,5.4,201852
30,14,161,31,416,178,140,51,144,1121,836,1957,8,5.5,201852
30,15,212,21,254,329,109,55,352,1332,1064,2396,11,5.666666667,201852
30,16,133,21,366,309,125,50,252,1256,957,2213,10,5.333333333,201852
30,17,175,29,244,402,54,51,80,1035,940,1975,8,5.5,201852
30,18,123,22,111,364,53,27,82,782,478,1260,8,5.25,201852
30,19,161,19,245,360,32,24,4,845,824,1669,13,5.6,201852
30,20,163,17,204,331,98,43,0,856,829,1685,10,5.4,201852
31,1,161,27,211,122,363,21,1,906,1066,1972,8,5.5,201852
31,2,81,16,195,0,504,27,0,823,889,1712,6,5.333333333,201852
31,3,321,64,1066,825,282,84,0,2642,3347,5989,20,6.333333333,201852
31,4,99,23,357,186,173,29,193,1060,1124,2184,6,5.5,201852
31,5,148,41,169,589,60,36,0,1043,1068,2111,6,5.333333333,201852
32,1,139,51,223,179,66,32,99,789,785,1574,12,5.2,201852
32,2,202,105,354,175,286,54,176,1352,1260,2612,14,5.142857143,201852
32,3,168,69,242,355,11,42,28,915,951,1866,15,5.5,201852
32,4,151,95,252,293,28,34,66,919,1163,2082,13,5.4,201852
1,1,175,41,251,267,54,34,12,834,822,1656,13,5.5,201853
1,2,242,51,486,436,58,41,34,1348,1203,2551,10,6,201853
1,3,243,62,447,433,48,52,51,1336,1315,2651,11,6,201853
2,1,185,17,363,417,26,48,7,1063,989,2052,11,5,201853
2,2,264,23,309,605,18,76,0,1295,1488,2783,9,4.666666667,201853
2,3,259,22,464,425,28,67,77,1342,1548,2890,11,4.666666667,201853
2,4,144,10,471,240,43,32,6,946,997,1943,9,5,201853
2,5,399,31,892,618,191,88,15,2234,2102,4336,13,5.333333333,201853
2,6,214,14,421,372,23,54,0,1098,1177,2275,7,5,201853
2,7,224,22,483,411,18,49,54,1261,1429,2690,12,4.75,201853
2,8,231,20,556,481,17,50,3,1358,1444,2802,8,5,201853
3,1,138,22,294,423,28,33,13,951,1037,1988,14,4.571428571,201853
3,2,105,7,464,273,12,18,0,879,1045,1924,9,5,201853
4,1,152,22,292,476,37,26,2,1007,895,1902,14,4.333333333,201853
4,2,158,20,329,317,52,18,27,921,1143,2064,14,4.4,201853
5,1,210,31,316,427,34,64,53,1135,976,2111,9,4.666666667,201853
5,2,151,10,178,317,29,21,0,706,834,1540,10,4.2,201853
5,3,129,21,179,320,27,38,44,758,858,1616,9,4.5,201853
5,4,167,28,365,428,8,56,99,1151,1134,2285,11,5,201853
5,5,169,40,344,627,23,35,58,1296,1397,2693,8,5,201853
5,6,101,16,189,272,14,11,64,667,647,1314,11,4.5,201853
5,7,135,16,244,317,0,22,3,737,914,1651,11,5,201853
6,1,138,29,301,336,18,39,105,966,929,1895,14,5,201853
6,2,162,21,347,243,89,28,26,916,883,1799,9,4.666666667,201853
7,1,148,5,138,352,4,21,9,677,776,1453,11,4.25,201853
7,2,122,5,93,292,13,13,0,538,1441,1979,12,4.25,201853
7,3,280,7,196,376,81,40,20,1000,855,1855,9,4.333333333,201853
7,4,149,16,156,228,7,18,40,614,561,1175,13,4.4,201853
7,5,250,15,156,420,12,28,3,884,1092,1976,11,4.666666667,201853
7,6,192,25,299,524,20,56,35,1151,1269,2420,10,4.666666667,201853
7,7,184,30,249,389,11,49,2,914,1093,2007,8,4.5,201853
7,8,228,14,185,496,10,40,0,973,1022,1995,12,4.5,201853
7,9,157,28,271,519,15,43,0,1033,1118,2151,11,4.5,201853
7,10,139,7,158,279,12,18,0,613,623,1236,10,4.5,201853
7,11,190,4,68,151,12,10,1,436,217,653,6,4.333333333,201853
7,12,187,14,244,523,7,31,0,1006,1110,2116,9,4.5,201853
7,13,42,3,41,138,4,12,0,240,1292,1532,9,4.25,201853
8,1,167,9,534,279,29,23,26,1067,1053,2120,4,5,201853
8,2,209,30,554,449,27,48,10,1327,1464,2791,16,4.75,201853
8,3,174,30,380,459,15,45,15,1118,1186,2304,4,5,201853
8,4,153,27,323,327,21,56,134,1041,1182,2223,9,4.5,201853
8,5,168,41,238,308,16,36,0,807,1081,1888,10,4.25,201853
8,6,171,41,349,466,53,57,107,1244,1431,2675,7,5.5,201853
8,7,177,43,179,348,8,37,0,792,835,1627,7,4.25,201853
8,8,156,39,359,586,9,55,25,1229,1140,2369,12,4.5,201853
8,9,184,46,220,337,51,29,0,867,1066,1933,10,4.2,201853
9,1,82,23,138,187,85,30,85,630,672,1302,5,5,201853
9,2,213,61,613,1192,115,69,175,2438,2589,5027,12,5,201853
9,3,81,34,262,467,28,43,176,1091,1403,2494,7,5,201853
9,4,156,33,309,616,70,46,79,1309,1339,2648,11,5,201853
9,5,108,26,307,526,61,31,36,1095,1151,2246,7,5,201853
9,6,76,34,195,214,108,39,118,784,890,1674,7,5,201853
9,7,81,19,226,618,1,29,1,975,1030,2005,9,5,201853
9,8,69,7,207,289,24,33,112,741,760,1501,5,5,201853
9,9,90,8,207,347,48,27,52,779,876,1655,5,5,201853
9,10,96,23,251,504,22,41,0,937,1013,1950,6,5,201853
9,11,147,39,353,762,80,57,81,1519,1573,3092,7,6,201853
9,12,109,38,531,620,39,44,231,1612,1615,3227,11,5,201853
9,13,72,17,165,275,67,28,134,758,832,1590,4,4,201853
9,14,95,9,177,271,101,33,163,849,858,1707,5,5,201853
9,15,132,43,764,988,39,80,344,2390,2772,5162,11,4.75,201853
9,16,225,64,572,1042,88,70,2,2063,2190,4253,15,5,201853
9,17,115,24,229,390,21,36,21,836,885,1721,6,6,201853
9,18,158,45,356,868,42,46,37,1552,1653,3205,12,5,201853
9,19,142,35,266,485,115,33,66,1142,1268,2410,5,5,201853
9,20,22,6,53,96,7,5,1,190,213,403,5,5,201853
9,21,91,26,157,244,50,25,47,640,699,1339,3,5,201853
9,22,112,16,192,279,90,32,123,844,897,1741,5,5,201853
9,23,113,16,301,541,62,34,86,1153,1228,2381,6,6,201853
9,24,220,41,521,1084,106,70,77,2119,2281,4400,12,5,201853
10,1,171,32,214,220,35,32,167,871,814,1685,12,3.666666667,201853
10,2,195,31,323,371,42,36,151,1149,1222,2371,9,4.5,201853
10,3,201,52,210,380,19,35,99,996,886,1882,11,4.4,201853
10,4,275,37,347,568,18,39,26,1310,1369,2679,14,5.333333333,201853
11,1,141,50,179,258,15,26,28,697,759,1456,7,4.666666667,201853
11,2,158,31,221,313,29,25,41,818,889,1707,7,5,201853
11,3,117,46,203,219,28,30,165,808,938,1746,3,5,201853
11,4,147,37,151,314,11,22,0,682,831,1513,10,4.4,201853
11,5,224,78,373,571,23,46,45,1360,1496,2856,7,5.5,201853
11,6,85,53,205,240,36,39,57,715,802,1517,8,5,201853
11,7,163,49,216,371,22,19,0,840,692,1532,9,4.5,201853
11,8,155,54,241,439,24,28,45,986,1070,2056,9,4.5,201853
11,9,168,65,320,438,18,35,49,1093,1222,2315,10,4.666666667,201853
11,10,130,86,248,345,43,36,110,998,998,1996,10,4.6,201853
11,11,139,54,252,369,12,22,0,848,1055,1903,5,5,201853
11,12,174,60,425,590,16,31,6,1302,1424,2726,7,5.5,201853
11,13,136,71,212,249,34,33,139,874,973,1847,8,4.5,201853
11,14,154,77,329,463,34,19,8,1084,851,1935,8,4.5,201853
11,15,100,41,167,297,1,22,0,628,726,1354,9,5,201853
12,1,114,41,265,114,86,26,34,680,719,1399,10,4.2,201853
12,2,180,37,249,453,19,32,18,988,1132,2120,10,4.5,201853
12,3,197,41,318,430,18,38,0,1042,765,1807,11,4.2,201853
12,4,154,19,346,581,26,31,0,1157,1270,2427,9,5,201853
12,5,268,23,212,353,3,23,69,951,715,1666,10,4.25,201853
12,6,194,23,167,335,41,21,0,781,493,1274,10,4.25,201853
12,7,267,41,335,461,29,37,80,1250,1060,2310,8,3.333333333,201853
12,8,220,21,315,360,3,21,0,940,837,1777,9,4.25,201853
12,9,205,22,291,494,18,31,7,1068,1024,2092,9,4.666666667,201853
13,1,110,26,103,412,34,23,4,712,610,1322,9,4.333333333,201853
13,2,90,13,114,277,57,20,12,583,599,1182,6,4.333333333,201853
13,3,103,21,159,290,119,28,0,720,707,1427,12,4.25,201853
13,4,182,19,259,242,48,29,35,814,845,1659,9,4.666666667,201853
13,5,131,32,284,284,113,41,112,997,1199,2196,9,4.75,201853
13,6,228,62,579,661,47,55,122,1754,1982,3736,13,4.75,201853
13,7,127,24,299,331,19,19,0,819,919,1738,8,4.5,201853
14,1,104,51,151,155,77,24,102,664,632,1296,7,4.5,201853
14,2,142,24,296,265,37,29,41,834,829,1663,5,4.666666667,201853
14,3,177,45,399,300,43,61,31,1056,980,2036,8,4.4,201853
14,4,133,29,263,468,28,29,63,1013,1116,2129,10,5,201853
14,5,120,13,293,216,45,27,11,725,885,1610,9,4,201853
14,6,155,19,407,324,37,34,34,1010,1094,2104,11,5,201853
14,7,106,11,210,193,0,19,0,539,543,1082,6,5,201853
14,8,272,71,647,1251,32,60,50,2383,2449,4832,13,4.5,201853
14,9,100,31,182,366,42,20,17,758,718,1476,8,5,201853
14,10,142,31,359,422,7,32,35,1028,1102,2130,5,5.5,201853
14,11,150,49,242,358,44,27,165,1035,1118,2153,4,5,201853
14,12,178,18,424,216,16,31,12,895,979,1874,9,4.5,201853
14,13,153,30,348,304,27,46,45,953,937,1890,6,5,201853
14,14,99,27,254,507,26,34,43,990,1108,2098,7,5,201853
14,15,179,53,245,378,39,38,27,959,1016,1975,10,4.6,201853
14,16,122,37,280,247,72,30,134,922,1059,1981,5,5,201853
14,17,102,43,211,236,26,25,89,732,698,1430,7,4.25,201853
14,18,166,57,302,374,24,43,150,1116,1348,2464,9,4.4,201853
14,19,146,31,246,344,41,32,9,849,936,1785,8,4.25,201853
14,20,116,26,276,190,28,25,22,683,683,1366,10,4.666666667,201853
15,1,123,27,281,86,481,24,23,1045,1036,2081,7,4.333333333,201853
15,2,99,14,238,320,52,27,98,848,874,1722,6,5,201853
15,3,149,38,187,385,256,34,76,1125,1314,2439,10,4.666666667,201853
15,4,139,26,212,413,31,37,82,940,1030,1970,4,5,201853
15,5,127,42,199,306,26,25,98,823,986,1809,8,4.666666667,201853
15,6,122,20,285,507,52,41,75,1102,1184,2286,7,5.5,201853
15,7,114,21,256,475,49,27,31,973,1085,2058,10,5,201853
15,8,64,15,126,277,10,20,12,524,597,1121,4,5,201853
15,9,175,21,146,150,214,20,46,772,619,1391,9,4.75,201853
15,10,134,22,197,316,64,23,47,803,785,1588,6,5,201853
15,11,189,23,239,539,61,32,22,1105,1099,2204,8,5,201853
15,12,204,23,410,530,27,39,9,1242,1367,2609,8,5,201853
15,13,69,27,147,276,104,28,0,651,744,1395,8,5,201853
15,14,57,26,136,305,28,15,1,568,563,1131,4,5,201853
15,15,111,51,264,420,35,30,76,987,1131,2118,6,5,201853
15,16,194,43,278,669,15,36,28,1263,1168,2431,8,5,201853
15,17,102,30,159,253,9,42,209,804,848,1652,8,5,201853
15,18,127,33,262,450,53,46,92,1063,1112,2175,7,4.666666667,201853
15,19,152,57,375,1010,10,44,14,1662,1838,3500,10,5,201853
15,20,72,16,211,369,24,19,13,724,717,1441,6,5,201853
15,21,80,7,78,238,28,17,68,516,589,1105,6,4.5,201853
15,22,234,73,424,847,36,114,198,1926,2019,3945,14,5,201853
15,23,117,8,171,378,25,30,0,729,848,1577,6,4.333333333,201853
15,24,86,21,196,305,38,35,14,695,702,1397,4,5,201853
15,25,127,15,197,283,50,39,65,776,861,1637,6,5,201853
15,26,106,15,172,291,80,24,18,706,774,1480,11,4.333333333,201853
15,27,155,24,299,424,19,50,213,1184,1149,2333,9,4.666666667,201853
15,28,185,26,458,397,89,45,75,1275,1452,2727,9,4.666666667,201853
15,29,175,55,369,765,23,42,24,1453,1393,2846,8,5,201853
15,30,175,32,333,439,49,37,29,1094,1010,2104,16,5,201853
15,31,153,58,269,593,11,34,0,1118,1161,2279,6,5,201853
15,32,159,15,279,489,22,29,42,1035,1076,2111,9,5,201853
15,33,142,14,223,447,26,38,3,893,947,1840,7,5,201853
15,34,99,12,159,408,14,35,58,785,853,1638,8,5,201853
15,35,225,32,250,545,16,46,6,1120,1034,2154,9,4.666666667,201853
15,36,152,28,279,365,68,27,5,924,994,1918,9,4.5,201853
15,37,163,31,243,433,61,37,124,1092,1131,2223,7,5,201853
15,38,140,39,220,439,11,31,20,900,869,1769,6,4.5,201853
15,39,104,29,204,328,13,28,10,716,752,1468,4,5,201853
15,40,188,21,304,426,90,35,16,1080,1231,2311,9,5,201853
15,41,201,35,413,510,37,37,64,1297,1421,2718,11,5,201853
16,1,99,28,234,193,29,24,1,608,739,1347,7,4.333333333,201853
16,2,125,35,137,215,52,26,0,590,361,951,9,4.25,201853
16,3,123,22,184,241,21,28,10,629,773,1402,10,4.25,201853
16,4,153,25,284,245,47,35,0,789,896,1685,8,4.5,201853
16,5,140,43,208,255,30,43,55,774,779,1553,10,4.666666667,201853
16,6,117,38,184,244,36,30,0,649,654,1303,12,4.5,201853
16,7,124,40,139,223,63,29,0,618,768,1386,9,4.5,201853
16,8,211,52,514,626,6,43,24,1476,1648,3124,12,5,201853
16,9,141,17,219,305,24,55,6,767,948,1715,9,5.5,201853
16,10,127,21,242,406,11,46,0,853,784,1637,8,4.666666667,201853
16,11,132,39,143,189,122,28,28,681,647,1328,10,4.4,201853
16,12,143,22,252,169,47,40,8,681,579,1260,10,4.25,201853
17,1,138,24,401,514,31,39,54,1201,1181,2382,11,5.5,201853
17,2,100,10,214,322,17,29,23,715,850,1565,8,4.666666667,201853
17,3,166,25,334,461,11,42,2,1041,1031,2072,8,4.5,201853
17,4,152,25,285,430,18,31,33,974,1104,2078,10,4.666666667,201853
17,5,60,15,87,207,15,21,9,414,376,790,5,4.5,201853
18,1,100,13,147,275,26,22,69,652,457,1109,7,4.25,201853
18,2,167,36,344,502,55,39,1,1144,1319,2463,11,5.75,201853
18,3,134,22,270,291,10,25,0,752,904,1656,8,4.75,201853
19,1,148,39,292,560,27,61,49,1176,1233,2409,9,5,201853
19,2,218,26,503,449,37,35,125,1393,1373,2766,9,5,201853
19,3,255,22,536,565,40,43,39,1500,1542,3042,7,5,201853
19,4,73,21,145,136,98,24,217,714,739,1453,5,5,201853
19,5,216,46,352,596,20,48,207,1485,1707,3192,8,5,201853
19,6,67,17,191,495,8,27,0,805,876,1681,5,5,201853
19,7,149,7,372,254,11,33,5,831,833,1664,10,4.5,201853
19,8,35,6,95,99,3,8,0,246,272,518,7,5,201853
19,9,128,30,157,224,27,33,12,611,639,1250,9,4.25,201853
19,10,135,20,279,282,6,61,322,1105,1279,2384,8,5,201853
19,11,335,77,622,1317,33,98,236,2718,2881,5599,13,5.333333333,201853
19,12,178,17,414,228,13,37,10,897,885,1782,8,4.666666667,201853
20,1,131,11,161,151,58,33,118,663,648,1311,7,4.5,201853
20,2,164,8,161,235,10,25,0,603,611,1214,6,4.333333333,201853
20,3,121,22,212,268,92,20,58,793,414,1207,6,4.333333333,201853
20,4,109,24,167,197,67,37,81,682,392,1074,6,4.333333333,201853
20,5,123,33,268,416,102,25,0,967,447,1414,11,4.25,201853
20,6,179,11,213,213,195,37,2,850,702,1552,8,4.25,201853
20,7,154,22,247,432,21,28,6,910,957,1867,8,4.75,201853
20,8,346,37,455,813,39,96,344,2130,2370,4500,15,5,201853
20,9,196,18,191,256,73,39,125,898,849,1747,8,4.666666667,201853
20,10,201,12,235,390,23,22,0,883,873,1756,9,4.25,201853
21,1,145,10,199,358,6,27,0,745,708,1453,10,4.4,201853
21,2,186,19,244,305,113,23,3,893,666,1559,10,4.2,201853
21,3,170,20,304,224,137,34,65,954,832,1786,9,4.5,201853
21,4,105,10,158,104,125,24,44,570,417,987,7,4.25,201853
21,5,208,27,351,403,15,54,29,1087,755,1842,8,4.666666667,201853
21,6,145,25,247,374,51,29,226,1097,1141,2238,6,5,201853
21,7,267,21,233,309,67,67,67,1031,831,1862,9,4.666666667,201853
21,8,189,15,462,206,105,40,39,1056,980,2036,10,4.2,201853
21,9,145,18,407,371,54,45,108,1148,1264,2412,9,5,201853
21,10,162,17,306,372,42,28,144,1071,1098,2169,7,5,201853
21,11,47,6,124,97,23,9,12,318,289,607,6,3.5,201853
21,12,269,30,639,985,58,94,150,2225,2349,4574,16,6,201853
21,13,169,13,290,381,69,44,67,1033,991,2024,8,4.666666667,201853
21,14,130,7,215,117,111,45,100,725,835,1560,12,4.333333333,201853
21,15,231,20,390,329,80,47,54,1151,1060,2211,7,4.5,201853
22,1,133,53,187,276,47,45,4,745,819,1564,11,4.2,201853
22,2,120,39,332,288,18,16,63,876,1145,2021,7,4.5,201853
22,3,207,79,708,619,40,33,7,1693,1689,3382,9,5,201853
22,4,144,62,473,528,30,32,27,1296,1446,2742,11,5,201853
22,5,170,34,490,198,102,32,32,1058,1126,2184,10,4.5,201853
23,1,233,9,921,305,26,23,53,1570,1773,3343,14,4.6,201853
23,2,173,28,340,482,19,33,3,1078,802,1880,10,4.25,201853
23,3,241,8,740,529,20,41,0,1579,1709,3288,15,6,201853
23,4,151,3,544,334,29,25,19,1105,1111,2216,10,4.5,201853
24,1,130,46,164,271,29,18,8,666,643,1309,10,4.2,201853
24,2,112,53,195,243,37,28,13,681,712,1393,6,4.5,201853
24,3,125,25,143,237,114,20,0,664,566,1230,9,4.25,201853
24,4,117,54,156,208,60,35,151,781,834,1615,5,4.5,201853
24,5,171,58,410,551,17,49,40,1296,1420,2716,9,5.333333333,201853
24,6,134,49,292,464,41,44,21,1045,1099,2144,8,4.5,201853
24,7,180,37,312,521,119,24,0,1193,836,2029,9,4.25,201853
25,1,100,20,158,320,20,27,70,715,774,1489,13,5,201853
25,2,147,31,309,519,57,40,0,1103,1288,2391,7,4.5,201853
25,3,202,17,335,424,81,28,13,1100,1039,2139,8,4.6,201853
25,4,119,25,156,330,10,31,70,741,1109,1850,8,4.333333333,201853
25,5,171,12,305,653,25,51,1,1218,1318,2536,10,4.25,201853
25,6,178,16,344,395,127,46,69,1175,1245,2420,8,4.75,201853
25,7,172,21,310,519,13,41,0,1076,1094,2170,6,5,201853
26,1,207,17,289,335,12,37,0,897,942,1839,9,4.5,201853
26,2,213,15,407,452,6,55,11,1159,1118,2277,12,4.4,201853
26,3,221,26,318,645,10,91,85,1396,1532,2928,17,5,201853
26,4,135,32,140,329,40,32,58,766,872,1638,9,4.2,201853
26,5,67,14,121,241,21,38,0,502,470,972,15,4.333333333,201853
26,6,143,16,303,477,8,40,0,987,1063,2050,10,4.333333333,201853
26,7,147,16,189,226,38,21,0,637,667,1304,10,4.5,201853
27,1,154,27,280,478,40,16,1,996,839,1835,8,4.5,201853
27,2,166,13,213,403,19,37,0,851,1065,1916,8,4.666666667,201853
27,3,165,23,183,452,10,21,8,862,722,1584,7,4.666666667,201853
27,4,177,29,262,784,8,34,73,1367,1082,2449,10,4.5,201853
27,5,110,6,106,292,11,20,2,547,430,977,6,4,201853
27,6,120,14,179,430,9,17,26,795,674,1469,8,4.5,201853
28,1,229,29,411,443,12,38,0,1162,1209,2371,13,5,201853
28,2,210,34,386,304,59,48,187,1228,1274,2502,13,5,201853
28,3,80,16,173,286,6,21,0,582,695,1277,7,4.333333333,201853
28,4,204,30,359,342,67,59,261,1322,1485,2807,15,5,201853
28,5,180,44,211,505,17,37,39,1033,1128,2161,12,5,201853
28,6,134,26,186,247,48,28,46,715,819,1534,14,4.166666667,201853
28,7,181,41,425,513,59,37,0,1256,1015,2271,8,5,201853
28,8,158,39,270,384,90,43,20,1004,1114,2118,9,5,201853
28,9,99,11,242,154,43,25,82,656,741,1397,11,4.75,201853
29,1,149,27,293,348,68,28,0,913,932,1845,7,4.5,201853
29,2,161,23,294,346,58,51,102,1035,1234,2269,12,5,201853
29,3,131,36,143,342,14,21,0,687,538,1225,5,4.666666667,201853
30,1,90,32,221,395,29,26,61,854,799,1653,7,4.333333333,201853
30,2,124,30,209,103,125,26,277,894,883,1777,8,4.25,201853
30,3,139,21,347,136,163,29,290,1125,1166,2291,6,4.666666667,201853
30,4,87,13,214,285,49,27,0,675,672,1347,8,5,201853
30,5,125,25,193,426,22,44,0,835,847,1682,7,4.5,201853
30,6,144,21,250,312,33,28,2,790,827,1617,9,4.333333333,201853
30,7,119,21,246,176,27,18,155,762,752,1514,11,4.25,201853
30,8,137,27,346,480,108,36,82,1216,1161,2377,11,4.4,201853
30,9,149,17,154,264,70,31,149,834,794,1628,8,4.5,201853
30,10,143,29,307,380,57,52,206,1174,1001,2175,9,4.25,201853
30,11,107,17,274,430,13,20,1,862,864,1726,5,4.5,201853
30,12,189,34,474,959,33,54,5,1748,1560,3308,10,5.25,201853
30,13,143,15,149,199,87,35,213,841,926,1767,10,4.4,201853
30,14,146,29,285,146,140,40,132,918,1112,2030,8,4.5,201853
30,15,182,16,251,264,106,54,276,1149,1254,2403,11,4.666666667,201853
30,16,140,21,226,278,96,49,332,1142,1192,2334,10,4.333333333,201853
30,17,153,44,202,305,85,38,59,886,929,1815,8,4.5,201853
30,18,141,17,154,249,33,24,23,641,784,1425,8,4.25,201853
30,19,138,9,242,352,38,26,11,816,795,1611,13,4.6,201853
30,20,128,22,199,348,155,32,0,884,952,1836,10,4.4,201853
31,1,129,23,146,109,270,20,0,697,809,1506,8,4.5,201853
31,2,81,17,162,0,364,18,0,642,578,1220,6,4.333333333,201853
31,3,274,55,1011,787,261,66,43,2497,2661,5158,21,5.666666667,201853
31,4,148,18,301,183,112,25,178,965,944,1909,6,4.5,201853
31,5,111,41,131,614,36,11,0,944,927,1871,6,4.333333333,201853
32,1,125,54,202,177,68,31,124,781,958,1739,12,4.2,201853
32,2,118,86,258,95,221,34,142,954,1024,1978,14,4.142857143,201853
32,3,205,80,286,480,16,22,38,1127,1103,2230,15,4.5,201853
32,4,179,117,285,346,47,33,107,1114,1090,2204,13,5,201853
1,1,234,45,338,396,52,31,10,1106,923,2029,13,5,201854
1,2,194,54,465,448,68,33,68,1330,1249,2579,10,5.25,201854
1,3,176,77,489,516,53,40,66,1417,1331,2748,11,5.25,201854
2,1,184,24,324,460,26,44,6,1068,922,1990,11,5,201854
2,2,243,21,371,852,18,66,0,1571,1147,2718,9,5,201854
2,3,263,37,569,551,32,62,102,1616,1156,2772,11,5,201854
2,4,175,6,407,229,48,26,4,895,656,1551,9,5,201854
2,5,318,69,834,641,215,78,17,2172,1867,4039,13,5.333333333,201854
2,6,196,13,435,443,32,49,0,1168,880,2048,7,5,201854
2,7,269,22,556,436,31,56,67,1437,1217,2654,12,5,201854
2,8,197,13,538,535,21,47,7,1358,1060,2418,8,5,201854
3,1,149,26,354,464,26,51,33,1103,818,1921,14,5,201854
3,2,128,11,527,322,10,24,0,1022,931,1953,9,5.333333333,201854
4,1,183,28,336,659,36,51,7,1300,1164,2464,14,5,201854
4,2,200,29,414,495,39,43,27,1247,1111,2358,14,5.2,201854
5,1,225,15,327,391,60,45,42,1105,1003,2108,9,5,201854
5,2,141,13,208,309,23,19,0,713,536,1249,10,5,201854
5,3,204,39,278,445,57,62,110,1195,971,2166,9,5,201854
5,4,205,44,465,466,23,82,104,1389,1107,2496,11,5,201854
5,5,160,23,380,615,14,46,74,1312,1144,2456,8,5,201854
5,6,118,17,224,329,14,29,78,809,621,1430,11,5,201854
5,7,161,23,242,430,12,31,0,899,751,1650,10,5,201854
6,1,130,42,370,335,29,42,166,1114,924,2038,14,5.333333333,201854
6,2,139,26,354,264,82,35,41,941,844,1785,9,5,201854
7,1,229,15,232,411,10,48,65,1010,870,1880,11,5,201854
7,2,216,10,131,344,24,33,1,759,813,1572,12,5,201854
7,3,274,8,314,377,150,39,21,1183,960,2143,9,5,201854
7,4,201,22,213,369,8,43,77,933,1065,1998,13,5,201854
7,5,281,14,188,440,11,28,6,968,959,1927,11,5,201854
7,6,252,36,343,613,31,60,41,1376,1489,2865,11,5.666666667,201854
7,7,229,33,339,522,31,57,5,1216,1291,2507,8,5,201854
7,8,201,9,195,664,13,30,0,1112,1158,2270,12,5,201854
7,9,194,30,290,582,28,38,4,1166,1196,2362,11,5,201854
7,10,156,9,209,385,7,25,0,791,1122,1913,10,5,201854
7,11,186,10,103,244,18,9,25,595,458,1053,6,5,201854
7,12,261,11,295,651,0,22,0,1240,1048,2288,9,5,201854
7,13,73,11,97,266,3,22,0,472,373,845,9,4.75,201854
8,1,151,13,455,336,35,23,25,1038,793,1831,4,5,201854
8,2,250,27,540,533,18,56,37,1461,1199,2660,16,5.25,201854
8,3,205,28,449,587,18,36,20,1343,1040,2383,4,5,201854
8,4,97,22,226,173,22,31,77,648,925,1573,9,7,201854
8,5,185,30,334,466,22,45,0,1082,737,1819,10,5,201854
8,6,178,33,451,642,57,76,114,1551,1068,2619,7,5.5,201854
8,7,160,47,219,449,13,45,0,933,786,1719,7,5,201854
8,8,175,35,370,565,20,42,42,1249,1070,2319,12,5.5,201854
8,9,195,63,250,423,94,71,14,1110,869,1979,10,5,201854
9,1,82,19,167,189,91,29,106,683,484,1167,5,5,201854
9,2,281,73,651,1296,108,93,201,2703,2255,4958,12,5,201854
9,3,107,37,339,503,75,56,225,1342,1157,2499,7,5,201854
9,4,159,37,375,703,93,63,77,1507,1062,2569,11,5,201854
9,5,112,18,323,609,76,43,40,1221,953,2174,7,5,201854
9,6,94,31,209,210,157,27,132,860,673,1533,7,5,201854
9,7,77,30,238,663,7,33,7,1055,871,1926,9,5,201854
9,8,71,16,228,278,25,29,166,813,685,1498,5,5,201854
9,9,114,16,184,390,48,21,61,834,690,1524,5,5,201854
9,10,83,32,275,593,16,43,0,1042,875,1917,6,5,201854
9,11,140,37,425,778,90,64,82,1616,1322,2938,7,6,201854
9,12,114,30,530,681,41,64,239,1699,1431,3130,11,5,201854
9,13,99,17,246,373,103,35,190,1063,969,2032,4,5,201854
9,14,96,27,222,280,128,35,223,1011,754,1765,5,5,201854
9,15,178,43,931,1284,48,92,384,2960,2174,5134,11,5,201854
9,16,221,65,580,1037,118,68,12,2101,1772,3873,15,6,201854
9,17,118,22,232,471,30,46,19,938,712,1650,6,5,201854
9,18,136,61,401,1044,64,61,42,1809,1328,3137,12,5,201854
9,19,147,49,302,606,99,46,106,1355,1001,2356,5,5,201854
9,20,42,5,56,92,5,6,19,225,164,389,5,5,201854
9,21,87,24,164,311,41,24,69,720,466,1186,3,5,201854
9,22,149,21,206,321,99,33,171,1000,739,1739,5,5,201854
9,23,111,29,263,607,51,41,137,1239,1074,2313,6,6,201854
9,24,222,50,592,1166,124,74,100,2328,1828,4156,12,5,201854
10,1,193,35,202,265,18,36,145,894,786,1680,12,4.333333333,201854
10,2,220,37,342,408,26,44,155,1232,965,2197,9,5.25,201854
10,3,203,50,223,473,12,30,53,1044,1011,2055,11,5,201854
10,4,252,39,414,622,26,64,33,1450,1162,2612,13,5.333333333,201854
11,1,179,68,217,365,54,28,37,948,782,1730,6,5,201854
11,2,156,43,266,338,40,30,44,917,726,1643,7,5,201854
11,3,121,62,248,248,27,37,206,949,740,1689,3,5,201854
11,4,158,50,249,425,19,26,0,927,720,1647,9,4.6,201854
11,5,200,112,428,655,23,60,42,1520,1176,2696,7,5.5,201854
11,6,104,35,270,257,38,27,45,776,577,1353,8,5,201854
11,7,185,48,308,447,29,37,0,1054,976,2030,9,5,201854
11,8,168,52,298,531,31,32,44,1156,925,2081,9,5,201854
11,9,209,105,401,574,22,53,99,1463,1067,2530,10,5,201854
11,10,175,103,323,482,52,37,111,1283,949,2232,10,5,201854
11,11,149,60,263,421,24,26,0,943,802,1745,5,5,201854
11,12,157,73,451,701,13,41,11,1447,1136,2583,7,5.5,201854
11,13,162,73,278,276,51,29,155,1024,809,1833,8,5,201854
11,14,191,123,355,638,50,51,21,1429,1111,2540,8,5,201854
11,15,121,54,205,336,4,37,0,757,541,1298,9,5,201854
12,1,162,45,364,152,164,33,51,971,883,1854,10,5,201854
12,2,189,43,382,569,28,53,24,1288,964,2252,10,5,201854
12,3,161,54,342,571,19,35,0,1182,960,2142,11,5,201854
12,4,141,25,355,588,24,35,2,1170,1000,2170,9,5.333333333,201854
12,5,204,38,246,323,10,21,38,880,969,1849,10,5,201854
12,6,199,25,210,439,34,24,1,932,873,1805,10,5,201854
12,7,217,40,268,525,9,53,76,1188,969,2157,8,4,201854
12,8,230,32,279,466,10,30,0,1047,983,2030,9,5,201854
12,9,149,15,284,514,12,25,4,1003,809,1812,9,5,201854
13,1,180,28,190,486,109,42,18,1053,733,1786,9,5,201854
13,2,150,42,160,474,95,28,35,984,902,1886,6,5,201854
13,3,152,29,208,322,110,37,0,858,706,1564,12,5,201854
13,4,190,51,352,299,112,51,68,1123,889,2012,9,5,201854
13,5,178,44,445,328,128,60,155,1338,983,2321,9,5,201854
13,6,276,82,662,702,54,62,133,1971,1642,3613,13,5.25,201854
13,7,135,37,364,486,27,37,0,1086,897,1983,8,5,201854
14,1,110,65,184,166,79,31,204,839,828,1667,7,4.25,201854
14,2,134,27,349,289,62,26,43,930,916,1846,5,5,201854
14,3,160,55,527,386,49,53,59,1289,977,2266,8,4.6,201854
14,4,130,43,321,530,38,29,69,1160,977,2137,10,5,201854
14,5,146,22,512,392,79,39,23,1213,1165,2378,9,5,201854
14,6,165,15,482,373,33,41,17,1126,950,2076,11,5,201854
14,7,105,18,269,219,0,15,0,626,585,1211,6,5,201854
14,8,238,79,714,1395,26,69,69,2590,2383,4973,13,5,201854
14,9,79,22,173,396,38,24,16,748,695,1443,8,5,201854
14,10,142,32,356,480,9,42,73,1134,1019,2153,5,5.5,201854
14,11,131,61,212,355,67,39,243,1108,951,2059,4,5,201854
14,12,187,36,529,287,18,40,21,1118,958,2076,9,5,201854
14,13,144,46,312,392,16,41,55,1006,756,1762,6,5,201854
14,14,88,37,300,664,32,28,70,1219,970,2189,7,5,201854
14,15,174,61,249,439,47,61,27,1058,1053,2111,10,5,201854
14,16,156,39,373,254,83,26,107,1038,820,1858,5,5,201854
14,17,170,61,316,275,61,47,111,1041,710,1751,7,5,201854
14,18,222,55,469,467,55,46,216,1530,1061,2591,9,5,201854
14,19,194,52,321,457,41,40,23,1128,1156,2284,8,5,201854
14,20,124,29,312,266,17,34,28,810,768,1578,10,5,201854
15,1,150,43,301,173,523,26,134,1350,1143,2493,7,5,201854
15,2,125,23,235,368,42,25,102,920,693,1613,6,5,201854
15,3,203,58,231,433,339,49,144,1457,1227,2684,10,5,201854
15,4,146,33,271,442,46,37,114,1089,893,1982,4,5,201854
15,5,148,44,260,359,34,32,155,1032,670,1702,8,5,201854
15,6,128,30,255,551,75,38,125,1202,919,2121,7,5.5,201854
15,7,126,24,261,544,48,33,30,1066,855,1921,10,5,201854
15,8,77,19,140,313,13,25,22,609,474,1083,4,5,201854
15,9,176,23,149,144,272,25,56,845,754,1599,9,5,201854
15,10,136,22,199,381,83,45,97,963,648,1611,6,5,201854
15,11,141,34,302,560,55,34,26,1152,892,2044,8,5,201854
15,12,200,24,463,558,41,37,16,1339,1034,2373,8,5,201854
15,13,84,31,132,303,132,26,0,708,565,1273,8,5,201854
15,14,86,22,152,364,22,22,0,668,504,1172,4,5,201854
15,15,129,40,278,440,38,36,104,1065,903,1968,6,5,201854
15,16,186,42,306,704,18,40,38,1334,991,2325,8,5,201854
15,17,92,19,194,288,20,53,271,937,679,1616,8,5,201854
15,18,179,48,330,502,62,52,135,1308,1095,2403,7,5,201854
15,19,185,57,439,970,11,57,52,1771,1498,3269,10,5,201854
15,20,72,22,183,420,25,25,23,770,596,1366,6,5,201854
15,21,76,13,105,243,19,22,71,549,624,1173,6,5,201854
15,22,200,89,485,933,54,66,321,2148,1684,3832,14,5,201854
15,23,139,16,215,562,23,38,0,993,919,1912,6,5,201854
15,24,93,35,208,317,33,17,21,724,592,1316,4,5,201854
15,25,173,33,247,257,61,41,88,900,694,1594,6,5,201854
15,26,132,15,227,364,81,28,29,876,662,1538,11,5,201854
15,27,147,31,278,441,28,65,289,1279,1021,2300,9,5,201854
15,28,214,49,543,387,113,39,76,1421,1062,2483,9,5,201854
15,29,176,47,407,786,36,50,35,1537,1231,2768,8,5,201854
15,30,206,35,351,448,33,34,39,1146,1037,2183,16,5,201854
15,31,146,73,242,597,13,34,17,1122,880,2002,6,5,201854
15,32,119,26,355,498,36,40,42,1116,857,1973,9,5,201854
15,33,135,14,291,410,26,42,7,925,720,1645,7,5,201854
15,34,136,20,153,479,10,27,64,889,669,1558,8,5,201854
15,35,211,31,258,493,27,51,4,1075,958,2033,9,5,201854
15,36,167,34,400,527,108,36,12,1284,1039,2323,9,5,201854
15,37,142,28,240,493,50,51,177,1181,923,2104,7,5,201854
15,38,135,38,268,499,13,32,24,1009,847,1856,6,5,201854
15,39,138,36,244,389,11,37,10,865,675,1540,4,5,201854
15,40,232,35,368,563,125,46,21,1390,986,2376,9,5,201854
15,41,185,37,436,541,39,50,96,1384,1151,2535,11,5,201854
16,1,141,22,215,312,27,39,2,758,767,1525,7,5,201854
16,2,141,42,222,360,37,32,0,834,810,1644,9,5,201854
16,3,154,31,247,305,35,33,19,824,587,1411,10,5,201854
16,4,210,42,440,342,86,55,0,1175,1049,2224,8,4.5,201854
16,5,202,64,255,393,58,71,44,1087,996,2083,10,5,201854
16,6,134,43,172,272,50,25,0,696,666,1362,12,5,201854
16,7,227,41,236,321,55,48,0,928,742,1670,9,5,201854
16,8,211,65,556,771,12,59,33,1707,1252,2959,12,5,201854
16,9,172,42,306,381,33,52,49,1035,749,1784,9,5.5,201854
16,10,132,33,297,402,14,27,4,909,633,1542,8,5,201854
16,11,165,41,269,283,165,55,22,1000,710,1710,10,5,201854
16,12,170,40,275,231,63,40,12,831,837,1668,10,5,201854
17,1,151,29,454,600,43,38,55,1370,986,2356,11,6,201854
17,2,117,13,303,412,18,42,37,942,730,1672,8,5,201854
17,3,183,33,414,612,11,50,0,1303,971,2274,8,5,201854
17,4,174,35,391,488,49,56,53,1246,1015,2261,10,5,201854
17,5,74,11,135,219,20,17,2,478,460,938,5,5,201854
18,1,165,30,183,298,26,50,45,797,902,1699,7,5,201854
18,2,212,53,385,570,79,42,3,1344,1045,2389,11,5.75,201854
18,3,143,27,306,328,29,39,0,872,713,1585,8,5.25,201854
19,1,203,46,386,697,31,56,111,1530,1032,2562,9,5,201854
19,2,251,32,565,476,31,31,163,1549,1155,2704,9,5,201854
19,3,259,28,660,704,41,56,37,1785,1491,3276,7,5,201854
19,4,92,35,190,131,124,28,300,900,711,1611,5,5,201854
19,5,300,59,420,786,42,62,235,1904,1409,3313,8,5,201854
19,6,85,27,229,577,6,39,0,963,782,1745,5,5,201854
19,7,227,21,522,395,20,37,6,1228,1224,2452,10,5,201854
19,8,48,9,99,127,5,12,0,300,219,519,7,5,201854
19,9,154,58,242,469,72,28,69,1092,758,1850,9,5,201854
19,10,130,37,324,331,8,45,476,1351,1119,2470,7,3.333333333,201854
19,11,379,132,659,1481,38,114,427,3230,2595,5825,13,5.333333333,201854
19,12,166,24,479,344,21,23,22,1079,1010,2089,8,5,201854
20,1,181,32,258,234,92,39,135,971,740,1711,7,5,201854
20,2,136,23,173,234,17,21,0,604,748,1352,6,5,201854
20,3,111,14,234,187,73,40,128,787,979,1766,6,5,201854
20,4,145,29,193,254,83,45,95,844,864,1708,6,5,201854
20,5,184,32,299,458,120,46,0,1139,1090,2229,11,5,201854
20,6,255,30,252,252,215,50,1,1055,1199,2254,8,5,201854
20,7,198,28,304,609,25,39,15,1218,1189,2407,8,5,201854
20,8,363,63,559,910,36,120,452,2503,2009,4512,15,5.333333333,201854
20,9,159,24,244,226,106,45,191,995,795,1790,8,5,201854
20,10,174,17,231,506,7,27,0,962,1051,2013,9,5,201854
21,1,163,22,244,423,15,38,0,905,687,1592,10,5,201854
21,2,201,30,364,311,243,51,11,1211,817,2028,10,5,201854
21,3,203,21,381,203,159,51,109,1127,933,2060,9,5,201854
21,4,195,15,204,206,106,55,72,853,543,1396,7,5,201854
21,5,132,20,351,350,22,47,45,967,799,1766,8,5,201854
21,6,138,16,289,365,49,30,301,1188,933,2121,6,5,201854
21,7,287,36,297,433,82,72,91,1298,1098,2396,9,5,201854
21,8,204,19,366,292,116,30,47,1074,866,1940,10,5,201854
21,9,146,18,359,391,94,39,137,1184,1009,2193,9,5,201854
21,10,161,26,305,357,39,53,166,1107,908,2015,7,5.5,201854
21,11,34,0,121,95,12,11,14,287,291,578,6,4.5,201854
21,12,242,35,738,1025,44,82,167,2333,1799,4132,15,5.5,201854
21,13,212,27,409,531,112,61,99,1451,1028,2479,8,5,201854
21,14,130,14,257,170,129,41,102,843,737,1580,12,5,201854
21,15,228,22,472,317,98,56,73,1266,871,2137,7,5,201854
22,1,160,47,266,358,33,23,59,946,708,1654,11,5,201854
22,2,150,48,366,335,30,47,40,1016,855,1871,7,5,201854
22,3,178,83,672,671,47,44,14,1709,1632,3341,9,5.333333333,201854
22,4,142,61,481,540,38,39,57,1358,1190,2548,11,5.333333333,201854
22,5,121,24,368,209,86,24,21,853,762,1615,10,5,201854
23,1,276,9,1112,357,26,34,58,1872,1634,3506,14,5,201854
23,2,166,31,423,531,10,41,4,1206,1109,2315,10,5,201854
23,3,223,11,778,517,24,20,0,1573,1397,2970,15,6,201854
23,4,186,6,734,412,25,28,31,1422,1147,2569,10,5,201854
24,1,180,54,229,339,48,25,7,882,660,1542,10,5,201854
24,2,144,71,303,339,41,31,8,937,769,1706,6,5,201854
24,3,173,60,230,372,117,35,0,987,869,1856,9,5,201854
24,4,143,51,210,186,93,40,171,894,769,1663,5,5,201854
24,5,230,47,424,668,21,48,52,1490,1220,2710,10,5.666666667,201854
24,6,147,71,304,522,53,33,16,1146,921,2067,8,3.5,201854
24,7,242,46,340,414,91,21,0,1154,1122,2276,9,5,201854
25,1,144,38,223,393,106,47,114,1065,1022,2087,13,5.25,201854
25,2,199,51,448,707,28,48,1,1482,1079,2561,7,5,201854
25,3,160,35,323,547,83,37,33,1218,1029,2247,8,5,201854
25,4,177,39,204,471,30,49,143,1113,896,2009,8,5,201854
25,5,191,21,299,793,44,48,0,1396,1283,2679,10,5,201854
25,6,186,30,424,517,98,55,69,1379,1174,2553,8,5,201854
25,7,179,24,365,684,21,51,0,1324,1082,2406,6,5,201854
26,1,184,19,325,409,9,57,0,1003,944,1947,9,5,201854
26,2,181,11,373,481,2,50,4,1102,997,2099,12,5,201854
26,3,303,37,392,801,5,87,110,1735,1614,3349,17,5.25,201854
26,4,164,24,222,362,49,44,105,970,972,1942,9,5,201854
26,5,107,14,170,281,19,33,1,625,549,1174,11,5,201854
26,6,121,30,327,563,17,43,0,1101,986,2087,10,5,201854
26,7,150,15,226,299,36,31,0,757,720,1477,10,5,201854
27,1,149,28,326,557,30,32,3,1125,888,2013,8,5,201854
27,2,219,23,315,494,24,29,0,1104,1121,2225,8,5,201854
27,3,175,16,251,535,17,27,3,1024,693,1717,7,5,201854
27,4,186,15,305,764,11,37,70,1388,1282,2670,10,5.25,201854
27,5,151,15,154,335,20,17,11,703,891,1594,6,5,201854
27,6,140,30,233,532,14,31,19,999,856,1855,8,5,201854
28,1,220,39,454,560,4,31,0,1308,1121,2429,13,5,201854
28,2,198,38,463,359,40,33,248,1379,1249,2628,11,7,201854
28,3,161,36,254,497,9,29,0,986,893,1879,7,5,201854
28,4,241,49,470,395,75,58,407,1695,1265,2960,15,5,201854
28,5,245,68,300,669,26,38,73,1419,1079,2498,11,5,201854
28,6,153,39,295,433,54,40,99,1113,844,1957,14,5,201854
28,7,165,52,444,620,76,37,0,1394,1250,2644,8,5,201854
28,8,148,56,299,503,92,36,15,1149,1011,2160,9,5,201854
28,9,162,20,369,181,27,28,151,938,657,1595,11,5,201854
29,1,182,40,331,412,93,29,1,1088,990,2078,7,5,201854
29,2,194,29,346,357,62,47,150,1185,1034,2219,13,5.5,201854
29,3,118,43,154,401,31,22,0,769,725,1494,5,5,201854
30,1,112,29,238,455,26,24,103,987,769,1756,7,5,201854
30,2,152,40,262,102,179,31,467,1233,1043,2276,8,5,201854
30,3,139,38,498,184,286,42,396,1583,1071,2654,6,5,201854
30,4,86,14,260,316,57,26,0,759,542,1301,8,5,201854
30,5,159,46,301,626,40,61,0,1233,882,2115,7,5,201854
30,6,144,18,289,358,40,36,5,890,789,1679,9,5,201854
30,7,196,29,349,308,65,48,255,1250,849,2099,11,5,201854
30,8,161,31,382,479,123,35,47,1258,998,2256,11,5,201854
30,9,174,20,257,175,101,43,196,966,834,1800,8,5,201854
30,10,154,41,397,461,86,53,247,1439,1208,2647,9,5.25,201854
30,11,121,17,267,594,8,30,0,1037,796,1833,5,5,201854
30,12,214,41,506,1097,40,66,8,1972,1454,3426,10,5.25,201854
30,13,215,29,239,361,166,51,433,1494,1069,2563,10,5,201854
30,14,146,43,429,173,181,57,169,1198,1101,2299,8,5,201854
30,15,200,30,296,303,134,63,408,1434,1091,2525,11,5,201854
30,16,183,37,384,323,188,57,447,1619,1177,2796,10,5,201854
30,17,185,33,278,502,49,57,109,1213,952,2165,8,5,201854
30,18,124,17,155,343,69,31,96,835,756,1591,8,5,201854
30,19,178,14,331,456,38,52,20,1089,830,1919,13,5,201854
30,20,160,30,229,452,130,36,0,1037,842,1879,10,5,201854
31,1,103,36,187,53,403,18,0,800,680,1480,8,5,201854
31,2,92,44,248,7,460,35,0,886,878,1764,6,5,201854
31,3,328,81,1239,761,288,89,32,2818,2059,4877,20,5.333333333,201854
31,4,69,28,292,184,162,20,221,976,830,1806,6,5,201854
31,5,135,32,183,612,41,36,0,1039,965,2004,6,5,201854
32,1,149,106,309,247,76,35,149,1071,782,1853,12,5,201854
32,2,229,141,341,190,355,52,235,1543,1310,2853,14,5,201854
32,3,182,95,283,489,24,36,44,1153,1026,2179,15,5.166666667,201854
32,4,177,125,292,400,40,36,85,1155,682,1837,13,5.2,201854
1,1,241,55,306,361,71,30,11,1075,968,2043,13,5.5,201855
1,2,254,77,574,538,117,54,117,1731,1514,3245,10,6,201855
1,3,224,103,602,636,65,42,72,1744,1628,3372,11,6,201855
2,1,208,31,382,527,39,47,0,1234,1261,2495,11,6,201855
2,2,162,21,337,864,22,75,0,1481,1446,2927,9,5.666666667,201855
2,3,296,45,523,539,24,65,146,1638,1789,3427,12,6.666666667,201855
2,4,181,14,456,248,52,27,15,993,1304,2297,9,6,201855
2,5,338,48,896,747,270,77,42,2418,2884,5302,13,6.333333333,201855
2,6,215,17,458,524,27,59,0,1300,1431,2731,7,6,201855
2,7,227,20,446,430,10,53,104,1290,1445,2735,12,5.25,201855
2,8,226,16,488,456,30,44,20,1280,1601,2881,8,6,201855
3,1,171,42,374,558,22,55,28,1250,1170,2420,14,5.571428571,201855
3,2,141,14,488,365,22,19,2,1051,1049,2100,9,6,201855
4,1,215,20,358,767,66,39,4,1469,1201,2670,14,5.166666667,201855
4,2,210,27,508,551,62,47,40,1445,1124,2569,14,5.4,201855
5,1,242,26,420,552,49,36,84,1409,1397,2806,9,5.666666667,201855
5,2,196,31,256,507,28,29,0,1047,900,1947,10,5.2,201855
5,3,229,31,317,510,70,59,108,1324,1014,2338,9,5.5,201855
5,4,249,59,460,650,26,85,169,1698,1436,3134,11,5.75,201855
5,5,231,40,482,848,32,39,112,1784,1517,3301,8,6,201855
5,6,139,28,280,338,11,31,147,974,927,1901,11,5.5,201855
5,7,186,20,276,457,10,32,31,1012,945,1957,10,5.5,201855
6,1,198,56,379,508,29,54,239,1463,1235,2698,14,5.333333333,201855
6,2,176,47,421,316,138,37,57,1192,1137,2329,9,5.666666667,201855
7,1,214,9,214,331,7,29,30,834,1130,1964,11,5.25,201855
7,2,293,22,94,351,7,21,0,788,1681,2469,12,5.25,201855
7,3,256,6,243,344,176,51,28,1104,1225,2329,9,5.333333333,201855
7,4,239,29,290,459,12,40,60,1129,926,2055,13,5.4,201855
7,5,252,13,182,501,12,21,2,983,1206,2189,11,5.666666667,201855
7,6,262,27,351,671,27,71,66,1475,1455,2930,11,6,201855
7,7,246,37,373,569,36,48,6,1315,1211,2526,8,5.5,201855
7,8,244,18,295,687,23,38,0,1305,1278,2583,12,5.25,201855
7,9,187,27,367,624,23,47,28,1303,1250,2553,11,5.5,201855
7,10,243,15,207,492,12,29,0,998,1528,2526,10,5.5,201855
7,11,97,4,66,117,19,6,0,309,699,1008,6,5.333333333,201855
7,12,227,12,290,664,6,39,0,1238,1407,2645,9,5.5,201855
7,13,53,18,57,200,8,11,0,347,728,1075,9,5.25,201855
8,1,207,19,504,372,47,34,31,1214,1304,2518,4,6,201855
8,2,271,27,588,643,31,57,26,1643,1650,3293,16,5.75,201855
8,3,201,40,464,531,30,49,194,1509,1454,2963,4,6,201855
8,4,178,49,418,465,48,62,201,1421,1011,2432,7,6,201855
8,5,157,32,267,459,26,46,0,987,1001,1988,10,5.25,201855
8,6,226,53,508,716,85,70,143,1801,1581,3382,7,6.5,201855
8,7,173,63,225,610,7,49,0,1127,1073,2200,7,5.25,201855
8,8,166,35,363,626,22,34,38,1284,1290,2574,12,5.5,201855
8,9,178,47,206,391,101,54,16,993,881,1874,10,5,201855
9,1,88,29,180,168,109,30,124,728,750,1478,5,6,201855
9,2,271,80,707,1589,163,95,285,3190,3063,6253,12,6,201855
9,3,117,66,432,616,93,53,393,1770,1555,3325,7,6,201855
9,4,173,35,383,764,97,57,153,1662,1677,3339,11,6,201855
9,5,136,26,363,780,75,51,65,1496,1364,2860,7,6,201855
9,6,94,31,252,223,190,40,206,1036,997,2033,7,6,201855
9,7,82,31,260,860,2,29,26,1290,1159,2449,9,6,201855
9,8,80,26,252,324,21,34,185,922,918,1840,5,6,201855
9,9,93,11,220,399,57,25,104,909,982,1891,5,6,201855
9,10,84,21,346,699,26,24,2,1202,1141,2343,6,6,201855
9,11,152,30,486,1086,75,51,117,1997,1854,3851,7,7,201855
9,12,121,46,594,716,51,70,410,2008,1959,3967,11,6,201855
9,13,92,29,254,422,144,37,228,1206,1068,2274,4,6,201855
9,14,98,28,228,316,162,42,336,1210,1113,2323,5,6,201855
9,15,199,68,895,1362,62,101,574,3261,3212,6473,11,4.5,201855
9,16,251,80,731,1413,163,89,16,2743,2606,5349,15,7,201855
9,17,113,31,300,573,26,39,34,1116,1026,2142,6,6,201855
9,18,185,62,470,1276,64,53,61,2171,1944,4115,12,6,201855
9,19,172,54,337,619,213,45,102,1542,1468,3010,5,6,201855
9,20,24,8,54,103,20,11,26,246,244,490,5,6,201855
9,21,110,13,168,331,53,20,73,768,767,1535,3,6,201855
9,22,159,26,231,331,112,41,231,1131,1098,2229,5,6,201855
9,23,131,32,348,665,89,38,195,1498,1381,2879,6,7,201855
9,24,238,52,627,1401,137,78,120,2653,2675,5328,12,6,201855
10,1,194,48,248,326,22,37,247,1122,1083,2205,12,5,201855
10,2,294,64,362,513,55,64,251,1603,1327,2930,9,5.5,201855
10,3,215,70,307,638,45,39,97,1411,1194,2605,11,5.2,201855
10,4,277,59,520,826,15,60,28,1785,1733,3518,14,6.333333333,201855
11,1,210,65,255,402,46,39,56,1073,875,1948,7,5.666666667,201855
11,2,250,46,340,458,80,32,66,1272,1106,2378,7,6,201855
11,3,140,87,262,253,25,27,287,1081,1114,2195,3,6,201855
11,4,157,54,227,429,38,30,0,935,983,1918,10,5.2,201855
11,5,273,159,514,928,33,53,76,2036,1785,3821,7,6.5,201855
11,6,125,48,284,251,50,38,83,879,908,1787,8,6,201855
11,7,207,32,276,369,28,34,0,946,1131,2077,9,5.5,201855
11,8,202,102,274,624,33,39,52,1326,1251,2577,9,5.5,201855
11,9,219,128,422,581,13,56,122,1541,1463,3004,10,5.666666667,201855
11,10,227,143,339,513,74,47,200,1543,1352,2895,10,5.6,201855
11,11,186,100,378,605,24,53,1,1347,1128,2475,5,6,201855
11,12,223,98,507,876,20,33,26,1783,1642,3425,7,6.5,201855
11,13,184,97,319,399,63,28,239,1329,1155,2484,8,5.5,201855
11,14,189,105,414,737,36,44,0,1525,1353,2878,8,5.5,201855
11,15,110,73,184,441,13,26,1,848,843,1691,9,6,201855
12,1,160,38,339,163,83,31,47,861,881,1742,10,5.2,201855
12,2,183,39,362,622,22,47,2,1277,1244,2521,10,5.5,201855
12,3,210,40,409,431,33,50,0,1173,1194,2367,11,5.2,201855
12,4,182,33,430,781,34,36,0,1496,1488,2984,9,6,201855
12,5,229,13,215,302,2,17,57,835,1156,1991,10,5.25,201855
12,6,172,25,176,246,34,20,6,679,921,1600,10,5.25,201855
12,7,357,47,400,726,16,53,100,1699,1626,3325,8,4.333333333,201855
12,8,266,20,223,332,12,19,0,872,1263,2135,9,5.25,201855
12,9,202,22,321,566,25,36,8,1180,1362,2542,9,5.666666667,201855
13,1,157,29,176,434,82,40,15,933,796,1729,9,5.333333333,201855
13,2,151,37,174,384,116,31,63,956,726,1682,6,5.333333333,201855
13,3,136,30,200,317,145,30,0,858,924,1782,12,5.25,201855
13,4,188,41,304,391,120,47,79,1170,1092,2262,9,5.666666667,201855
13,5,179,39,534,433,213,67,261,1726,1367,3093,9,5.75,201855
13,6,305,114,732,854,52,62,294,2413,2348,4761,13,5.75,201855
13,7,125,24,402,537,29,27,0,1144,1060,2204,8,5.5,201855
14,1,113,63,216,227,81,33,194,927,790,1717,7,5,201855
14,2,143,36,354,333,24,43,42,975,1092,2067,5,5.666666667,201855
14,3,206,78,641,509,77,63,46,1620,1214,2834,8,5.4,201855
14,4,166,37,411,770,54,41,98,1577,1264,2841,10,6,201855
14,5,174,22,413,380,90,35,55,1169,986,2155,9,5.5,201855
14,6,203,39,587,534,50,28,27,1468,1283,2751,11,6,201855
14,7,110,13,278,269,0,17,0,687,719,1406,6,6,201855
14,8,259,107,881,1696,43,72,269,3327,3143,6470,13,5.666666667,201855
14,9,113,35,232,549,60,28,50,1067,933,2000,8,6,201855
14,10,154,42,452,655,7,32,46,1388,1360,2748,5,6.5,201855
14,11,158,54,229,379,83,41,364,1308,1330,2638,4,6,201855
14,12,192,20,606,305,13,45,18,1199,1140,2339,9,5.5,201855
14,13,164,49,373,493,31,52,95,1257,1289,2546,6,6,201855
14,14,96,61,359,772,39,34,158,1519,1337,2856,7,6,201855
14,15,215,72,283,570,94,53,60,1347,1154,2501,10,5.6,201855
14,16,142,49,404,338,89,36,126,1184,1220,2404,5,6,201855
14,17,134,67,283,257,47,38,101,927,880,1807,7,5.25,201855
14,18,209,67,469,522,53,52,201,1573,1480,3053,9,5.4,201855
14,19,197,58,342,572,74,48,52,1343,1088,2431,8,5.25,201855
14,20,160,52,405,323,30,41,57,1068,916,1984,10,5.666666667,201855
15,1,175,33,357,169,689,40,39,1502,1260,2762,7,5.333333333,201855
15,2,130,25,284,443,65,35,169,1151,1087,2238,6,6,201855
15,3,238,60,309,554,465,47,154,1827,1542,3369,10,5.666666667,201855
15,4,173,43,286,583,59,33,144,1321,1151,2472,4,6,201855
15,5,178,75,300,511,70,35,178,1347,1071,2418,8,5.666666667,201855
15,6,151,33,345,730,90,40,147,1536,1406,2942,7,6.5,201855
15,7,94,32,280,643,51,36,0,1136,1259,2395,10,6,201855
15,8,89,13,201,354,12,29,72,770,684,1454,4,6,201855
15,9,187,32,164,194,368,35,97,1077,959,2036,9,5.75,201855
15,10,121,31,244,450,110,23,133,1112,1056,2168,6,6,201855
15,11,201,56,328,777,86,31,16,1495,1392,2887,8,6,201855
15,12,226,31,612,700,43,45,33,1690,1605,3295,8,6,201855
15,13,81,44,182,368,192,32,1,900,872,1772,8,6,201855
15,14,83,20,170,382,21,24,6,706,774,1480,4,6,201855
15,15,144,68,291,539,45,39,197,1323,1227,2550,6,6,201855
15,16,232,54,350,883,16,47,53,1635,1627,3262,8,6,201855
15,17,116,44,248,265,24,39,423,1159,1064,2223,8,6,201855
15,18,224,63,330,666,65,44,178,1570,1336,2906,7,5.666666667,201855
15,19,181,110,488,1259,32,55,84,2209,2163,4372,10,6,201855
15,20,75,24,243,483,37,26,53,941,838,1779,6,6,201855
15,21,105,10,104,300,24,28,102,673,640,1313,6,5.5,201855
15,22,179,89,543,1205,47,71,426,2560,2372,4932,14,6,201855
15,23,151,37,227,660,30,37,0,1142,909,2051,6,5.333333333,201855
15,24,114,39,218,368,56,27,42,864,909,1773,4,6,201855
15,25,195,36,318,336,54,48,84,1071,1026,2097,6,6,201855
15,26,155,14,276,450,107,28,40,1070,955,2025,11,5.333333333,201855
15,27,192,59,384,450,39,55,409,1588,1615,3203,9,5.666666667,201855
15,28,243,51,603,592,133,61,133,1816,1725,3541,9,5.666666667,201855
15,29,206,70,445,934,35,59,35,1784,1772,3556,8,6,201855
15,30,253,35,427,558,47,37,53,1410,1113,2523,16,6,201855
15,31,181,82,316,689,20,60,43,1391,1356,2747,6,6,201855
15,32,183,14,288,617,70,40,70,1282,1248,2530,9,6,201855
15,33,186,24,332,604,40,46,3,1235,1190,2425,7,6,201855
15,34,135,23,195,655,9,22,49,1088,1025,2113,8,6,201855
15,35,257,48,404,703,27,45,15,1499,1426,2925,9,5.666666667,201855
15,36,199,46,444,532,130,45,10,1406,1246,2652,9,5.5,201855
15,37,197,44,355,608,67,54,273,1598,1467,3065,7,6,201855
15,38,187,69,274,699,24,52,88,1393,1170,2563,6,5.5,201855
15,39,164,33,306,508,11,27,8,1057,928,1985,4,6,201855
15,40,286,41,463,705,203,61,11,1770,1515,3285,9,6,201855
15,41,290,35,555,651,58,47,144,1780,1655,3435,11,6,201855
16,1,148,22,243,288,15,23,4,743,581,1324,7,5.333333333,201855
16,2,185,46,276,368,52,46,0,973,804,1777,9,5.25,201855
16,3,148,49,305,380,47,37,29,995,774,1769,10,5.25,201855
16,4,206,45,450,404,103,37,0,1245,1077,2322,8,5.5,201855
16,5,209,79,307,369,68,78,86,1196,1079,2275,10,5.666666667,201855
16,6,216,57,285,374,52,45,0,1029,852,1881,12,5.5,201855
16,7,232,60,275,409,72,50,0,1098,991,2089,9,5.5,201855
16,8,304,90,655,965,18,72,72,2176,2007,4183,12,6,201855
16,9,230,51,344,445,37,54,110,1271,1110,2381,9,6.5,201855
16,10,135,41,331,567,13,29,0,1116,1094,2210,8,5.666666667,201855
16,11,205,47,302,317,222,47,97,1237,1427,2664,10,5.4,201855
16,12,203,47,354,242,61,41,14,962,950,1912,10,5.25,201855
17,1,154,48,446,618,62,49,107,1484,1602,3086,11,6.5,201855
17,2,151,23,333,433,31,24,65,1060,973,2033,8,5.666666667,201855
17,3,168,35,440,713,18,47,2,1423,1337,2760,8,5.5,201855
17,4,191,38,437,742,53,56,34,1551,1351,2902,10,5.666666667,201855
17,5,93,25,136,275,24,22,15,590,565,1155,5,5.5,201855
18,1,136,33,204,352,39,38,88,890,754,1644,7,5.25,201855
18,2,212,72,506,708,133,45,3,1679,1566,3245,11,6.5,201855
18,3,170,41,432,473,19,25,0,1160,1109,2269,8,5.75,201855
19,1,209,54,427,788,36,59,140,1713,1628,3341,9,6,201855
19,2,219,42,576,511,23,34,238,1643,1737,3380,9,6,201855
19,3,253,53,686,835,51,49,46,1973,1888,3861,7,6,201855
19,4,95,40,172,153,164,21,373,1018,901,1919,5,6,201855
19,5,287,75,480,850,37,68,316,2113,2005,4118,8,6,201855
19,6,91,23,249,736,15,39,0,1153,1006,2159,5,6,201855
19,7,163,18,486,347,16,29,8,1067,1056,2123,10,5.5,201855
19,8,43,10,106,171,9,5,0,344,362,706,7,6,201855
19,9,182,48,254,548,101,50,144,1327,1524,2851,9,5.25,201855
19,10,158,47,343,366,15,39,509,1477,1429,2906,8,5.333333333,201855
19,11,400,143,779,1704,52,116,626,3820,3437,7257,13,6.333333333,201855
19,12,174,21,509,401,32,44,35,1216,1205,2421,8,5.333333333,201855
20,1,182,24,223,217,89,38,147,920,858,1778,7,5.5,201855
20,2,89,16,119,203,10,21,0,458,403,861,6,5.333333333,201855
20,3,90,10,177,129,63,21,103,593,960,1553,6,5.333333333,201855
20,4,125,20,171,208,54,49,91,718,730,1448,6,5.333333333,201855
20,5,113,18,271,373,122,26,0,923,1231,2154,11,5.25,201855
20,6,181,20,189,228,286,32,2,938,1234,2172,8,5.25,201855
20,7,192,26,333,567,37,51,12,1218,1140,2358,8,5.75,201855
20,8,435,51,641,923,51,107,600,2808,2792,5600,15,6,201855
20,9,272,33,276,272,163,56,241,1313,1150,2463,8,5.666666667,201855
20,10,230,16,420,547,12,41,0,1266,1120,2386,9,5.25,201855
21,1,174,27,264,492,17,41,3,1018,987,2005,10,5.4,201855
21,2,158,28,283,362,206,37,3,1077,1240,2317,10,5.2,201855
21,3,193,17,368,298,199,57,63,1195,1131,2326,9,5.5,201855
21,4,110,17,104,119,110,28,48,536,688,1224,7,5.25,201855
21,5,176,21,400,420,27,58,33,1135,1224,2359,8,5.666666667,201855
21,6,162,37,322,436,56,46,410,1469,1438,2907,6,6,201855
21,7,225,20,281,432,95,59,139,1251,1248,2499,9,5.666666667,201855
21,8,140,16,397,264,119,47,69,1052,1447,2499,10,5.2,201855
21,9,182,39,490,555,101,56,255,1678,1508,3186,9,6,201855
21,10,171,28,378,420,54,50,272,1373,1393,2766,7,6,201855
21,11,71,9,131,132,28,12,19,402,443,845,6,4.5,201855
21,12,317,49,881,1312,85,68,330,3042,2789,5831,15,6.5,201855
21,13,186,25,362,513,62,38,149,1335,1297,2632,8,5.666666667,201855
21,14,200,15,320,194,120,40,190,1079,1022,2101,12,5.333333333,201855
21,15,252,27,541,398,131,50,104,1503,1295,2798,7,5.5,201855
22,1,198,72,305,429,44,27,84,1159,1021,2180,11,5.2,201855
22,2,159,31,402,351,32,26,64,1065,1073,2138,7,5.5,201855
22,3,323,149,851,939,86,51,47,2446,2081,4527,9,6,201855
22,4,212,101,633,645,56,48,74,1769,1584,3353,11,6,201855
22,5,159,55,543,332,158,26,57,1330,1183,2513,10,5.5,201855
23,1,244,13,1139,364,25,29,64,1878,1866,3744,14,5.6,201855
23,2,205,33,393,503,8,13,6,1161,1448,2609,10,5.25,201855
23,3,265,12,948,607,27,44,3,1906,1916,3822,15,7,201855
23,4,184,15,733,395,36,27,41,1431,1451,2882,10,5.5,201855
24,1,148,56,144,381,47,15,13,804,759,1563,10,5.2,201855
24,2,153,61,271,343,34,37,23,922,841,1763,6,5.5,201855
24,3,173,66,259,418,134,31,0,1081,1024,2105,9,5.25,201855
24,4,158,55,258,243,84,33,230,1061,1021,2082,5,5.5,201855
24,5,279,76,433,822,28,50,113,1801,1658,3459,10,6.666666667,201855
24,6,223,72,386,682,51,36,31,1481,1344,2825,8,5.5,201855
24,7,194,50,420,623,137,32,0,1456,1506,2962,9,5.25,201855
25,1,134,31,226,450,27,34,152,1054,934,1988,13,6,201855
25,2,241,50,476,824,50,57,0,1698,1470,3168,7,5.5,201855
25,3,179,19,380,488,101,41,58,1266,1217,2483,8,5.6,201855
25,4,201,47,234,551,26,37,126,1222,1082,2304,8,5.333333333,201855
25,5,168,37,370,829,45,41,1,1491,1607,3098,10,5.5,201855
25,6,223,39,416,577,153,60,121,1589,1440,3029,8,5.75,201855
25,7,182,24,394,776,15,45,0,1436,1331,2767,6,6,201855
26,1,194,22,310,501,18,40,0,1085,1107,2192,9,5.5,201855
26,2,222,15,449,618,7,71,21,1403,1496,2899,12,5.4,201855
26,3,289,46,495,991,16,89,205,2131,1877,4008,17,5.75,201855
26,4,147,32,230,400,50,44,173,1076,892,1968,9,5.2,201855
26,5,111,11,167,468,30,38,0,825,630,1455,15,5.333333333,201855
26,6,163,22,376,610,28,47,0,1246,1192,2438,10,5.333333333,201855
26,7,198,21,224,401,62,39,1,946,772,1718,10,5.5,201855
27,1,197,48,327,602,51,41,6,1272,1208,2480,8,5,201855
27,2,288,20,317,556,27,35,0,1243,996,2239,8,5.666666667,201855
27,3,226,28,257,700,13,34,5,1263,1028,2291,7,5.666666667,201855
27,4,237,32,320,976,18,57,147,1787,1693,3480,10,5.5,201855
27,5,130,9,222,345,7,24,4,741,795,1536,6,5.333333333,201855
27,6,160,25,251,661,6,24,52,1179,935,2114,8,5.5,201855
28,1,307,35,544,679,4,37,0,1606,1324,2930,13,6,201855
28,2,187,54,513,443,55,39,277,1568,1554,3122,11,7,201855
28,3,141,44,289,515,10,25,0,1024,709,1733,7,5.333333333,201855
28,4,357,61,518,532,102,57,461,2088,1702,3790,15,6,201855
28,5,291,62,282,644,27,49,65,1420,1213,2633,12,5.4,201855
28,6,211,57,286,428,93,39,120,1234,965,2199,14,5.166666667,201855
28,7,244,62,534,707,90,43,0,1680,1722,3402,8,6,201855
28,8,194,76,346,596,115,45,33,1405,1288,2693,9,6,201855
28,9,181,29,441,221,44,26,249,1191,949,2140,11,5.75,201855
29,1,185,50,383,435,97,27,1,1178,1179,2357,7,5.5,201855
29,2,187,28,441,342,89,54,206,1347,1313,2660,13,6,201855
29,3,115,42,154,536,40,27,0,914,810,1724,5,5.666666667,201855
30,1,132,49,303,575,45,30,88,1222,1032,2254,7,5.333333333,201855
30,2,175,33,307,134,140,23,498,1310,1149,2459,8,5.25,201855
30,3,152,43,509,152,287,48,485,1676,1611,3287,6,5.666666667,201855
30,4,105,19,264,391,91,39,6,915,840,1755,8,6,201855
30,5,152,50,326,692,39,44,0,1303,1074,2377,7,5.5,201855
30,6,154,39,349,492,40,29,3,1106,948,2054,9,5.333333333,201855
30,7,181,33,447,192,48,51,331,1283,1034,2317,11,5.25,201855
30,8,178,40,409,630,107,52,160,1576,1347,2923,11,5.4,201855
30,9,175,28,238,262,101,49,318,1171,1006,2177,8,5.5,201855
30,10,171,36,470,536,103,46,431,1793,1521,3314,9,5.25,201855
30,11,152,41,361,748,14,36,0,1352,1033,2385,5,5.5,201855
30,12,226,48,664,1343,46,84,8,2419,2035,4454,10,6.25,201855
30,13,178,32,260,316,164,49,359,1358,1087,2445,10,5.4,201855
30,14,189,63,552,152,256,61,265,1538,1052,2590,8,5.5,201855
30,15,226,26,298,293,200,65,486,1594,1540,3134,11,5.666666667,201855
30,16,183,31,391,328,176,47,511,1667,1471,3138,10,5.333333333,201855
30,17,171,68,333,469,71,49,93,1254,821,2075,8,5.5,201855
30,18,169,36,191,364,34,33,69,896,711,1607,8,5.25,201855
30,19,142,26,333,451,38,27,22,1039,1038,2077,13,5.6,201855
30,20,122,29,294,468,162,44,0,1119,1147,2266,10,5.4,201855
31,1,160,29,201,88,437,31,0,946,734,1680,8,5.5,201855
31,2,72,27,148,3,464,14,0,728,750,1478,6,5.333333333,201855
31,3,361,77,1474,1167,366,84,23,3552,3289,6841,21,6.666666667,201855
31,4,101,30,347,220,160,29,253,1140,1222,2362,6,5.5,201855
31,5,149,39,184,750,50,29,0,1201,999,2200,6,5.333333333,201855
32,1,153,89,287,248,93,41,172,1083,994,2077,12,5.2,201855
32,2,184,102,317,123,280,53,188,1247,1137,2384,14,5.142857143,201855
32,3,177,103,336,547,21,46,53,1283,1108,2391,15,5.5,201855
32,4,210,186,350,499,51,51,118,1465,1593,3058,13,5.4,201855
1,1,178,44,241,316,41,29,8,857,990,1847,13,5.5,201856
1,2,211,65,487,450,121,27,126,1487,1383,2870,10,6,201856
1,3,147,88,539,538,52,37,80,1481,1337,2818,11,6,201856
2,1,204,19,401,695,37,51,24,1431,1101,2532,11,6,201856
2,2,177,27,318,905,21,43,0,1491,1538,3029,9,5.666666667,201856
2,3,262,39,559,541,41,51,160,1653,1649,3302,12,6,201856
2,4,175,6,494,260,44,26,15,1020,899,1919,9,6,201856
2,5,329,47,892,868,261,85,45,2527,2427,4954,13,6.333333333,201856
2,6,206,28,459,578,37,43,0,1351,1276,2627,7,6,201856
2,7,310,31,577,548,36,47,114,1663,1420,3083,12,5.75,201856
2,8,223,16,523,549,21,45,54,1431,1254,2685,8,6,201856
3,1,151,36,377,586,42,53,34,1279,1218,2497,14,5.571428571,201856
3,2,139,17,469,295,16,17,5,958,1039,1997,9,5.666666667,201856
4,1,204,22,298,752,61,39,6,1382,1348,2730,14,4.666666667,201856
4,2,170,27,324,428,39,40,43,1071,1319,2390,14,5.2,201856
5,1,208,28,374,538,55,53,63,1319,1404,2723,9,5.666666667,201856
5,2,146,12,189,388,19,21,0,775,767,1542,10,5.2,201856
5,3,218,38,273,521,58,51,139,1298,1331,2629,9,5.5,201856
5,4,224,39,496,534,31,61,270,1655,1441,3096,11,5.5,201856
5,5,221,47,386,763,24,46,115,1602,1596,3198,8,6,201856
5,6,153,24,267,320,9,34,143,950,913,1863,11,5.5,201856
5,7,162,38,250,458,4,17,35,964,916,1880,10,5.5,201856
6,1,175,72,461,553,33,45,370,1709,1176,2885,14,5.333333333,201856
6,2,145,37,427,279,139,46,104,1177,1180,2357,9,5.666666667,201856
7,1,135,8,185,340,33,13,29,743,785,1528,11,5.25,201856
7,2,168,4,105,364,23,16,0,680,1613,2293,12,5.25,201856
7,3,240,6,274,363,129,51,28,1091,1268,2359,9,5.333333333,201856
7,4,145,16,214,279,5,47,28,734,933,1667,13,5.4,201856
7,5,214,8,164,413,12,22,1,834,1047,1881,11,5.666666667,201856
7,6,186,30,305,467,25,34,46,1093,1092,2185,11,5.666666667,201856
7,7,261,28,368,589,44,55,7,1352,1390,2742,8,5.5,201856
7,8,243,17,275,658,23,39,0,1255,1291,2546,12,5.25,201856
7,9,181,26,308,623,25,40,1,1204,1153,2357,11,5.5,201856
7,10,155,9,162,425,11,26,9,797,1030,1827,10,5.5,201856
7,11,99,3,69,121,15,8,1,316,773,1089,6,5.333333333,201856
7,12,250,15,297,690,6,37,0,1295,1331,2626,9,5.5,201856
7,13,103,17,173,241,3,10,13,560,640,1200,9,5.25,201856
8,1,189,12,413,343,38,27,84,1106,1215,2321,4,6,201856
8,2,263,43,529,598,40,46,30,1549,1524,3073,16,5.5,201856
8,3,218,47,421,383,43,45,310,1467,1422,2889,4,6,201856
8,4,110,41,436,376,38,51,285,1337,799,2136,11,6,201856
8,5,208,41,343,568,31,34,0,1225,940,2165,10,5.25,201856
8,6,245,39,471,741,94,62,177,1829,1602,3431,7,6.5,201856
8,7,139,44,232,496,13,32,0,956,831,1787,7,5.25,201856
8,8,185,60,376,718,12,30,58,1439,1379,2818,12,3.5,201856
8,9,105,38,155,378,78,38,7,799,919,1718,10,4.8,201856
9,1,72,37,160,187,130,22,173,781,689,1470,5,6,201856
9,2,226,88,557,1474,117,78,312,2852,2481,5333,12,6,201856
9,3,118,56,360,576,56,45,342,1553,1313,2866,7,6,201856
9,4,157,34,318,693,75,53,181,1511,1375,2886,11,6,201856
9,5,108,18,295,816,82,30,75,1424,1308,2732,7,6,201856
9,6,80,30,206,218,154,29,182,899,835,1734,7,6,201856
9,7,76,26,225,699,2,21,17,1066,1035,2101,9,6,201856
9,8,63,17,236,256,18,34,251,875,801,1676,5,6,201856
9,9,86,11,179,369,65,15,99,824,717,1541,5,6,201856
9,10,88,48,295,627,24,22,3,1107,1038,2145,6,6,201856
9,11,163,29,388,907,71,49,164,1771,1522,3293,7,6,201856
9,12,132,34,555,679,52,70,481,2003,1680,3683,11,6,201856
9,13,77,19,201,352,129,27,311,1116,999,2115,4,6,201856
9,14,89,16,188,281,117,36,338,1065,985,2050,5,6,201856
9,15,133,66,831,1202,51,78,689,3050,2802,5852,11,5.5,201856
9,16,228,70,629,1365,132,63,10,2497,2098,4595,15,6,201856
9,17,96,24,237,583,29,31,31,1031,948,1979,6,6,201856
9,18,154,49,373,1276,61,54,31,1998,1865,3863,12,6,201856
9,19,132,36,271,529,173,34,100,1275,1241,2516,5,6,201856
9,20,29,8,64,130,16,4,25,276,195,471,5,6,201856
9,21,94,8,136,328,49,13,123,751,706,1457,3,6,201856
9,22,118,19,185,251,91,27,263,954,901,1855,5,6,201856
9,23,95,30,269,677,70,29,221,1391,1250,2641,6,6,201856
9,24,188,52,534,1305,173,55,170,2477,2187,4664,12,6,201856
10,1,253,54,230,344,32,55,249,1217,1057,2274,12,5.166666667,201856
10,2,209,57,372,391,48,36,249,1362,1316,2678,9,5.5,201856
10,3,148,35,181,372,13,32,47,828,1106,1934,11,5,201856
10,4,193,28,418,732,20,56,16,1463,1506,2969,14,5.666666667,201856
11,1,152,64,199,404,50,15,40,924,843,1767,7,4.666666667,201856
11,2,150,41,221,313,45,24,79,873,771,1644,7,5,201856
11,3,110,77,229,225,27,20,272,960,790,1750,3,5,201856
11,4,104,34,143,346,14,11,0,652,677,1329,9,4.8,201856
11,5,182,113,383,732,29,44,87,1570,1324,2894,7,5,201856
11,6,84,60,224,252,45,23,69,757,721,1478,8,5,201856
11,7,177,54,255,364,39,39,0,928,988,1916,9,5.5,201856
11,8,145,77,250,546,33,29,62,1142,1033,2175,9,5.25,201856
11,9,246,111,326,486,28,54,149,1400,1275,2675,10,5.666666667,201856
11,10,162,103,263,418,50,42,123,1161,1161,2322,10,5.6,201856
11,11,139,68,306,526,27,21,1,1088,798,1886,5,5,201856
11,12,142,91,420,687,13,26,20,1399,1213,2612,7,5,201856
11,13,157,79,195,237,76,26,202,972,933,1905,8,5.5,201856
11,14,159,103,299,568,39,32,53,1253,1305,2558,8,4.5,201856
11,15,103,64,154,347,6,20,5,699,707,1406,9,6,201856
12,1,164,70,395,212,114,40,36,1031,975,2006,10,5.2,201856
12,2,219,42,280,552,23,25,20,1161,1288,2449,10,5.5,201856
12,3,192,40,341,466,25,26,0,1090,1199,2289,11,5.2,201856
12,4,195,28,407,698,25,41,1,1395,1294,2689,9,5.666666667,201856
12,5,201,16,189,278,3,23,60,770,834,1604,10,5.25,201856
12,6,122,33,176,335,26,17,5,714,875,1589,10,5.25,201856
12,7,213,34,272,642,16,26,55,1258,1238,2496,8,4,201856
12,8,174,30,238,298,6,19,0,765,933,1698,9,5.25,201856
12,9,183,21,304,503,25,35,11,1082,1098,2180,9,5.666666667,201856
13,1,164,37,160,437,59,31,27,915,1050,1965,9,5.333333333,201856
13,2,146,40,130,488,97,41,73,1015,982,1997,6,5.333333333,201856
13,3,183,37,260,433,149,37,0,1099,800,1899,12,5.25,201856
13,4,141,29,297,326,146,28,113,1080,1129,2209,9,5.666666667,201856
13,5,213,46,523,421,199,42,302,1746,1421,3167,9,5.75,201856
13,6,249,78,560,794,45,48,249,2023,2019,4042,13,4.75,201856
13,7,150,27,310,494,44,21,1,1047,1035,2082,8,5.5,201856
14,1,131,87,205,215,89,35,242,1004,912,1916,7,5.5,201856
14,2,127,40,360,350,58,34,42,1011,850,1861,5,5.666666667,201856
14,3,163,55,611,446,62,64,61,1462,1470,2932,8,5.4,201856
14,4,150,57,387,773,53,37,116,1573,1207,2780,10,6,201856
14,5,187,31,492,454,63,40,49,1316,1111,2427,9,5.5,201856
14,6,194,27,650,618,58,36,34,1617,1255,2872,11,6,201856
14,7,94,15,246,275,0,12,0,642,565,1207,6,6,201856
14,8,234,93,903,1632,36,51,390,3339,2887,6226,13,5.666666667,201856
14,9,103,61,255,600,95,19,59,1192,785,1977,8,6,201856
14,10,151,48,426,701,15,27,60,1428,1214,2642,5,6,201856
14,11,125,63,235,346,87,26,374,1256,1154,2410,4,6,201856
14,12,205,42,592,341,14,41,14,1249,1096,2345,9,5.5,201856
14,13,194,46,378,398,36,28,126,1206,1104,2310,6,6,201856
14,14,122,63,339,767,34,41,232,1598,1317,2915,7,6,201856
14,15,224,68,331,527,36,60,58,1304,1069,2373,10,5.6,201856
14,16,132,59,324,286,90,34,184,1109,1113,2222,5,6,201856
14,17,163,75,288,282,74,32,134,1048,1003,2051,7,5.25,201856
14,18,193,54,430,502,27,32,211,1449,1193,2642,9,5.4,201856
14,19,225,52,328,661,49,43,0,1358,931,2289,8,5.25,201856
14,20,177,48,404,434,49,38,58,1208,621,1829,10,5.666666667,201856
15,1,127,46,399,117,873,26,15,1603,1250,2853,7,5.333333333,201856
15,2,117,22,259,362,47,25,213,1045,874,1919,6,6,201856
15,3,214,66,199,477,414,41,275,1686,1446,3132,10,5.666666667,201856
15,4,135,45,294,500,62,31,151,1218,1064,2282,4,6,201856
15,5,152,71,289,551,77,34,224,1398,1033,2431,8,5.666666667,201856
15,6,143,32,292,731,89,31,145,1463,1223,2686,7,6,201856
15,7,101,35,304,566,71,36,65,1178,1051,2229,10,6,201856
15,8,75,17,175,335,16,24,88,730,402,1132,4,6,201856
15,9,192,35,215,209,373,25,105,1154,1061,2215,9,5.75,201856
15,10,125,37,244,385,151,32,150,1124,979,2103,6,6,201856
15,11,164,37,324,777,95,32,57,1486,1196,2682,8,6,201856
15,12,198,37,510,671,47,39,53,1555,1387,2942,8,6,201856
15,13,71,37,143,391,185,29,4,860,753,1613,8,6,201856
15,14,56,24,176,404,17,23,0,700,626,1326,4,6,201856
15,15,134,55,269,582,44,39,182,1305,1091,2396,6,6,201856
15,16,174,66,312,855,25,47,58,1537,1363,2900,8,6,201856
15,17,100,36,209,292,9,38,479,1163,978,2141,8,6,201856
15,18,162,57,307,643,76,48,189,1482,1467,2949,7,5.666666667,201856
15,19,140,84,416,1192,20,42,88,1982,1721,3703,10,6,201856
15,20,75,41,209,543,27,19,48,962,786,1748,6,6,201856
15,21,91,12,128,292,21,18,66,628,529,1157,6,5.5,201856
15,22,209,93,499,1187,50,61,477,2576,2184,4760,14,6,201856
15,23,155,39,254,778,30,40,1,1297,1018,2315,6,5.333333333,201856
15,24,96,25,185,412,44,21,47,830,700,1530,4,6,201856
15,25,145,25,250,297,61,39,120,937,918,1855,6,6,201856
15,26,135,22,270,433,120,28,52,1060,919,1979,11,5.333333333,201856
15,27,171,38,340,417,39,42,517,1564,1321,2885,9,5.666666667,201856
15,28,213,39,567,471,145,36,180,1651,1411,3062,9,5.666666667,201856
15,29,169,60,364,963,43,57,81,1737,1549,3286,8,6,201856
15,30,226,36,322,531,44,44,70,1273,1311,2584,16,6,201856
15,31,180,91,306,826,8,37,21,1469,1138,2607,6,6,201856
15,32,135,37,216,455,38,41,88,1010,1097,2107,9,6,201856
15,33,165,22,295,573,36,40,1,1132,1012,2144,7,6,201856
15,34,111,21,179,568,13,21,117,1030,916,1946,8,6,201856
15,35,236,46,334,665,43,53,15,1392,1120,2512,9,5.666666667,201856
15,36,192,47,400,544,103,35,23,1344,1090,2434,9,5.5,201856
15,37,185,45,297,533,90,36,280,1466,1184,2650,7,6,201856
15,38,132,44,263,553,11,30,82,1115,987,2102,6,5.5,201856
15,39,137,34,242,457,8,22,10,910,854,1764,4,6,201856
15,40,212,42,385,721,226,43,17,1646,1433,3079,9,6,201856
15,41,223,35,465,586,51,37,178,1575,1449,3024,11,6,201856
16,1,141,27,280,334,22,30,1,835,929,1764,7,5.333333333,201856
16,2,157,43,179,346,51,57,0,833,716,1549,9,5.25,201856
16,3,160,27,273,430,55,29,41,1015,830,1845,10,5.25,201856
16,4,176,54,402,380,96,59,0,1167,1050,2217,8,5.5,201856
16,5,201,72,207,381,55,56,109,1081,1085,2166,10,5.666666667,201856
16,6,181,60,223,386,63,33,0,946,818,1764,12,5.5,201856
16,7,221,47,233,343,59,53,0,956,808,1764,9,5.5,201856
16,8,263,91,616,1003,15,58,50,2096,1794,3890,12,6,201856
16,9,178,43,320,408,25,36,132,1142,1045,2187,9,6,201856
16,10,142,30,311,571,12,41,0,1107,956,2063,8,5.666666667,201856
16,11,208,63,327,418,281,68,67,1432,1107,2539,10,5.4,201856
16,12,208,56,365,262,91,44,31,1057,823,1880,10,5.25,201856
17,1,116,51,441,606,59,35,107,1415,1387,2802,11,6,201856
17,2,133,26,316,419,35,33,96,1058,846,1904,8,5.666666667,201856
17,3,178,43,408,704,22,49,7,1411,1177,2588,8,5.5,201856
17,4,175,43,457,751,38,45,61,1570,1270,2840,10,5.666666667,201856
17,5,105,17,121,262,27,26,11,569,402,971,5,5.5,201856
18,1,137,27,222,325,49,26,58,844,825,1669,7,5.25,201856
18,2,253,64,426,660,161,59,0,1623,1405,3028,10,5.75,201856
18,3,154,33,376,381,10,21,0,975,798,1773,8,5.5,201856
19,1,170,43,382,752,36,64,151,1598,1665,3263,9,6,201856
19,2,249,33,498,658,32,44,74,1588,1622,3210,9,6,201856
19,3,250,35,555,810,53,55,54,1812,1963,3775,7,6,201856
19,4,92,43,171,123,181,18,374,1002,946,1948,5,6,201856
19,5,234,76,492,822,47,94,323,2088,1957,4045,8,6,201856
19,6,85,23,238,637,8,32,0,1023,1092,2115,5,6,201856
19,7,168,18,473,390,16,36,7,1108,1100,2208,10,5.5,201856
19,8,62,11,125,219,3,14,0,434,261,695,7,6,201856
19,9,232,58,351,494,117,40,200,1492,1017,2509,9,5.25,201856
19,10,143,30,286,403,11,44,556,1473,1424,2897,8,5.333333333,201856
19,11,308,119,661,1470,44,86,692,3380,3220,6600,13,6,201856
19,12,178,24,450,377,23,39,30,1121,957,2078,8,5.666666667,201856
20,1,182,34,229,195,94,44,200,978,963,1941,7,5.5,201856
20,2,102,13,124,187,20,6,0,452,807,1259,6,5.333333333,201856
20,3,98,21,178,148,73,24,119,661,828,1489,6,5.333333333,201856
20,4,100,22,140,202,67,29,64,624,850,1474,6,5.333333333,201856
20,5,115,25,268,370,54,26,0,858,1009,1867,11,5.25,201856
20,6,208,26,212,224,235,32,5,942,957,1899,8,5.25,201856
20,7,179,31,281,642,42,42,9,1226,1210,2436,8,5.75,201856
20,8,416,48,588,937,38,91,691,2809,2569,5378,15,5.666666667,201856
20,9,171,25,196,193,115,41,264,1005,956,1961,8,5.666666667,201856
20,10,229,19,262,547,20,40,0,1117,995,2112,9,5.25,201856
21,1,105,9,201,419,16,20,1,771,836,1607,10,5.4,201856
21,2,136,19,239,279,99,23,3,798,1091,1889,10,5.2,201856
21,3,137,25,357,295,192,23,81,1110,1057,2167,9,5.5,201856
21,4,64,8,89,133,75,18,53,440,761,1201,7,5.25,201856
21,5,135,19,327,387,45,29,80,1022,1030,2052,8,5.666666667,201856
21,6,135,28,264,414,66,22,525,1454,1268,2722,6,7,201856
21,7,202,33,279,411,101,57,127,1210,1292,2502,9,5.666666667,201856
21,8,159,19,394,265,96,51,89,1073,1346,2419,10,5.2,201856
21,9,166,33,378,484,102,42,284,1489,1253,2742,9,6,201856
21,10,188,15,394,365,58,38,358,1416,1236,2652,7,6,201856
21,11,62,6,112,125,23,11,12,351,295,646,6,5.5,201856
21,12,261,48,885,1303,69,64,408,3038,2456,5494,16,7,201856
21,13,148,18,329,498,98,30,102,1223,1334,2557,8,5.666666667,201856
21,14,172,30,299,161,142,22,229,1055,1038,2093,12,5.333333333,201856
21,15,191,16,433,314,109,33,119,1215,1178,2393,7,5.5,201856
22,1,157,58,213,370,60,26,88,972,967,1939,11,5.2,201856
22,2,177,44,416,392,27,32,63,1151,1076,2227,7,5.5,201856
22,3,228,98,739,875,66,42,33,2081,1730,3811,9,5.666666667,201856
22,4,181,136,628,778,48,45,97,1913,1557,3470,11,6,201856
22,5,116,27,367,255,111,23,52,951,972,1923,10,5.5,201856
23,1,198,9,974,331,20,29,55,1616,1952,3568,14,5.6,201856
23,2,204,30,438,553,8,27,1,1261,1470,2731,11,5.5,201856
23,3,227,7,663,490,16,21,0,1424,1338,2762,15,5,201856
23,4,153,6,649,342,36,21,28,1235,1323,2558,10,5,201856
24,1,182,47,187,364,42,16,4,842,833,1675,10,5.2,201856
24,2,165,72,230,403,59,34,21,984,886,1870,6,5.5,201856
24,3,142,54,215,292,115,25,3,846,877,1723,9,5,201856
24,4,146,68,224,222,106,30,251,1047,901,1948,5,5.5,201856
24,5,220,94,439,774,32,47,119,1725,1311,3036,10,6.333333333,201856
24,6,141,80,331,555,50,30,50,1237,1079,2316,8,5.5,201856
24,7,257,40,403,531,98,36,0,1365,1074,2439,9,5.25,201856
25,1,151,47,232,448,100,35,161,1174,896,2070,13,5.75,201856
25,2,208,56,447,817,55,59,0,1642,1472,3114,7,5.5,201856
25,3,195,28,335,620,133,37,76,1424,1179,2603,8,5.6,201856
25,4,178,60,235,670,36,33,145,1357,939,2296,8,5.333333333,201856
25,5,183,30,357,972,47,57,0,1646,1517,3163,10,5.5,201856
25,6,260,48,481,589,132,46,167,1723,1357,3080,8,5.75,201856
25,7,204,29,418,852,8,48,4,1563,1277,2840,6,6,201856
26,1,206,24,334,571,24,40,0,1199,923,2122,9,5.5,201856
26,2,181,9,308,491,4,58,21,1072,1043,2115,12,5.4,201856
26,3,287,45,444,1055,12,119,224,2186,1739,3925,17,5.5,201856
26,4,135,18,212,471,35,32,102,1005,833,1838,9,5.2,201856
26,5,145,19,197,444,25,45,0,875,680,1555,15,5.333333333,201856
26,6,150,30,381,682,18,40,0,1301,1188,2489,10,5.333333333,201856
26,7,146,23,220,376,43,20,0,828,769,1597,10,5.5,201856
27,1,169,34,318,595,40,25,2,1183,1271,2454,8,5.5,201856
27,2,168,26,268,578,22,27,0,1089,924,2013,8,5.666666667,201856
27,3,172,25,177,633,13,31,9,1060,850,1910,7,5.666666667,201856
27,4,197,29,302,863,13,35,186,1625,1521,3146,10,5.25,201856
27,5,160,14,146,385,22,29,20,776,717,1493,6,5.333333333,201856
27,6,119,9,179,551,6,15,59,938,907,1845,8,5.5,201856
28,1,224,27,398,634,19,28,1,1331,1386,2717,13,6,201856
28,2,191,39,377,343,56,33,261,1300,1401,2701,11,6.333333333,201856
28,3,128,26,182,372,10,20,0,738,764,1502,7,5.333333333,201856
28,4,332,69,530,454,92,53,507,2037,1867,3904,15,6,201856
28,5,240,62,303,660,37,39,75,1416,1486,2902,12,5.4,201856
28,6,180,39,272,395,118,45,98,1147,1036,2183,14,5.166666667,201856
28,7,271,49,501,815,118,57,0,1811,1363,3174,8,6,201856
28,8,204,68,319,654,111,26,34,1416,1238,2654,9,6,201856
28,9,191,35,358,197,48,25,277,1131,1024,2155,11,5.75,201856
29,1,169,31,319,432,69,40,7,1067,1058,2125,7,5.5,201856
29,2,194,34,402,357,107,39,213,1346,1037,2383,14,6,201856
29,3,100,27,142,474,11,19,1,774,692,1466,5,5.666666667,201856
30,1,120,38,251,476,42,29,109,1065,1015,2080,7,5.333333333,201856
30,2,178,59,301,112,140,27,535,1352,1158,2510,8,5.25,201856
30,3,152,38,548,169,359,50,513,1829,1445,3274,6,5.666666667,201856
30,4,119,17,279,376,65,23,1,880,716,1596,8,6,201856
30,5,137,54,256,685,49,26,0,1207,1043,2250,7,5.5,201856
30,6,140,25,362,416,52,38,19,1052,906,1958,9,5.333333333,201856
30,7,187,43,321,327,56,42,362,1338,1128,2466,11,5.25,201856
30,8,142,52,395,611,114,47,138,1499,1384,2883,11,5.4,201856
30,9,168,27,262,162,88,34,324,1065,945,2010,8,5.5,201856
30,10,113,46,393,466,77,39,414,1548,1313,2861,9,5.5,201856
30,11,137,23,335,660,10,27,0,1192,1013,2205,5,5.5,201856
30,12,229,49,595,1380,41,64,13,2371,2043,4414,10,6,201856
30,13,191,31,242,319,169,48,537,1537,1472,3009,10,5.4,201856
30,14,179,59,458,208,257,45,276,1482,1043,2525,8,5.5,201856
30,15,203,27,284,289,159,52,478,1492,1428,2920,11,5.666666667,201856
30,16,154,30,325,334,172,64,557,1636,1533,3169,10,5.333333333,201856
30,17,149,36,295,485,95,49,106,1215,1074,2289,8,5.5,201856
30,18,133,29,151,349,63,23,112,860,738,1598,8,5.25,201856
30,19,133,34,340,480,57,30,56,1130,1088,2218,13,5.6,201856
30,20,124,28,206,438,134,17,0,947,911,1858,10,5.4,201856
31,1,156,31,214,89,484,16,0,990,900,1890,8,5.5,201856
31,2,77,28,221,6,403,24,0,759,665,1424,6,5.333333333,201856
31,3,324,95,1347,1335,294,69,10,3474,2847,6321,20,6,201856
31,4,84,29,335,191,194,23,328,1184,1033,2217,6,5.5,201856
31,5,127,40,146,742,50,39,0,1144,990,2134,6,5.333333333,201856
32,1,182,100,329,271,87,38,214,1221,970,2191,12,5.2,201856
32,2,227,139,379,161,423,53,230,1612,1518,3130,14,5.142857143,201856
32,3,166,110,283,653,26,41,35,1314,1268,2582,13,4.5,201856
32,4,164,128,264,376,41,38,119,1130,1221,2351,13,5.4,201856
1,1,241,70,299,461,73,34,11,1189,1096,2285,13,5.5,201858
1,2,195,99,551,525,152,62,164,1748,1763,3511,10,6.666666667,201858
1,3,193,122,582,775,115,41,113,1941,1727,3668,12,7,201858
2,1,179,21,443,817,60,66,17,1603,1340,2943,11,6,201858
2,2,135,32,272,994,13,39,0,1485,1811,3296,9,6.5,201858
2,3,224,39,456,458,47,57,187,1468,1822,3290,11,6,201858
2,4,166,13,433,277,75,17,4,985,1095,2080,9,6,201858
2,5,318,62,881,846,312,74,46,2539,2515,5054,13,6.333333333,201858
2,6,190,28,465,533,15,45,0,1276,1371,2647,7,6,201858
2,7,238,33,481,541,20,48,162,1523,1633,3156,12,5.75,201858
2,8,174,26,465,516,33,37,48,1299,1194,2493,8,6,201858
3,1,130,30,322,661,38,49,36,1266,1318,2584,12,5.666666667,201858
3,2,135,14,453,270,14,15,2,903,930,1833,9,4.666666667,201858
4,1,155,31,236,767,58,21,4,1272,1423,2695,12,5.5,201858
4,2,189,16,389,547,49,33,55,1278,1283,2561,14,5.2,201858
5,1,166,37,316,489,100,33,78,1219,1171,2390,9,5.333333333,201858
5,2,129,24,178,407,32,10,0,780,1177,1957,10,5.2,201858
5,3,145,40,240,443,71,56,165,1160,1218,2378,9,5.5,201858
5,4,190,58,475,463,43,69,362,1660,1770,3430,9,5.666666667,201858
5,5,181,51,354,721,22,39,185,1553,1702,3255,8,6,201858
5,6,119,25,206,409,16,22,173,970,957,1927,11,5.5,201858
5,7,124,29,281,526,5,24,29,1018,1089,2107,10,5.5,201858
6,1,173,78,499,548,53,53,394,1798,1626,3424,12,6,201858
6,2,125,42,468,283,152,45,117,1232,1122,2354,9,5.666666667,201858
7,1,274,17,262,478,8,37,65,1141,1196,2337,9,5.25,201858
7,2,231,7,88,355,22,26,0,729,675,1404,9,5.25,201858
7,3,220,8,286,829,213,35,34,1625,869,2494,7,5.333333333,201858
7,4,149,17,212,405,5,45,75,908,971,1879,11,5.4,201858
7,5,251,19,181,532,8,23,4,1018,895,1913,11,5.666666667,201858
7,6,273,40,441,759,36,64,219,1832,1378,3210,9,5.666666667,201858
7,7,189,29,319,559,25,38,11,1170,1078,2248,8,5.5,201858
7,8,215,16,193,779,32,23,0,1258,944,2202,12,5.25,201858
7,9,146,51,333,678,50,51,33,1342,1455,2797,9,5.666666667,201858
7,10,173,13,278,564,49,28,4,1109,892,2001,8,5.5,201858
7,11,121,6,67,151,30,8,2,385,294,679,7,5.333333333,201858
7,12,234,15,311,797,13,22,0,1392,1270,2662,9,5.5,201858
7,13,138,31,129,509,2,23,0,832,292,1124,8,5.25,201858
8,1,116,10,331,257,47,20,93,874,1093,1967,4,6,201858
8,2,215,24,519,637,28,51,31,1505,1552,3057,16,5.5,201858
8,3,130,27,301,294,53,28,297,1130,1513,2643,4,6,201858
8,4,134,27,476,424,58,59,378,1556,1543,3099,11,6,201858
8,5,227,65,333,574,42,42,0,1283,1245,2528,10,5.25,201858
8,6,195,59,505,897,115,61,222,2054,2006,4060,7,6.5,201858
8,7,144,40,214,503,8,27,0,936,851,1787,7,5.25,201858
8,8,164,41,390,854,21,40,61,1571,1294,2865,10,6,201858
8,9,204,59,307,536,83,46,8,1243,972,2215,10,5.2,201858
9,1,58,34,121,107,121,11,140,592,902,1494,5,6,201858
9,2,237,124,600,1727,151,61,309,3209,3679,6888,12,6,201858
9,3,99,60,369,623,88,43,471,1753,2066,3819,7,6,201858
9,4,168,46,282,774,88,39,333,1730,1881,3611,11,6,201858
9,5,100,33,286,726,81,34,60,1320,1442,2762,7,6,201858
9,6,63,20,179,126,211,30,190,819,1095,1914,7,6,201858
9,7,69,22,177,700,12,16,58,1054,1383,2437,9,6,201858
9,8,61,22,225,297,31,33,308,977,1034,2011,5,6,201858
9,9,102,25,171,456,59,23,182,1018,1091,2109,5,6,201858
9,10,97,56,329,772,48,25,39,1366,1388,2754,6,6,201858
9,11,132,35,376,912,84,55,198,1792,2036,3828,7,6,201858
9,12,97,57,572,687,58,67,596,2134,2260,4394,11,6,201858
9,13,100,29,259,333,201,27,437,1386,1471,2857,4,6,201858
9,14,75,24,149,174,114,22,285,843,1208,2051,5,6,201858
9,15,152,62,838,1346,56,75,746,3275,3775,7050,10,7,201858
9,16,166,73,369,1138,331,48,3,2128,2592,4720,15,6,201858
9,17,93,19,230,553,25,29,14,963,1039,2002,6,6,201858
9,18,115,62,294,1174,77,49,91,1862,2262,4124,12,6,201858
9,19,147,58,254,623,193,45,232,1552,1673,3225,5,6,201858
9,20,40,4,83,145,39,7,111,429,270,699,5,6,201858
9,21,103,28,156,434,114,20,170,1025,988,2013,3,6,201858
9,22,119,21,176,274,128,29,342,1089,1124,2213,5,6,201858
9,23,129,23,282,752,106,31,266,1589,1653,3242,6,6,201858
9,24,198,63,521,1568,161,59,203,2773,3131,5904,12,6,201858
10,1,176,55,242,278,34,46,321,1152,1169,2321,12,4.833333333,201858
10,2,193,61,409,488,74,37,294,1556,1539,3095,9,5.5,201858
10,3,218,77,287,654,43,26,67,1372,1146,2518,11,5.4,201858
10,4,218,39,425,832,12,43,67,1636,1783,3419,14,7.5,201858
11,1,168,76,216,436,48,43,55,1042,1054,2096,6,5.666666667,201858
11,2,194,73,325,424,99,39,113,1267,1390,2657,7,6,201858
11,3,107,95,225,263,32,25,404,1151,1320,2471,3,6,201858
11,4,136,70,204,510,18,22,0,960,1017,1977,7,5.666666667,201858
11,5,183,179,419,763,48,43,131,1766,2048,3814,7,6,201858
11,6,102,105,267,379,85,25,123,1086,1047,2133,8,6,201858
11,7,198,54,337,565,45,49,0,1248,1049,2297,9,5.5,201858
11,8,196,93,272,826,42,34,107,1570,1456,3026,9,5,201858
11,9,241,152,400,735,59,47,166,1800,1628,3428,10,5.666666667,201858
11,10,271,176,322,557,114,70,250,1760,1851,3611,10,5.6,201858
11,11,157,103,431,637,44,32,0,1404,1634,3038,5,6,201858
11,12,226,143,478,1081,32,52,11,2023,2112,4135,7,6,201858
11,13,207,98,287,307,65,58,227,1249,1355,2604,8,5.5,201858
11,14,244,119,387,827,57,64,18,1716,1694,3410,8,5.5,201858
11,15,84,81,182,407,11,19,19,803,937,1740,9,6,201858
12,1,202,56,357,174,147,44,26,1006,610,1616,10,5.2,201858
12,2,197,55,361,724,32,44,14,1427,1324,2751,10,5.5,201858
12,3,224,27,292,474,38,41,0,1096,1016,2112,11,5.2,201858
12,4,152,28,366,802,48,44,0,1440,1401,2841,9,5.666666667,201858
12,5,337,47,300,369,6,38,101,1198,889,2087,10,5.25,201858
12,6,143,20,313,326,35,24,10,871,750,1621,10,5,201858
12,7,188,37,274,662,24,32,101,1318,1489,2807,6,5.5,201858
12,8,215,17,261,379,7,18,0,897,1006,1903,9,5.25,201858
12,9,167,40,342,572,30,29,14,1194,1180,2374,9,5.666666667,201858
13,1,207,27,176,577,91,32,13,1123,1023,2146,9,5.333333333,201858
13,2,117,37,111,330,87,30,82,794,970,1764,6,5.333333333,201858
13,3,100,14,171,188,165,36,0,674,643,1317,12,5.25,201858
13,4,175,38,324,373,159,38,195,1302,1036,2338,9,5.666666667,201858
13,5,227,50,396,376,215,55,400,1719,1756,3475,9,5.75,201858
13,6,276,89,609,843,51,53,324,2245,2273,4518,11,5.666666667,201858
13,7,148,35,320,521,39,46,0,1109,1204,2313,8,5.5,201858
14,1,127,77,202,204,86,35,174,905,1058,1963,6,5.5,201858
14,2,126,47,367,306,41,38,35,960,1026,1986,5,5.666666667,201858
14,3,205,73,661,557,91,74,41,1702,1355,3057,8,5.4,201858
14,4,158,57,366,762,40,42,109,1534,1560,3094,10,5.5,201858
14,5,153,38,364,424,83,32,48,1142,1132,2274,9,5.5,201858
14,6,171,46,627,668,74,31,73,1690,1597,3287,10,6,201858
14,7,52,11,154,199,0,6,0,422,729,1151,6,6,201858
14,8,221,115,823,1796,46,57,512,3570,3572,7142,12,6.5,201858
14,9,114,58,270,731,61,25,21,1280,1006,2286,8,6,201858
14,10,128,43,366,652,16,37,71,1313,1517,2830,5,6,201858
14,11,61,39,122,122,55,21,314,734,1200,1934,4,6,201858
14,12,189,34,570,334,11,22,9,1169,1259,2428,9,5.5,201858
14,13,160,43,342,483,29,39,123,1219,1249,2468,6,6,201858
14,14,100,81,337,848,42,28,182,1618,1649,3267,7,6,201858
14,15,196,86,290,549,61,59,69,1310,1060,2370,10,5.6,201858
14,16,60,47,337,251,82,29,236,1042,1289,2331,5,6,201858
14,17,159,42,251,216,44,40,123,875,1029,1904,7,5.25,201858
14,18,179,75,370,448,67,46,215,1400,1530,2930,9,5.4,201858
14,19,174,51,250,534,39,37,30,1115,967,2082,8,5.25,201858
14,20,162,51,427,443,59,44,84,1270,1306,2576,10,5.666666667,201858
15,1,117,67,276,216,610,26,155,1467,1743,3210,7,5.333333333,201858
15,2,156,33,278,436,86,25,341,1355,1281,2636,6,6,201858
15,3,227,68,256,576,553,37,187,1904,1604,3508,10,5.666666667,201858
15,4,106,48,214,538,50,42,190,1188,1418,2606,4,6,201858
15,5,151,82,296,529,81,31,332,1502,1599,3101,8,5.666666667,201858
15,6,152,48,330,714,109,33,239,1625,1676,3301,7,6,201858
15,7,114,35,222,517,72,26,77,1063,1211,2274,10,6,201858
15,8,73,28,175,328,21,23,119,767,1031,1798,4,6,201858
15,9,166,39,188,149,422,28,119,1111,1111,2222,9,5.75,201858
15,10,122,48,295,522,155,33,162,1337,1185,2522,6,6,201858
15,11,174,43,350,803,103,32,52,1557,1591,3148,8,6,201858
15,12,248,44,502,777,48,50,43,1712,1661,3373,8,6,201858
15,13,78,38,151,407,182,35,0,891,1024,1915,8,6,201858
15,14,62,33,194,393,31,18,2,733,737,1470,4,6,201858
15,15,106,77,214,577,32,34,218,1258,1341,2599,6,6,201858
15,16,208,67,349,1008,23,41,72,1768,1614,3382,8,6,201858
15,17,93,44,187,267,21,26,569,1207,1268,2475,8,6,201858
15,18,184,67,297,747,70,34,140,1539,1422,2961,7,5.666666667,201858
15,19,193,106,454,1400,17,39,133,2342,2394,4736,10,6,201858
15,20,63,35,187,526,26,19,35,891,1083,1974,6,6,201858
15,21,121,15,108,257,25,33,183,742,697,1439,6,5.5,201858
15,22,215,106,409,1103,52,63,324,2272,2677,4949,14,6,201858
15,23,120,27,204,660,43,29,0,1083,904,1987,6,5.333333333,201858
15,24,106,57,212,439,88,19,118,1039,875,1914,4,6,201858
15,25,172,38,269,351,83,33,178,1124,1042,2166,6,6,201858
15,26,83,20,286,437,80,19,26,951,1014,1965,8,6,201858
15,27,175,46,324,409,40,38,599,1631,1564,3195,9,5.666666667,201858
15,28,172,60,546,457,135,43,108,1521,1569,3090,9,5.666666667,201858
15,29,186,66,404,1168,40,47,84,1995,1889,3884,8,6,201858
15,30,240,41,387,632,66,45,106,1517,1470,2987,16,6,201858
15,31,114,81,194,590,7,26,2,1014,1374,2388,6,6,201858
15,32,178,28,313,652,50,47,92,1360,1282,2642,9,6,201858
15,33,155,30,275,676,55,29,0,1220,1206,2426,7,6,201858
15,34,100,24,167,610,20,23,156,1100,1115,2215,8,6,201858
15,35,239,42,327,759,35,40,8,1450,1345,2795,9,5.666666667,201858
15,36,203,37,425,517,114,30,6,1332,1324,2656,9,5.5,201858
15,37,177,78,299,517,102,37,424,1634,1659,3293,7,6,201858
15,38,181,77,348,765,24,34,113,1542,1411,2953,6,5.5,201858
15,39,155,45,279,593,18,27,22,1139,1065,2204,4,6,201858
15,40,174,46,385,610,272,46,3,1536,1548,3084,9,6,201858
15,41,245,47,428,622,63,34,243,1682,1844,3526,11,6,201858
16,1,143,49,265,311,47,34,0,849,726,1575,7,5.333333333,201858
16,2,184,62,255,426,37,60,0,1024,955,1979,9,5.25,201858
16,3,183,39,203,481,59,24,41,1030,831,1861,10,5.25,201858
16,4,237,61,406,363,145,52,1,1265,1388,2653,8,5.5,201858
16,5,197,70,251,389,75,63,84,1129,1307,2436,10,5.666666667,201858
16,6,183,82,259,434,58,40,0,1056,957,2013,12,5.5,201858
16,7,233,75,328,455,76,60,0,1227,1158,2385,9,5.5,201858
16,8,216,95,494,967,27,59,73,1931,2233,4164,12,6,201858
16,9,197,49,322,504,31,44,121,1268,1340,2608,9,6,201858
16,10,144,52,365,764,23,42,8,1398,1142,2540,6,6,201858
16,11,177,75,307,386,320,39,94,1398,1121,2519,10,5.4,201858
16,12,146,39,252,212,101,41,35,826,852,1678,10,5.25,201858
17,1,109,39,364,656,59,21,58,1306,1555,2861,8,6,201858
17,2,122,22,338,523,34,32,95,1166,1214,2380,8,5.666666667,201858
17,3,224,45,434,895,41,46,17,1702,1705,3407,8,5.5,201858
17,4,168,53,456,720,73,36,104,1610,1748,3358,10,5.666666667,201858
17,5,69,20,128,280,15,16,26,554,625,1179,5,5.5,201858
18,1,141,50,169,274,29,37,77,777,748,1525,7,5.25,201858
18,2,231,52,489,721,170,58,0,1721,1725,3446,8,6,201858
18,3,188,32,464,469,40,30,0,1223,1005,2228,8,5.5,201858
19,1,151,38,300,741,44,40,179,1493,1372,2865,9,6,201858
19,2,204,38,440,782,27,42,11,1544,1736,3280,9,6,201858
19,3,216,49,459,738,65,33,51,1611,1870,3481,7,6,201858
19,4,87,44,126,112,181,21,439,1010,1064,2074,5,6,201858
19,5,198,61,394,733,47,70,329,1832,2208,4040,8,6,201858
19,6,80,14,198,577,9,18,0,896,1054,1950,5,6,201858
19,7,140,22,379,314,9,22,4,890,1060,1950,10,5.5,201858
19,8,83,11,148,280,3,8,0,533,347,880,7,6,201858
19,9,176,48,226,361,99,32,192,1134,1074,2208,9,5.25,201858
19,10,80,16,135,249,9,31,249,769,1289,2058,7,7,201858
19,11,245,104,538,1418,41,76,701,3123,3397,6520,13,6,201858
19,12,133,23,387,337,32,21,40,973,1312,2285,8,5.666666667,201858
20,1,208,39,270,217,95,41,233,1103,739,1842,7,5.5,201858
20,2,155,27,156,303,11,20,0,672,399,1071,6,5.333333333,201858
20,3,149,25,209,179,169,30,188,949,690,1639,6,5.333333333,201858
20,4,157,34,165,206,79,33,66,740,637,1377,6,5.333333333,201858
20,5,235,39,395,767,139,54,0,1629,960,2589,11,5.25,201858
20,6,238,12,198,331,138,29,4,950,695,1645,8,5.25,201858
20,7,167,35,242,722,66,29,28,1289,939,2228,7,5.75,201858
20,8,409,57,565,873,50,91,861,2906,2958,5864,14,6.5,201858
20,9,291,55,322,405,164,58,406,1701,1254,2955,8,5.666666667,201858
20,10,259,19,273,717,12,37,0,1317,926,2243,9,5.25,201858
21,1,187,24,296,545,39,31,9,1131,903,2034,9,5.4,201858
21,2,187,18,372,501,214,32,1,1325,1004,2329,9,5.2,201858
21,3,187,34,473,348,266,48,112,1468,1268,2736,8,5.5,201858
21,4,192,21,237,259,180,23,45,957,527,1484,6,5.25,201858
21,5,193,31,444,532,44,54,123,1421,1150,2571,8,5.666666667,201858
21,6,165,31,349,329,72,39,610,1595,1501,3096,6,6,201858
21,7,243,44,323,434,150,38,185,1417,1129,2546,9,5.666666667,201858
21,8,178,23,299,292,109,28,111,1040,846,1886,9,5.2,201858
21,9,165,42,458,549,146,43,395,1798,1799,3597,9,6,201858
21,10,189,39,393,431,76,44,339,1511,1218,2729,7,5.5,201858
21,11,76,6,179,184,34,14,46,539,389,928,5,7,201858
21,12,264,46,817,1313,83,61,496,3080,3097,6177,16,6.5,201858
21,13,187,25,308,520,109,49,137,1335,1420,2755,8,5.666666667,201858
21,14,214,28,330,184,230,42,229,1257,929,2186,12,5.333333333,201858
21,15,201,27,507,429,105,41,145,1455,1224,2679,7,5.5,201858
22,1,221,78,264,400,47,27,100,1137,1017,2154,11,5.2,201858
22,2,168,50,380,452,40,24,25,1139,1066,2205,7,5.5,201858
22,3,255,133,905,1028,46,52,53,2472,2296,4768,9,5.666666667,201858
22,4,184,143,708,995,74,39,141,2284,1999,4283,8,6,201858
22,5,171,63,549,377,197,44,75,1476,1213,2689,10,5.5,201858
23,1,244,3,827,291,12,27,54,1458,1672,3130,14,5.6,201858
23,2,169,26,358,567,31,21,0,1172,1044,2216,10,5.25,201858
23,3,135,9,525,397,18,16,2,1102,1720,2822,15,7,201858
23,4,174,12,624,385,34,22,54,1305,1285,2590,8,5.666666667,201858
24,1,102,60,156,405,31,22,4,780,605,1385,10,5.2,201858
24,2,123,72,209,377,47,23,49,900,689,1589,6,5.5,201858
24,3,158,64,215,367,198,40,1,1043,947,1990,9,5.25,201858
24,4,130,51,210,176,91,36,321,1015,873,1888,5,5.5,201858
24,5,196,94,460,889,34,42,167,1882,1883,3765,10,6.333333333,201858
24,6,158,120,372,827,98,38,53,1666,1512,3178,7,7,201858
24,7,218,48,352,609,122,23,0,1372,1449,2821,9,5.25,201858
25,1,150,50,243,444,127,37,210,1261,1271,2532,13,5.75,201858
25,2,201,71,490,1064,69,57,0,1952,1760,3712,7,5.5,201858
25,3,194,25,294,623,103,32,67,1338,1274,2612,8,5.6,201858
25,4,179,55,201,670,18,35,101,1259,1268,2527,8,5.333333333,201858
25,5,168,32,332,1039,29,62,2,1664,1588,3252,8,5.666666667,201858
25,6,198,39,376,503,207,43,148,1514,1692,3206,8,5.75,201858
25,7,175,28,384,868,15,38,2,1510,1650,3160,6,6,201858
26,1,129,24,242,494,21,42,1,953,819,1772,9,5.5,201858
26,2,137,7,261,394,2,39,4,844,1102,1946,12,5.4,201858
26,3,174,25,317,648,21,55,354,1594,2212,3806,14,6.5,201858
26,4,123,23,178,478,27,35,91,955,966,1921,9,5.2,201858
26,5,78,20,143,435,31,31,0,738,828,1566,15,6,201858
26,6,159,21,327,728,24,31,0,1290,1571,2861,10,5.333333333,201858
26,7,113,20,198,342,57,23,0,753,948,1701,10,5.5,201858
27,1,168,40,301,618,81,33,39,1280,1087,2367,8,5.5,201858
27,2,207,34,344,674,44,46,0,1349,1534,2883,8,5.666666667,201858
27,3,184,40,280,937,18,22,5,1486,1573,3059,7,5.666666667,201858
27,4,193,26,330,970,18,32,207,1776,1656,3432,8,6,201858
27,5,119,8,106,353,11,17,0,614,577,1191,6,5.333333333,201858
27,6,129,34,218,669,14,29,66,1159,1282,2441,8,5.5,201858
28,1,205,36,414,688,20,29,0,1392,1621,3013,13,6,201858
28,2,148,43,355,413,61,37,319,1376,1233,2609,11,6,201858
28,3,138,40,231,628,10,19,0,1066,1064,2130,7,5.333333333,201858
28,4,244,57,365,451,89,43,492,1741,1877,3618,15,6,201858
28,5,190,85,273,828,23,38,92,1529,1315,2844,12,6.75,201858
28,6,119,34,231,351,65,23,97,920,932,1852,14,5.166666667,201858
28,7,206,72,455,867,120,37,0,1757,2008,3765,8,6,201858
28,8,184,79,294,657,138,45,33,1430,1461,2891,9,6,201858
28,9,181,33,281,193,63,30,277,1058,954,2012,11,5.75,201858
29,1,204,44,370,495,84,33,0,1230,1170,2400,7,5.5,201858
29,2,162,54,408,484,106,35,268,1517,1407,2924,11,6,201858
29,3,94,43,138,578,36,26,0,915,809,1724,5,5.666666667,201858
30,1,122,50,259,454,29,36,149,1099,1128,2227,7,5.333333333,201858
30,2,189,46,306,103,195,28,545,1412,1164,2576,8,5.25,201858
30,3,182,46,522,164,311,49,591,1865,1851,3716,6,5.666666667,201858
30,4,116,25,302,535,95,23,8,1104,1141,2245,8,6,201858
30,5,123,45,266,780,112,27,0,1353,1377,2730,7,5.5,201858
30,6,171,33,413,462,29,27,25,1160,920,2080,9,5.333333333,201858
30,7,209,60,386,335,79,75,526,1670,1117,2787,11,5.25,201858
30,8,179,58,459,808,190,45,286,2025,1427,3452,11,5.4,201858
30,9,157,33,294,188,139,43,392,1246,1024,2270,8,5.5,201858
30,10,155,68,516,760,135,43,512,2189,1923,4112,7,6.5,201858
30,11,144,44,398,877,14,33,1,1511,1543,3054,5,5.5,201858
30,12,181,65,572,1736,42,73,71,2740,2842,5582,10,6,201858
30,13,171,35,211,335,154,44,514,1464,1226,2690,10,5.4,201858
30,14,234,66,584,210,290,69,388,1841,1388,3229,8,5.5,201858
30,15,202,29,290,262,177,44,612,1616,1665,3281,11,5.666666667,201858
30,16,166,29,409,346,206,58,889,2103,1745,3848,10,5.333333333,201858
30,17,196,56,312,645,130,52,106,1497,1467,2964,8,5.5,201858
30,18,192,25,220,472,31,30,62,1032,795,1827,8,5.25,201858
30,19,161,22,425,622,147,35,34,1446,932,2378,13,5.6,201858
30,20,186,34,303,685,204,53,0,1465,1048,2513,10,5.4,201858
31,1,147,40,246,106,649,16,0,1204,1030,2234,8,5.5,201858
31,2,83,25,182,1,559,24,0,874,868,1742,6,5.333333333,201858
31,3,307,110,1445,1539,435,77,13,3926,3677,7603,20,6,201858
31,4,76,40,269,175,170,29,420,1179,1301,2480,4,6,201858
31,5,118,32,162,776,14,20,0,1122,1303,2425,6,5.333333333,201858
32,1,136,88,252,200,85,29,205,995,964,1959,12,5.2,201858
32,2,191,118,303,116,321,39,184,1272,1133,2405,13,5.142857143,201858
32,3,148,109,325,654,26,38,42,1342,1148,2490,13,5.4,201858
32,4,188,141,294,437,61,40,172,1333,1253,2586,13,5.4,201858
1,1,118,31,215,244,38,25,2,673,609,1282,13,3.5,201859
1,2,124,67,398,414,87,34,92,1216,840,2056,10,4.666666667,201859
1,3,93,79,394,539,77,21,102,1305,1132,2437,10,4.666666667,201859
2,1,108,23,272,590,28,36,9,1066,865,1931,11,4,201859
2,2,77,14,155,619,20,30,0,915,919,1834,8,4.5,201859
2,3,116,25,264,327,29,25,84,870,985,1855,12,4,201859
2,4,78,2,275,147,27,14,11,554,424,978,9,4,201859
2,5,202,34,582,519,203,57,28,1625,1520,3145,13,4.333333333,201859
2,6,88,10,230,319,25,18,0,690,710,1400,7,4,201859
2,7,101,22,311,313,20,29,132,928,853,1781,12,3.75,201859
2,8,116,14,300,364,12,22,46,874,1018,1892,8,4,201859
3,1,0,0,0,0,0,0,0,0,0,0,0,0,201859
3,2,0,0,0,0,0,0,0,0,0,0,0,0,201859
4,1,0,0,0,0,0,0,0,0,0,0,0,0,201859
4,2,0,0,0,0,0,0,0,0,0,0,0,0,201859
5,1,0,0,0,0,0,0,0,0,0,0,0,0,201859
5,2,0,0,0,0,0,0,0,0,0,0,0,0,201859
5,3,0,0,0,0,0,0,0,0,0,0,0,0,201859
5,4,0,0,0,0,0,0,0,0,0,0,0,0,201859
5,5,0,0,0,0,0,0,0,0,0,0,0,0,201859
5,6,0,0,0,0,0,0,0,0,0,0,0,0,201859
5,7,0,0,0,0,0,0,0,0,0,0,0,0,201859
6,1,0,0,0,0,0,0,0,0,0,0,0,0,201859
6,2,0,0,0,0,0,0,0,0,0,0,0,0,201859
7,1,0,0,0,0,0,0,0,0,0,0,0,0,201859
7,2,0,0,0,0,0,0,0,0,0,0,0,0,201859
7,3,0,0,0,0,0,0,0,0,0,0,0,0,201859
7,4,0,0,0,0,0,0,0,0,0,0,0,0,201859
7,5,0,0,0,0,0,0,0,0,0,0,0,0,201859
7,6,0,0,0,0,0,0,0,0,0,0,0,0,201859
7,7,0,0,0,0,0,0,0,0,0,0,0,0,201859
7,8,0,0,0,0,0,0,0,0,0,0,0,0,201859
7,9,0,0,0,0,0,0,0,0,0,0,0,0,201859
7,10,0,0,0,0,0,0,0,0,0,0,0,0,201859
7,11,0,0,0,0,0,0,0,0,0,0,0,0,201859
7,12,0,0,0,0,0,0,0,0,0,0,0,0,201859
7,13,0,0,0,0,0,0,0,0,0,0,0,0,201859
8,1,0,0,0,0,0,0,0,0,0,0,0,0,201859
8,2,0,0,0,0,0,0,0,0,0,0,0,0,201859
8,3,0,0,0,0,0,0,0,0,0,0,0,0,201859
8,4,0,0,0,0,0,0,0,0,0,0,0,0,201859
8,5,0,0,0,0,0,0,0,0,0,0,0,0,201859
8,6,0,0,0,0,0,0,0,0,0,0,0,0,201859
8,7,0,0,0,0,0,0,0,0,0,0,0,0,201859
8,8,0,0,0,0,0,0,0,0,0,0,0,0,201859
8,9,0,0,0,0,0,0,0,0,0,0,0,0,201859
9,1,0,0,0,0,0,0,0,0,0,0,0,0,201859
9,2,0,0,0,0,0,0,0,0,0,0,0,0,201859
9,3,0,0,0,0,0,0,0,0,0,0,0,0,201859
9,4,0,0,0,0,0,0,0,0,0,0,0,0,201859
9,5,0,0,0,0,0,0,0,0,0,0,0,0,201859
9,6,0,0,0,0,0,0,0,0,0,0,0,0,201859
9,7,0,0,0,0,0,0,0,0,0,0,0,0,201859
9,8,0,0,0,0,0,0,0,0,0,0,0,0,201859
9,9,0,0,0,0,0,0,0,0,0,0,0,0,201859
9,10,0,0,0,0,0,0,0,0,0,0,0,0,201859
9,11,0,0,0,0,0,0,0,0,0,0,0,0,201859
9,12,0,0,0,0,0,0,0,0,0,0,0,0,201859
9,13,0,0,0,0,0,0,0,0,0,0,0,0,201859
9,14,0,0,0,0,0,0,0,0,0,0,0,0,201859
9,15,0,0,0,0,0,0,0,0,0,0,0,0,201859
9,16,0,0,0,0,0,0,0,0,0,0,0,0,201859
9,17,0,0,0,0,0,0,0,0,0,0,0,0,201859
9,18,0,0,0,0,0,0,0,0,0,0,0,0,201859
9,19,0,0,0,0,0,0,0,0,0,0,0,0,201859
9,20,0,0,0,0,0,0,0,0,0,0,0,0,201859
9,21,0,0,0,0,0,0,0,0,0,0,0,0,201859
9,22,0,0,0,0,0,0,0,0,0,0,0,0,201859
9,23,0,0,0,0,0,0,0,0,0,0,0,0,201859
9,24,0,0,0,0,0,0,0,0,0,0,0,0,201859
10,1,89,25,117,186,15,20,151,603,598,1201,12,2.833333333,201859
10,2,105,38,231,319,50,30,172,945,752,1697,9,3.5,201859
10,3,94,21,121,300,14,22,13,585,693,1278,11,3.4,201859
10,4,87,29,244,448,19,31,56,914,812,1726,12,5,201859
11,1,0,0,0,0,0,0,0,0,0,0,0,0,201859
11,2,0,0,0,0,0,0,0,0,0,0,0,0,201859
11,3,0,0,0,0,0,0,0,0,0,0,0,0,201859
11,4,0,0,0,0,0,0,0,0,0,0,0,0,201859
11,5,0,0,0,0,0,0,0,0,0,0,0,0,201859
11,6,0,0,0,0,0,0,0,0,0,0,0,0,201859
11,7,0,0,0,0,0,0,0,0,0,0,0,0,201859
11,8,0,0,0,0,0,0,0,0,0,0,0,0,201859
11,9,0,0,0,0,0,0,0,0,0,0,0,0,201859
11,10,0,0,0,0,0,0,0,0,0,0,0,0,201859
11,11,0,0,0,0,0,0,0,0,0,0,0,0,201859
11,12,0,0,0,0,0,0,0,0,0,0,0,0,201859
11,13,0,0,0,0,0,0,0,0,0,0,0,0,201859
11,14,0,0,0,0,0,0,0,0,0,0,0,0,201859
11,15,0,0,0,0,0,0,0,0,0,0,0,0,201859
12,1,0,0,0,0,0,0,0,0,0,0,0,0,201859
12,2,0,0,0,0,0,0,0,0,0,0,0,0,201859
12,3,0,0,0,0,0,0,0,0,0,0,0,0,201859
12,4,0,0,0,0,0,0,0,0,0,0,0,0,201859
12,5,0,0,0,0,0,0,0,0,0,0,0,0,201859
12,6,0,0,0,0,0,0,0,0,0,0,0,0,201859
12,7,0,0,0,0,0,0,0,0,0,0,0,0,201859
12,8,0,0,0,0,0,0,0,0,0,0,0,0,201859
12,9,0,0,0,0,0,0,0,0,0,0,0,0,201859
13,1,0,0,0,0,0,0,0,0,0,0,0,0,201859
13,2,0,0,0,0,0,0,0,0,0,0,0,0,201859
13,3,0,0,0,0,0,0,0,0,0,0,0,0,201859
13,4,0,0,0,0,0,0,0,0,0,0,0,0,201859
13,5,0,0,0,0,0,0,0,0,0,0,0,0,201859
13,6,0,0,0,0,0,0,0,0,0,0,0,0,201859
13,7,0,0,0,0,0,0,0,0,0,0,0,0,201859
14,1,0,0,0,0,0,0,0,0,0,0,0,0,201859
14,2,0,0,0,0,0,0,0,0,0,0,0,0,201859
14,3,0,0,0,0,0,0,0,0,0,0,0,0,201859
14,4,0,0,0,0,0,0,0,0,0,0,0,0,201859
14,5,0,0,0,0,0,0,0,0,0,0,0,0,201859
14,6,0,0,0,0,0,0,0,0,0,0,0,0,201859
14,7,0,0,0,0,0,0,0,0,0,0,0,0,201859
14,8,0,0,0,0,0,0,0,0,0,0,0,0,201859
14,9,0,0,0,0,0,0,0,0,0,0,0,0,201859
14,10,0,0,0,0,0,0,0,0,0,0,0,0,201859
14,11,0,0,0,0,0,0,0,0,0,0,0,0,201859
14,12,0,0,0,0,0,0,0,0,0,0,0,0,201859
14,13,0,0,0,0,0,0,0,0,0,0,0,0,201859
14,14,0,0,0,0,0,0,0,0,0,0,0,0,201859
14,15,0,0,0,0,0,0,0,0,0,0,0,0,201859
14,16,0,0,0,0,0,0,0,0,0,0,0,0,201859
14,17,0,0,0,0,0,0,0,0,0,0,0,0,201859
14,18,0,0,0,0,0,0,0,0,0,0,0,0,201859
14,19,0,0,0,0,0,0,0,0,0,0,0,0,201859
14,20,0,0,0,0,0,0,0,0,0,0,0,0,201859
15,1,0,0,0,0,0,0,0,0,0,0,0,0,201859
15,2,0,0,0,0,0,0,0,0,0,0,0,0,201859
15,3,0,0,0,0,0,0,0,0,0,0,0,0,201859
15,4,0,0,0,0,0,0,0,0,0,0,0,0,201859
15,5,0,0,0,0,0,0,0,0,0,0,0,0,201859
15,6,0,0,0,0,0,0,0,0,0,0,0,0,201859
15,7,0,0,0,0,0,0,0,0,0,0,0,0,201859
15,8,0,0,0,0,0,0,0,0,0,0,0,0,201859
15,9,0,0,0,0,0,0,0,0,0,0,0,0,201859
15,10,0,0,0,0,0,0,0,0,0,0,0,0,201859
15,11,0,0,0,0,0,0,0,0,0,0,0,0,201859
15,12,0,0,0,0,0,0,0,0,0,0,0,0,201859
15,13,0,0,0,0,0,0,0,0,0,0,0,0,201859
15,14,0,0,0,0,0,0,0,0,0,0,0,0,201859
15,15,0,0,0,0,0,0,0,0,0,0,0,0,201859
15,16,0,0,0,0,0,0,0,0,0,0,0,0,201859
15,17,0,0,0,0,0,0,0,0,0,0,0,0,201859
15,18,0,0,0,0,0,0,0,0,0,0,0,0,201859
15,19,0,0,0,0,0,0,0,0,0,0,0,0,201859
15,20,0,0,0,0,0,0,0,0,0,0,0,0,201859
15,21,0,0,0,0,0,0,0,0,0,0,0,0,201859
15,22,0,0,0,0,0,0,0,0,0,0,0,0,201859
15,23,0,0,0,0,0,0,0,0,0,0,0,0,201859
15,24,0,0,0,0,0,0,0,0,0,0,0,0,201859
15,25,0,0,0,0,0,0,0,0,0,0,0,0,201859
15,26,0,0,0,0,0,0,0,0,0,0,0,0,201859
15,27,0,0,0,0,0,0,0,0,0,0,0,0,201859
15,28,0,0,0,0,0,0,0,0,0,0,0,0,201859
15,29,0,0,0,0,0,0,0,0,0,0,0,0,201859
15,30,0,0,0,0,0,0,0,0,0,0,0,0,201859
15,31,0,0,0,0,0,0,0,0,0,0,0,0,201859
15,32,0,0,0,0,0,0,0,0,0,0,0,0,201859
15,33,0,0,0,0,0,0,0,0,0,0,0,0,201859
15,34,0,0,0,0,0,0,0,0,0,0,0,0,201859
15,35,0,0,0,0,0,0,0,0,0,0,0,0,201859
15,36,0,0,0,0,0,0,0,0,0,0,0,0,201859
15,37,0,0,0,0,0,0,0,0,0,0,0,0,201859
15,38,0,0,0,0,0,0,0,0,0,0,0,0,201859
15,39,0,0,0,0,0,0,0,0,0,0,0,0,201859
15,40,0,0,0,0,0,0,0,0,0,0,0,0,201859
15,41,0,0,0,0,0,0,0,0,0,0,0,0,201859
16,1,0,0,0,0,0,0,0,0,0,0,0,0,201859
16,2,0,0,0,0,0,0,0,0,0,0,0,0,201859
16,3,0,0,0,0,0,0,0,0,0,0,0,0,201859
16,4,0,0,0,0,0,0,0,0,0,0,0,0,201859
16,5,0,0,0,0,0,0,0,0,0,0,0,0,201859
16,6,0,0,0,0,0,0,0,0,0,0,0,0,201859
16,7,0,0,0,0,0,0,0,0,0,0,0,0,201859
16,8,0,0,0,0,0,0,0,0,0,0,0,0,201859
16,9,0,0,0,0,0,0,0,0,0,0,0,0,201859
16,10,0,0,0,0,0,0,0,0,0,0,0,0,201859
16,11,0,0,0,0,0,0,0,0,0,0,0,0,201859
16,12,0,0,0,0,0,0,0,0,0,0,0,0,201859
17,1,0,0,0,0,0,0,0,0,0,0,0,0,201859
17,2,0,0,0,0,0,0,0,0,0,0,0,0,201859
17,3,0,0,0,0,0,0,0,0,0,0,0,0,201859
17,4,0,0,0,0,0,0,0,0,0,0,0,0,201859
17,5,0,0,0,0,0,0,0,0,0,0,0,0,201859
18,1,0,0,0,0,0,0,0,0,0,0,0,0,201859
18,2,0,0,0,0,0,0,0,0,0,0,0,0,201859
18,3,0,0,0,0,0,0,0,0,0,0,0,0,201859
19,1,0,0,0,0,0,0,0,0,0,0,0,0,201859
19,2,0,0,0,0,0,0,0,0,0,0,0,0,201859
19,3,0,0,0,0,0,0,0,0,0,0,0,0,201859
19,4,0,0,0,0,0,0,0,0,0,0,0,0,201859
19,5,0,0,0,0,0,0,0,0,0,0,0,0,201859
19,6,0,0,0,0,0,0,0,0,0,0,0,0,201859
19,7,0,0,0,0,0,0,0,0,0,0,0,0,201859
19,8,0,0,0,0,0,0,0,0,0,0,0,0,201859
19,9,0,0,0,0,0,0,0,0,0,0,0,0,201859
19,10,0,0,0,0,0,0,0,0,0,0,0,0,201859
19,11,0,0,0,0,0,0,0,0,0,0,0,0,201859
19,12,0,0,0,0,0,0,0,0,0,0,0,0,201859
20,1,0,0,0,0,0,0,0,0,0,0,0,0,201859
20,2,0,0,0,0,0,0,0,0,0,0,0,0,201859
20,3,0,0,0,0,0,0,0,0,0,0,0,0,201859
20,4,0,0,0,0,0,0,0,0,0,0,0,0,201859
20,5,0,0,0,0,0,0,0,0,0,0,0,0,201859
20,6,0,0,0,0,0,0,0,0,0,0,0,0,201859
20,7,0,0,0,0,0,0,0,0,0,0,0,0,201859
20,8,0,0,0,0,0,0,0,0,0,0,0,0,201859
20,9,0,0,0,0,0,0,0,0,0,0,0,0,201859
20,10,0,0,0,0,0,0,0,0,0,0,0,0,201859
21,1,0,0,0,0,0,0,0,0,0,0,0,0,201859
21,2,0,0,0,0,0,0,0,0,0,0,0,0,201859
21,3,0,0,0,0,0,0,0,0,0,0,0,0,201859
21,4,0,0,0,0,0,0,0,0,0,0,0,0,201859
21,5,0,0,0,0,0,0,0,0,0,0,0,0,201859
21,6,0,0,0,0,0,0,0,0,0,0,0,0,201859
21,7,0,0,0,0,0,0,0,0,0,0,0,0,201859
21,8,0,0,0,0,0,0,0,0,0,0,0,0,201859
21,9,0,0,0,0,0,0,0,0,0,0,0,0,201859
21,10,0,0,0,0,0,0,0,0,0,0,0,0,201859
21,11,0,0,0,0,0,0,0,0,0,0,0,0,201859
21,12,0,0,0,0,0,0,0,0,0,0,0,0,201859
21,13,0,0,0,0,0,0,0,0,0,0,0,0,201859
21,14,0,0,0,0,0,0,0,0,0,0,0,0,201859
21,15,0,0,0,0,0,0,0,0,0,0,0,0,201859
22,1,0,0,0,0,0,0,0,0,0,0,0,0,201859
22,2,0,0,0,0,0,0,0,0,0,0,0,0,201859
22,3,0,0,0,0,0,0,0,0,0,0,0,0,201859
22,4,0,0,0,0,0,0,0,0,0,0,0,0,201859
22,5,0,0,0,0,0,0,0,0,0,0,0,0,201859
23,1,113,6,552,214,10,15,59,969,713,1682,14,3.6,201859
23,2,101,12,232,439,20,32,0,836,378,1214,10,3.25,201859
23,3,58,5,328,208,8,3,0,610,454,1064,15,5,201859
23,4,79,6,348,186,66,13,26,724,669,1393,8,3.666666667,201859
24,1,0,0,0,0,0,0,0,0,0,0,0,0,201859
24,2,0,0,0,0,0,0,0,0,0,0,0,0,201859
24,3,0,0,0,0,0,0,0,0,0,0,0,0,201859
24,4,0,0,0,0,0,0,0,0,0,0,0,0,201859
24,5,0,0,0,0,0,0,0,0,0,0,0,0,201859
24,6,0,0,0,0,0,0,0,0,0,0,0,0,201859
24,7,0,0,0,0,0,0,0,0,0,0,0,0,201859
25,1,0,0,0,0,0,0,0,0,0,0,0,0,201859
25,2,0,0,0,0,0,0,0,0,0,0,0,0,201859
25,3,0,0,0,0,0,0,0,0,0,0,0,0,201859
25,4,0,0,0,0,0,0,0,0,0,0,0,0,201859
25,5,0,0,0,0,0,0,0,0,0,0,0,0,201859
25,6,0,0,0,0,0,0,0,0,0,0,0,0,201859
25,7,0,0,0,0,0,0,0,0,0,0,0,0,201859
26,1,0,0,0,0,0,0,0,0,0,0,0,0,201859
26,2,0,0,0,0,0,0,0,0,0,0,0,0,201859
26,3,0,0,0,0,0,0,0,0,0,0,0,0,201859
26,4,0,0,0,0,0,0,0,0,0,0,0,0,201859
26,5,0,0,0,0,0,0,0,0,0,0,0,0,201859
26,6,0,0,0,0,0,0,0,0,0,0,0,0,201859
26,7,0,0,0,0,0,0,0,0,0,0,0,0,201859
27,1,0,0,0,0,0,0,0,0,0,0,0,0,201859
27,2,0,0,0,0,0,0,0,0,0,0,0,0,201859
27,3,0,0,0,0,0,0,0,0,0,0,0,0,201859
27,4,0,0,0,0,0,0,0,0,0,0,0,0,201859
27,5,0,0,0,0,0,0,0,0,0,0,0,0,201859
27,6,0,0,0,0,0,0,0,0,0,0,0,0,201859
28,1,75,15,201,348,5,10,0,654,930,1584,13,4,201859
28,2,90,29,223,257,29,27,184,839,556,1395,11,4,201859
28,3,53,22,116,261,6,11,1,470,228,698,7,3.333333333,201859
28,4,94,24,224,208,39,30,266,885,797,1682,15,4,201859
28,5,100,57,167,516,19,20,41,920,616,1536,10,3.5,201859
28,6,66,18,90,189,14,26,74,477,418,895,14,3.166666667,201859
28,7,72,27,273,553,40,15,0,980,973,1953,8,4,201859
28,8,81,49,169,394,87,27,19,826,731,1557,9,4,201859
28,9,56,10,162,81,34,8,127,478,509,987,11,3.75,201859
29,1,0,0,0,0,0,0,0,0,0,0,0,0,201859
29,2,0,0,0,0,0,0,0,0,0,0,0,0,201859
29,3,0,0,0,0,0,0,0,0,0,0,0,0,201859
30,1,0,0,0,0,0,0,0,0,0,0,0,0,201859
30,2,0,0,0,0,0,0,0,0,0,0,0,0,201859
30,3,0,0,0,0,0,0,0,0,0,0,0,0,201859
30,4,0,0,0,0,0,0,0,0,0,0,0,0,201859
30,5,0,0,0,0,0,0,0,0,0,0,0,0,201859
30,6,0,0,0,0,0,0,0,0,0,0,0,0,201859
30,7,0,0,0,0,0,0,0,0,0,0,0,0,201859
30,8,0,0,0,0,0,0,0,0,0,0,0,0,201859
30,9,0,0,0,0,0,0,0,0,0,0,0,0,201859
30,10,0,0,0,0,0,0,0,0,0,0,0,0,201859
30,11,0,0,0,0,0,0,0,0,0,0,0,0,201859
30,12,0,0,0,0,0,0,0,0,0,0,0,0,201859
30,13,0,0,0,0,0,0,0,0,0,0,0,0,201859
30,14,0,0,0,0,0,0,0,0,0,0,0,0,201859
30,15,0,0,0,0,0,0,0,0,0,0,0,0,201859
30,16,0,0,0,0,0,0,0,0,0,0,0,0,201859
30,17,0,0,0,0,0,0,0,0,0,0,0,0,201859
30,18,0,0,0,0,0,0,0,0,0,0,0,0,201859
30,19,0,0,0,0,0,0,0,0,0,0,0,0,201859
30,20,0,0,0,0,0,0,0,0,0,0,0,0,201859
31,1,0,0,0,0,0,0,0,0,0,0,0,0,201859
31,2,0,0,0,0,0,0,0,0,0,0,0,0,201859
31,3,0,0,0,0,0,0,0,0,0,0,0,0,201859
31,4,0,0,0,0,0,0,0,0,0,0,0,0,201859
31,5,0,0,0,0,0,0,0,0,0,0,0,0,201859
32,1,0,0,0,0,0,0,0,0,0,0,0,0,201859
32,2,0,0,0,0,0,0,0,0,0,0,0,0,201859
32,3,0,0,0,0,0,0,0,0,0,0,0,0,201859
32,4,0,0,0,0,0,0,0,0,0,0,0,0,201859
1,1,146,49,253,287,80,34,11,860,493,1353,13,3.5,201901
1,2,187,80,528,562,162,106,140,1765,732,2497,10,5.333333333,201901
1,3,112,78,585,589,80,75,73,1592,900,2492,10,4.333333333,201901
2,1,146,27,405,689,31,52,1,1351,788,2139,11,4,201901
2,2,91,29,257,700,18,57,0,1152,798,1950,7,4,201901
2,3,124,17,341,323,25,44,144,1018,850,1868,11,3.666666667,201901
2,4,100,11,382,204,29,28,5,759,390,1149,9,4,201901
2,5,201,28,739,646,258,108,49,2029,1263,3292,13,4,201901
2,6,130,16,358,465,32,50,0,1051,693,1744,7,4,201901
2,7,125,23,350,314,40,41,154,1047,669,1716,12,3.75,201901
2,8,128,14,424,416,26,46,86,1140,720,1860,8,4,201901
3,1,88,4,138,192,11,354,1,788,528,1316,12,3.666666667,201901
3,2,83,5,214,157,12,177,0,648,355,1003,9,3.333333333,201901
4,1,126,14,184,361,30,391,1,1107,430,1537,11,3.25,201901
4,2,100,13,306,318,50,16,68,871,430,1301,14,3.2,201901
5,1,146,16,202,210,38,359,8,979,456,1435,9,3.666666667,201901
5,2,129,11,171,319,29,104,11,774,375,1149,10,3.2,201901
5,3,129,7,168,268,47,338,13,970,499,1469,9,3.5,201901
5,4,169,15,330,328,16,611,22,1491,620,2111,9,3.666666667,201901
5,5,156,11,243,367,11,445,19,1252,403,1655,8,4,201901
5,6,102,13,165,201,15,232,27,755,246,1001,11,3.5,201901
5,7,122,8,156,241,0,356,2,885,158,1043,10,3,201901
6,1,145,20,239,228,8,901,4,1545,534,2079,11,3.8,201901
6,2,79,6,184,106,34,409,3,821,353,1174,9,3.666666667,201901
7,1,92,7,116,184,2,59,10,470,288,758,9,3.25,201901
7,2,165,5,58,151,18,31,0,428,252,680,9,3.25,201901
7,3,157,6,148,293,102,104,2,812,453,1265,7,3.333333333,201901
7,4,124,6,125,236,22,56,35,604,222,826,11,3.4,201901
7,5,170,2,81,324,13,187,1,778,334,1112,11,3.666666667,201901
7,6,135,10,158,368,9,392,15,1087,475,1562,8,3.333333333,201901
7,7,134,20,213,333,17,105,30,852,293,1145,8,3.5,201901
7,8,119,9,94,335,10,206,1,774,597,1371,12,3.25,201901
7,9,98,11,151,301,13,317,0,891,546,1437,9,3.666666667,201901
7,10,124,9,122,362,16,100,3,736,180,916,9,3.5,201901
7,11,102,7,71,141,8,40,3,372,159,531,6,3.333333333,201901
7,12,137,5,170,481,9,201,0,1003,435,1438,9,3.5,201901
7,13,63,9,50,197,0,15,0,334,75,409,9,3.25,201901
8,1,115,3,258,178,15,348,6,923,361,1284,4,4,201901
8,2,251,25,388,368,17,507,16,1572,754,2326,16,3.5,201901
8,3,118,23,248,213,49,91,131,873,590,1463,4,4,201901
8,4,116,14,345,201,46,420,41,1183,438,1621,11,4,201901
8,5,117,17,140,265,9,182,7,737,519,1256,10,3.25,201901
8,6,160,22,227,344,16,782,23,1574,945,2519,6,4,201901
8,7,131,17,144,193,5,302,0,792,457,1249,7,3.25,201901
8,8,132,38,237,495,10,427,7,1346,665,2011,11,5,201901
8,9,105,22,100,153,20,309,9,718,460,1178,10,3.2,201901
9,1,37,1,65,72,14,266,3,458,358,816,5,4,201901
9,2,150,33,324,732,56,1084,8,2387,1130,3517,12,4,201901
9,3,72,15,195,268,33,577,44,1204,472,1676,7,4,201901
9,4,116,10,209,362,31,593,7,1328,840,2168,11,4,201901
9,5,65,8,131,294,26,539,2,1065,825,1890,7,4,201901
9,6,65,11,87,104,39,321,3,630,317,947,7,4,201901
9,7,37,7,83,217,1,239,4,588,480,1068,9,4,201901
9,8,62,10,164,221,17,395,3,872,494,1366,5,4,201901
9,9,64,5,118,219,36,375,5,822,301,1123,5,4,201901
9,10,74,66,253,628,42,26,19,1108,449,1557,6,4,201901
9,11,67,6,145,190,14,521,2,945,740,1685,7,4,201901
9,12,77,8,324,464,17,700,18,1608,1001,2609,11,4,201901
9,13,53,6,120,201,29,515,19,943,682,1625,4,4,201901
9,14,50,2,74,142,19,386,5,678,410,1088,5,4,201901
9,15,121,15,449,593,18,1253,51,2500,1672,4172,8,4,201901
9,16,103,25,199,469,51,754,2,1603,1182,2785,15,4,201901
9,17,53,4,89,268,10,307,1,732,564,1296,6,4,201901
9,18,105,16,150,294,27,724,4,1320,1078,2398,12,4,201901
9,19,101,16,155,216,79,518,8,1093,432,1525,5,4,201901
9,20,45,1,56,109,11,170,4,396,93,489,5,4,201901
9,21,52,11,80,242,24,348,9,766,368,1134,3,4,201901
9,22,108,11,115,217,43,422,15,931,504,1435,5,4,201901
9,23,51,5,110,217,23,499,1,906,849,1755,6,4,201901
9,24,142,24,266,503,24,1075,5,2039,948,2987,12,4,201901
10,1,107,39,182,168,15,18,234,763,639,1402,12,2.833333333,201901
10,2,139,41,326,337,58,33,191,1125,560,1685,9,3.25,201901
10,3,123,40,197,410,44,39,69,922,638,1560,11,3.4,201901
10,4,165,39,462,640,17,31,16,1370,710,2080,11,4,201901
11,1,109,41,178,295,48,161,34,866,369,1235,6,3.666666667,201901
11,2,132,7,148,202,29,348,3,869,410,1279,7,4,201901
11,3,75,9,92,143,7,419,12,757,430,1187,3,4,201901
11,4,69,16,91,148,8,230,0,562,382,944,7,3.666666667,201901
11,5,105,24,167,241,7,517,1,1062,557,1619,7,4,201901
11,6,106,20,168,213,23,505,5,1040,362,1402,8,4,201901
11,7,173,32,297,433,33,288,0,1256,548,1804,9,3.5,201901
11,8,109,19,145,296,15,409,17,1010,388,1398,7,2.75,201901
11,9,142,64,208,397,17,478,27,1333,753,2086,10,3.666666667,201901
11,10,134,21,175,210,22,604,4,1170,837,2007,10,3.6,201901
11,11,137,84,285,507,29,80,2,1124,561,1685,5,4,201901
11,12,168,17,293,410,4,696,4,1592,537,2129,7,4,201901
11,13,107,47,189,270,41,74,177,905,235,1140,8,3.5,201901
11,14,123,22,183,237,32,361,1,959,479,1438,8,3.5,201901
11,15,84,23,111,171,8,214,11,622,259,881,9,4,201901
12,1,118,18,173,49,138,108,11,615,379,994,10,3.2,201901
12,2,124,17,155,214,42,365,52,969,507,1476,10,3.5,201901
12,3,99,15,116,305,13,73,0,621,359,980,11,3.2,201901
12,4,95,12,208,345,19,270,0,949,361,1310,9,3.666666667,201901
12,5,121,19,87,175,0,130,21,553,315,868,10,3.25,201901
12,6,104,14,90,215,19,72,16,530,99,629,10,3.25,201901
12,7,158,14,162,232,17,311,38,932,546,1478,6,3.5,201901
12,8,162,17,157,240,8,20,0,604,279,883,9,3.25,201901
12,9,111,12,142,284,13,145,5,712,231,943,9,3.666666667,201901
13,1,99,9,90,171,21,187,10,587,345,932,9,3.333333333,201901
13,2,100,14,76,192,23,265,16,686,228,914,6,3.333333333,201901
13,3,89,6,105,126,70,192,4,592,188,780,12,3.25,201901
13,4,137,15,168,188,48,232,15,803,317,1120,9,3.666666667,201901
13,5,157,14,188,183,51,573,10,1176,721,1897,9,3.75,201901
13,6,192,112,410,525,52,387,61,1739,1162,2901,11,3.666666667,201901
13,7,114,8,301,294,19,287,0,1023,477,1500,8,3.5,201901
14,1,80,23,106,86,19,218,127,659,191,850,6,3.5,201901
14,2,96,13,121,50,12,359,6,657,314,971,5,3.666666667,201901
14,3,128,26,171,144,33,504,30,1036,543,1579,8,3.4,201901
14,4,129,10,250,336,17,850,3,1595,661,2256,10,4,201901
14,5,91,8,241,225,39,305,1,910,517,1427,9,3.5,201901
14,6,130,3,280,197,20,670,3,1303,414,1717,10,4,201901
14,7,28,4,39,26,0,133,0,230,224,454,6,4,201901
14,8,164,17,300,487,4,1391,34,2397,1069,3466,10,4,201901
14,9,63,12,114,201,15,591,4,1000,416,1416,8,4,201901
14,10,81,5,153,137,1,506,0,883,589,1472,5,4,201901
14,11,36,5,41,51,7,300,2,442,629,1071,4,4,201901
14,12,113,11,257,137,10,246,0,774,437,1211,9,3.5,201901
14,13,87,6,143,128,13,511,5,893,256,1149,6,4,201901
14,14,72,5,147,152,9,671,8,1064,638,1702,7,4,201901
14,15,125,32,175,143,35,518,28,1056,561,1617,10,3.6,201901
14,16,83,2,118,104,14,541,4,866,328,1194,5,4,201901
14,17,93,15,132,125,31,104,34,534,481,1015,7,3.25,201901
14,18,116,27,142,292,20,413,1,1011,762,1773,9,3,201901
14,19,131,25,212,289,45,366,13,1081,476,1557,8,3.25,201901
14,20,103,10,192,141,15,487,3,951,455,1406,10,3.666666667,201901
15,1,96,9,155,68,174,201,27,730,525,1255,7,3.333333333,201901
15,2,133,6,160,206,19,378,24,926,504,1430,6,4,201901
15,3,127,16,133,270,95,479,13,1133,654,1787,10,3.666666667,201901
15,4,64,5,101,162,12,418,3,765,595,1360,4,4,201901
15,5,114,19,146,205,22,446,62,1014,641,1655,8,3.666666667,201901
15,6,115,9,188,282,19,505,11,1129,821,1950,7,4,201901
15,7,100,8,132,210,30,529,1,1010,439,1449,10,4,201901
15,8,66,5,105,213,7,292,8,696,296,992,4,4,201901
15,9,147,7,78,133,111,368,16,860,347,1207,9,3.75,201901
15,10,114,1,131,186,28,478,12,950,623,1573,6,4,201901
15,11,115,8,121,203,23,463,1,934,604,1538,8,4,201901
15,12,151,5,268,344,22,439,1,1230,668,1898,8,4,201901
15,13,43,8,45,91,34,286,0,507,193,700,8,4,201901
15,14,56,5,86,194,2,235,0,578,224,802,4,4,201901
15,15,70,29,124,346,18,310,45,942,818,1760,6,4,201901
15,16,219,15,208,514,15,619,5,1595,936,2531,8,4,201901
15,17,80,9,106,168,6,465,33,867,664,1531,8,4,201901
15,18,141,13,153,239,18,519,9,1092,426,1518,7,3.666666667,201901
15,19,110,51,249,658,2,478,1,1549,700,2249,10,4,201901
15,20,48,8,96,264,18,198,36,668,281,949,6,4,201901
15,21,89,6,60,160,14,193,33,555,354,909,6,3.5,201901
15,22,125,17,238,489,13,719,14,1615,1423,3038,14,4,201901
15,23,113,11,158,308,21,307,0,918,494,1412,6,3.333333333,201901
15,24,76,14,132,244,22,329,12,829,483,1312,4,4,201901
15,25,133,16,142,204,33,240,7,775,597,1372,6,4,201901
15,26,85,4,99,147,34,355,1,725,310,1035,8,4,201901
15,27,151,8,195,310,13,523,12,1212,605,1817,9,3.666666667,201901
15,28,163,11,219,271,27,435,4,1130,733,1863,9,3.666666667,201901
15,29,151,14,225,393,12,639,0,1434,760,2194,8,4,201901
15,30,221,30,315,473,69,179,76,1363,373,1736,16,4,201901
15,31,74,16,120,208,7,376,0,801,628,1429,6,4,201901
15,32,150,4,209,392,26,453,1,1235,615,1850,9,4,201901
15,33,190,4,177,301,10,333,0,1015,549,1564,7,4,201901
15,34,84,6,107,258,11,283,56,805,410,1215,8,4,201901
15,35,176,23,186,395,8,324,0,1112,373,1485,9,3.666666667,201901
15,36,146,23,252,301,60,138,10,930,371,1301,9,3.5,201901
15,37,124,6,133,222,28,456,14,983,491,1474,7,4,201901
15,38,140,14,145,370,10,397,0,1076,763,1839,6,3.5,201901
15,39,120,11,195,288,16,304,0,934,489,1423,4,4,201901
15,40,197,8,174,384,39,581,0,1383,633,2016,9,4,201901
15,41,202,13,338,506,22,544,12,1637,779,2416,11,4,201901
16,1,75,15,116,171,12,137,10,536,517,1053,7,3.333333333,201901
16,2,103,24,86,147,20,168,18,566,433,999,9,3.25,201901
16,3,103,9,115,177,13,229,9,655,324,979,10,3.25,201901
16,4,148,19,114,133,34,407,4,859,425,1284,8,3.5,201901
16,5,146,11,88,123,13,348,4,733,262,995,10,3.666666667,201901
16,6,124,18,106,150,16,271,0,685,341,1026,12,3.5,201901
16,7,153,27,197,239,28,205,0,849,481,1330,9,3.5,201901
16,8,113,38,243,471,13,462,27,1367,467,1834,12,4,201901
16,9,114,14,111,185,6,448,7,885,225,1110,9,4,201901
16,10,98,7,206,271,6,542,0,1130,409,1539,6,4,201901
16,11,109,31,160,132,135,318,23,908,384,1292,10,3.4,201901
16,12,152,22,207,134,34,171,10,730,414,1144,10,3.25,201901
17,1,98,5,213,240,15,613,2,1186,331,1517,8,4,201901
17,2,90,5,163,267,16,296,3,840,370,1210,8,3.666666667,201901
17,3,118,16,242,332,10,471,0,1189,419,1608,8,3.5,201901
17,4,117,12,193,286,30,456,5,1099,560,1659,10,3.666666667,201901
17,5,76,10,87,158,11,141,15,498,170,668,5,3.5,201901
18,1,98,22,118,100,16,172,71,597,229,826,7,3.25,201901
18,2,176,16,295,329,50,697,2,1565,766,2331,8,4,201901
18,3,89,17,207,186,20,202,0,721,330,1051,8,3.5,201901
19,1,78,14,221,437,22,308,60,1140,423,1563,9,4,201901
19,2,109,20,379,472,20,254,0,1254,604,1858,9,4,201901
19,3,127,5,216,220,10,552,4,1134,573,1707,7,4,201901
19,4,39,3,63,55,13,410,23,606,310,916,5,4,201901
19,5,127,10,250,365,9,832,9,1602,580,2182,8,4,201901
19,6,48,6,93,130,5,500,0,782,326,1108,5,4,201901
19,7,66,7,221,123,13,113,9,552,288,840,10,3.25,201901
19,8,42,5,94,127,0,194,4,466,151,617,7,4,201901
19,9,108,7,151,294,28,219,1,808,887,1695,9,3.25,201901
19,10,60,8,91,174,7,418,81,839,611,1450,5,4,201901
19,11,158,44,284,539,12,1022,166,2225,746,2971,13,4,201901
19,12,102,9,351,283,13,233,1,992,394,1386,8,3.666666667,201901
20,1,96,3,125,145,35,167,44,615,269,884,7,3.5,201901
20,2,148,12,141,219,5,69,0,594,282,876,6,3.333333333,201901
20,3,123,6,148,113,63,234,40,727,148,875,6,3.333333333,201901
20,4,83,8,80,185,28,177,6,567,190,757,6,3.333333333,201901
20,5,115,23,228,295,35,186,0,882,238,1120,11,3.25,201901
20,6,109,8,126,211,104,106,0,664,169,833,8,3.25,201901
20,7,102,6,166,256,40,201,1,772,258,1030,7,3.75,201901
20,8,275,26,319,583,38,992,73,2306,1119,3425,13,4,201901
20,9,172,15,160,171,87,175,214,994,242,1236,8,3.666666667,201901
20,10,109,8,94,267,5,101,1,585,123,708,9,3.25,201901
21,1,144,6,162,324,24,174,4,838,397,1235,9,3.4,201901
21,2,109,7,175,244,81,165,0,781,507,1288,9,3.2,201901
21,3,184,13,287,220,122,369,55,1250,378,1628,8,3.5,201901
21,4,142,9,187,100,99,182,10,729,280,1009,6,3.25,201901
21,5,171,8,270,286,12,417,35,1199,409,1608,8,3.666666667,201901
21,6,110,12,177,229,30,547,36,1141,655,1796,6,4,201901
21,7,211,19,286,354,57,246,1,1174,353,1527,9,3.666666667,201901
21,8,125,7,225,199,53,199,14,822,196,1018,9,3.2,201901
21,9,205,12,341,504,78,645,27,1812,661,2473,9,4,201901
21,10,146,7,212,211,35,408,34,1053,490,1543,7,3.5,201901
21,11,75,1,107,147,9,210,4,553,159,712,4,4,201901
21,12,218,6,438,543,36,980,26,2247,1427,3674,15,4,201901
21,13,147,10,240,296,57,299,31,1080,386,1466,8,3.666666667,201901
21,14,134,9,152,138,67,189,48,737,379,1116,12,3.333333333,201901
21,15,154,10,293,201,30,433,9,1130,640,1770,7,3.5,201901
22,1,144,32,152,328,37,127,37,857,291,1148,11,3.2,201901
22,2,87,21,178,177,14,293,19,789,257,1046,7,3.5,201901
22,3,259,93,666,646,24,761,19,2468,1165,3633,9,3.666666667,201901
22,4,160,30,385,401,23,915,8,1922,803,2725,8,4,201901
22,5,128,18,426,222,54,290,11,1149,380,1529,10,3.5,201901
23,1,138,4,660,273,15,52,26,1168,770,1938,14,3.6,201901
23,2,95,21,267,475,20,25,1,904,575,1479,10,3.25,201901
23,3,92,7,550,302,17,13,0,981,462,1443,15,5,201901
23,4,118,10,399,267,63,19,23,899,565,1464,8,3.666666667,201901
24,1,105,25,106,204,12,144,10,606,388,994,10,3.2,201901
24,2,137,42,158,274,41,314,5,971,367,1338,6,3.5,201901
24,3,156,22,171,193,62,226,8,838,365,1203,9,3.25,201901
24,4,86,16,121,104,20,345,30,722,326,1048,5,3.5,201901
24,5,161,36,311,484,13,787,87,1879,615,2494,9,4,201901
24,6,126,44,198,407,21,517,19,1332,764,2096,7,5,201901
24,7,128,14,125,224,38,145,0,674,500,1174,9,3.25,201901
25,1,94,9,134,181,22,408,7,855,343,1198,13,3.75,201901
25,2,106,22,255,302,15,508,1,1209,791,2000,7,3.5,201901
25,3,137,7,155,246,15,337,7,904,459,1363,8,3.6,201901
25,4,107,22,114,289,17,256,45,850,360,1210,8,3.333333333,201901
25,5,119,8,334,471,38,464,2,1436,714,2150,8,3.666666667,201901
25,6,125,15,217,235,35,509,33,1169,613,1782,8,3.75,201901
25,7,163,8,329,318,8,590,0,1416,609,2025,6,4,201901
26,1,91,13,214,304,10,154,0,786,348,1134,9,3.5,201901
26,2,109,5,189,288,8,169,0,768,325,1093,12,3.2,201901
26,3,99,8,150,267,9,629,22,1184,525,1709,14,4.5,201901
26,4,82,29,99,245,14,168,1,638,277,915,9,3.2,201901
26,5,72,8,116,110,16,268,0,590,294,884,14,3.5,201901
26,6,58,8,158,197,15,298,0,734,508,1242,10,3.333333333,201901
26,7,62,5,112,171,22,175,0,547,225,772,10,3.5,201901
27,1,123,4,250,255,35,239,29,935,417,1352,8,3.5,201901
27,2,115,23,208,333,39,204,3,925,329,1254,8,3.666666667,201901
27,3,158,11,154,427,7,283,6,1046,516,1562,7,3.666666667,201901
27,4,111,13,164,557,13,400,14,1272,742,2014,7,3.5,201901
27,5,93,5,95,262,11,94,7,567,196,763,6,3.333333333,201901
27,6,90,14,149,382,5,228,0,868,326,1194,8,3.5,201901
28,1,126,16,324,510,8,21,0,1005,726,1731,13,4,201901
28,2,149,32,350,287,55,25,309,1207,724,1931,11,4,201901
28,3,75,17,138,290,3,10,23,556,214,770,7,3.333333333,201901
28,4,193,50,315,383,73,62,459,1535,1087,2622,15,4,201901
28,5,92,51,228,393,37,23,218,1042,630,1672,9,3.25,201901
28,6,59,21,164,335,62,31,51,723,374,1097,14,3.166666667,201901
28,7,118,33,339,586,64,58,1,1199,838,2037,8,4,201901
28,8,103,36,207,457,99,47,33,982,657,1639,9,4,201901
28,9,124,11,245,156,43,28,197,804,599,1403,11,3.75,201901
29,1,121,35,277,292,63,250,10,1048,389,1437,7,3.5,201901
29,2,161,22,390,283,66,161,140,1223,555,1778,10,3.666666667,201901
29,3,108,27,118,376,30,208,0,867,319,1186,5,3.666666667,201901
30,1,68,18,145,200,32,99,55,617,318,935,7,3.333333333,201901
30,2,90,14,158,73,108,147,140,730,521,1251,8,3.25,201901
30,3,100,8,244,120,109,283,178,1042,367,1409,6,3.666666667,201901
30,4,59,3,148,117,14,397,0,738,502,1240,8,4,201901
30,5,71,11,138,355,24,255,0,854,363,1217,7,3.5,201901
30,6,97,9,139,138,25,229,4,641,322,963,9,3.333333333,201901
30,7,111,6,243,166,18,284,26,854,330,1184,11,3.25,201901
30,8,135,12,244,260,41,567,51,1310,489,1799,11,3.4,201901
30,9,140,14,138,157,42,462,41,994,458,1452,8,3.5,201901
30,10,115,9,207,238,21,882,37,1509,748,2257,6,4,201901
30,11,93,8,197,321,16,358,0,993,506,1499,5,3.5,201901
30,12,155,11,343,457,11,744,9,1730,838,2568,10,4,201901
30,13,148,26,171,240,112,338,60,1095,560,1655,10,3.4,201901
30,14,100,22,268,146,82,281,68,967,482,1449,8,3.5,201901
30,15,150,12,106,177,54,540,67,1106,690,1796,11,3.666666667,201901
30,16,166,8,235,237,99,604,91,1440,1079,2519,10,3.333333333,201901
30,17,117,22,179,356,29,163,34,900,484,1384,8,3.5,201901
30,18,186,12,129,261,25,105,52,770,257,1027,8,3.25,201901
30,19,112,10,243,232,39,284,1,921,374,1295,13,3.6,201901
30,20,145,12,197,311,132,204,12,1013,484,1497,10,3.4,201901
31,1,93,22,116,6,286,242,1,766,349,1115,8,3.5,201901
31,2,63,5,116,0,205,284,0,673,290,963,6,3.333333333,201901
31,3,292,17,576,404,119,1655,1,3064,1222,4286,20,4,201901
31,4,56,6,97,82,50,521,29,841,404,1245,4,4,201901
31,5,90,19,112,341,19,212,0,793,432,1225,6,3.333333333,201901
32,1,103,24,113,131,32,218,40,661,590,1251,12,3.2,201901
32,2,139,46,217,75,181,160,72,890,546,1436,13,3.142857143,201901
32,3,154,58,295,537,16,174,21,1255,402,1657,13,3.4,201901
32,4,113,49,153,221,22,196,79,833,339,1172,12,3.2,201901
1,1,363,125,602,727,141,90,40,2088,887,2975,13,6.5,201902
1,2,417,133,1025,874,241,198,192,3080,1753,4833,10,7.333333333,201902
1,3,310,162,1016,1073,144,176,164,3045,1797,4842,10,7.333333333,201902
2,1,308,40,874,1239,83,116,23,2683,1492,4175,11,6,201902
2,2,225,55,600,1415,31,96,0,2422,1281,3703,8,6.5,201902
2,3,456,65,889,751,109,123,445,2838,1496,4334,12,6,201902
2,4,256,17,882,402,123,68,30,1778,1112,2890,9,6,201902
2,5,483,67,1284,1029,416,230,78,3587,2314,5901,13,6,201902
2,6,286,36,730,826,51,101,16,2046,1207,3253,7,6,201902
2,7,330,40,726,561,74,82,322,2135,1221,3356,12,5.75,201902
2,8,247,27,743,674,35,97,108,1931,1380,3311,8,6,201902
3,1,180,11,295,312,11,662,4,1475,1070,2545,13,5.833333333,201902
3,2,162,8,457,220,34,317,0,1198,724,1922,9,5.666666667,201902
4,1,289,37,417,628,69,706,94,2240,1107,3347,11,5.25,201902
4,2,282,42,635,681,133,38,108,1919,1065,2984,14,5.2,201902
5,1,230,15,396,268,53,628,7,1597,1121,2718,9,5.666666667,201902
5,2,253,37,444,597,62,229,104,1726,544,2270,10,5.2,201902
5,3,246,22,277,356,68,568,8,1545,927,2472,9,5.5,201902
5,4,313,23,501,499,31,970,22,2359,1422,3781,9,5.666666667,201902
5,5,271,25,406,541,25,705,35,2008,1597,3605,8,6,201902
5,6,212,28,328,444,14,418,34,1478,792,2270,11,5.5,201902
5,7,250,14,302,326,9,568,16,1485,661,2146,10,5.5,201902
6,1,247,23,434,340,17,1439,15,2515,1387,3902,12,6,201902
6,2,150,18,311,182,48,733,4,1446,1144,2590,9,5.666666667,201902
7,1,317,6,264,432,10,93,40,1162,882,2044,9,5.25,201902
7,2,348,10,169,361,99,67,0,1054,808,1862,9,5.25,201902
7,3,318,13,303,381,150,193,1,1359,689,2048,7,5.333333333,201902
7,4,266,16,331,434,25,148,161,1381,648,2029,11,5.4,201902
7,5,383,15,183,547,18,351,3,1500,865,2365,11,5.666666667,201902
7,6,298,24,359,621,31,649,33,2015,1559,3574,9,5.666666667,201902
7,7,283,33,352,524,36,214,83,1525,1097,2622,8,5.5,201902
7,8,225,6,185,470,18,369,1,1274,1247,2521,12,5.25,201902
7,9,190,27,289,450,22,537,26,1541,1119,2660,10,6,201902
7,10,212,10,231,567,17,183,1,1221,878,2099,9,5.5,201902
7,11,187,3,85,209,17,92,11,604,330,934,6,5.333333333,201902
7,12,307,24,419,814,14,393,0,1971,1308,3279,9,5.5,201902
7,13,115,17,134,571,0,18,0,855,283,1138,9,5.25,201902
8,1,220,9,403,251,28,432,8,1351,799,2150,4,6,201902
8,2,386,31,737,635,46,877,30,2742,1759,4501,16,5.5,201902
8,3,168,34,330,244,69,138,201,1184,1114,2298,4,5,201902
8,4,216,35,528,290,67,899,48,2083,1188,3271,11,6,201902
8,5,298,64,561,753,50,345,28,2099,1266,3365,10,5.25,201902
8,6,268,42,459,624,43,1155,68,2659,1429,4088,7,6.5,201902
8,7,210,43,236,424,10,494,0,1417,1005,2422,7,5.25,201902
8,8,218,30,362,697,18,765,0,2090,1837,3927,11,7,201902
8,9,213,59,202,342,42,541,8,1407,991,2398,10,5.2,201902
9,1,65,2,88,81,36,351,0,623,704,1327,5,6,201902
9,2,339,49,653,1151,69,1578,27,3866,2325,6191,12,6,201902
9,3,129,35,344,425,80,831,61,1905,1736,3641,7,6,201902
9,4,253,10,418,702,79,898,7,2367,1310,3677,11,6,201902
9,5,103,12,227,300,38,580,12,1272,1360,2632,7,6,201902
9,6,90,13,153,137,45,392,6,836,787,1623,7,6,201902
9,7,69,14,231,506,6,373,11,1210,1057,2267,9,6,201902
9,8,74,10,274,308,25,559,6,1256,833,2089,5,6,201902
9,9,142,10,233,342,47,576,7,1357,848,2205,5,6,201902
9,10,108,33,349,524,21,500,10,1545,1127,2672,6,6,201902
9,11,131,14,256,378,42,651,6,1478,1426,2904,7,5,201902
9,12,133,25,549,719,47,1148,17,2638,2023,4661,11,6,201902
9,13,125,11,231,333,60,644,18,1422,1239,2661,4,6,201902
9,14,73,5,144,197,37,502,12,970,987,1957,5,6,201902
9,15,191,30,729,875,37,1625,46,3533,3200,6733,9,6.5,201902
9,16,221,27,412,734,103,878,0,2375,2029,4404,15,6,201902
9,17,118,11,242,383,28,387,0,1169,976,2145,6,6,201902
9,18,177,17,272,512,36,995,7,2016,1738,3754,12,6,201902
9,19,187,27,235,325,70,681,2,1527,1413,2940,5,6,201902
9,20,59,5,111,164,16,217,6,578,253,831,5,6,201902
9,21,148,14,174,462,43,318,144,1303,934,2237,3,6,201902
9,22,159,9,185,258,53,551,22,1237,964,2201,5,6,201902
9,23,144,12,239,401,87,837,5,1725,1369,3094,6,6,201902
9,24,249,33,435,711,92,1465,3,2988,2402,5390,12,6,201902
10,1,341,85,438,399,55,70,553,1941,1006,2947,12,4.666666667,201902
10,2,324,88,660,799,81,93,339,2384,759,3143,9,5.25,201902
10,3,309,99,417,814,96,56,227,2018,927,2945,11,5.4,201902
10,4,375,87,940,1349,59,87,119,3016,1543,4559,14,7.5,201902
11,1,240,126,330,472,71,288,178,1705,970,2675,6,5.666666667,201902
11,2,256,25,286,298,53,680,9,1607,958,2565,7,6,201902
11,3,120,35,155,232,6,567,26,1141,1013,2154,3,6,201902
11,4,203,35,212,306,21,540,0,1317,778,2095,8,6.333333333,201902
11,5,278,86,370,587,25,818,5,2169,1564,3733,7,6,201902
11,6,171,38,228,254,29,712,5,1437,1036,2473,8,6,201902
11,7,289,52,470,633,30,396,0,1870,845,2715,9,5.5,201902
11,8,289,47,390,589,62,806,10,2193,1046,3239,9,5,201902
11,9,288,110,296,485,20,609,70,1878,1294,3172,10,5.666666667,201902
11,10,281,55,252,366,25,1070,6,2055,1188,3243,10,5.6,201902
11,11,237,81,389,586,29,431,6,1759,1047,2806,5,6,201902
11,12,305,61,475,583,15,1073,0,2512,1476,3988,7,6,201902
11,13,224,101,363,398,56,143,245,1530,1099,2629,8,5.5,201902
11,14,223,69,360,463,51,713,1,1880,1484,3364,8,5.5,201902
11,15,187,73,209,314,10,454,10,1257,577,1834,9,6,201902
12,1,170,48,337,128,100,296,24,1103,824,1927,10,5.2,201902
12,2,252,48,311,399,40,747,34,1831,1290,3121,10,5.5,201902
12,3,247,53,422,673,33,193,1,1622,876,2498,11,5.2,201902
12,4,253,34,458,639,53,609,4,2050,1684,3734,9,5.666666667,201902
12,5,227,31,251,326,3,225,46,1109,709,1818,10,5.25,201902
12,6,223,32,236,431,30,100,51,1103,529,1632,10,5,201902
12,7,300,11,281,347,27,687,78,1731,1251,2982,6,5.5,201902
12,8,254,29,307,515,9,20,0,1134,692,1826,9,5.25,201902
12,9,260,35,410,709,27,423,12,1876,871,2747,9,5.666666667,201902
13,1,229,36,225,427,76,370,56,1419,1061,2480,9,5.333333333,201902
13,2,228,21,169,479,70,577,33,1577,627,2204,6,5.333333333,201902
13,3,281,31,356,519,122,350,17,1676,1296,2972,12,5.25,201902
13,4,227,25,350,369,70,502,20,1563,965,2528,9,5.666666667,201902
13,5,244,22,407,259,97,1256,4,2289,1677,3966,9,5.75,201902
13,6,391,218,807,790,94,591,79,2970,1661,4631,12,6,201902
13,7,262,36,504,612,53,485,0,1952,1088,3040,8,5.5,201902
14,1,128,46,160,73,62,368,204,1041,796,1837,6,5.5,201902
14,2,118,18,190,128,16,595,19,1084,924,2008,5,5.666666667,201902
14,3,201,40,331,157,52,782,55,1618,1603,3221,8,5.4,201902
14,4,274,28,403,494,23,1281,4,2507,1339,3846,10,6,201902
14,5,225,36,626,416,81,565,15,1964,1079,3043,9,5.5,201902
14,6,247,8,495,293,23,976,1,2043,1499,3542,10,6,201902
14,7,99,3,115,100,0,436,0,753,467,1220,6,6,201902
14,8,294,32,527,695,17,2168,6,3739,2585,6324,11,6.25,201902
14,9,149,22,243,359,20,1036,2,1831,1107,2938,8,6,201902
14,10,166,12,245,205,7,809,2,1446,1073,2519,5,6,201902
14,11,69,8,70,110,22,526,2,807,792,1599,4,6,201902
14,12,209,46,512,325,34,370,1,1497,1117,2614,9,5.5,201902
14,13,156,10,278,230,18,856,12,1560,459,2019,6,6,201902
14,14,156,11,183,170,13,966,6,1505,1475,2980,7,6,201902
14,15,237,61,338,252,62,929,51,1930,1148,3078,10,5.6,201902
14,16,137,15,214,147,21,730,3,1267,849,2116,5,6,201902
14,17,156,87,326,298,63,165,41,1136,986,2122,7,5.25,201902
14,18,241,44,443,697,28,598,13,2064,1143,3207,9,5.4,201902
14,19,267,90,509,623,109,626,88,2312,1182,3494,8,5.25,201902
14,20,230,31,370,279,37,889,22,1858,1062,2920,10,5.666666667,201902
15,1,164,36,330,108,451,428,29,1546,1522,3068,7,5.333333333,201902
15,2,205,14,266,391,44,636,23,1579,1086,2665,6,6,201902
15,3,249,36,228,525,135,816,13,2002,1794,3796,10,5.666666667,201902
15,4,123,18,183,195,26,585,34,1164,1279,2443,4,6,201902
15,5,192,53,282,372,25,787,89,1800,1332,3132,8,5.666666667,201902
15,6,185,9,290,448,36,845,9,1822,1246,3068,7,6,201902
15,7,112,17,221,257,36,740,2,1385,1034,2419,10,6,201902
15,8,128,20,186,295,20,389,7,1045,680,1725,4,6,201902
15,9,271,16,144,176,161,554,44,1366,1036,2402,9,5.75,201902
15,10,162,10,251,318,58,721,19,1539,1034,2573,6,6,201902
15,11,213,19,311,379,53,802,3,1780,1416,3196,8,6,201902
15,12,278,17,540,500,38,765,4,2142,1596,3738,8,6,201902
15,13,94,11,122,107,56,458,0,848,677,1525,8,6,201902
15,14,96,19,166,302,14,398,1,996,577,1573,4,6,201902
15,15,128,37,228,499,25,435,53,1405,1027,2432,6,6,201902
15,16,363,49,484,797,21,1027,4,2745,1292,4037,8,6,201902
15,17,140,9,210,252,13,721,26,1371,1136,2507,8,6,201902
15,18,243,45,358,529,49,746,2,1972,1557,3529,7,5.666666667,201902
15,19,208,89,464,950,9,736,24,2480,1418,3898,10,6,201902
15,20,93,17,232,386,11,346,5,1090,353,1443,6,6,201902
15,21,167,16,135,308,55,323,28,1032,650,1682,6,5.5,201902
15,22,245,21,433,782,40,1230,19,2770,1991,4761,14,6,201902
15,23,253,38,289,627,44,536,0,1787,1207,2994,6,5.333333333,201902
15,24,131,24,252,381,26,450,3,1267,836,2103,4,6,201902
15,25,225,26,244,303,46,384,18,1246,920,2166,6,6,201902
15,26,138,7,177,219,24,517,5,1087,643,1730,9,7,201902
15,27,236,27,350,388,25,836,27,1889,1366,3255,9,5.666666667,201902
15,28,251,25,361,339,97,628,5,1706,1230,2936,9,5.666666667,201902
15,29,214,25,332,505,10,886,0,1972,1973,3945,8,6,201902
15,30,340,40,516,686,115,318,60,2075,1413,3488,16,6,201902
15,31,154,19,193,270,11,498,0,1145,1109,2254,6,6,201902
15,32,248,7,351,542,51,626,5,1830,1286,3116,9,6,201902
15,33,264,7,288,459,16,591,1,1626,525,2151,7,6,201902
15,34,155,16,176,539,14,428,57,1385,958,2343,8,6,201902
15,35,313,32,338,543,16,566,0,1808,1497,3305,9,5.666666667,201902
15,36,264,28,502,467,125,351,24,1761,1128,2889,9,5.5,201902
15,37,247,28,302,430,57,823,30,1917,1593,3510,7,6,201902
15,38,235,25,226,426,21,618,3,1554,1083,2637,6,5.5,201902
15,39,206,41,272,444,27,443,0,1433,1003,2436,4,6,201902
15,40,285,23,255,473,47,978,1,2062,1466,3528,9,6,201902
15,41,360,28,586,805,41,725,12,2557,1350,3907,11,6,201902
16,1,145,32,243,212,56,264,54,1006,739,1745,7,5.333333333,201902
16,2,139,38,188,264,53,299,29,1010,953,1963,9,5,201902
16,3,211,44,361,341,28,370,21,1376,996,2372,10,5.25,201902
16,4,172,31,203,218,83,681,0,1388,1229,2617,8,5.5,201902
16,5,194,48,218,259,35,602,5,1361,1195,2556,10,5.666666667,201902
16,6,222,49,258,330,76,466,1,1402,1075,2477,12,5.5,201902
16,7,257,65,387,391,49,393,2,1544,1239,2783,9,5.5,201902
16,8,216,41,424,633,15,840,2,2171,1641,3812,12,6,201902
16,9,205,19,217,235,11,877,9,1573,996,2569,9,6,201902
16,10,189,21,348,410,9,870,0,1847,1138,2985,6,6,201902
16,11,182,63,375,248,245,545,6,1664,981,2645,10,5.4,201902
16,12,235,39,346,197,44,434,18,1313,995,2308,10,5.25,201902
17,1,224,9,341,402,17,1020,2,2015,1009,3024,8,6,201902
17,2,184,15,315,397,23,530,2,1466,1023,2489,8,5.666666667,201902
17,3,283,24,505,508,16,776,4,2116,1476,3592,8,5.5,201902
17,4,246,19,323,412,34,807,13,1854,1674,3528,10,5.666666667,201902
17,5,146,27,175,233,37,212,51,881,557,1438,5,5.5,201902
18,1,249,46,313,236,78,325,132,1379,1051,2430,7,5.25,201902
18,2,355,30,518,489,91,1265,1,2749,1835,4584,9,6.333333333,201902
18,3,218,42,500,442,44,605,2,1853,862,2715,8,5.5,201902
19,1,215,26,302,335,40,886,15,1819,1479,3298,9,6,201902
19,2,252,22,619,590,29,366,0,1878,1651,3529,9,6,201902
19,3,243,16,432,393,16,850,0,1950,1824,3774,7,6,201902
19,4,93,5,144,97,21,799,17,1176,799,1975,5,6,201902
19,5,279,17,411,491,20,1432,15,2665,2129,4794,8,6,201902
19,6,97,16,183,198,7,718,47,1266,973,2239,5,6,201902
19,7,188,28,639,419,27,241,10,1552,957,2509,10,5.25,201902
19,8,89,5,201,225,9,439,0,968,446,1414,7,6,201902
19,9,248,36,373,565,64,538,8,1832,1411,3243,9,5.25,201902
19,10,123,21,178,168,10,309,514,1323,1213,2536,7,8,201902
19,11,285,67,413,692,21,1593,116,3187,3162,6349,13,6,201902
19,12,247,29,798,471,17,393,2,1957,746,2703,8,5.666666667,201902
20,1,251,35,293,258,68,361,96,1362,1162,2524,7,5.5,201902
20,2,157,19,192,306,16,83,28,801,443,1244,6,5.333333333,201902
20,3,164,12,212,150,99,289,76,1002,688,1690,6,5.333333333,201902
20,4,159,12,164,288,46,356,29,1054,544,1598,6,5.333333333,201902
20,5,250,25,422,569,59,344,0,1669,1054,2723,11,5.25,201902
20,6,173,8,185,365,217,122,4,1074,582,1656,8,5.25,201902
20,7,220,25,301,492,68,315,0,1421,830,2251,7,5.75,201902
20,8,482,39,571,833,36,1450,274,3685,3214,6899,13,6,201902
20,9,337,45,298,342,107,409,402,1940,962,2902,8,5.666666667,201902
20,10,256,24,237,629,28,164,42,1380,1044,2424,9,5.25,201902
21,1,258,17,292,459,30,338,8,1402,901,2303,9,5.4,201902
21,2,245,25,408,385,149,296,3,1511,943,2454,9,5.2,201902
21,3,309,33,465,294,183,594,97,1975,1461,3436,8,5.5,201902
21,4,265,8,337,157,152,344,50,1313,496,1809,6,5.25,201902
21,5,348,22,476,444,22,728,36,2076,1177,3253,8,5.666666667,201902
21,6,196,18,275,340,39,787,43,1698,1580,3278,6,6,201902
21,7,329,36,405,572,120,492,29,1983,1365,3348,9,5.666666667,201902
21,8,222,19,346,190,148,390,31,1346,755,2101,9,5.2,201902
21,9,253,23,597,705,100,796,44,2518,1742,4260,9,6,201902
21,10,233,12,381,344,57,779,33,1839,957,2796,7,5.5,201902
21,11,105,3,218,173,27,309,1,836,490,1326,5,7,201902
21,12,358,24,773,864,61,1616,38,3734,3126,6860,16,6.5,201902
21,13,196,18,293,232,67,656,19,1481,1198,2679,8,5.666666667,201902
21,14,255,14,374,217,152,417,147,1576,1100,2676,12,5.333333333,201902
21,15,309,27,497,302,85,695,2,1917,1516,3433,7,5.5,201902
22,1,319,116,350,574,95,178,79,1711,787,2498,11,5.2,201902
22,2,159,41,313,367,54,398,23,1355,1087,2442,7,5.5,201902
22,3,401,105,981,734,48,1113,24,3406,2380,5786,9,5.666666667,201902
22,4,301,63,705,581,29,1231,15,2925,1989,4914,9,6.5,201902
22,5,228,36,753,394,97,486,7,2001,934,2935,10,5.5,201902
23,1,330,10,1368,518,63,109,105,2503,1588,4091,14,5.6,201902
23,2,348,61,751,922,62,38,9,2191,796,2987,9,5.5,201902
23,3,361,29,1302,731,45,28,53,2549,983,3532,15,7,201902
23,4,276,9,920,459,149,53,41,1907,885,2792,8,5.666666667,201902
24,1,203,59,219,369,48,314,30,1242,773,2015,10,5.2,201902
24,2,234,70,325,304,69,487,25,1514,1054,2568,6,5.5,201902
24,3,257,49,344,354,115,362,17,1498,744,2242,9,5.25,201902
24,4,178,20,196,141,28,609,20,1192,981,2173,5,5.5,201902
24,5,341,60,406,676,18,978,36,2515,1643,4158,10,6.333333333,201902
24,6,273,66,370,590,33,760,0,2092,1072,3164,7,7,201902
24,7,300,34,332,573,102,241,0,1582,964,2546,9,5.25,201902
25,1,200,28,275,438,81,761,13,1796,1183,2979,13,5.75,201902
25,2,279,44,447,424,140,1062,4,2400,1437,3837,7,5.5,201902
25,3,292,24,492,543,112,761,19,2243,1435,3678,8,5.6,201902
25,4,225,39,197,395,40,624,147,1667,1098,2765,8,5.333333333,201902
25,5,250,28,640,674,33,947,83,2655,1507,4162,8,5.666666667,201902
25,6,282,21,393,343,73,925,80,2117,1311,3428,8,5.75,201902
25,7,274,28,554,430,24,1033,0,2343,1364,3707,6,6,201902
26,1,245,36,462,579,21,312,0,1655,867,2522,9,5.5,201902
26,2,335,21,514,639,26,484,77,2096,1134,3230,12,5.4,201902
26,3,240,15,236,405,9,998,45,1948,1337,3285,15,7,201902
26,4,183,37,263,440,36,275,1,1235,894,2129,9,5.2,201902
26,5,151,7,174,181,7,601,0,1121,662,1783,14,5.5,201902
26,6,159,18,300,391,13,514,0,1395,1153,2548,10,5.333333333,201902
26,7,178,22,282,421,54,361,1,1319,513,1832,10,5.5,201902
27,1,236,33,469,651,71,429,79,1968,1110,3078,8,5.5,201902
27,2,305,25,399,639,18,380,1,1767,1150,2917,8,5.666666667,201902
27,3,261,16,269,514,12,484,25,1581,1204,2785,7,5.666666667,201902
27,4,259,33,397,915,26,743,20,2393,1621,4014,8,6,201902
27,5,149,8,183,404,8,161,137,1050,704,1754,6,5.333333333,201902
27,6,184,26,319,582,14,380,1,1506,630,2136,8,5.5,201902
28,1,413,83,904,1375,36,66,1,2878,1350,4228,13,6,201902
28,2,398,84,895,563,109,115,827,2991,1603,4594,14,6,201902
28,3,181,43,271,488,18,28,83,1112,785,1897,7,5.333333333,201902
28,4,562,139,1007,839,209,123,1170,4049,1481,5530,15,6,201902
28,5,236,106,434,803,87,72,402,2140,1425,3565,10,5.5,201902
28,6,257,75,419,784,125,46,148,1854,951,2805,14,5.166666667,201902
28,7,343,88,741,1255,123,123,0,2673,1627,4300,8,6,201902
28,8,258,113,415,814,159,60,46,1865,1362,3227,9,6,201902
28,9,329,68,578,279,102,71,590,2017,992,3009,11,5.75,201902
29,1,271,44,521,463,76,357,18,1750,1114,2864,7,5.5,201902
29,2,273,41,575,357,111,528,165,2050,1424,3474,11,6,201902
29,3,205,61,205,552,39,335,0,1397,801,2198,5,5.666666667,201902
30,1,171,42,356,653,43,148,245,1658,1115,2773,7,5.333333333,201902
30,2,250,40,281,154,80,258,665,1728,1282,3010,8,5.25,201902
30,3,176,28,504,172,180,493,395,1948,1573,3521,6,5.666666667,201902
30,4,153,7,299,204,40,647,0,1350,898,2248,8,6,201902
30,5,173,27,250,467,24,578,9,1528,1278,2806,7,5.5,201902
30,6,196,37,406,362,112,405,22,1540,1118,2658,9,5.333333333,201902
30,7,278,41,575,310,79,508,232,2023,1595,3618,11,5.25,201902
30,8,255,37,503,452,101,988,220,2556,986,3542,11,5.4,201902
30,9,221,16,271,199,69,650,81,1507,1068,2575,8,5.5,201902
30,10,240,16,459,426,33,1424,29,2627,1826,4453,6,6,201902
30,11,161,30,390,495,18,667,0,1761,1240,3001,5,5.5,201902
30,12,246,22,617,758,48,1389,27,3107,2639,5746,10,6,201902
30,13,279,36,427,382,160,671,358,2313,1627,3940,10,5.4,201902
30,14,227,46,603,293,169,561,169,2068,1562,3630,8,5.5,201902
30,15,258,15,229,289,60,851,137,1839,1400,3239,11,5.666666667,201902
30,16,252,25,404,407,163,1255,200,2706,1582,4288,10,5.333333333,201902
30,17,228,62,365,546,117,347,167,1832,1069,2901,8,5.5,201902
30,18,244,19,318,249,62,290,153,1335,818,2153,8,5.25,201902
30,19,242,27,449,553,36,416,24,1747,1223,2970,13,5.6,201902
30,20,253,24,404,578,202,389,24,1874,1102,2976,10,5.4,201902
31,1,160,24,227,31,347,408,0,1197,887,2084,8,5.5,201902
31,2,117,17,227,1,262,524,1,1149,737,1886,6,5.333333333,201902
31,3,409,34,928,634,146,2245,0,4396,3707,8103,20,6,201902
31,4,106,11,223,109,56,687,67,1259,1362,2621,5,7,201902
31,5,156,29,241,512,24,432,23,1417,1427,2844,6,5.333333333,201902
32,1,241,62,325,259,66,406,106,1465,981,2446,12,5.2,201902
32,2,311,96,450,147,247,541,142,1934,1516,3450,13,5.142857143,201902
32,3,207,64,229,412,9,851,2,1774,892,2666,13,5.4,201902
32,4,291,131,354,418,58,364,158,1774,1106,2880,13,5.4,201902
1,1,299,93,475,845,73,62,18,1865,1629,3494,13,5.5,201903
1,2,270,112,651,1011,121,136,102,2403,2575,4978,10,6.333333333,201903
1,3,208,100,696,1122,52,103,97,2378,2463,4841,10,6.333333333,201903
2,1,230,26,434,1533,41,64,5,2333,2120,4453,11,6,201903
2,2,176,26,322,1467,15,63,0,2069,1398,3467,8,6.5,201903
2,3,368,30,492,952,46,73,220,2181,1439,3620,12,6,201903
2,4,125,6,375,466,44,27,12,1055,1354,2409,9,6,201903
2,5,267,34,626,1139,188,118,50,2422,3202,5624,13,6,201903
2,6,178,24,421,885,25,47,9,1589,1711,3300,7,6,201903
2,7,246,34,408,512,46,49,344,1639,1924,3563,12,5.75,201903
2,8,153,14,347,899,13,52,58,1536,1760,3296,8,6,201903
3,1,186,14,332,343,10,674,0,1559,1059,2618,14,5.833333333,201903
3,2,145,7,438,214,31,368,0,1203,623,1826,9,5.666666667,201903
4,1,247,36,412,498,68,709,85,2055,1397,3452,11,5.25,201903
4,2,266,41,525,632,48,40,52,1604,790,2394,14,4.8,201903
5,1,257,18,421,319,71,628,7,1721,1204,2925,9,5.666666667,201903
5,2,210,29,446,505,73,210,99,1572,839,2411,10,5.2,201903
5,3,235,31,298,396,118,586,7,1671,1785,3456,9,5.5,201903
5,4,226,27,494,476,17,990,27,2257,2248,4505,9,5.666666667,201903
5,5,235,16,434,447,21,713,24,1890,1746,3636,8,6,201903
5,6,176,29,359,429,11,344,37,1385,609,1994,11,5.5,201903
5,7,196,18,310,399,28,463,21,1435,1294,2729,10,5.5,201903
6,1,197,32,453,290,14,1284,6,2276,1525,3801,12,6,201903
6,2,113,8,374,164,42,766,11,1478,1147,2625,9,5.666666667,201903
7,1,223,7,295,421,21,121,32,1120,565,1685,9,5.25,201903
7,2,336,14,174,535,68,74,0,1201,715,1916,9,5.25,201903
7,3,306,12,263,338,190,200,3,1312,1416,2728,7,5.333333333,201903
7,4,323,21,292,531,9,155,189,1520,1028,2548,11,5.4,201903
7,5,351,10,190,602,17,327,37,1534,1003,2537,11,5.666666667,201903
7,6,231,19,288,324,19,611,29,1521,1293,2814,9,5.666666667,201903
7,7,288,31,419,690,46,227,55,1756,698,2454,8,5.5,201903
7,8,279,14,215,520,15,379,5,1427,991,2418,12,5.25,201903
7,9,230,20,294,456,29,564,38,1631,922,2553,10,6,201903
7,10,203,9,235,330,12,155,0,944,918,1862,9,5.5,201903
7,11,129,36,136,63,8,108,0,480,352,832,6,5.333333333,201903
7,12,308,10,371,770,6,328,0,1793,1546,3339,9,5.5,201903
7,13,134,41,130,722,3,21,0,1051,204,1255,9,5.25,201903
8,1,150,7,357,212,18,421,10,1175,1162,2337,4,6,201903
8,2,316,52,775,611,34,854,17,2659,2472,5131,16,5.5,201903
8,3,215,51,462,312,88,185,258,1571,1059,2630,4,6,201903
8,4,203,24,493,288,55,950,57,2070,1441,3511,11,6,201903
8,5,261,69,560,644,54,413,20,2021,941,2962,10,5.25,201903
8,6,222,41,480,555,41,1095,34,2468,2074,4542,7,6.5,201903
8,7,182,35,234,417,16,492,0,1376,542,1918,7,5.25,201903
8,8,203,31,414,521,9,849,1,2028,2082,4110,11,7,201903
8,9,300,66,243,328,58,593,40,1628,964,2592,10,5.2,201903
9,1,70,2,97,93,35,352,5,654,647,1301,5,6,201903
9,2,309,56,754,1008,105,1531,23,3786,1998,5784,12,6,201903
9,3,124,45,270,326,81,660,27,1533,1750,3283,7,5,201903
9,4,221,14,425,535,57,843,5,2100,749,2849,11,6,201903
9,5,91,15,237,306,30,518,10,1207,1443,2650,7,6,201903
9,6,81,15,179,130,43,444,3,895,932,1827,7,6,201903
9,7,94,10,252,408,1,401,23,1189,1203,2392,9,6,201903
9,8,70,10,291,272,23,582,7,1255,458,1713,5,6,201903
9,9,140,13,261,325,63,512,8,1322,986,2308,5,6,201903
9,10,89,19,355,384,25,639,2,1513,1350,2863,6,6,201903
9,11,138,11,281,388,42,659,2,1521,1993,3514,7,6,201903
9,12,170,11,608,652,60,1106,26,2633,2628,5261,11,6,201903
9,13,107,15,281,245,79,598,14,1339,1442,2781,4,6,201903
9,14,97,12,143,184,40,476,10,962,1169,2131,5,6,201903
9,15,200,30,812,749,25,1645,41,3502,3587,7089,9,6.5,201903
9,16,224,39,417,622,94,956,4,2356,1129,3485,15,6,201903
9,17,140,20,221,359,20,367,3,1130,1142,2272,6,6,201903
9,18,153,19,298,445,68,910,1,1894,2125,4019,12,6,201903
9,19,159,23,280,377,100,703,4,1646,1550,3196,5,6,201903
9,20,63,14,116,223,22,231,9,678,709,1387,5,6,201903
9,21,161,16,174,327,40,335,160,1213,1242,2455,3,6,201903
9,22,182,10,292,314,87,543,18,1446,538,1984,5,6,201903
9,23,140,16,292,353,58,737,2,1598,1634,3232,6,6,201903
9,24,259,19,454,732,79,1404,13,2960,2123,5083,12,6,201903
10,1,279,61,404,612,130,43,278,1807,1330,3137,12,4.833333333,201903
10,2,192,74,410,1177,40,36,167,2096,1495,3591,9,5.25,201903
10,3,251,93,325,1217,24,25,85,2020,1722,3742,11,5.4,201903
10,4,284,66,651,1508,25,44,43,2621,2350,4971,12,7,201903
11,1,264,111,390,431,69,259,149,1673,1207,2880,6,5.666666667,201903
11,2,254,21,293,275,45,699,18,1605,895,2500,7,6,201903
11,3,129,39,152,222,11,550,29,1132,1250,2382,3,6,201903
11,4,192,45,184,256,23,572,0,1272,473,1745,8,6,201903
11,5,302,74,350,490,15,935,6,2172,1187,3359,7,6,201903
11,6,186,26,232,257,45,721,1,1468,1601,3069,8,6,201903
11,7,259,65,364,449,37,453,0,1627,1012,2639,9,5.5,201903
11,8,333,41,369,526,27,847,8,2151,1832,3983,9,5.5,201903
11,9,289,110,352,469,25,596,69,1910,1901,3811,10,5.666666667,201903
11,10,347,60,359,406,29,1065,7,2273,1699,3972,10,5.6,201903
11,11,290,66,355,561,26,410,1,1709,783,2492,5,6,201903
11,12,302,54,616,636,16,962,3,2589,1395,3984,7,6,201903
11,13,235,125,373,394,77,137,313,1654,1223,2877,8,5.5,201903
11,14,261,94,404,420,44,814,7,2044,1395,3439,8,5.5,201903
11,15,180,54,226,313,10,418,24,1225,720,1945,9,6,201903
12,1,170,35,326,122,99,365,20,1137,1076,2213,10,5.2,201903
12,2,265,40,313,332,8,753,18,1729,1619,3348,10,5.5,201903
12,3,326,74,511,674,28,225,1,1839,1216,3055,11,5.2,201903
12,4,261,36,522,684,50,627,0,2180,1866,4046,9,5.666666667,201903
12,5,358,37,367,370,6,228,62,1428,1101,2529,10,5.25,201903
12,6,163,27,245,258,32,123,2,850,803,1653,10,5,201903
12,7,262,24,311,364,10,664,19,1654,1492,3146,6,5.5,201903
12,8,353,29,247,417,19,17,0,1082,604,1686,9,5.25,201903
12,9,279,29,457,580,24,449,3,1821,1028,2849,9,5.666666667,201903
13,1,280,25,331,377,60,443,81,1597,1276,2873,9,5.333333333,201903
13,2,177,23,185,308,105,511,6,1315,577,1892,6,5.333333333,201903
13,3,172,23,249,288,118,339,14,1203,871,2074,12,5.25,201903
13,4,285,32,420,382,172,515,95,1901,1663,3564,9,5.666666667,201903
13,5,254,37,346,246,81,1188,7,2159,1270,3429,9,5.75,201903
13,6,320,165,789,787,65,584,85,2795,1482,4277,11,5.666666667,201903
13,7,190,28,420,494,57,417,0,1606,1317,2923,8,5.5,201903
14,1,108,48,196,73,49,405,178,1057,915,1972,6,5.5,201903
14,2,127,15,213,132,16,710,9,1222,872,2094,5,5.666666667,201903
14,3,205,47,333,207,56,780,48,1676,1779,3455,8,5.4,201903
14,4,225,25,320,386,17,988,4,1965,945,2910,10,6,201903
14,5,194,21,460,378,49,568,0,1670,1260,2930,9,5.5,201903
14,6,253,12,475,286,21,914,4,1965,2508,4473,10,6,201903
14,7,96,6,119,109,0,419,0,749,298,1047,6,6,201903
14,8,286,39,569,673,19,2021,13,3620,3563,7183,11,6,201903
14,9,154,17,229,338,25,1012,1,1776,1736,3512,8,6,201903
14,10,152,12,272,196,5,787,1,1425,1392,2817,5,6,201903
14,11,90,11,103,115,25,523,4,871,450,1321,4,6,201903
14,12,212,26,558,283,18,412,2,1511,1334,2845,9,5.5,201903
14,13,145,18,253,177,10,709,10,1322,1002,2324,6,6,201903
14,14,131,19,201,194,24,915,18,1502,607,2109,7,6,201903
14,15,256,54,374,246,50,916,53,1949,1823,3772,10,5.6,201903
14,16,128,18,197,133,29,653,7,1165,1483,2648,5,6,201903
14,17,182,71,338,327,51,227,32,1228,840,2068,7,5.25,201903
14,18,298,79,455,637,42,614,7,2132,1819,3951,9,5.4,201903
14,19,239,53,419,584,77,560,79,2011,1184,3195,8,5.25,201903
14,20,256,41,371,287,30,917,20,1922,1276,3198,10,5.666666667,201903
15,1,216,28,353,272,370,499,92,1830,1558,3388,7,5.333333333,201903
15,2,189,17,293,388,42,591,16,1536,846,2382,6,6,201903
15,3,250,34,243,427,201,947,9,2111,1246,3357,10,5.666666667,201903
15,4,129,8,168,192,16,657,0,1170,654,1824,4,6,201903
15,5,210,40,295,371,26,766,71,1779,666,2445,8,5.666666667,201903
15,6,221,20,355,449,31,771,12,1859,1163,3022,7,6,201903
15,7,141,17,262,276,33,622,2,1353,779,2132,10,6,201903
15,8,134,13,196,299,21,384,8,1055,798,1853,4,6,201903
15,9,201,17,103,137,140,527,19,1144,799,1943,9,5.75,201903
15,10,154,14,224,295,62,675,14,1438,1530,2968,6,6,201903
15,11,212,7,315,368,55,787,3,1747,1221,2968,8,6,201903
15,12,304,14,590,511,38,677,2,2136,2247,4383,8,6,201903
15,13,80,8,158,146,56,503,0,951,654,1605,8,6,201903
15,14,84,13,169,292,11,321,0,890,855,1745,4,6,201903
15,15,144,50,289,436,34,460,45,1458,311,1769,6,6,201903
15,16,340,52,536,795,38,944,8,2713,1754,4467,8,6,201903
15,17,130,12,212,261,14,666,26,1321,1198,2519,8,6,201903
15,18,246,38,294,545,49,713,2,1887,883,2770,7,5.666666667,201903
15,19,199,49,489,877,16,691,43,2364,1727,4091,10,6,201903
15,20,90,18,199,392,19,383,3,1104,727,1831,6,6,201903
15,21,168,9,149,330,47,292,19,1014,448,1462,6,5.5,201903
15,22,226,40,462,677,31,1021,26,2483,1764,4247,14,6,201903
15,23,198,33,256,528,26,501,2,1544,777,2321,6,5.333333333,201903
15,24,161,13,320,328,27,411,3,1263,457,1720,4,6,201903
15,25,221,17,332,336,35,398,20,1359,473,1832,6,6,201903
15,26,113,3,181,167,25,530,3,1022,1046,2068,9,7,201903
15,27,217,22,376,401,20,747,40,1823,1744,3567,9,5.666666667,201903
15,28,232,30,444,339,72,608,7,1732,1737,3469,9,5.666666667,201903
15,29,258,33,391,459,13,898,0,2052,2139,4191,8,6,201903
15,30,320,47,641,686,78,327,41,2140,1663,3803,16,6,201903
15,31,179,44,176,258,7,441,0,1105,574,1679,6,6,201903
15,32,237,17,373,439,46,575,2,1689,1704,3393,9,6,201903
15,33,259,16,351,462,20,604,0,1712,839,2551,7,6,201903
15,34,161,12,213,407,10,609,6,1418,618,2036,8,6,201903
15,35,291,27,271,600,16,609,0,1814,1350,3164,9,5.666666667,201903
15,36,252,30,414,388,182,510,75,1851,1116,2967,9,5.5,201903
15,37,258,15,339,443,47,1009,26,2137,815,2952,7,6,201903
15,38,240,40,350,624,16,643,2,1915,781,2696,6,5.5,201903
15,39,188,18,302,344,21,374,1,1248,525,1773,4,5,201903
15,40,311,12,278,353,50,1001,27,2032,972,3004,9,6,201903
15,41,399,33,565,769,36,749,10,2561,1697,4258,11,6,201903
16,1,146,18,231,149,78,262,5,889,646,1535,7,5.333333333,201903
16,2,150,62,275,345,43,290,75,1240,900,2140,9,5.25,201903
16,3,173,20,193,319,20,375,26,1126,1341,2467,10,5.25,201903
16,4,169,17,257,223,95,696,0,1457,1099,2556,8,5.5,201903
16,5,214,53,275,233,49,610,9,1443,1007,2450,10,5.666666667,201903
16,6,285,45,245,335,52,488,0,1450,820,2270,12,5.5,201903
16,7,245,61,347,402,93,364,0,1512,1277,2789,9,5.5,201903
16,8,236,42,477,551,7,922,0,2235,2501,4736,12,6,201903
16,9,211,12,240,207,7,820,6,1503,1509,3012,9,6,201903
16,10,208,25,380,394,12,949,2,1970,1368,3338,6,6,201903
16,11,231,55,463,247,269,582,74,1921,1065,2986,10,5.4,201903
16,12,216,40,343,210,37,358,38,1242,805,2047,10,5.25,201903
17,1,189,19,390,374,18,923,1,1914,1206,3120,9,7,201903
17,2,178,24,378,436,26,502,0,1544,927,2471,8,5.666666667,201903
17,3,294,45,438,454,11,806,2,2050,1692,3742,8,5.5,201903
17,4,235,34,381,388,35,875,42,1990,1786,3776,10,5.666666667,201903
17,5,136,16,198,216,23,245,30,864,481,1345,5,5.5,201903
18,1,183,42,238,235,57,308,193,1256,886,2142,7,5.25,201903
18,2,321,34,540,373,84,1164,1,2517,2585,5102,9,6.333333333,201903
18,3,225,40,443,381,23,554,1,1667,1211,2878,8,5.5,201903
19,1,169,17,293,274,20,980,6,1759,1756,3515,9,6,201903
19,2,272,37,610,644,28,362,0,1953,1519,3472,9,6,201903
19,3,252,15,478,344,31,898,0,2018,1384,3402,7,6,201903
19,4,100,10,115,104,27,672,15,1043,1163,2206,5,6,201903
19,5,327,24,467,498,13,1353,9,2691,2486,5177,8,6,201903
19,6,52,14,173,157,6,735,16,1153,1196,2349,5,6,201903
19,7,236,31,610,434,26,285,9,1631,1170,2801,10,5.5,201903
19,8,113,8,154,179,4,430,0,888,855,1743,7,6,201903
19,9,163,29,314,509,93,452,6,1566,1266,2832,9,5.25,201903
19,10,82,24,147,178,13,231,499,1174,1205,2379,5,6,201903
19,11,280,71,392,622,16,1467,62,2910,3920,6830,13,6,201903
19,12,237,17,565,437,19,390,3,1668,812,2480,8,5.666666667,201903
20,1,211,14,277,220,70,370,49,1211,1006,2217,7,5.5,201903
20,2,191,23,301,363,19,94,15,1006,850,1856,6,5.333333333,201903
20,3,165,21,209,183,63,230,63,934,1028,1962,6,5.333333333,201903
20,4,124,13,86,156,26,298,6,709,774,1483,6,5.333333333,201903
20,5,202,21,354,472,46,235,0,1330,1631,2961,11,5.25,201903
20,6,219,11,181,317,203,133,2,1066,1060,2126,8,5.25,201903
20,7,159,26,253,498,46,284,0,1266,1306,2572,7,5.75,201903
20,8,512,46,665,930,57,1512,186,3908,3659,7567,14,6.5,201903
20,9,273,48,307,259,111,361,362,1721,1572,3293,8,5.666666667,201903
20,10,256,20,239,582,28,119,6,1250,1375,2625,9,5.25,201903
21,1,309,13,402,525,26,350,5,1630,1250,2880,9,5.4,201903
21,2,229,32,409,351,214,279,1,1515,1192,2707,9,5.2,201903
21,3,280,24,452,231,175,571,57,1790,1770,3560,8,5.5,201903
21,4,173,6,166,107,79,291,34,856,839,1695,6,5.25,201903
21,5,306,17,462,363,31,746,55,1980,1547,3527,8,5.666666667,201903
21,6,194,11,290,320,32,783,20,1650,1849,3499,6,6,201903
21,7,321,20,373,487,96,460,0,1757,1407,3164,9,5.666666667,201903
21,8,202,21,265,189,89,401,48,1215,1269,2484,9,5.2,201903
21,9,280,25,547,626,96,741,48,2363,2298,4661,9,6,201903
21,10,224,14,317,303,22,729,10,1619,1329,2948,7,5.5,201903
21,11,110,9,218,162,17,331,2,849,814,1663,4,6,201903
21,12,388,22,800,773,57,1568,17,3625,3535,7160,16,6.5,201903
21,13,250,11,220,192,45,820,5,1543,1412,2955,8,5.666666667,201903
21,14,271,25,362,207,206,523,100,1694,1173,2867,12,5.333333333,201903
21,15,324,14,424,354,64,646,3,1829,1695,3524,7,5.5,201903
22,1,276,76,319,506,57,169,29,1432,1271,2703,11,5.2,201903
22,2,162,45,318,272,32,421,29,1279,716,1995,7,5.5,201903
22,3,352,104,977,722,24,977,22,3178,3580,6758,9,5.666666667,201903
22,4,260,47,732,515,32,1190,7,2783,2526,5309,9,6.5,201903
22,5,251,41,672,304,92,500,5,1865,1975,3840,10,5.5,201903
23,1,213,9,684,834,25,51,32,1848,2139,3987,14,5.6,201903
23,2,239,33,446,1079,27,35,2,1861,1707,3568,9,5.5,201903
23,3,298,12,924,680,27,15,52,2008,922,2930,15,6,201903
23,4,208,8,534,378,57,41,30,1256,1169,2425,7,5.666666667,201903
24,1,158,38,171,231,26,287,30,941,825,1766,10,5.2,201903
24,2,192,41,319,243,33,466,34,1328,442,1770,6,5.5,201903
24,3,216,46,303,351,145,357,9,1427,913,2340,9,5.25,201903
24,4,155,19,178,156,33,614,16,1171,1316,2487,5,5.5,201903
24,5,241,48,429,497,10,836,41,2102,2500,4602,10,6.333333333,201903
24,6,232,43,366,497,34,814,0,1986,1965,3951,7,7,201903
24,7,294,47,378,584,92,281,0,1676,1353,3029,9,5.25,201903
25,1,244,48,377,530,94,721,10,2024,996,3020,13,5.75,201903
25,2,286,49,487,482,40,1028,0,2372,1064,3436,7,5.5,201903
25,3,221,21,354,450,39,766,12,1863,1653,3516,8,5.6,201903
25,4,227,50,237,538,32,671,65,1820,1178,2998,8,5.333333333,201903
25,5,217,19,707,520,52,947,56,2518,1645,4163,8,5.666666667,201903
25,6,243,27,402,316,110,987,70,2155,1179,3334,8,5.75,201903
25,7,209,20,637,418,10,994,0,2288,1564,3852,6,6,201903
26,1,191,29,506,423,27,456,0,1632,808,2440,9,5.5,201903
26,2,283,20,573,525,23,450,103,1977,1271,3248,12,5.4,201903
26,3,228,8,226,353,16,1035,39,1905,1618,3523,15,7,201903
26,4,152,26,246,490,51,275,6,1246,945,2191,9,5.2,201903
26,5,163,9,210,235,21,803,0,1441,639,2080,14,5.5,201903
26,6,149,15,348,410,11,572,0,1505,847,2352,10,5.333333333,201903
26,7,170,23,280,382,58,298,0,1211,959,2170,10,5.5,201903
27,1,241,36,412,476,76,443,111,1795,1600,3395,8,5.5,201903
27,2,259,25,485,530,20,375,0,1694,1585,3279,8,5.666666667,201903
27,3,281,18,321,566,39,497,13,1735,1613,3348,7,5.666666667,201903
27,4,223,23,382,619,18,721,42,2028,2343,4371,9,6.5,201903
27,5,111,5,170,282,11,162,60,801,821,1622,6,5.333333333,201903
27,6,269,55,355,688,12,515,0,1894,1788,3682,7,5.5,201903
28,1,461,74,754,1411,17,63,0,2780,847,3627,13,6,201903
28,2,291,75,570,1108,35,112,401,2592,2171,4763,14,6,201903
28,3,134,41,226,799,10,18,83,1311,1118,2429,7,5.333333333,201903
28,4,316,73,549,1138,120,59,549,2804,1676,4480,15,6,201903
28,5,265,103,439,516,58,67,398,1846,989,2835,11,5.75,201903
28,6,133,61,289,931,119,29,124,1686,1182,2868,14,5.166666667,201903
28,7,275,94,616,1238,98,87,0,2408,1352,3760,8,6,201903
28,8,218,99,423,685,99,67,69,1660,719,2379,9,6,201903
28,9,287,46,472,321,78,47,436,1687,1338,3025,11,5.75,201903
29,1,225,48,462,391,76,393,22,1617,948,2565,7,5.5,201903
29,2,269,36,561,313,107,676,99,2061,1322,3383,11,6,201903
29,3,120,25,229,385,32,362,0,1153,1070,2223,5,5.666666667,201903
30,1,185,44,322,468,31,131,266,1447,820,2267,7,5.333333333,201903
30,2,240,45,385,150,67,206,509,1602,1137,2739,8,5.25,201903
30,3,204,22,548,177,157,532,322,1962,1174,3136,6,5.666666667,201903
30,4,137,7,300,167,42,622,0,1275,1118,2393,8,6,201903
30,5,135,24,228,339,100,626,4,1456,1392,2848,7,5.5,201903
30,6,257,21,426,365,55,386,27,1537,1230,2767,9,5.333333333,201903
30,7,228,26,315,205,45,518,175,1512,1193,2705,11,5.25,201903
30,8,218,30,464,377,89,849,165,2192,1635,3827,11,5.4,201903
30,9,253,13,241,178,39,571,59,1354,1337,2691,8,5.5,201903
30,10,260,26,544,396,32,1323,35,2616,1595,4211,7,6.5,201903
30,11,187,35,459,640,30,646,6,2003,1718,3721,5,5.5,201903
30,12,272,25,759,685,45,1329,33,3148,2969,6117,10,6,201903
30,13,268,21,326,325,68,809,184,2001,884,2885,10,5.4,201903
30,14,276,39,645,224,182,550,114,2030,1859,3889,8,5.5,201903
30,15,252,16,215,265,66,928,108,1850,1014,2864,11,5.666666667,201903
30,16,261,18,488,332,107,1149,200,2555,2109,4664,10,5.333333333,201903
30,17,252,28,336,302,74,715,33,1740,1575,3315,8,5.5,201903
30,18,274,25,231,218,38,230,145,1161,988,2149,8,5.25,201903
30,19,191,20,352,392,29,438,9,1431,1055,2486,13,5.6,201903
30,20,223,32,486,586,198,396,40,1961,1573,3534,10,5.4,201903
31,1,204,15,286,37,392,480,0,1414,1081,2495,8,5.5,201903
31,2,166,53,245,5,285,529,0,1283,1046,2329,6,5.333333333,201903
31,3,463,52,1017,607,163,2274,7,4583,4501,9084,20,6,201903
31,4,113,16,224,141,53,640,53,1240,1298,2538,4,6,201903
31,5,163,38,219,316,20,502,156,1414,967,2381,6,5.333333333,201903
32,1,224,84,320,319,60,431,84,1522,720,2242,12,5.2,201903
32,2,243,63,334,124,207,472,137,1580,1218,2798,13,5,201903
32,3,220,97,419,513,31,624,38,1942,1232,3174,13,5.4,201903
32,4,309,179,446,523,61,392,176,2086,1158,3244,13,6.2,201903
1,1,93,26,8,685,0,10,0,822,1778,2600,13,5.5,201904
1,2,87,47,192,1224,10,74,1,1635,3089,4724,10,6.333333333,201904
1,3,54,26,152,1195,4,35,3,1469,2900,4369,9,6,201904
2,1,0,0,0,1917,0,2,0,1919,3266,5185,11,6,201904
2,2,0,0,0,2097,0,0,0,2097,2620,4717,8,6.5,201904
2,3,0,0,0,1612,0,0,0,1612,3019,4631,12,6,201904
2,4,0,0,0,572,0,0,0,572,1814,2386,9,6,201904
2,5,1,0,0,1691,0,2,0,1694,3617,5311,13,6,201904
2,6,0,0,0,1119,0,0,0,1119,2110,3229,7,6,201904
2,7,122,3,0,566,0,0,526,1217,2199,3416,12,5.75,201904
2,8,0,0,0,1447,0,1,0,1448,1928,3376,8,6,201904
3,1,169,23,383,336,23,616,11,1561,1671,3232,12,5.666666667,201904
3,2,131,11,494,194,13,323,0,1166,1489,2655,9,5.666666667,201904
4,1,240,28,436,445,103,716,45,2013,2280,4293,11,5.25,201904
4,2,256,23,556,491,72,417,38,1853,991,2844,14,5.2,201904
5,1,235,15,334,292,28,842,6,1752,1556,3308,9,5.666666667,201904
5,2,203,17,356,369,28,548,19,1540,1156,2696,10,5.2,201904
5,3,173,15,236,318,36,677,4,1459,1048,2507,9,5.5,201904
5,4,256,35,524,468,15,1107,14,2419,2397,4816,9,5.666666667,201904
5,5,267,23,392,391,19,582,16,1690,2171,3861,8,6,201904
5,6,176,25,295,380,11,422,53,1362,879,2241,11,5.5,201904
5,7,179,18,290,264,31,528,20,1330,1683,3013,10,5.5,201904
6,1,201,18,435,249,16,1212,5,2136,2940,5076,12,6,201904
6,2,137,9,356,144,31,754,7,1438,1114,2552,9,5.666666667,201904
7,1,271,11,241,262,15,132,28,960,1110,2070,9,5.25,201904
7,2,320,13,159,445,55,68,0,1060,608,1668,9,5.25,201904
7,3,308,7,166,244,91,211,1,1028,1704,2732,7,5.333333333,201904
7,4,166,24,264,560,29,129,42,1214,875,2089,11,5.4,201904
7,5,281,9,169,397,12,310,1,1179,1452,2631,11,5.666666667,201904
7,6,190,10,289,345,25,553,52,1464,1380,2844,9,5.666666667,201904
7,7,314,36,401,512,64,263,60,1650,1391,3041,8,5.5,201904
7,8,324,12,272,495,14,388,2,1507,1054,2561,12,5.25,201904
7,9,207,35,287,435,15,550,4,1533,1612,3145,10,6,201904
7,10,161,2,195,464,25,191,0,1038,923,1961,9,5.5,201904
7,11,162,6,134,147,19,101,40,609,498,1107,6,5.333333333,201904
7,12,274,5,324,617,7,341,0,1568,1602,3170,9,5.5,201904
7,13,115,29,138,306,1,22,0,611,635,1246,9,5.25,201904
8,1,161,9,372,202,22,369,4,1139,1551,2690,4,6,201904
8,2,336,46,749,615,45,814,29,2634,2419,5053,16,5.5,201904
8,3,214,37,407,309,57,303,143,1470,1268,2738,4,6,201904
8,4,190,27,429,279,30,919,40,1914,1997,3911,11,6,201904
8,5,251,70,499,483,70,370,29,1772,1020,2792,10,5.25,201904
8,6,244,39,463,573,45,962,19,2345,2414,4759,7,6.5,201904
8,7,151,63,271,443,11,479,0,1418,895,2313,7,5.25,201904
8,8,202,35,381,455,10,835,7,1925,1934,3859,11,7,201904
8,9,214,49,238,300,29,537,8,1375,1174,2549,10,5,201904
9,1,67,12,81,112,47,361,1,681,637,1318,5,6,201904
9,2,286,66,726,951,88,1342,35,3494,4214,7708,12,6,201904
9,3,106,28,365,375,47,733,12,1666,1801,3467,7,6,201904
9,4,209,20,400,481,62,706,7,1885,1996,3881,11,6,201904
9,5,131,12,218,305,43,546,16,1271,1228,2499,7,6,201904
9,6,89,10,166,154,60,440,5,924,982,1906,7,6,201904
9,7,70,11,200,271,2,468,18,1040,1082,2122,9,6,201904
9,8,68,24,313,296,17,542,1,1261,1111,2372,5,6,201904
9,9,141,10,294,360,62,505,4,1376,1224,2600,5,6,201904
9,10,104,20,321,313,33,667,4,1462,1874,3336,6,6,201904
9,11,204,19,458,508,73,824,5,2091,1657,3748,7,6,201904
9,12,156,33,632,642,46,1004,33,2546,2478,5024,11,6,201904
9,13,104,10,239,242,68,595,16,1274,1336,2610,4,6,201904
9,14,73,7,155,158,53,466,10,922,897,1819,5,6,201904
9,15,188,29,813,741,23,1589,23,3406,3305,6711,10,7,201904
9,16,219,46,425,639,145,871,1,2346,2114,4460,15,6,201904
9,17,127,9,228,403,29,420,4,1220,1070,2290,6,6,201904
9,18,173,27,302,487,42,899,2,1932,2061,3993,12,6,201904
9,19,172,27,294,341,78,600,8,1520,1791,3311,5,6,201904
9,20,72,7,143,189,25,254,9,699,632,1331,5,6,201904
9,21,137,21,245,356,55,331,146,1291,1108,2399,3,6,201904
9,22,170,14,318,318,83,517,20,1440,1152,2592,5,6,201904
9,23,162,11,323,368,80,658,8,1610,1679,3289,6,6,201904
9,24,245,27,463,693,73,1349,27,2877,2565,5442,12,6,201904
10,1,0,0,0,845,0,0,3,848,1332,2180,4,2,201904
10,2,125,11,8,1301,0,0,0,1445,3277,4722,9,5.25,201904
10,3,142,60,96,1278,1,2,0,1579,1608,3187,11,5.4,201904
10,4,168,42,240,1502,1,1,0,1954,2659,4613,12,6.5,201904
11,1,260,93,334,351,41,334,166,1579,1580,3159,6,5.666666667,201904
11,2,212,36,270,236,44,651,13,1462,1643,3105,7,6,201904
11,3,116,30,146,180,4,594,44,1114,1213,2327,3,6,201904
11,4,199,56,199,256,15,552,0,1277,938,2215,8,6,201904
11,5,249,81,318,485,24,794,7,1958,2224,4182,7,6,201904
11,6,175,26,269,284,39,676,2,1471,1329,2800,8,6,201904
11,7,268,47,362,400,26,484,0,1587,1902,3489,9,5.5,201904
11,8,286,57,428,534,52,844,17,2218,1953,4171,9,5.5,201904
11,9,275,87,397,483,25,734,80,2081,1851,3932,10,5.666666667,201904
11,10,320,57,361,419,41,1077,3,2278,2087,4365,10,5.6,201904
11,11,225,64,373,534,22,458,1,1677,1616,3293,5,6,201904
11,12,253,56,540,574,16,967,3,2409,2323,4732,7,6,201904
11,13,210,93,301,340,42,320,241,1547,1349,2896,8,5.5,201904
11,14,254,74,372,313,30,936,10,1989,1835,3824,8,5.5,201904
11,15,172,61,253,229,10,451,17,1193,1658,2851,9,6,201904
12,1,180,46,346,142,120,268,27,1129,1051,2180,10,5.2,201904
12,2,344,48,403,424,33,707,39,1998,1737,3735,10,5.5,201904
12,3,192,31,370,629,16,233,0,1471,1113,2584,11,5.2,201904
12,4,256,42,591,597,44,565,4,2099,2002,4101,9,5.666666667,201904
12,5,223,29,305,311,10,237,49,1164,1016,2180,10,5.25,201904
12,6,164,25,116,376,19,97,1,798,789,1587,10,5,201904
12,7,320,19,372,369,29,669,29,1807,1680,3487,6,5.5,201904
12,8,339,36,324,386,13,35,2,1135,1167,2302,9,5.25,201904
12,9,240,28,436,530,30,390,2,1656,2317,3973,9,5.666666667,201904
13,1,202,30,255,315,78,371,59,1310,930,2240,9,5.333333333,201904
13,2,188,35,190,468,61,432,0,1374,1570,2944,6,5.333333333,201904
13,3,235,42,311,448,116,377,26,1555,1424,2979,12,5.25,201904
13,4,265,39,461,329,148,475,31,1748,1516,3264,9,5.666666667,201904
13,5,226,20,389,243,73,1075,0,2026,2357,4383,9,5.75,201904
13,6,286,164,816,772,77,672,47,2834,3240,6074,11,5.666666667,201904
13,7,188,33,573,514,35,460,0,1803,1852,3655,8,5.5,201904
14,1,83,64,162,71,49,379,230,1038,913,1951,6,5.5,201904
14,2,137,25,206,147,22,664,11,1212,1285,2497,5,5.666666667,201904
14,3,220,60,344,191,58,761,63,1697,1504,3201,8,5.4,201904
14,4,206,22,320,341,18,918,4,1829,2141,3970,10,6,201904
14,5,191,35,578,373,68,595,1,1841,1765,3606,9,5.5,201904
14,6,249,10,443,271,17,930,2,1922,2006,3928,10,6,201904
14,7,91,9,137,83,0,413,0,733,541,1274,6,6,201904
14,8,220,40,555,709,14,1929,5,3472,3998,7470,11,6,201904
14,9,178,23,270,319,17,995,1,1803,2025,3828,8,6,201904
14,10,176,8,270,204,2,757,0,1417,1146,2563,5,6,201904
14,11,92,9,86,114,27,516,1,845,1092,1937,4,6,201904
14,12,216,31,557,270,27,430,1,1532,1316,2848,9,5.5,201904
14,13,157,18,272,159,19,651,5,1281,1906,3187,6,6,201904
14,14,124,22,219,155,12,960,4,1496,896,2392,7,6,201904
14,15,247,63,339,210,41,862,54,1816,1561,3377,10,5.6,201904
14,16,98,16,169,117,21,553,4,978,1330,2308,5,6,201904
14,17,142,79,317,262,34,266,72,1172,670,1842,7,5.25,201904
14,18,195,90,444,671,41,625,10,2076,1760,3836,9,5.4,201904
14,19,303,97,503,640,90,528,95,2256,1898,4154,8,5.25,201904
14,20,231,36,416,288,25,853,21,1870,1502,3372,10,5.666666667,201904
15,1,209,29,292,190,440,583,35,1778,1153,2931,7,5.333333333,201904
15,2,170,14,316,396,42,558,21,1517,1555,3072,6,6,201904
15,3,265,37,215,430,194,792,9,1942,1923,3865,10,5.666666667,201904
15,4,125,11,175,183,15,645,6,1160,1635,2795,4,6,201904
15,5,207,41,290,306,20,790,68,1722,1523,3245,8,5,201904
15,6,157,17,379,420,36,656,4,1669,2365,4034,7,6,201904
15,7,154,15,244,229,38,671,1,1352,1404,2756,10,6,201904
15,8,117,11,217,252,24,429,8,1058,1321,2379,4,6,201904
15,9,246,15,179,187,192,604,15,1438,1248,2686,9,5.75,201904
15,10,156,7,244,272,49,673,16,1417,1553,2970,6,6,201904
15,11,178,18,345,332,44,712,3,1632,2258,3890,8,6,201904
15,12,286,18,649,550,42,665,1,2211,1874,4085,8,5.666666667,201904
15,13,97,12,136,123,51,488,0,907,800,1707,8,6,201904
15,14,102,17,187,260,14,324,1,905,1171,2076,4,6,201904
15,15,126,38,246,448,40,453,28,1379,1567,2946,6,6,201904
15,16,359,51,579,814,32,966,5,2806,3393,6199,8,6,201904
15,17,134,13,225,203,12,620,24,1231,1207,2438,8,6,201904
15,18,247,19,360,353,50,636,2,1667,1799,3466,7,5.666666667,201904
15,19,121,66,434,530,33,432,103,1719,1977,3696,10,6,201904
15,20,97,21,214,365,22,316,3,1038,1161,2199,6,6,201904
15,21,146,17,159,306,31,255,17,931,845,1776,6,5.5,201904
15,22,214,39,489,630,39,1061,11,2483,3055,5538,14,6,201904
15,23,225,27,291,482,32,529,1,1587,1476,3063,6,5.333333333,201904
15,24,154,21,263,285,23,392,13,1151,1012,2163,4,6,201904
15,25,183,37,353,312,44,383,11,1323,1042,2365,6,6,201904
15,26,127,4,159,176,27,512,2,1007,1312,2319,9,7,201904
15,27,251,26,405,379,19,694,39,1813,1884,3697,9,5.666666667,201904
15,28,223,23,397,390,79,608,4,1724,1980,3704,9,5.666666667,201904
15,29,164,19,325,455,13,697,0,1673,1495,3168,8,5,201904
15,30,256,34,531,509,38,390,18,1776,1759,3535,16,5.5,201904
15,31,136,42,188,267,12,434,1,1080,1075,2155,6,6,201904
15,32,257,8,404,515,55,604,2,1845,1776,3621,9,6,201904
15,33,236,23,321,416,32,581,0,1609,1698,3307,7,6,201904
15,34,203,19,246,405,9,566,4,1452,1220,2672,8,6,201904
15,35,289,32,315,570,14,496,29,1745,2146,3891,9,5.666666667,201904
15,36,292,21,404,363,149,531,39,1799,1506,3305,9,5.5,201904
15,37,258,18,353,427,49,892,23,2020,1328,3348,7,6,201904
15,38,201,47,286,488,9,508,5,1544,1369,2913,6,5.5,201904
15,39,213,24,316,378,31,409,3,1374,2104,3478,4,6,201904
15,40,261,17,259,326,78,916,21,1878,1649,3527,9,5.333333333,201904
15,41,348,42,657,703,44,743,6,2543,2207,4750,11,6,201904
16,1,172,34,344,216,116,289,98,1269,779,2048,7,5.333333333,201904
16,2,172,53,242,312,56,253,23,1111,579,1690,9,5.25,201904
16,3,237,43,316,355,28,384,15,1378,854,2232,10,5.25,201904
16,4,189,33,236,190,75,586,0,1309,1153,2462,8,5.5,201904
16,5,198,36,244,234,26,554,5,1297,1114,2411,10,5.666666667,201904
16,6,273,66,326,359,65,435,1,1525,1269,2794,12,5.5,201904
16,7,290,52,322,402,83,413,0,1562,1323,2885,9,5.5,201904
16,8,240,50,539,632,6,878,1,2346,2205,4551,12,6,201904
16,9,184,23,223,181,12,769,11,1403,1441,2844,9,6,201904
16,10,232,25,362,419,11,917,0,1966,1978,3944,6,6,201904
16,11,251,53,426,227,231,509,55,1752,1148,2900,10,5.4,201904
16,12,275,38,431,172,95,360,38,1409,1113,2522,10,5.25,201904
17,1,202,20,347,351,14,866,1,1801,1784,3585,9,7,201904
17,2,171,23,355,298,17,443,6,1313,1313,2626,8,5.666666667,201904
17,3,254,15,440,381,15,737,2,1844,2186,4030,8,5.5,201904
17,4,253,22,339,350,26,823,5,1818,1588,3406,10,5.666666667,201904
17,5,114,8,185,169,4,261,3,744,851,1595,5,5,201904
18,1,180,17,232,203,16,473,57,1178,896,2074,7,5.25,201904
18,2,284,33,572,439,71,1140,0,2539,2169,4708,9,6.333333333,201904
18,3,154,17,389,235,10,554,0,1359,1474,2833,8,5.5,201904
19,1,129,19,305,289,17,1000,10,1769,1522,3291,9,6,201904
19,2,210,20,550,464,18,589,0,1851,1446,3297,9,6,201904
19,3,224,12,471,327,31,813,0,1878,1894,3772,7,6,201904
19,4,88,6,108,88,19,674,24,1007,992,1999,5,6,201904
19,5,278,37,449,446,21,1367,19,2617,2003,4620,8,6,201904
19,6,60,12,208,169,4,746,15,1214,1097,2311,5,6,201904
19,7,199,13,528,232,9,562,8,1551,1072,2623,10,5.5,201904
19,8,122,9,203,214,9,441,0,998,729,1727,7,6,201904
19,9,187,16,240,294,37,1017,2,1793,1297,3090,9,5.25,201904
19,10,85,31,204,184,15,156,572,1247,995,2242,7,8,201904
19,11,233,65,424,616,23,1479,118,2958,2942,5900,13,6,201904
19,12,228,25,675,440,15,461,1,1845,1195,3040,8,5.666666667,201904
20,1,229,25,399,210,73,459,66,1461,1225,2686,7,5.5,201904
20,2,220,31,236,408,10,80,16,1001,854,1855,6,5.333333333,201904
20,3,102,10,159,120,42,307,31,771,915,1686,6,5.333333333,201904
20,4,111,11,112,164,22,307,6,733,847,1580,6,5.333333333,201904
20,5,124,17,295,327,63,246,0,1072,1431,2503,11,5.25,201904
20,6,229,12,224,238,173,117,1,994,842,1836,8,5.25,201904
20,7,164,28,350,469,61,339,0,1411,1250,2661,7,5.75,201904
20,8,516,49,753,838,55,1567,87,3865,2916,6781,14,6.5,201904
20,9,241,35,235,193,93,403,346,1546,1266,2812,8,5.666666667,201904
20,10,153,14,165,375,10,185,3,905,1047,1952,9,5.25,201904
21,1,302,18,370,516,33,262,1,1502,1444,2946,9,5.4,201904
21,2,228,20,367,375,159,241,0,1390,1254,2644,9,5.2,201904
21,3,374,29,476,242,157,533,56,1867,1644,3511,8,5.5,201904
21,4,170,14,164,95,83,313,55,894,1172,2066,6,5.25,201904
21,5,311,18,378,330,21,800,40,1898,1625,3523,8,5.666666667,201904
21,6,225,15,315,332,31,719,25,1662,1561,3223,6,6,201904
21,7,319,17,347,429,63,456,0,1631,1780,3411,9,5.666666667,201904
21,8,250,16,285,174,104,402,42,1273,1184,2457,9,5.2,201904
21,9,275,20,549,506,84,671,29,2134,2238,4372,9,6,201904
21,10,246,15,338,293,29,673,26,1620,1633,3253,7,5.5,201904
21,11,99,4,227,165,29,250,1,775,743,1518,4,6,201904
21,12,398,19,837,758,61,1414,30,3517,3389,6906,16,6.5,201904
21,13,232,10,244,195,26,688,3,1398,1696,3094,8,5.666666667,201904
21,14,246,20,235,185,130,458,60,1334,1213,2547,12,5.333333333,201904
21,15,293,14,361,243,45,557,9,1522,1721,3243,7,5.5,201904
22,1,246,62,301,437,60,205,35,1346,1313,2659,11,5.2,201904
22,2,186,40,330,259,42,439,33,1329,1592,2921,7,5.5,201904
22,3,412,136,1082,740,51,1016,13,3450,2914,6364,9,5.666666667,201904
22,4,279,48,717,540,30,1022,4,2640,2740,5380,9,6.5,201904
22,5,193,24,588,253,88,522,3,1671,1660,3331,10,5.5,201904
23,1,38,0,0,1309,0,1,0,1348,1865,3213,14,5.6,201904
23,2,17,8,0,934,0,2,0,961,1478,2439,8,5.25,201904
23,3,11,3,0,596,0,0,56,666,1556,2222,15,6,201904
23,4,55,3,269,574,20,2,34,957,1681,2638,8,5.666666667,201904
24,1,183,33,203,308,29,363,9,1128,930,2058,10,5.2,201904
24,2,181,39,294,168,26,598,12,1318,1084,2402,6,5.5,201904
24,3,228,53,252,354,98,315,14,1314,1142,2456,9,5.25,201904
24,4,161,23,187,163,26,696,15,1271,1179,2450,5,5.5,201904
24,5,270,48,453,589,25,864,57,2306,2596,4902,10,6.333333333,201904
24,6,232,76,410,515,29,881,1,2144,1784,3928,7,7,201904
24,7,303,30,377,562,56,316,0,1644,1063,2707,9,5.25,201904
25,1,154,19,321,323,37,683,14,1551,1633,3184,13,5.75,201904
25,2,255,32,460,386,16,1017,0,2166,1939,4105,7,5.5,201904
25,3,216,40,412,584,45,723,7,2027,1525,3552,8,5.6,201904
25,4,206,39,254,389,61,597,140,1686,1018,2704,8,5.333333333,201904
25,5,245,25,782,560,67,918,89,2686,2799,5485,8,5.666666667,201904
25,6,218,19,385,326,40,878,37,1903,1810,3713,8,5.75,201904
25,7,223,28,652,407,16,894,0,2220,2545,4765,6,6,201904
26,1,181,22,556,399,28,572,0,1758,1077,2835,9,5.5,201904
26,2,245,16,579,597,9,511,72,2029,1352,3381,12,5.4,201904
26,3,179,11,279,310,9,968,71,1827,2406,4233,14,6.5,201904
26,4,120,22,182,332,21,439,1,1117,587,1704,9,5.2,201904
26,5,155,10,224,239,12,747,0,1387,1267,2654,14,5.5,201904
26,6,133,11,302,272,12,702,0,1432,1360,2792,10,5.333333333,201904
26,7,174,22,310,355,35,342,0,1238,1236,2474,10,5.5,201904
27,1,225,24,431,458,96,440,57,1731,1400,3131,8,5.5,201904
27,2,266,27,452,542,34,373,1,1695,1249,2944,8,5.666666667,201904
27,3,228,18,314,533,9,518,2,1622,1306,2928,7,5.666666667,201904
27,4,286,22,486,612,28,758,29,2221,1684,3905,8,6,201904
27,5,152,10,194,331,8,177,104,976,721,1697,6,5.333333333,201904
27,6,209,29,324,538,14,466,0,1580,1317,2897,7,5.5,201904
28,1,2,0,5,1253,0,6,0,1266,1939,3205,13,6,201904
28,2,0,1,0,1384,0,0,1,1386,2516,3902,14,6,201904
28,3,54,21,13,744,0,0,0,832,961,1793,7,5.333333333,201904
28,4,0,0,0,1443,0,3,1,1447,4445,5892,15,6,201904
28,5,0,0,0,934,0,3,0,937,1589,2526,9,5.25,201904
28,6,23,6,1,863,0,1,0,894,1163,2057,14,5.166666667,201904
28,7,57,30,156,1211,5,70,0,1529,2744,4273,8,6,201904
28,8,0,0,0,1517,0,0,0,1517,1562,3079,9,6,201904
28,9,102,12,0,309,1,1,255,680,1828,2508,11,5.75,201904
29,1,197,26,378,323,48,609,10,1591,1624,3215,7,5.5,201904
29,2,277,25,469,338,60,774,58,2001,1935,3936,11,6,201904
29,3,159,28,228,362,16,459,0,1252,1230,2482,5,5.666666667,201904
30,1,139,33,330,401,41,203,185,1332,1241,2573,7,5.333333333,201904
30,2,199,35,256,125,132,176,359,1282,1024,2306,8,5.25,201904
30,3,188,22,442,161,134,645,139,1731,1675,3406,6,5.666666667,201904
30,4,144,8,316,136,29,493,0,1126,1083,2209,8,6,201904
30,5,191,15,213,334,28,690,0,1471,1248,2719,7,5.5,201904
30,6,233,31,414,331,49,393,32,1483,1221,2704,9,5.333333333,201904
30,7,270,29,455,265,55,448,176,1698,1645,3343,11,5.25,201904
30,8,290,32,473,340,63,781,107,2086,1967,4053,11,5.4,201904
30,9,298,20,243,196,52,708,65,1582,1507,3089,8,5.5,201904
30,10,264,20,482,358,33,1128,22,2307,2829,5136,7,6.5,201904
30,11,179,25,399,513,9,556,2,1683,1163,2846,5,5.5,201904
30,12,267,29,665,549,43,1167,69,2789,2317,5106,10,6,201904
30,13,258,18,322,313,74,812,108,1905,1733,3638,10,5.4,201904
30,14,233,34,665,212,174,609,100,2027,1670,3697,8,5.5,201904
30,15,324,18,234,210,81,830,159,1856,2071,3927,11,5.666666667,201904
30,16,259,14,398,305,91,1040,198,2305,2323,4628,10,5.333333333,201904
30,17,258,10,327,319,66,788,19,1787,1337,3124,8,5.5,201904
30,18,259,33,283,193,62,295,115,1240,1086,2326,8,5.25,201904
30,19,251,20,402,447,38,479,12,1649,1188,2837,13,5.6,201904
30,20,257,31,517,556,234,514,20,2129,1510,3639,10,5.4,201904
31,1,228,31,299,44,392,482,2,1478,965,2443,8,5.5,201904
31,2,119,19,190,2,235,545,0,1110,909,2019,6,5.333333333,201904
31,3,460,71,1013,581,145,2118,3,4391,3587,7978,21,6.333333333,201904
31,4,138,20,224,159,58,641,49,1289,910,2199,4,6,201904
31,5,206,7,181,223,41,683,31,1372,710,2082,6,5.333333333,201904
32,1,220,30,169,169,33,751,22,1394,1266,2660,12,5.2,201904
32,2,251,44,201,126,131,970,57,1780,1609,3389,13,5.142857143,201904
32,3,224,80,356,424,18,761,22,1885,1601,3486,13,5.4,201904
32,4,233,110,351,434,46,452,128,1754,1368,3122,13,5.4,201904
1,1,99,21,63,669,17,47,7,923,1584,2507,13,5.5,201905
1,2,70,52,253,1018,9,77,3,1482,1655,3137,10,6.333333333,201905
1,3,71,18,113,1175,4,50,12,1443,1846,3289,9,6,201905
2,1,19,2,96,1811,3,17,0,1948,2152,4100,11,6,201905
2,2,28,5,77,1874,5,22,0,2011,2450,4461,8,6.5,201905
2,3,29,13,90,1710,7,16,50,1915,1927,3842,12,6,201905
2,4,21,1,96,579,7,16,4,724,813,1537,9,6,201905
2,5,46,14,187,1620,75,33,26,2001,2184,4185,13,6,201905
2,6,57,15,155,1122,5,28,3,1385,1153,2538,7,6,201905
2,7,33,14,160,889,11,27,70,1204,1236,2440,12,5.75,201905
2,8,35,1,142,1213,5,25,28,1449,1522,2971,8,6,201905
3,1,183,16,351,317,23,660,7,1557,1420,2977,12,5.666666667,201905
3,2,140,5,484,177,19,314,0,1139,1484,2623,9,5.666666667,201905
4,1,259,22,377,450,51,664,29,1852,2195,4047,12,5.5,201905
4,2,228,31,590,479,103,393,6,1830,1910,3740,14,5.2,201905
5,1,230,20,391,266,42,731,6,1686,1585,3271,9,5.666666667,201905
5,2,171,30,331,244,39,505,22,1342,899,2241,10,5.2,201905
5,3,193,16,273,329,52,739,11,1613,1446,3059,9,5.5,201905
5,4,251,30,561,431,13,885,23,2194,2238,4432,9,5.666666667,201905
5,5,233,24,415,458,23,631,32,1816,1804,3620,8,6,201905
5,6,147,26,294,315,15,358,42,1197,1612,2809,11,5.5,201905
5,7,169,18,263,353,5,417,14,1239,1256,2495,10,5.5,201905
6,1,258,21,423,307,13,1082,2,2106,2425,4531,12,6,201905
6,2,143,13,356,176,44,661,15,1408,1422,2830,9,5.666666667,201905
7,1,316,7,247,471,25,92,24,1182,1636,2818,9,5.25,201905
7,2,382,15,190,491,13,94,0,1185,778,1963,9,5.25,201905
7,3,234,6,193,255,114,219,1,1022,1215,2237,7,5.333333333,201905
7,4,199,21,244,437,13,136,113,1163,1111,2274,11,5.4,201905
7,5,296,13,153,404,19,269,6,1160,1622,2782,11,5.666666667,201905
7,6,270,14,340,523,28,536,32,1743,1922,3665,8,5.333333333,201905
7,7,253,32,348,412,25,345,22,1437,1157,2594,8,5.5,201905
7,8,371,24,358,542,28,417,12,1752,1283,3035,12,5.25,201905
7,9,203,29,291,405,14,440,11,1393,1938,3331,9,5.666666667,201905
7,10,210,12,234,523,11,160,1,1151,1182,2333,9,5.5,201905
7,11,194,4,96,167,17,86,24,588,517,1105,6,5.333333333,201905
7,12,264,16,302,639,9,282,0,1512,1839,3351,9,5.5,201905
7,13,116,28,146,327,0,21,0,638,266,904,9,5.25,201905
8,1,117,9,390,187,23,390,8,1124,1195,2319,4,6,201905
8,2,286,49,842,684,52,382,16,2311,2283,4594,16,5.5,201905
8,3,150,31,395,334,32,527,12,1481,1583,3064,4,6,201905
8,4,180,33,481,279,36,824,30,1863,1955,3818,11,6,201905
8,5,229,39,383,501,22,508,3,1685,1721,3406,10,5.25,201905
8,6,199,40,478,545,46,837,20,2165,2619,4784,7,6.5,201905
8,7,158,29,254,404,12,500,2,1359,1151,2510,7,5.25,201905
8,8,169,34,442,587,10,764,0,2006,1924,3930,11,7,201905
8,9,136,19,231,150,26,536,1,1099,834,1933,10,5.2,201905
9,1,61,4,99,94,37,347,5,647,602,1249,5,6,201905
9,2,288,65,710,911,113,1206,23,3316,5439,8755,12,6,201905
9,3,132,48,351,363,54,726,20,1694,1682,3376,7,6,201905
9,4,195,16,483,578,106,714,14,2106,2101,4207,11,6,201905
9,5,115,4,257,284,59,502,27,1248,1317,2565,7,6,201905
9,6,95,17,190,161,67,390,9,929,872,1801,7,6,201905
9,7,87,15,257,403,2,404,5,1173,1165,2338,9,6,201905
9,8,101,27,337,300,23,525,4,1317,1240,2557,5,6,201905
9,9,133,7,279,295,56,443,9,1222,1159,2381,5,6,201905
9,10,106,23,366,354,38,555,3,1445,1480,2925,6,6,201905
9,11,181,16,441,492,77,772,4,1983,1777,3760,7,6,201905
9,12,161,43,601,584,37,864,17,2307,2553,4860,11,6,201905
9,13,115,22,238,247,88,547,17,1274,1236,2510,4,6,201905
9,14,82,11,143,191,48,411,14,900,989,1889,5,6,201905
9,15,206,31,813,784,50,1383,27,3294,3277,6571,9,6.5,201905
9,16,231,58,461,667,128,728,1,2274,2244,4518,15,6,201905
9,17,130,16,253,331,28,340,1,1099,1202,2301,6,6,201905
9,18,172,34,404,475,65,855,8,2013,1881,3894,12,6,201905
9,19,174,27,336,357,135,596,20,1645,1595,3240,5,6,201905
9,20,64,6,142,148,22,207,4,593,629,1222,5,6,201905
9,21,159,17,239,356,61,236,136,1204,1157,2361,3,6,201905
9,22,141,14,227,236,79,444,23,1164,1435,2599,5,6,201905
9,23,140,26,335,414,93,607,5,1620,1572,3192,6,6,201905
9,24,257,36,494,637,55,1138,22,2639,2713,5352,12,6,201905
10,1,14,7,48,690,2,0,0,761,1179,1940,12,4,201905
10,2,105,11,59,1299,4,12,7,1497,1899,3396,9,5.25,201905
10,3,113,75,75,959,8,5,30,1265,1703,2968,11,5.4,201905
10,4,140,34,129,1260,3,8,0,1574,2022,3596,12,6.5,201905
11,1,242,44,257,284,29,707,0,1563,1606,3169,6,5.666666667,201905
11,2,202,31,296,241,30,542,9,1351,1768,3119,7,6,201905
11,3,113,39,171,186,17,593,47,1166,1116,2282,3,6,201905
11,4,153,46,224,241,11,540,0,1215,1136,2351,8,6,201905
11,5,254,72,344,512,21,720,14,1937,2291,4228,7,6,201905
11,6,155,28,227,237,41,563,3,1254,1490,2744,8,6,201905
11,7,241,48,354,442,35,401,0,1521,2038,3559,9,5.5,201905
11,8,268,71,448,538,27,761,31,2144,2223,4367,9,5.5,201905
11,9,266,93,325,429,18,581,79,1791,2068,3859,10,5.666666667,201905
11,10,273,56,318,322,25,958,5,1957,2089,4046,10,5.6,201905
11,11,203,95,362,474,17,263,0,1414,1620,3034,5,6,201905
11,12,242,58,527,585,14,794,2,2222,2773,4995,7,6,201905
11,13,280,56,251,319,32,491,173,1602,1535,3137,8,5.5,201905
11,14,220,44,374,280,28,785,16,1747,1934,3681,8,5.5,201905
11,15,161,87,248,255,12,462,4,1229,1298,2527,9,6,201905
12,1,221,37,259,164,46,467,6,1200,883,2083,10,5.2,201905
12,2,244,34,359,348,23,678,7,1693,1745,3438,10,5.5,201905
12,3,233,52,454,503,47,271,0,1560,1476,3036,11,5.2,201905
12,4,226,37,464,543,39,466,1,1776,1866,3642,9,5.666666667,201905
12,5,277,32,253,297,8,267,30,1164,1135,2299,10,5.25,201905
12,6,234,42,277,527,41,207,9,1337,1214,2551,10,5.25,201905
12,7,286,14,356,287,24,528,30,1525,1900,3425,6,5.5,201905
12,8,264,25,310,343,3,160,0,1105,1129,2234,9,5.25,201905
12,9,235,32,421,551,17,379,2,1637,1963,3600,9,5.666666667,201905
13,1,231,39,291,404,124,326,135,1550,1425,2975,9,5.333333333,201905
13,2,195,30,184,404,77,405,13,1308,1837,3145,6,5.333333333,201905
13,3,230,35,329,380,148,481,1,1604,1324,2928,12,5.25,201905
13,4,238,43,457,377,129,469,34,1747,1493,3240,9,5.666666667,201905
13,5,210,30,437,235,112,1039,6,2069,2384,4453,9,5.75,201905
13,6,279,90,863,733,63,782,28,2838,3382,6220,11,5.666666667,201905
13,7,196,37,488,565,69,451,0,1806,1718,3524,8,5.5,201905
14,1,117,58,179,52,62,372,205,1045,1151,2196,6,5.5,201905
14,2,134,15,218,159,17,620,14,1177,1003,2180,5,5.666666667,201905
14,3,201,40,345,139,59,707,66,1557,1360,2917,8,5.4,201905
14,4,223,22,396,474,20,864,10,2009,2391,4400,10,6,201905
14,5,248,44,650,445,86,491,3,1967,1863,3830,9,5.5,201905
14,6,197,12,455,235,24,737,8,1668,1878,3546,11,6,201905
14,7,79,6,148,88,0,362,0,683,1115,1798,6,6,201905
14,8,256,60,622,769,15,1826,22,3570,3947,7517,11,6.25,201905
14,9,172,30,319,335,46,863,4,1769,1646,3415,8,6,201905
14,10,171,16,298,233,6,729,4,1457,1405,2862,7,6,201905
14,11,96,9,94,118,16,469,6,808,1083,1891,4,6,201905
14,12,213,39,516,237,24,454,0,1483,1464,2947,9,5.5,201905
14,13,132,13,270,190,8,552,6,1171,1501,2672,6,6,201905
14,14,140,16,235,211,15,819,2,1438,1382,2820,7,6,201905
14,15,272,36,287,159,37,1069,46,1906,1649,3555,10,5.6,201905
14,16,127,14,209,136,29,610,5,1130,1190,2320,5,6,201905
14,17,152,92,237,241,53,295,66,1136,1276,2412,7,5.25,201905
14,18,211,66,406,636,28,458,6,1811,1958,3769,9,5.2,201905
14,19,213,84,417,438,52,578,86,1868,2317,4185,8,5.25,201905
14,20,216,28,369,255,31,847,23,1769,2009,3778,10,5.666666667,201905
15,1,206,26,285,134,332,904,22,1909,1687,3596,7,5.333333333,201905
15,2,164,30,353,391,61,472,14,1485,2163,3648,6,6,201905
15,3,256,41,214,420,130,811,8,1880,2232,4112,10,5.666666667,201905
15,4,129,21,180,199,22,620,10,1181,1320,2501,4,6,201905
15,5,171,46,315,293,24,656,61,1566,1927,3493,8,5.666666667,201905
15,6,155,16,383,427,38,632,12,1663,1893,3556,7,6,201905
15,7,153,21,217,301,43,540,1,1276,1738,3014,10,6,201905
15,8,118,10,231,293,36,407,7,1102,1072,2174,4,6,201905
15,9,281,19,155,187,142,553,16,1353,1306,2659,9,5.75,201905
15,10,146,9,270,271,53,603,14,1366,1434,2800,6,6,201905
15,11,160,23,343,345,55,614,2,1542,1804,3346,8,6,201905
15,12,260,24,701,515,40,664,0,2204,2245,4449,8,6,201905
15,13,81,7,135,139,61,387,1,811,1279,2090,8,6,201905
15,14,95,21,181,301,18,290,2,908,940,1848,4,6,201905
15,15,149,42,257,460,28,382,35,1353,2177,3530,6,6,201905
15,16,272,50,566,788,35,874,7,2592,2795,5387,8,6,201905
15,17,138,13,203,245,28,581,18,1226,1065,2291,8,6,201905
15,18,263,37,435,470,45,605,2,1857,2301,4158,7,5.666666667,201905
15,19,185,46,464,589,23,774,62,2143,2476,4619,10,6,201905
15,20,98,20,211,402,9,274,3,1017,1009,2026,6,6,201905
15,21,141,16,146,248,40,330,12,933,977,1910,6,5.5,201905
15,22,210,47,507,637,48,938,17,2404,2510,4914,14,6,201905
15,23,204,35,287,527,37,468,0,1558,1570,3128,6,5.333333333,201905
15,24,145,34,274,382,43,358,7,1243,1259,2502,4,6,201905
15,25,193,23,348,274,35,308,13,1194,1194,2388,6,6,201905
15,26,124,4,190,188,45,459,3,1013,1202,2215,9,11,201905
15,27,239,20,453,392,24,701,40,1869,1975,3844,9,5.666666667,201905
15,28,219,17,466,267,71,637,3,1680,1699,3379,9,5.666666667,201905
15,29,194,45,442,562,84,723,0,2050,2348,4398,8,6,201905
15,30,305,20,634,642,50,535,24,2210,2587,4797,16,6,201905
15,31,139,42,212,246,7,420,0,1066,1104,2170,6,6,201905
15,32,224,24,402,437,59,517,5,1668,1738,3406,9,6,201905
15,33,191,14,406,399,27,490,0,1527,1589,3116,7,6,201905
15,34,207,20,233,409,13,550,4,1436,2196,3632,8,6,201905
15,35,314,43,308,529,20,612,38,1864,1809,3673,9,5.666666667,201905
15,36,326,24,362,360,148,443,42,1705,2100,3805,9,5.5,201905
15,37,211,24,378,480,67,900,19,2079,1873,3952,7,6,201905
15,38,187,40,321,493,25,541,9,1616,1513,3129,6,5.5,201905
15,39,141,36,347,375,19,336,0,1254,1446,2700,4,6,201905
15,40,313,24,313,375,70,984,37,2116,2368,4484,9,5.666666667,201905
15,41,318,39,711,737,74,557,23,2459,2845,5304,11,5.75,201905
16,1,170,22,221,187,37,355,17,1009,1027,2036,7,5.333333333,201905
16,2,146,24,234,234,30,365,18,1051,972,2023,9,5.25,201905
16,3,198,11,225,236,30,558,11,1269,1380,2649,10,5.25,201905
16,4,173,34,243,270,82,523,1,1326,1506,2832,8,5.5,201905
16,5,224,31,256,260,40,540,9,1360,1532,2892,10,5.666666667,201905
16,6,259,34,312,273,51,420,0,1349,1187,2536,12,5.5,201905
16,7,255,42,298,277,34,522,4,1432,1384,2816,9,5.5,201905
16,8,281,45,576,629,16,706,2,2255,2493,4748,12,6,201905
16,9,215,16,292,230,15,639,5,1412,1665,3077,9,6,201905
16,10,197,30,431,398,17,780,1,1854,1993,3847,6,6,201905
16,11,189,42,307,201,157,534,27,1457,1593,3050,10,5.4,201905
16,12,199,22,228,174,14,500,5,1142,1116,2258,10,5.25,201905
17,1,204,22,415,364,22,813,9,1849,1760,3609,9,7,201905
17,2,154,10,371,309,15,424,4,1287,1710,2997,8,5.666666667,201905
17,3,261,12,402,389,15,689,4,1772,2197,3969,8,5.5,201905
17,4,253,16,404,336,34,741,15,1799,1955,3754,10,5.666666667,201905
17,5,151,22,172,186,21,309,2,863,993,1856,5,5.5,201905
18,1,193,19,284,224,20,367,56,1163,1250,2413,7,5.25,201905
18,2,263,23,559,350,68,980,2,2245,2650,4895,9,6.333333333,201905
18,3,179,16,483,240,15,467,0,1400,1627,3027,8,5.5,201905
19,1,170,12,278,248,14,961,9,1692,1727,3419,9,6,201905
19,2,204,17,504,265,23,861,0,1874,1961,3835,9,6,201905
19,3,240,18,483,351,25,727,2,1846,2017,3863,7,6,201905
19,4,86,10,119,90,27,669,13,1014,1028,2042,5,6,201905
19,5,298,50,433,482,16,1297,32,2608,2538,5146,8,6,201905
19,6,79,13,195,174,6,704,26,1197,1263,2460,5,6,201905
19,7,225,14,512,260,20,663,2,1696,1399,3095,10,5.5,201905
19,8,86,14,197,236,5,439,10,987,917,1904,7,6,201905
19,9,180,22,271,290,51,714,1,1529,1254,2783,9,5.25,201905
19,10,101,21,198,201,15,157,526,1219,1165,2384,7,8,201905
19,11,251,50,437,642,26,1434,106,2946,3176,6122,13,6,201905
19,12,195,14,462,238,18,611,4,1542,1685,3227,8,5.666666667,201905
20,1,224,20,391,215,60,467,26,1403,1262,2665,7,5.5,201905
20,2,166,27,246,278,11,112,10,850,729,1579,6,5.333333333,201905
20,3,149,13,178,155,53,279,24,851,1015,1866,6,5.333333333,201905
20,4,117,18,143,210,34,258,3,783,920,1703,6,5.333333333,201905
20,5,171,17,396,408,33,288,11,1324,1515,2839,11,5.25,201905
20,6,100,18,133,322,207,113,1,894,1217,2111,8,5.25,201905
20,7,151,15,290,274,23,452,0,1205,1210,2415,7,5.75,201905
20,8,469,42,618,833,66,1349,76,3453,3914,7367,15,7,201905
20,9,307,39,279,213,73,430,300,1641,2013,3654,8,5.666666667,201905
20,10,251,16,222,407,16,239,4,1155,1282,2437,9,5.25,201905
21,1,242,15,324,493,23,164,1,1262,1210,2472,9,5.4,201905
21,2,198,25,316,353,127,322,3,1344,1273,2617,9,5.2,201905
21,3,283,32,518,331,181,379,71,1795,1848,3643,8,5.5,201905
21,4,178,11,214,114,70,214,24,825,1032,1857,6,5.25,201905
21,5,264,21,521,448,20,370,28,1672,1728,3400,8,5.666666667,201905
21,6,201,15,366,416,45,450,102,1595,1633,3228,6,6,201905
21,7,295,20,444,495,131,335,0,1720,1387,3107,9,5.666666667,201905
21,8,157,20,307,193,63,311,50,1101,1196,2297,9,5.2,201905
21,9,240,23,603,645,116,464,94,2185,2252,4437,9,6,201905
21,10,193,15,431,372,83,366,56,1516,1492,3008,7,5.5,201905
21,11,80,6,245,206,26,142,44,749,682,1431,5,7,201905
21,12,335,38,917,872,126,813,122,3223,3422,6645,16,6.5,201905
21,13,232,13,304,242,51,575,40,1457,1323,2780,8,5.666666667,201905
21,14,248,18,304,188,121,382,80,1341,1615,2956,12,5.333333333,201905
21,15,276,27,516,375,98,335,43,1670,1852,3522,7,5.5,201905
22,1,241,68,291,464,29,342,19,1454,1416,2870,11,5.2,201905
22,2,148,32,312,273,52,372,7,1196,1490,2686,7,5.5,201905
22,3,322,82,994,679,47,803,10,2937,2898,5835,9,5.666666667,201905
22,4,235,46,724,483,27,876,5,2396,2551,4947,9,6.5,201905
22,5,205,34,507,267,89,545,4,1651,1666,3317,10,5.5,201905
23,1,64,2,189,1004,7,14,0,1280,1983,3263,14,5.6,201905
23,2,53,1,6,898,1,3,0,962,2076,3038,8,5.25,201905
23,3,46,7,106,605,3,5,106,878,2572,3450,15,6,201905
23,4,52,5,293,541,40,5,37,973,1569,2542,8,5.666666667,201905
24,1,224,64,286,303,32,402,10,1321,1205,2526,10,5.2,201905
24,2,157,17,265,208,16,529,5,1197,1558,2755,6,5.5,201905
24,3,247,50,314,318,91,347,9,1376,1336,2712,9,5.25,201905
24,4,194,16,190,148,37,665,20,1270,1118,2388,5,5.5,201905
24,5,291,62,528,676,23,702,33,2315,2234,4549,10,6.333333333,201905
24,6,214,63,402,454,31,755,0,1919,1973,3892,7,7,201905
24,7,300,32,354,484,80,333,0,1583,1463,3046,9,5.25,201905
25,1,229,63,386,351,87,678,13,1807,2150,3957,13,5.75,201905
25,2,237,56,439,413,31,980,1,2157,2285,4442,7,5.5,201905
25,3,282,14,403,349,36,694,14,1792,1670,3462,8,5.6,201905
25,4,174,22,243,283,8,709,6,1445,1160,2605,8,5.333333333,201905
25,5,211,26,709,541,54,731,136,2408,2496,4904,8,5.333333333,201905
25,6,231,11,406,319,50,890,4,1911,2044,3955,8,5.75,201905
25,7,223,18,704,402,32,873,3,2255,2272,4527,6,6,201905
26,1,197,12,483,255,28,626,0,1601,999,2600,9,5.5,201905
26,2,217,18,466,430,8,568,36,1743,1804,3547,12,5.4,201905
26,3,198,13,288,366,17,1009,6,1897,2185,4082,14,6.5,201905
26,4,110,8,138,224,17,480,4,981,952,1933,9,5.2,201905
26,5,119,11,181,178,19,603,0,1111,1215,2326,14,5.5,201905
26,6,136,14,277,209,11,679,0,1326,1648,2974,10,5.333333333,201905
26,7,162,15,304,350,45,389,1,1266,1242,2508,10,5.5,201905
27,1,278,32,454,503,60,429,55,1811,1613,3424,8,5.5,201905
27,2,298,26,422,618,63,353,1,1781,1707,3488,8,5.666666667,201905
27,3,283,17,386,529,23,540,1,1779,1488,3267,7,5.666666667,201905
27,4,315,17,439,716,19,699,24,2229,2146,4375,8,6,201905
27,5,169,9,221,393,19,241,52,1104,744,1848,6,5.333333333,201905
27,6,208,33,305,521,15,383,0,1465,1538,3003,7,5.5,201905
28,1,19,0,0,1237,0,7,0,1263,2373,3636,13,6,201905
28,2,23,6,52,1169,2,11,71,1334,2124,3458,13,5.666666667,201905
28,3,25,14,20,557,1,1,2,620,905,1525,7,5.333333333,201905
28,4,0,0,0,1343,0,2,0,1345,2921,4266,15,6,201905
28,5,27,21,51,1203,6,19,70,1397,2163,3560,10,6.5,201905
28,6,84,11,14,781,1,4,4,899,1795,2694,14,5.166666667,201905
28,7,53,19,162,1385,10,28,8,1665,2283,3948,8,6,201905
28,8,23,30,69,1182,14,22,18,1358,1657,3015,9,6,201905
28,9,118,9,31,266,4,4,239,671,1251,1922,11,5.75,201905
29,1,266,37,356,386,63,508,7,1623,2158,3781,7,5.5,201905
29,2,274,24,483,334,69,727,35,1946,2204,4150,11,6,201905
29,3,173,31,212,368,27,431,0,1242,1230,2472,5,5.666666667,201905
30,1,186,32,291,368,29,256,209,1371,1532,2903,7,5.333333333,201905
30,2,264,35,233,122,77,193,406,1330,1789,3119,8,5.25,201905
30,3,208,14,386,151,85,742,102,1688,2428,4116,6,5.666666667,201905
30,4,152,8,312,160,36,448,0,1116,1121,2237,8,6,201905
30,5,187,19,220,297,38,729,0,1490,1348,2838,7,5.5,201905
30,6,257,19,440,253,63,514,2,1548,1363,2911,9,5.333333333,201905
30,7,280,31,395,289,34,629,115,1773,1899,3672,11,5.25,201905
30,8,289,47,420,364,108,841,90,2159,2545,4704,11,5.4,201905
30,9,256,10,295,172,53,734,30,1550,1460,3010,8,5.5,201905
30,10,267,20,478,375,33,1115,20,2308,2598,4906,7,6.5,201905
30,11,157,15,399,390,12,578,11,1562,1690,3252,5,5.5,201905
30,12,250,25,592,548,38,1174,1,2628,3073,5701,10,6,201905
30,13,303,21,283,342,75,1079,90,2193,1808,4001,10,5.4,201905
30,14,228,41,563,229,101,660,37,1859,1777,3636,8,5.5,201905
30,15,305,22,260,230,53,712,135,1717,1472,3189,11,5.666666667,201905
30,16,233,11,349,259,79,905,38,1874,1949,3823,10,5.333333333,201905
30,17,252,17,346,257,61,716,12,1661,1442,3103,8,5.5,201905
30,18,243,18,144,205,38,383,111,1142,1080,2222,8,5.25,201905
30,19,243,13,320,359,15,674,7,1631,1771,3402,13,5.6,201905
30,20,216,20,469,514,177,467,5,1868,1728,3596,10,5.4,201905
31,1,262,54,251,72,366,482,1,1488,908,2396,8,5.5,201905
31,2,129,16,214,3,180,593,1,1136,880,2016,6,5.333333333,201905
31,3,479,54,1072,601,180,1721,2,4109,4034,8143,21,6.333333333,201905
31,4,92,14,240,153,69,606,31,1205,1197,2402,5,7,201905
31,5,186,12,200,289,35,678,57,1457,1059,2516,6,5.333333333,201905
32,1,187,30,176,192,29,697,30,1341,1613,2954,12,5.2,201905
32,2,218,53,208,97,88,1028,22,1714,1549,3263,13,5.142857143,201905
32,3,164,57,248,299,9,798,28,1603,1749,3352,13,5.4,201905
32,4,206,135,307,417,39,399,134,1637,2100,3737,13,5.4,201905
1,1,51,39,155,138,52,49,30,514,901,1415,13,4.5,201906
1,2,71,38,323,285,29,104,7,857,1432,2289,10,5.333333333,201906
1,3,74,54,331,299,12,100,69,939,1402,2341,9,5,201906
2,1,82,22,358,661,18,61,14,1216,1833,3049,11,5,201906
2,2,94,20,317,699,12,79,0,1221,1695,2916,8,5.5,201906
2,3,155,55,452,401,35,111,143,1352,1668,3020,12,5,201906
2,4,67,11,316,160,34,26,21,635,673,1308,9,5,201906
2,5,133,47,568,214,239,91,122,1414,1911,3325,13,5,201906
2,6,105,26,399,426,21,61,3,1041,1217,2258,7,5,201906
2,7,158,24,504,268,43,78,234,1309,840,2149,12,4.75,201906
2,8,94,23,402,199,8,49,147,922,1439,2361,8,5,201906
3,1,114,3,336,309,11,534,6,1313,1422,2735,12,4.666666667,201906
3,2,92,6,389,184,18,245,2,936,1125,2061,9,4.666666667,201906
4,1,128,14,273,277,62,501,19,1274,1671,2945,11,4.25,201906
4,2,173,22,462,387,22,365,13,1444,1836,3280,14,4.2,201906
5,1,170,14,306,262,39,501,3,1295,1553,2848,9,4.666666667,201906
5,2,154,26,320,280,24,514,8,1326,1810,3136,10,4.2,201906
5,3,139,16,249,291,33,635,7,1370,1259,2629,9,4.5,201906
5,4,147,25,409,384,21,763,25,1774,1884,3658,9,4.666666667,201906
5,5,148,25,352,362,20,525,30,1462,1582,3044,8,5,201906
5,6,108,14,261,288,12,330,21,1034,1805,2839,11,4.5,201906
5,7,140,17,282,289,6,351,9,1094,1023,2117,10,4.5,201906
6,1,128,33,389,202,10,834,4,1600,1828,3428,12,5,201906
6,2,102,15,313,135,27,572,4,1168,1438,2606,9,4.666666667,201906
7,1,118,12,155,256,3,99,16,659,431,1090,9,4.25,201906
7,2,217,9,110,532,43,55,2,968,694,1662,9,4.25,201906
7,3,236,9,218,370,117,175,5,1130,1111,2241,7,4.333333333,201906
7,4,196,13,191,632,19,149,89,1289,653,1942,11,4.4,201906
7,5,274,11,157,475,12,245,8,1182,871,2053,11,4.666666667,201906
7,6,240,21,308,405,38,408,59,1479,1618,3097,9,4.666666667,201906
7,7,180,13,260,333,14,315,6,1121,1474,2595,8,4.5,201906
7,8,218,10,168,452,16,274,5,1143,1223,2366,11,4.25,201906
7,9,125,31,266,366,28,419,2,1237,1266,2503,9,4.666666667,201906
7,10,168,10,187,557,17,141,2,1082,767,1849,9,4.5,201906
7,11,141,5,77,124,7,63,21,438,403,841,6,4.333333333,201906
7,12,204,8,334,513,8,227,0,1294,1600,2894,9,4.5,201906
7,13,63,10,104,267,0,86,0,530,247,777,9,4.25,201906
8,1,117,7,334,173,16,315,5,967,1087,2054,4,5,201906
8,2,229,43,691,529,34,302,27,1855,1966,3821,16,4.5,201906
8,3,134,19,296,252,27,455,7,1190,1445,2635,4,5,201906
8,4,122,30,351,255,28,693,31,1510,1190,2700,11,5,201906
8,5,174,26,316,363,18,449,4,1350,1442,2792,10,4.25,201906
8,6,168,30,325,373,31,687,4,1618,2694,4312,7,5.5,201906
8,7,119,28,160,230,5,377,1,920,1155,2075,7,4.25,201906
8,8,148,33,318,360,7,675,0,1541,1910,3451,11,6,201906
8,9,188,20,230,165,19,639,6,1267,1256,2523,10,4.2,201906
9,1,44,5,103,71,42,292,4,561,674,1235,5,5,201906
9,2,195,82,631,764,101,1113,18,2904,3634,6538,12,5,201906
9,3,90,17,264,292,43,574,10,1290,1567,2857,7,5,201906
9,4,144,20,394,508,71,595,11,1743,1895,3638,11,5,201906
9,5,86,12,190,239,30,381,11,949,944,1893,7,5,201906
9,6,77,13,167,141,55,332,8,793,795,1588,7,5,201906
9,7,69,9,179,253,1,338,0,849,1108,1957,9,5,201906
9,8,69,19,254,201,15,378,0,936,1776,2712,5,5,201906
9,9,72,9,218,234,42,359,2,936,1066,2002,5,5,201906
9,10,69,10,271,268,18,450,1,1087,929,2016,6,5,201906
9,11,133,11,342,421,48,604,2,1561,1853,3414,7,5,201906
9,12,128,29,515,505,23,716,17,1933,2084,4017,11,5,201906
9,13,98,5,220,221,71,454,3,1072,1127,2199,4,5,201906
9,14,59,6,148,152,48,345,8,766,908,1674,5,5,201906
9,15,133,31,709,681,29,1145,12,2740,2771,5511,10,6,201906
9,16,159,37,377,585,101,680,0,1939,2202,4141,15,5,201906
9,17,82,7,194,246,24,303,2,858,1059,1917,6,5,201906
9,18,118,15,330,429,47,696,1,1636,1844,3480,12,5,201906
9,19,138,20,344,328,95,522,3,1450,1566,3016,5,5,201906
9,20,51,2,115,141,17,177,2,505,616,1121,5,5,201906
9,21,91,19,185,272,41,279,69,956,1132,2088,3,5,201906
9,22,105,8,205,237,67,368,22,1012,2109,3121,5,5,201906
9,23,102,18,243,350,41,499,3,1256,1300,2556,6,5,201906
9,24,169,16,405,516,89,903,18,2116,2801,4917,12,5,201906
10,1,25,5,26,15,4,9,8,92,930,1022,8,2.333333333,201906
10,2,131,61,282,187,32,53,106,852,1526,2378,9,4.25,201906
10,3,85,33,112,82,10,31,207,560,1002,1562,11,4.4,201906
10,4,88,47,433,517,13,62,7,1167,1508,2675,12,5.5,201906
11,1,190,33,203,244,20,489,2,1181,1424,2605,6,4.666666667,201906
11,2,142,25,225,192,27,429,9,1049,1639,2688,7,5,201906
11,3,94,26,168,194,10,413,25,930,1143,2073,3,5,201906
11,4,154,32,168,199,26,483,0,1062,1265,2327,8,5,201906
11,5,158,59,282,426,16,574,8,1523,2092,3615,7,5,201906
11,6,141,32,201,221,41,508,4,1148,1254,2402,8,5,201906
11,7,225,41,305,421,21,425,0,1438,1625,3063,9,4.5,201906
11,8,207,39,335,359,23,601,19,1583,1944,3527,9,4.5,201906
11,9,184,90,319,369,13,604,21,1600,1956,3556,10,4.666666667,201906
11,10,231,38,244,226,24,830,3,1596,2065,3661,10,4.6,201906
11,11,154,58,323,381,12,320,2,1250,1345,2595,5,5,201906
11,12,174,31,455,504,3,609,0,1776,2259,4035,7,5,201906
11,13,128,31,174,257,29,400,130,1149,1841,2990,8,4.5,201906
11,14,144,37,242,175,17,709,10,1334,1887,3221,8,4.5,201906
11,15,117,43,183,220,7,435,1,1006,1114,2120,9,5,201906
12,1,147,24,245,99,26,342,4,887,966,1853,10,4.2,201906
12,2,199,33,291,291,24,482,2,1322,1532,2854,10,4.5,201906
12,3,218,32,422,436,38,244,4,1394,1489,2883,11,4.2,201906
12,4,182,33,370,501,26,373,0,1485,1726,3211,9,4.666666667,201906
12,5,289,27,215,306,3,236,18,1094,827,1921,10,4.25,201906
12,6,156,30,132,477,29,89,5,918,761,1679,10,4.25,201906
12,7,195,17,265,283,9,547,22,1338,1344,2682,6,4.5,201906
12,8,250,25,237,313,6,175,0,1006,999,2005,9,4.25,201906
12,9,200,24,429,488,23,294,0,1458,1507,2965,9,4.666666667,201906
13,1,165,23,221,242,67,420,22,1160,2246,3406,9,4.333333333,201906
13,2,112,27,160,248,43,370,4,964,1030,1994,6,4.333333333,201906
13,3,132,30,200,293,105,320,12,1092,1149,2241,12,4.25,201906
13,4,216,27,383,308,141,407,17,1499,1619,3118,9,4.666666667,201906
13,5,149,18,300,151,56,752,2,1428,1950,3378,9,4.75,201906
13,6,202,60,727,601,54,602,13,2259,2645,4904,11,4.666666667,201906
13,7,114,23,346,396,43,394,0,1316,1353,2669,8,4.5,201906
14,1,88,13,98,49,27,471,52,798,908,1706,6,4.5,201906
14,2,92,14,117,65,5,653,2,948,1071,2019,5,4.666666667,201906
14,3,131,39,229,135,39,654,22,1249,1638,2887,8,4.4,201906
14,4,158,21,293,352,19,685,5,1533,2271,3804,10,5,201906
14,5,145,22,300,236,29,482,3,1217,1288,2505,9,4.5,201906
14,6,189,18,371,226,16,638,2,1460,1655,3115,11,5,201906
14,7,71,5,121,81,0,284,0,562,718,1280,6,5,201906
14,8,217,43,542,697,11,1475,4,2989,3220,6209,11,5.25,201906
14,9,121,20,220,238,19,757,1,1376,1324,2700,8,5,201906
14,10,114,11,283,183,4,626,1,1222,1235,2457,7,5,201906
14,11,65,6,95,87,15,381,8,657,869,1526,4,5,201906
14,12,204,16,385,164,9,375,0,1153,1163,2316,9,4.5,201906
14,13,123,9,215,157,7,533,3,1047,1341,2388,6,5,201906
14,14,117,12,224,150,10,758,3,1274,1211,2485,7,5,201906
14,15,201,42,207,155,37,878,9,1529,1599,3128,10,4.6,201906
14,16,92,8,167,109,9,567,4,956,962,1918,5,5,201906
14,17,141,23,135,104,17,603,11,1034,702,1736,7,4.25,201906
14,18,189,68,369,409,28,451,2,1516,1793,3309,9,4.4,201906
14,19,150,42,267,249,30,460,40,1238,1654,2892,8,4.25,201906
14,20,162,13,292,186,16,682,1,1352,1740,3092,10,4.666666667,201906
15,1,192,12,249,127,157,731,16,1484,1162,2646,7,4.333333333,201906
15,2,150,15,266,337,36,397,16,1217,1330,2547,6,5,201906
15,3,163,21,180,231,118,801,4,1518,1889,3407,10,4.666666667,201906
15,4,119,8,178,161,16,512,13,1007,1166,2173,4,5,201906
15,5,136,37,239,224,17,522,26,1201,1455,2656,8,4.666666667,201906
15,6,118,12,317,378,26,491,8,1350,1628,2978,7,5,201906
15,7,87,10,213,207,27,478,0,1022,1764,2786,10,5,201906
15,8,74,17,205,233,31,328,5,893,1017,1910,4,5,201906
15,9,172,11,93,113,100,452,11,952,1067,2019,9,4.75,201906
15,10,88,12,232,215,50,460,8,1065,1295,2360,6,5,201906
15,11,123,16,289,262,45,468,2,1205,1502,2707,8,5,201906
15,12,193,25,555,396,44,517,0,1730,2061,3791,8,5,201906
15,13,41,7,109,88,36,321,0,602,1054,1656,8,5,201906
15,14,82,24,165,230,13,259,0,773,780,1553,4,5,201906
15,15,93,28,224,354,22,357,4,1082,1540,2622,6,5,201906
15,16,213,48,439,699,25,646,6,2076,2565,4641,8,5,201906
15,17,96,13,196,224,13,470,34,1046,951,1997,8,5,201906
15,18,155,21,294,376,45,485,4,1380,1676,3056,7,4.666666667,201906
15,19,113,47,337,531,18,509,22,1577,2888,4465,10,5,201906
15,20,63,12,172,301,17,207,5,777,1027,1804,6,5,201906
15,21,102,8,143,204,42,213,4,716,1192,1908,6,4.5,201906
15,22,168,34,427,532,29,883,14,2087,2353,4440,14,5,201906
15,23,137,29,211,333,12,451,0,1173,1310,2483,6,4.333333333,201906
15,24,106,22,237,275,27,301,6,974,1146,2120,4,5,201906
15,25,133,30,259,248,26,278,8,982,1184,2166,6,5,201906
15,26,94,4,169,137,26,395,1,826,830,1656,9,6,201906
15,27,155,16,304,361,15,671,27,1549,1524,3073,9,4.666666667,201906
15,28,132,23,359,250,34,562,5,1365,1394,2759,9,4.666666667,201906
15,29,150,16,399,555,12,679,0,1811,1621,3432,8,5,201906
15,30,195,34,483,494,29,407,8,1650,2072,3722,16,5,201906
15,31,79,27,183,224,10,311,0,834,1413,2247,6,5,201906
15,32,169,8,363,355,34,399,3,1331,1633,2964,9,5,201906
15,33,136,13,267,323,25,416,0,1180,1425,2605,7,5,201906
15,34,101,18,209,311,12,435,2,1088,1519,2607,8,5,201906
15,35,212,16,245,375,7,540,5,1400,1505,2905,9,4.666666667,201906
15,36,181,17,257,285,135,427,25,1327,1432,2759,9,4.5,201906
15,37,156,18,309,351,44,652,13,1543,2099,3642,7,5,201906
15,38,152,40,279,467,17,443,2,1400,1519,2919,6,4.5,201906
15,39,123,29,266,345,21,286,1,1071,1289,2360,4,5,201906
15,40,236,19,260,369,47,955,29,1915,2196,4111,9,5,201906
15,41,192,45,610,644,52,422,31,1996,3084,5080,11,5,201906
16,1,103,23,223,136,22,280,2,789,776,1565,7,4.333333333,201906
16,2,114,18,169,191,19,318,2,831,1206,2037,9,4.25,201906
16,3,120,14,174,213,6,322,7,856,1048,1904,10,4.25,201906
16,4,129,11,132,89,36,566,1,964,1074,2038,8,4.5,201906
16,5,159,13,173,172,19,553,5,1094,1021,2115,10,4.666666667,201906
16,6,142,36,177,243,19,334,0,951,1424,2375,12,4.5,201906
16,7,168,28,215,289,41,410,0,1151,1177,2328,9,4.5,201906
16,8,193,34,454,435,13,607,1,1737,2039,3776,12,5,201906
16,9,158,18,194,180,10,563,5,1128,1165,2293,9,5,201906
16,10,163,17,370,304,14,587,0,1455,1573,3028,6,5,201906
16,11,168,27,224,139,123,569,26,1276,1615,2891,10,4.4,201906
16,12,140,16,201,125,22,317,0,821,1111,1932,10,4.25,201906
17,1,123,13,277,261,7,600,1,1282,2668,3950,9,6,201906
17,2,127,9,306,273,15,425,1,1156,1384,2540,8,4.666666667,201906
17,3,206,14,387,368,15,572,0,1562,1736,3298,8,4.5,201906
17,4,157,25,351,278,21,631,14,1477,1385,2862,10,4.666666667,201906
17,5,106,2,139,146,5,228,2,628,683,1311,5,4.5,201906
18,1,118,21,159,166,27,334,58,883,951,1834,7,4.25,201906
18,2,177,21,426,345,61,785,0,1815,2208,4023,9,5.333333333,201906
18,3,137,32,362,257,10,444,0,1242,1053,2295,8,4.5,201906
19,1,115,11,246,215,13,845,5,1450,1269,2719,9,5,201906
19,2,165,11,467,238,14,730,0,1625,1900,3525,9,5,201906
19,3,158,14,376,274,16,647,0,1485,1548,3033,7,5,201906
19,4,57,5,93,83,14,538,10,800,829,1629,5,5,201906
19,5,182,24,362,398,15,1127,14,2122,2214,4336,8,5,201906
19,6,56,10,177,169,2,617,2,1033,946,1979,5,5,201906
19,7,151,14,407,224,4,431,0,1231,1232,2463,10,4.5,201906
19,8,63,7,147,180,5,342,1,745,829,1574,7,5,201906
19,9,81,18,179,185,22,520,2,1007,872,1879,9,4.25,201906
19,10,71,14,156,169,5,130,427,972,1006,1978,7,7,201906
19,11,173,59,345,531,24,1184,54,2370,2595,4965,13,5,201906
19,12,151,13,481,177,12,527,0,1361,1602,2963,8,4.666666667,201906
20,1,152,10,304,161,31,265,26,949,1096,2045,7,4.5,201906
20,2,160,23,201,353,15,87,16,855,299,1154,6,4.333333333,201906
20,3,127,15,182,126,101,229,61,841,503,1344,6,4.333333333,201906
20,4,137,11,187,238,28,234,5,840,773,1613,6,4.333333333,201906
20,5,205,25,329,407,48,345,32,1391,1061,2452,11,4.25,201906
20,6,148,10,119,247,130,91,4,749,441,1190,8,4.25,201906
20,7,150,12,207,320,28,375,0,1092,988,2080,7,4.75,201906
20,8,322,39,545,729,45,1076,71,2827,2851,5678,13,5,201906
20,9,170,18,219,248,39,497,28,1219,1409,2628,8,4.666666667,201906
20,10,224,16,310,535,12,292,3,1392,774,2166,9,4.25,201906
21,1,176,17,209,330,15,19,1,767,1116,1883,9,4.4,201906
21,2,170,25,308,342,151,39,2,1037,929,1966,9,4.2,201906
21,3,201,29,442,247,146,58,86,1209,1082,2291,8,4.5,201906
21,4,164,16,266,167,185,36,6,840,728,1568,6,4.25,201906
21,5,174,23,374,316,27,64,44,1022,1623,2645,8,4.666666667,201906
21,6,139,14,236,219,39,51,149,847,1320,2167,6,5,201906
21,7,192,13,253,287,94,34,26,899,1417,2316,9,4.666666667,201906
21,8,179,17,457,102,167,44,61,1027,741,1768,9,4.2,201906
21,9,126,29,493,462,127,77,199,1513,1872,3385,9,5,201906
21,10,126,24,402,180,78,79,237,1126,1439,2565,7,4.5,201906
21,11,62,9,177,78,29,23,55,433,617,1050,4,5,201906
21,12,213,27,810,481,181,102,142,1956,2749,4705,16,5.5,201906
21,13,134,14,224,89,58,305,65,889,1103,1992,8,4.666666667,201906
21,14,128,18,235,120,126,29,118,774,1256,2030,12,4.333333333,201906
21,15,153,21,422,333,90,49,93,1161,1275,2436,7,4.5,201906
22,1,171,51,271,358,57,259,1,1168,1148,2316,11,4.2,201906
22,2,91,18,234,190,22,361,3,919,1215,2134,7,4.5,201906
22,3,215,55,806,611,28,660,1,2376,2251,4627,9,4.666666667,201906
22,4,177,38,569,443,23,687,2,1939,2196,4135,9,5.5,201906
22,5,150,26,420,204,46,389,4,1239,1428,2667,10,4.5,201906
23,1,77,6,669,254,35,49,0,1090,1199,2289,14,4.6,201906
23,2,102,20,216,260,15,15,0,628,1196,1824,8,4.25,201906
23,3,60,7,280,8,11,14,58,438,1332,1770,15,5,201906
23,4,54,6,311,112,30,20,30,563,812,1375,8,4.666666667,201906
24,1,129,58,175,247,21,246,7,883,763,1646,10,4.2,201906
24,2,117,24,210,166,15,378,3,913,1174,2087,6,4.5,201906
24,3,148,27,187,208,42,229,7,848,1181,2029,9,4.25,201906
24,4,61,12,147,151,18,427,11,827,912,1739,5,4.5,201906
24,5,224,37,396,505,20,655,34,1871,2226,4097,10,5.333333333,201906
24,6,170,31,375,377,25,674,0,1652,1626,3278,7,6,201906
24,7,184,36,259,399,50,261,0,1189,1180,2369,9,4.25,201906
25,1,134,12,251,240,26,707,14,1384,1462,2846,13,4.75,201906
25,2,215,30,361,378,24,807,0,1815,2072,3887,7,4.5,201906
25,3,152,8,257,327,20,628,6,1398,1634,3032,8,4.6,201906
25,4,137,18,194,271,10,568,0,1198,1455,2653,8,4.333333333,201906
25,5,176,15,575,381,35,682,76,1940,2272,4212,8,4.666666667,201906
25,6,188,4,320,235,63,623,36,1469,1634,3103,8,4.75,201906
25,7,200,32,520,374,23,702,0,1851,2188,4039,6,5,201906
26,1,137,6,358,199,11,507,0,1218,1397,2615,9,4.5,201906
26,2,186,8,381,355,8,414,8,1360,1673,3033,12,4.4,201906
26,3,170,15,250,280,5,813,9,1542,1559,3101,14,5.5,201906
26,4,92,8,152,195,13,388,2,850,965,1815,9,4.2,201906
26,5,100,8,167,152,17,525,1,970,1264,2234,14,4.5,201906
26,6,96,9,225,174,4,614,0,1122,1368,2490,10,4.333333333,201906
26,7,152,15,238,289,45,327,2,1068,1009,2077,10,4.5,201906
27,1,141,14,334,384,49,333,19,1274,1144,2418,8,4.5,201906
27,2,177,20,353,487,17,366,0,1420,1170,2590,8,4.666666667,201906
27,3,164,21,347,451,21,438,0,1442,1658,3100,7,4.666666667,201906
27,4,160,19,448,625,10,566,23,1851,1388,3239,8,5,201906
27,5,133,5,183,386,19,240,15,981,538,1519,6,4.333333333,201906
27,6,150,18,278,387,6,398,0,1237,1405,2642,7,4.5,201906
28,1,1,0,2,262,0,2,0,267,1924,2191,13,5,201906
28,2,72,31,203,20,23,50,235,634,1404,2038,14,5,201906
28,3,63,34,182,380,7,29,40,735,990,1725,7,4.333333333,201906
28,4,80,32,254,65,85,52,308,876,1434,2310,15,4.6,201906
28,5,46,50,169,123,21,39,268,716,1859,2575,9,4.25,201906
28,6,65,11,70,149,19,19,11,344,1046,1390,14,4.166666667,201906
28,7,81,46,418,378,46,107,23,1099,1455,2554,13,5,201906
28,8,48,72,181,337,49,70,117,874,1837,2711,9,5,201906
28,9,64,9,189,91,25,31,144,553,503,1056,11,4.75,201906
29,1,194,31,289,326,58,390,17,1305,1415,2720,7,4.5,201906
29,2,173,17,354,333,43,539,35,1494,2093,3587,11,5,201906
29,3,122,21,207,265,20,323,0,958,1148,2106,5,4.666666667,201906
30,1,95,30,249,284,8,179,193,1038,1066,2104,7,4.333333333,201906
30,2,169,25,229,121,37,151,339,1071,1389,2460,8,4.25,201906
30,3,138,12,295,119,45,765,35,1409,1717,3126,6,4.666666667,201906
30,4,100,8,226,130,28,445,1,938,1004,1942,8,5,201906
30,5,107,22,204,218,24,594,0,1169,1326,2495,7,4.5,201906
30,6,184,12,245,238,45,404,11,1139,1287,2426,9,4.333333333,201906
30,7,143,21,202,182,30,297,107,982,1149,2131,11,4.25,201906
30,8,222,35,351,300,87,953,65,2013,1844,3857,11,4.4,201906
30,9,212,6,212,158,41,556,46,1231,1198,2429,8,4.5,201906
30,10,144,17,375,288,24,599,13,1460,2044,3504,6,5,201906
30,11,148,20,363,379,13,649,21,1593,1440,3033,5,4.5,201906
30,12,175,11,444,413,19,885,1,1948,2389,4337,10,5,201906
30,13,147,13,218,208,68,661,50,1365,1859,3224,10,4.4,201906
30,14,183,35,525,164,99,525,43,1574,1970,3544,8,4.5,201906
30,15,180,12,182,181,27,822,27,1431,1593,3024,11,4.666666667,201906
30,16,168,13,311,281,47,977,43,1840,1789,3629,10,4.333333333,201906
30,17,175,12,298,245,39,654,23,1446,1085,2531,8,4.5,201906
30,18,185,10,134,180,12,333,21,875,685,1560,8,4.25,201906
30,19,230,15,343,294,23,558,8,1471,1448,2919,13,4.6,201906
30,20,155,20,350,417,152,336,5,1435,1559,2994,10,4.4,201906
31,1,122,16,217,18,228,518,0,1119,1043,2162,8,4.5,201906
31,2,63,11,138,2,170,449,0,833,912,1745,6,4.333333333,201906
31,3,275,43,840,431,148,1426,2,3165,3718,6883,21,5.333333333,201906
31,4,67,8,214,152,55,502,23,1021,1026,2047,4,5,201906
31,5,180,13,166,206,30,466,64,1125,985,2110,6,4.333333333,201906
32,1,152,46,171,170,31,550,20,1140,1312,2452,12,4.2,201906
32,2,164,28,155,70,85,618,27,1147,1332,2479,13,4.142857143,201906
32,3,203,53,238,328,12,677,9,1520,1977,3497,13,4.4,201906
32,4,185,104,249,330,30,505,79,1482,1974,3456,13,4.4,201906
1,1,71,42,194,311,52,53,28,751,586,1337,13,5.5,201907
1,2,75,29,372,795,37,102,26,1436,795,2231,10,6.333333333,201907
1,3,68,62,421,651,42,98,86,1428,972,2400,9,6,201907
2,1,87,25,405,779,30,84,12,1422,1352,2774,11,6,201907
2,2,96,22,409,702,10,109,0,1348,1540,2888,8,6.5,201907
2,3,154,45,430,402,24,92,200,1347,1184,2531,12,5.666666667,201907
2,4,69,8,395,183,44,37,22,758,271,1029,9,6,201907
2,5,149,28,689,258,280,103,154,1661,862,2523,13,6,201907
2,6,113,18,385,401,18,55,3,993,598,1591,7,6,201907
2,7,143,36,543,176,32,92,266,1288,571,1859,12,5.75,201907
2,8,105,16,375,478,10,60,158,1202,620,1822,8,5.5,201907
3,1,158,11,378,299,18,615,4,1483,1411,2894,12,5.666666667,201907
3,2,145,9,468,214,25,289,0,1150,1119,2269,9,5.666666667,201907
4,1,162,11,365,354,55,612,31,1590,1374,2964,11,5.25,201907
4,2,203,12,446,350,51,440,17,1519,1827,3346,14,5.2,201907
5,1,222,13,424,320,24,541,5,1549,1503,3052,9,5.666666667,201907
5,2,219,23,418,343,35,489,2,1529,1632,3161,10,5.2,201907
5,3,127,18,214,276,46,470,1,1152,1338,2490,8,6.333333333,201907
5,4,176,25,481,401,26,831,19,1959,1844,3803,9,5.666666667,201907
5,5,194,16,485,476,27,576,32,1806,1521,3327,8,6,201907
5,6,132,26,345,395,17,337,48,1300,1573,2873,11,5.5,201907
5,7,163,16,285,261,4,601,5,1335,1251,2586,10,5.5,201907
6,1,148,28,380,209,9,774,5,1553,1907,3460,12,6,201907
6,2,114,13,378,171,49,612,8,1345,1217,2562,9,5.666666667,201907
7,1,286,11,253,385,23,157,37,1152,835,1987,9,5.25,201907
7,2,327,22,146,1061,29,61,0,1646,1086,2732,9,5.25,201907
7,3,325,7,270,631,159,195,0,1587,1048,2635,7,5.333333333,201907
7,4,157,25,195,655,9,149,40,1230,681,1911,11,5.4,201907
7,5,313,12,192,766,33,282,26,1624,991,2615,11,5.666666667,201907
7,6,236,12,384,447,25,514,42,1660,1412,3072,9,5.666666667,201907
7,7,222,30,328,438,33,307,30,1388,1696,3084,8,5.5,201907
7,8,298,18,205,718,21,360,6,1626,1047,2673,11,5.25,201907
7,9,184,37,309,387,24,489,8,1438,1320,2758,9,5.666666667,201907
7,10,198,11,248,564,28,150,1,1200,926,2126,9,5.5,201907
7,11,133,3,80,136,12,82,24,470,855,1325,6,5.333333333,201907
7,12,270,14,418,728,3,249,12,1694,1407,3101,9,5.5,201907
7,13,75,12,115,219,0,53,18,492,218,710,9,5.25,201907
8,1,102,10,422,191,29,358,5,1117,1051,2168,4,6,201907
8,2,270,36,742,513,35,678,4,2278,1960,4238,16,5.5,201907
8,3,154,19,410,310,25,541,11,1470,1546,3016,4,6,201907
8,4,186,26,436,275,36,695,31,1685,1238,2923,11,6,201907
8,5,172,36,304,273,9,614,0,1408,1959,3367,10,5.25,201907
8,6,215,32,396,382,25,936,3,1989,2067,4056,7,6.5,201907
8,7,187,44,281,336,109,487,7,1451,1317,2768,7,5.25,201907
8,8,169,32,400,319,9,826,2,1757,1770,3527,11,7,201907
8,9,179,37,214,212,25,635,18,1320,1325,2645,10,5.2,201907
9,1,64,5,112,116,32,310,3,642,615,1257,5,6,201907
9,2,263,58,749,842,101,1307,9,3329,3192,6521,12,6,201907
9,3,106,25,371,337,36,666,10,1551,1586,3137,7,6,201907
9,4,137,17,474,497,69,626,8,1828,1901,3729,11,6,201907
9,5,90,10,226,213,64,504,1,1108,1176,2284,7,6,201907
9,6,95,15,206,177,68,424,7,992,845,1837,7,6,201907
9,7,75,9,248,254,3,507,1,1097,1022,2119,9,6,201907
9,8,78,17,358,306,21,395,4,1179,1325,2504,5,6,201907
9,9,100,11,216,276,49,355,5,1012,1528,2540,5,6,201907
9,10,90,12,318,328,27,533,1,1309,1422,2731,6,6,201907
9,11,144,22,436,473,47,688,0,1810,1744,3554,7,6,201907
9,12,130,28,666,638,45,826,30,2363,2086,4449,11,6,201907
9,13,99,8,285,304,56,521,6,1279,1259,2538,4,6,201907
9,14,73,5,168,175,38,471,5,935,832,1767,5,6,201907
9,15,166,28,868,810,36,1254,8,3170,3237,6407,10,7,201907
9,16,205,48,450,626,100,862,2,2293,2350,4643,15,6,201907
9,17,100,13,259,274,23,396,1,1066,1040,2106,6,6,201907
9,18,140,23,393,555,38,739,5,1893,1779,3672,12,6,201907
9,19,147,31,354,354,97,533,3,1519,1481,3000,5,6,201907
9,20,57,8,109,140,24,195,3,536,538,1074,5,6,201907
9,21,105,9,245,252,50,416,1,1078,1085,2163,3,6,201907
9,22,148,8,322,302,108,492,16,1396,1242,2638,5,6,201907
9,23,103,20,341,418,50,616,1,1549,1378,2927,6,6,201907
9,24,186,25,514,586,79,1096,3,2489,2635,5124,12,6,201907
10,1,51,20,92,256,35,17,43,514,911,1425,12,3.333333333,201907
10,2,128,61,355,592,34,83,76,1329,787,2116,9,5.25,201907
10,3,92,63,149,298,25,40,298,965,973,1938,11,5.4,201907
10,4,145,53,447,942,19,64,18,1688,981,2669,12,6.5,201907
11,1,207,40,214,267,28,559,5,1320,1437,2757,6,5.666666667,201907
11,2,173,23,291,231,30,570,10,1328,1340,2668,7,6,201907
11,3,142,23,197,226,10,506,37,1141,1033,2174,3,6,201907
11,4,157,47,209,200,24,488,0,1125,1247,2372,8,6,201907
11,5,241,54,387,486,19,764,4,1955,1894,3849,7,6,201907
11,6,127,19,263,249,30,558,3,1249,1059,2308,8,6,201907
11,7,248,48,337,453,18,429,0,1533,1440,2973,9,5.5,201907
11,8,199,37,380,389,28,706,3,1742,2071,3813,9,5.5,201907
11,9,223,71,344,385,13,765,26,1827,1545,3372,10,5.666666667,201907
11,10,233,42,309,307,37,928,2,1858,2002,3860,10,5.6,201907
11,11,202,48,341,354,28,579,0,1552,1448,3000,5,6,201907
11,12,196,40,507,517,12,636,1,1909,2303,4212,7,6,201907
11,13,190,35,231,256,18,592,46,1368,1422,2790,8,5.5,201907
11,14,198,38,258,226,33,858,14,1625,1753,3378,8,5.5,201907
11,15,139,43,249,253,9,499,1,1193,1100,2293,9,6,201907
12,1,238,24,301,112,97,427,6,1205,1026,2231,10,5,201907
12,2,241,53,381,400,29,587,4,1695,1753,3448,10,5.5,201907
12,3,195,35,356,359,22,230,1,1198,834,2032,11,4.4,201907
12,4,173,34,414,593,41,379,7,1641,1614,3255,9,5.666666667,201907
12,5,327,43,306,427,1,280,14,1398,1092,2490,10,5.25,201907
12,6,197,24,168,444,35,227,3,1098,586,1684,10,5.25,201907
12,7,234,22,349,352,19,578,16,1570,1533,3103,6,5.5,201907
12,8,267,45,301,387,8,187,0,1195,957,2152,9,5.25,201907
12,9,172,24,378,532,30,301,0,1437,1366,2803,9,5.666666667,201907
13,1,176,16,165,218,47,539,3,1164,1091,2255,9,5.333333333,201907
13,2,157,33,167,306,48,480,2,1193,1246,2439,6,5.333333333,201907
13,3,171,25,248,269,97,439,2,1251,987,2238,12,5.25,201907
13,4,255,36,505,315,151,441,32,1735,1506,3241,9,5.666666667,201907
13,5,192,20,407,255,60,1014,1,1949,1732,3681,9,5.75,201907
13,6,239,60,896,586,55,734,6,2576,2286,4862,11,5.666666667,201907
13,7,143,18,399,439,20,391,0,1410,1546,2956,8,5.5,201907
14,1,125,41,117,58,18,595,103,1057,744,1801,6,5.5,201907
14,2,152,21,130,108,9,741,5,1166,981,2147,5,5.666666667,201907
14,3,197,44,279,222,34,800,1,1577,1663,3240,8,5.4,201907
14,4,193,12,342,373,18,795,4,1737,1892,3629,10,6,201907
14,5,152,28,424,259,54,501,10,1428,1599,3027,9,5.5,201907
14,6,206,13,486,256,18,670,1,1650,1390,3040,11,6,201907
14,7,91,6,147,84,0,374,0,702,672,1374,6,6,201907
14,8,306,49,682,806,11,1599,5,3458,3346,6804,11,6.25,201907
14,9,170,19,274,251,24,865,3,1606,1967,3573,8,6,201907
14,10,157,8,304,211,3,713,1,1397,1530,2927,7,6,201907
14,11,79,13,102,136,29,456,6,821,770,1591,4,6,201907
14,12,207,9,449,167,7,505,0,1344,1401,2745,9,5.5,201907
14,13,145,10,262,193,15,673,1,1299,1190,2489,6,6,201907
14,14,119,9,260,187,19,835,5,1434,1346,2780,7,6,201907
14,15,237,45,318,186,43,1001,21,1851,1914,3765,10,5.6,201907
14,16,143,13,268,173,20,732,3,1352,1029,2381,5,6,201907
14,17,174,14,200,115,16,665,3,1187,766,1953,7,5.25,201907
14,18,233,69,355,441,19,620,9,1746,1537,3283,9,5.4,201907
14,19,204,46,382,459,36,529,63,1719,1425,3144,8,5.25,201907
14,20,213,16,373,203,23,843,1,1672,1742,3414,10,5.666666667,201907
15,1,207,10,266,118,215,800,8,1624,1621,3245,7,5.333333333,201907
15,2,133,18,323,375,48,465,17,1379,996,2375,6,6,201907
15,3,231,19,217,299,102,879,6,1753,1804,3557,10,5.666666667,201907
15,4,125,15,228,219,26,602,8,1223,1095,2318,4,6,201907
15,5,163,35,287,295,21,648,63,1512,1648,3160,8,5.666666667,201907
15,6,139,15,372,472,41,570,6,1615,1553,3168,7,6,201907
15,7,130,12,250,292,30,537,0,1251,1215,2466,10,6,201907
15,8,103,9,248,294,30,337,7,1028,1058,2086,4,6,201907
15,9,254,10,149,192,143,706,9,1463,1438,2901,9,5.75,201907
15,10,121,14,258,232,57,518,11,1211,1336,2547,6,6,201907
15,11,150,29,357,374,41,561,2,1514,1381,2895,8,6,201907
15,12,219,18,695,497,51,632,0,2112,2061,4173,8,6,201907
15,13,58,14,145,153,56,400,0,826,780,1606,8,6,201907
15,14,72,24,186,252,20,326,0,880,893,1773,4,6,201907
15,15,117,54,281,435,34,468,21,1410,1274,2684,6,6,201907
15,16,226,33,500,696,40,733,4,2232,2333,4565,8,6,201907
15,17,95,15,203,248,16,505,27,1109,1186,2295,8,6,201907
15,18,221,19,376,414,27,683,2,1742,1772,3514,7,5.666666667,201907
15,19,148,34,397,508,25,809,9,1930,2350,4280,10,6,201907
15,20,63,17,218,384,22,207,20,931,1062,1993,6,6,201907
15,21,140,18,148,202,23,279,2,812,875,1687,6,5.5,201907
15,22,188,26,439,605,32,1003,14,2307,2391,4698,14,6,201907
15,23,167,22,276,326,29,612,0,1432,1502,2934,6,5.333333333,201907
15,24,135,21,261,254,44,344,2,1061,1145,2206,4,6,201907
15,25,148,28,311,296,36,291,15,1125,1276,2401,6,6,201907
15,26,92,4,236,208,33,421,1,995,949,1944,9,7,201907
15,27,197,17,361,428,13,716,27,1759,1712,3471,9,5.666666667,201907
15,28,190,19,428,314,70,633,5,1659,1769,3428,9,5.666666667,201907
15,29,198,35,439,550,18,769,0,2009,1757,3766,8,6,201907
15,30,281,31,576,530,55,409,6,1888,1959,3847,16,6,201907
15,31,123,31,246,344,7,433,0,1184,1406,2590,6,6,201907
15,32,171,9,390,407,53,420,5,1455,1491,2946,9,6,201907
15,33,183,12,320,310,26,514,0,1365,1706,3071,7,6,201907
15,34,119,14,243,318,9,485,4,1192,1294,2486,8,6,201907
15,35,256,24,297,455,5,686,1,1724,1589,3313,9,5.666666667,201907
15,36,270,14,368,386,119,610,26,1793,1816,3609,9,5.5,201907
15,37,178,21,374,450,58,758,12,1851,2072,3923,7,6,201907
15,38,189,53,344,554,9,587,3,1739,1588,3327,6,5.5,201907
15,39,132,26,290,362,23,340,0,1173,1230,2403,4,6,201907
15,40,332,25,323,447,97,1040,33,2297,2042,4339,9,6,201907
15,41,224,35,700,673,44,579,29,2284,2312,4596,11,6,201907
16,1,148,12,253,156,17,577,0,1163,957,2120,7,5.333333333,201907
16,2,144,27,147,133,17,401,3,872,1184,2056,9,5.25,201907
16,3,196,23,246,286,14,592,8,1365,1283,2648,10,5.25,201907
16,4,156,17,185,114,38,714,0,1224,1200,2424,8,5.5,201907
16,5,203,21,198,149,11,629,5,1216,1340,2556,10,5.666666667,201907
16,6,182,32,232,231,35,409,0,1121,1357,2478,12,5.5,201907
16,7,225,31,245,202,33,555,1,1292,1264,2556,9,5.5,201907
16,8,229,31,539,463,8,841,0,2111,1973,4084,12,6,201907
16,9,191,16,235,249,13,677,4,1385,1372,2757,9,6,201907
16,10,170,17,391,349,10,630,0,1567,1641,3208,7,6.5,201907
16,11,196,15,206,122,50,943,1,1533,2011,3544,10,5.4,201907
16,12,202,18,206,134,43,558,4,1165,1488,2653,10,5.25,201907
17,1,151,20,355,351,18,631,3,1529,2022,3551,9,7,201907
17,2,157,15,390,338,17,484,4,1405,1146,2551,8,5.666666667,201907
17,3,241,12,456,368,14,685,0,1776,1613,3389,8,5.5,201907
17,4,189,16,403,330,26,758,1,1723,1565,3288,10,5.666666667,201907
17,5,103,11,192,185,13,241,3,748,613,1361,5,5.5,201907
18,1,195,22,210,212,19,404,57,1119,973,2092,7,5.25,201907
18,2,227,25,489,402,68,713,0,1924,2036,3960,9,6.333333333,201907
18,3,149,24,348,211,21,399,1,1153,1196,2349,8,5.5,201907
19,1,146,17,269,206,19,892,3,1552,1715,3267,9,6,201907
19,2,196,18,541,249,30,792,2,1828,1835,3663,9,6,201907
19,3,212,23,516,333,29,798,2,1913,1867,3780,7,6,201907
19,4,96,7,124,104,29,563,10,933,1150,2083,5,6,201907
19,5,271,25,526,491,13,1197,16,2539,2518,5057,8,6,201907
19,6,63,15,182,196,8,633,0,1097,1204,2301,5,6,201907
19,7,151,5,523,196,3,468,0,1346,1815,3161,10,5.5,201907
19,8,77,4,191,197,5,403,0,877,900,1777,7,6,201907
19,9,179,17,298,229,31,701,4,1459,2189,3648,9,5.25,201907
19,10,85,24,194,197,10,320,324,1154,1297,2451,6,7,201907
19,11,251,49,454,583,29,1534,20,2920,2796,5716,13,6,201907
19,12,191,11,598,217,9,597,3,1626,1779,3405,8,5.666666667,201907
20,1,207,11,326,230,51,481,24,1330,1365,2695,7,5.5,201907
20,2,142,22,160,147,16,343,1,831,427,1258,6,5.333333333,201907
20,3,166,15,220,111,81,335,46,974,553,1527,6,5.333333333,201907
20,4,99,16,112,112,41,432,21,833,474,1307,6,5.333333333,201907
20,5,95,17,237,291,18,317,0,975,944,1919,11,3.75,201907
20,6,162,8,378,257,286,165,1,1257,893,2150,8,5.25,201907
20,7,142,19,218,288,14,526,0,1207,1311,2518,7,5.5,201907
20,8,406,38,566,771,37,1170,53,3041,3318,6359,14,6.5,201907
20,9,242,21,252,173,46,753,17,1504,1407,2911,8,5.666666667,201907
20,10,229,14,390,273,25,527,0,1458,1206,2664,9,5.25,201907
21,1,158,8,172,73,2,27,0,440,1099,1539,9,5.4,201907
21,2,261,24,338,409,208,42,0,1282,1110,2392,9,5.2,201907
21,3,241,24,442,200,160,75,81,1223,1543,2766,8,5.5,201907
21,4,172,27,186,134,187,39,7,752,827,1579,6,5.25,201907
21,5,159,13,372,204,23,57,33,861,1807,2668,8,5.666666667,201907
21,6,121,17,269,379,25,36,96,943,1342,2285,6,6,201907
21,7,202,15,264,183,103,34,2,803,1771,2574,9,5,201907
21,8,183,13,507,59,196,41,50,1049,1052,2101,9,5.2,201907
21,9,193,32,589,154,267,58,353,1646,1892,3538,9,6,201907
21,10,161,25,439,26,139,61,375,1226,2075,3301,7,5.5,201907
21,11,78,10,171,113,21,16,74,483,719,1202,5,7,201907
21,12,261,28,833,369,328,127,236,2182,3181,5363,16,6.5,201907
21,13,57,5,96,22,31,90,23,324,1158,1482,8,5.666666667,201907
21,14,186,20,258,1,245,38,141,889,1259,2148,12,5.333333333,201907
21,15,199,24,434,316,82,60,106,1221,1619,2840,7,5.5,201907
22,1,179,60,249,405,38,263,13,1207,1466,2673,11,5.2,201907
22,2,179,28,350,277,42,434,0,1310,1214,2524,7,5.5,201907
22,3,262,49,857,556,16,759,2,2501,3016,5517,9,5.666666667,201907
22,4,173,34,657,470,22,710,2,2068,2275,4343,9,6.5,201907
22,5,178,23,433,186,71,484,6,1381,1583,2964,10,5.5,201907
23,1,73,4,642,249,22,62,0,1052,1015,2067,14,5.6,201907
23,2,70,9,170,284,9,20,13,575,908,1483,8,5.25,201907
23,3,38,1,296,22,7,14,66,444,688,1132,15,5,201907
23,4,57,2,333,172,30,33,51,678,542,1220,8,5.666666667,201907
24,1,141,47,179,264,31,270,4,936,1035,1971,10,5.2,201907
24,2,141,26,264,173,12,570,0,1186,1373,2559,6,5.5,201907
24,3,169,51,212,269,53,294,4,1052,1264,2316,9,5.25,201907
24,4,136,22,189,153,23,562,23,1108,954,2062,5,5.5,201907
24,5,256,38,492,476,12,876,6,2156,2300,4456,10,7,201907
24,6,183,27,392,373,24,752,0,1751,1627,3378,6,6,201907
24,7,192,22,263,513,38,307,0,1335,1479,2814,9,5.25,201907
25,1,181,14,359,312,36,715,7,1624,1710,3334,13,5.75,201907
25,2,237,38,420,428,25,876,0,2024,2075,4099,7,5.5,201907
25,3,220,17,314,311,32,590,6,1490,1904,3394,8,5.6,201907
25,4,227,28,263,370,10,729,2,1629,1624,3253,8,5.333333333,201907
25,5,225,17,598,467,54,743,55,2159,2379,4538,8,5.666666667,201907
25,6,200,14,368,307,44,753,1,1687,2105,3792,8,5.75,201907
25,7,232,26,567,403,19,786,0,2033,2282,4315,6,6,201907
26,1,146,9,433,208,17,564,0,1377,2137,3514,9,5.5,201907
26,2,246,15,442,393,1,450,15,1562,1747,3309,12,5.4,201907
26,3,197,18,245,379,15,894,12,1760,1813,3573,14,6.5,201907
26,4,116,8,142,232,10,464,2,974,1339,2313,9,5.2,201907
26,5,143,8,220,231,17,615,0,1234,1348,2582,15,6,201907
26,6,130,7,282,250,3,715,0,1387,1370,2757,10,5.333333333,201907
26,7,172,19,259,267,43,403,0,1163,1153,2316,10,5.5,201907
27,1,130,16,325,338,54,395,4,1262,1329,2591,8,5.5,201907
27,2,210,22,377,540,27,395,0,1571,1241,2812,8,5.666666667,201907
27,3,172,19,368,472,11,530,1,1573,1564,3137,7,5.666666667,201907
27,4,166,16,428,641,13,607,15,1886,1776,3662,8,6,201907
27,5,118,7,190,395,15,192,0,917,604,1521,6,5.333333333,201907
27,6,152,13,304,351,7,499,0,1326,1410,2736,7,5.5,201907
28,1,8,0,6,373,0,5,0,392,1707,2099,13,6,201907
28,2,97,31,196,164,28,60,316,892,1119,2011,14,6,201907
28,3,60,8,117,346,0,19,21,571,842,1413,7,5.333333333,201907
28,4,150,59,445,317,118,68,406,1563,1300,2863,15,6,201907
28,5,63,69,217,278,13,43,377,1060,1001,2061,10,5.5,201907
28,6,44,30,131,221,44,24,4,498,956,1454,14,5.166666667,201907
28,7,96,43,407,442,53,89,23,1153,1153,2306,13,6,201907
28,8,54,49,245,430,76,81,167,1102,1342,2444,9,6,201907
28,9,55,10,186,139,36,28,123,577,305,882,11,5.75,201907
29,1,202,28,353,307,77,648,3,1618,1620,3238,7,5.5,201907
29,2,201,19,348,485,57,645,43,1798,1427,3225,11,6,201907
29,3,146,33,236,306,17,405,0,1143,1204,2347,5,5.666666667,201907
30,1,113,40,304,315,28,273,172,1245,1285,2530,7,5.333333333,201907
30,2,171,40,228,147,69,209,398,1262,1043,2305,8,5.25,201907
30,3,175,13,420,142,76,799,56,1681,1700,3381,6,5.666666667,201907
30,4,108,8,287,185,34,440,0,1062,1115,2177,8,6,201907
30,5,118,7,251,192,133,676,0,1377,1328,2705,7,5.5,201907
30,6,202,19,348,227,24,589,4,1413,1073,2486,9,5.333333333,201907
30,7,208,20,298,274,66,494,87,1447,1601,3048,11,5.25,201907
30,8,256,32,465,367,105,925,70,2220,1940,4160,11,5.4,201907
30,9,246,9,273,222,58,638,44,1490,1502,2992,8,5.5,201907
30,10,140,18,393,298,38,640,19,1546,2186,3732,7,6.5,201907
30,11,149,15,472,377,16,677,1,1707,1533,3240,5,5.5,201907
30,12,204,10,552,516,28,977,0,2287,2624,4911,10,6,201907
30,13,211,20,321,308,57,906,51,1874,1978,3852,10,5.4,201907
30,14,209,27,646,197,125,546,30,1780,1858,3638,8,5.5,201907
30,15,266,24,223,259,34,917,108,1831,1741,3572,11,5.666666667,201907
30,16,209,12,456,361,68,1141,45,2292,1986,4278,10,5.333333333,201907
30,17,177,28,364,330,35,687,7,1628,1578,3206,8,5.5,201907
30,18,202,16,156,245,16,347,44,1026,1169,2195,8,5.25,201907
30,19,182,10,374,262,64,619,2,1513,1743,3256,13,5.6,201907
30,20,217,26,392,519,168,408,7,1737,1756,3493,10,5.4,201907
31,1,162,16,250,30,257,561,0,1276,1140,2416,8,5.5,201907
31,2,103,12,180,2,162,560,0,1019,990,2009,6,5.333333333,201907
31,3,297,48,982,533,169,1414,1,3444,3630,7074,21,6.333333333,201907
31,4,79,15,252,164,106,531,23,1170,1289,2459,4,6,201907
31,5,166,12,186,178,22,668,81,1313,1359,2672,6,5.333333333,201907
32,1,157,38,203,173,26,752,8,1357,1164,2521,12,5.2,201907
32,2,211,33,181,124,68,899,12,1528,1587,3115,13,5.142857143,201907
32,3,144,41,188,244,8,734,8,1367,1703,3070,14,5.6,201907
32,4,196,79,252,295,21,602,16,1461,1325,2786,13,5.4,201907
1,1,101,53,237,288,72,42,36,829,453,1282,13,5.5,201908
1,2,85,40,362,764,38,85,43,1417,811,2228,10,6.333333333,201908
1,3,76,55,440,608,54,86,84,1403,671,2074,9,6,201908
2,1,112,14,354,609,25,67,6,1187,742,1929,11,6,201908
2,2,133,32,385,709,14,104,0,1377,600,1977,7,6,201908
2,3,135,35,388,448,19,73,205,1303,620,1923,11,5.666666667,201908
2,4,90,13,435,204,52,42,32,868,113,981,9,6,201908
2,5,185,29,731,283,242,118,148,1736,382,2118,13,6,201908
2,6,121,19,388,510,23,61,12,1134,201,1335,7,6,201908
2,7,151,28,511,291,29,84,252,1346,215,1561,12,5.75,201908
2,8,121,18,373,494,25,61,195,1287,400,1687,8,6,201908
3,1,161,13,387,259,20,510,3,1353,1622,2975,12,5.666666667,201908
3,2,134,13,517,223,15,311,0,1213,1150,2363,9,5.666666667,201908
4,1,183,20,363,374,78,652,37,1707,1918,3625,11,5.25,201908
4,2,194,17,472,446,92,375,3,1599,1934,3533,14,5.2,201908
5,1,243,21,464,308,33,720,5,1794,1723,3517,9,5.666666667,201908
5,2,174,18,381,342,18,469,0,1402,1256,2658,10,5.2,201908
5,3,155,22,223,307,29,670,9,1415,1455,2870,8,6.333333333,201908
5,4,211,32,542,422,29,859,17,2112,2087,4199,9,5.666666667,201908
5,5,186,28,448,427,20,567,17,1693,1681,3374,8,6,201908
5,6,151,21,336,387,10,430,53,1388,1175,2563,11,5.5,201908
5,7,146,17,300,281,9,477,2,1232,1239,2471,10,5.5,201908
6,1,174,26,389,273,8,836,5,1711,1940,3651,12,6,201908
6,2,111,22,377,146,30,620,7,1313,1547,2860,9,5.666666667,201908
7,1,269,13,315,522,21,153,32,1325,1165,2490,9,5.25,201908
7,2,330,19,134,682,46,107,0,1318,1586,2904,9,5.25,201908
7,3,280,11,297,281,150,363,1,1383,1073,2456,7,5.333333333,201908
7,4,148,17,207,456,3,232,6,1069,891,1960,11,5.4,201908
7,5,323,17,177,604,20,319,3,1463,1290,2753,11,5.666666667,201908
7,6,249,17,299,397,18,672,6,1658,2288,3946,9,5.666666667,201908
7,7,217,29,330,412,60,360,38,1446,2107,3553,8,5.5,201908
7,8,279,14,210,528,12,477,8,1528,1228,2756,11,5.25,201908
7,9,174,23,327,344,25,466,11,1370,1377,2747,9,5.666666667,201908
7,10,255,12,269,530,24,269,1,1360,853,2213,9,5.5,201908
7,11,228,2,69,170,14,219,28,730,552,1282,6,5.333333333,201908
7,12,247,9,367,617,6,303,0,1549,1544,3093,9,5.5,201908
7,13,110,18,124,214,0,104,2,572,1258,1830,9,5.25,201908
8,1,142,7,428,203,23,314,2,1119,1091,2210,4,6,201908
8,2,276,30,661,460,31,533,4,1995,2744,4739,16,5.5,201908
8,3,166,14,397,312,31,460,11,1391,1442,2833,4,6,201908
8,4,165,25,409,277,29,665,42,1612,1524,3136,11,6,201908
8,5,243,35,356,253,21,588,2,1498,1910,3408,10,5.25,201908
8,6,210,27,456,406,34,863,4,2000,2148,4148,7,6.5,201908
8,7,197,38,255,234,15,723,1,1463,1203,2666,7,5.25,201908
8,8,171,20,404,347,8,695,1,1646,1767,3413,11,7,201908
8,9,174,7,133,126,12,647,21,1120,1109,2229,10,5,201908
9,1,71,5,128,115,47,287,2,655,653,1308,5,6,201908
9,2,246,54,787,855,94,1281,4,3321,3379,6700,12,6,201908
9,3,115,51,316,399,59,621,8,1569,1670,3239,7,6,201908
9,4,159,15,426,538,44,590,12,1784,2230,4014,11,6,201908
9,5,95,12,227,232,58,520,2,1146,1121,2267,7,6,201908
9,6,86,21,204,204,84,373,9,981,926,1907,7,6,201908
9,7,94,10,326,312,7,418,1,1168,1041,2209,9,6,201908
9,8,71,20,379,360,22,461,13,1326,1138,2464,5,6,201908
9,9,100,10,250,303,44,346,6,1059,1485,2544,5,6,201908
9,10,84,22,284,261,8,495,4,1158,1615,2773,6,6,201908
9,11,146,11,469,513,62,677,2,1880,1838,3718,7,6,201908
9,12,157,51,660,618,33,783,30,2332,2530,4862,11,6,201908
9,13,96,15,305,292,83,477,11,1279,1290,2569,4,6,201908
9,14,83,10,209,195,46,426,7,976,901,1877,5,6,201908
9,15,142,35,816,745,52,1140,2,2932,3060,5992,10,6.5,201908
9,16,211,70,489,592,80,800,2,2244,2137,4381,15,6,201908
9,17,102,11,257,273,28,319,0,990,1082,2072,6,6,201908
9,18,120,38,442,572,40,748,4,1964,1818,3782,12,6,201908
9,19,133,32,371,368,134,534,7,1579,1658,3237,5,6,201908
9,20,55,6,146,135,22,180,3,547,598,1145,5,6,201908
9,21,96,9,240,281,44,401,4,1075,1161,2236,3,6,201908
9,22,142,7,328,347,86,458,16,1384,1372,2756,5,6,201908
9,23,109,11,309,437,60,584,1,1511,1547,3058,6,6,201908
9,24,234,26,602,639,84,1143,6,2734,2628,5362,12,6,201908
10,1,88,18,108,310,27,19,48,618,659,1277,12,4.833333333,201908
10,2,128,45,372,519,36,62,152,1314,615,1929,9,5.25,201908
10,3,98,66,187,328,32,36,324,1071,473,1544,11,5.4,201908
10,4,143,42,386,919,12,64,19,1585,645,2230,12,6.5,201908
11,1,214,23,242,266,16,581,2,1344,1519,2863,6,5.666666667,201908
11,2,166,26,324,213,25,509,13,1276,1293,2569,7,6,201908
11,3,131,26,203,203,8,496,22,1089,1125,2214,3,6,201908
11,4,179,57,181,233,15,568,0,1233,1151,2384,8,6,201908
11,5,263,80,390,427,24,810,9,2003,1970,3973,7,6,201908
11,6,134,21,289,258,32,520,3,1257,1314,2571,8,6,201908
11,7,244,42,426,452,22,414,4,1604,1421,3025,9,5.5,201908
11,8,199,35,371,411,34,649,0,1699,2022,3721,9,5.5,201908
11,9,219,79,334,340,13,659,20,1664,1868,3532,10,5.666666667,201908
11,10,185,36,273,273,17,744,7,1535,1735,3270,10,5.6,201908
11,11,190,41,343,306,23,572,0,1475,1565,3040,5,6,201908
11,12,232,53,490,462,13,570,0,1820,2080,3900,7,6,201908
11,13,175,17,206,165,14,590,6,1173,1281,2454,8,4.5,201908
11,14,208,26,284,214,21,766,20,1539,1622,3161,8,5.5,201908
11,15,143,32,183,229,8,461,1,1057,1292,2349,9,6,201908
12,1,169,28,298,113,66,546,8,1228,1207,2435,10,5.2,201908
12,2,201,49,365,331,39,448,8,1441,1364,2805,10,5.5,201908
12,3,265,42,412,521,18,397,3,1658,1153,2811,11,5.2,201908
12,4,185,32,481,537,53,359,6,1653,1794,3447,9,5.666666667,201908
12,5,212,33,202,321,7,258,20,1053,830,1883,10,4.5,201908
12,6,196,29,192,329,40,254,3,1043,599,1642,10,5.25,201908
12,7,289,25,378,349,18,649,32,1740,1497,3237,6,5.5,201908
12,8,164,18,212,269,1,156,0,820,827,1647,9,4.5,201908
12,9,191,35,493,475,16,317,2,1529,1569,3098,9,5.666666667,201908
13,1,187,22,223,256,55,604,5,1352,1371,2723,9,5.333333333,201908
13,2,183,21,166,245,32,568,3,1218,1222,2440,6,5.333333333,201908
13,3,194,16,273,338,96,475,0,1392,1596,2988,12,5.25,201908
13,4,193,26,441,289,57,433,17,1456,1459,2915,9,5.666666667,201908
13,5,225,20,411,259,83,1137,3,2138,1818,3956,9,5.75,201908
13,6,247,97,831,606,63,740,10,2594,2486,5080,11,5.666666667,201908
13,7,129,27,502,398,38,397,0,1491,1609,3100,8,5.5,201908
14,1,116,20,104,66,18,638,20,982,1028,2010,6,5.5,201908
14,2,148,25,223,148,23,593,11,1171,1070,2241,5,5.666666667,201908
14,3,238,43,369,187,73,605,21,1536,1539,3075,8,5.4,201908
14,4,225,28,352,366,23,750,2,1746,1748,3494,10,6,201908
14,5,182,16,470,353,38,565,8,1632,1445,3077,9,5.5,201908
14,6,182,17,488,287,31,547,10,1562,1361,2923,11,6,201908
14,7,87,7,170,127,0,406,0,797,698,1495,6,6,201908
14,8,286,42,660,680,13,1559,6,3246,3703,6949,11,6,201908
14,9,182,20,275,267,34,809,1,1588,1773,3361,8,6,201908
14,10,161,21,310,231,8,663,2,1396,1420,2816,7,6,201908
14,11,101,9,131,147,12,434,9,843,838,1681,4,6,201908
14,12,205,11,466,169,14,543,0,1408,1389,2797,9,5.5,201908
14,13,164,13,277,193,20,587,5,1259,1185,2444,6,6,201908
14,14,133,17,263,198,16,776,5,1408,2060,3468,7,6,201908
14,15,216,47,311,213,52,718,29,1586,1746,3332,10,5.6,201908
14,16,166,14,255,186,21,673,4,1319,1284,2603,5,6,201908
14,17,135,9,175,90,23,571,19,1022,760,1782,7,5,201908
14,18,187,18,239,122,16,883,1,1466,1505,2971,9,5.4,201908
14,19,186,47,348,402,27,514,39,1563,1406,2969,8,5.25,201908
14,20,238,18,400,232,15,726,2,1631,1252,2883,10,5.666666667,201908
15,1,188,9,262,107,162,1094,5,1827,1481,3308,7,5.333333333,201908
15,2,122,25,302,350,54,417,6,1276,1541,2817,6,6,201908
15,3,217,19,252,209,128,988,6,1819,1875,3694,10,5.666666667,201908
15,4,116,10,208,228,26,606,7,1201,1213,2414,4,6,201908
15,5,150,43,306,285,39,639,23,1485,1260,2745,8,5.666666667,201908
15,6,153,18,410,413,49,549,8,1600,1675,3275,7,6,201908
15,7,114,11,259,326,31,524,0,1265,1250,2515,10,6,201908
15,8,92,20,263,315,32,354,7,1083,1012,2095,4,6,201908
15,9,247,16,179,156,127,701,7,1433,1305,2738,9,5.75,201908
15,10,122,9,287,292,65,454,7,1236,1293,2529,6,6,201908
15,11,120,26,392,391,54,535,6,1524,1524,3048,8,6,201908
15,12,221,23,631,495,53,587,1,2011,2146,4157,8,6,201908
15,13,65,14,187,162,56,401,0,885,827,1712,8,6,201908
15,14,62,21,197,230,21,314,0,845,931,1776,4,6,201908
15,15,115,37,316,476,36,465,23,1468,1352,2820,6,6,201908
15,16,207,42,495,701,27,752,7,2231,2500,4731,8,6,201908
15,17,91,19,245,273,21,474,16,1139,1132,2271,8,6,201908
15,18,223,20,365,463,33,796,3,1903,1763,3666,7,5.666666667,201908
15,19,136,36,498,509,28,801,8,2016,2223,4239,10,6,201908
15,20,69,25,244,342,16,255,21,972,919,1891,6,6,201908
15,21,113,10,145,223,22,326,17,856,747,1603,6,5.5,201908
15,22,206,32,584,691,33,1052,10,2608,2283,4891,14,6,201908
15,23,234,19,262,350,24,680,0,1569,1503,3072,6,5.333333333,201908
15,24,121,37,235,239,36,324,2,994,1106,2100,4,6,201908
15,25,163,25,338,282,45,315,11,1179,1110,2289,6,6,201908
15,26,95,5,216,201,25,472,4,1018,1038,2056,9,7,201908
15,27,200,17,334,435,31,720,36,1773,1778,3551,9,5.666666667,201908
15,28,168,23,478,308,62,608,1,1648,1589,3237,9,5.666666667,201908
15,29,189,33,485,678,8,701,0,2094,2424,4518,8,6,201908
15,30,191,25,537,523,57,442,11,1786,2035,3821,16,6,201908
15,31,114,38,244,247,14,342,1,1000,1193,2193,6,6,201908
15,32,180,12,431,466,51,382,4,1526,1588,3114,9,6,201908
15,33,157,16,350,320,24,495,0,1362,1296,2658,7,6,201908
15,34,142,15,255,379,7,456,0,1254,1339,2593,8,6,201908
15,35,251,17,306,321,6,827,0,1728,1606,3334,9,5.666666667,201908
15,36,239,17,409,297,47,726,0,1735,1399,3134,9,5.5,201908
15,37,180,26,392,471,54,775,25,1923,1816,3739,7,6,201908
15,38,183,43,340,393,19,659,5,1642,1615,3257,6,5.5,201908
15,39,112,29,346,345,26,334,0,1192,1256,2448,4,6,201908
15,40,279,40,361,422,69,1053,7,2231,2213,4444,9,6,201908
15,41,234,36,732,651,42,680,7,2382,2399,4781,11,6,201908
16,1,132,10,228,150,26,394,0,940,880,1820,7,5.333333333,201908
16,2,146,22,165,224,9,408,1,975,764,1739,9,5.25,201908
16,3,218,20,235,246,20,576,1,1316,1419,2735,10,5.25,201908
16,4,173,13,179,104,32,656,0,1157,1032,2189,8,5.5,201908
16,5,160,25,199,177,20,517,6,1104,1139,2243,10,5.666666667,201908
16,6,228,29,215,268,33,382,0,1155,1305,2460,12,5.5,201908
16,7,223,23,215,209,38,645,0,1353,1321,2674,9,5.5,201908
16,8,257,32,510,473,8,826,0,2106,2021,4127,12,6,201908
16,9,212,30,265,229,12,592,5,1345,1374,2719,9,6,201908
16,10,201,16,379,337,13,614,0,1560,1694,3254,6,6,201908
16,11,222,17,219,154,63,974,2,1651,1531,3182,10,5.4,201908
16,12,200,7,254,158,18,445,1,1083,1087,2170,10,5,201908
17,1,178,23,400,382,16,678,0,1677,1611,3288,9,7,201908
17,2,156,10,349,327,13,378,4,1237,1184,2421,8,5.666666667,201908
17,3,212,35,442,385,16,586,0,1676,1624,3300,8,5.5,201908
17,4,206,14,411,319,23,673,1,1647,1639,3286,10,5.666666667,201908
17,5,104,13,191,168,12,202,0,690,636,1326,5,5.5,201908
18,1,238,9,163,187,27,321,33,978,862,1840,7,5.25,201908
18,2,273,25,474,423,71,697,2,1965,2110,4075,9,6.333333333,201908
18,3,193,17,427,219,22,614,4,1496,1289,2785,8,5.5,201908
19,1,118,13,280,218,12,767,6,1414,1627,3041,9,6,201908
19,2,196,12,536,266,22,783,0,1815,1959,3774,9,6,201908
19,3,234,20,532,258,37,800,0,1881,1650,3531,7,6,201908
19,4,79,13,136,103,33,594,16,974,937,1911,5,6,201908
19,5,318,32,485,541,29,1123,37,2565,2514,5079,8,6,201908
19,6,73,17,196,176,10,609,3,1084,1142,2226,5,6,201908
19,7,189,14,607,209,12,419,1,1451,1617,3068,10,5.5,201908
19,8,101,13,205,234,5,276,12,846,808,1654,7,6,201908
19,9,204,13,233,209,24,736,0,1419,1594,3013,9,5.25,201908
19,10,78,10,182,161,8,618,9,1066,1206,2272,7,8,201908
19,11,231,38,398,476,23,1630,4,2800,2854,5654,13,6,201908
19,12,196,12,524,227,16,569,3,1547,1473,3020,8,5.666666667,201908
20,1,218,23,363,216,55,436,38,1349,1211,2560,7,5.5,201908
20,2,111,12,195,176,13,338,0,845,750,1595,6,5.333333333,201908
20,3,128,13,174,116,101,279,28,839,675,1514,6,5.333333333,201908
20,4,80,7,106,84,34,327,24,662,585,1247,6,5.333333333,201908
20,5,155,19,291,653,52,341,0,1511,1022,2533,11,5.25,201908
20,6,218,16,177,257,126,184,0,978,593,1571,8,5.25,201908
20,7,163,14,318,295,9,564,0,1363,1695,3058,7,5.75,201908
20,8,391,40,636,861,46,1226,49,3249,3394,6643,14,6.5,201908
20,9,272,20,257,182,59,892,22,1704,1570,3274,8,5.666666667,201908
20,10,243,10,248,275,16,584,2,1378,1331,2709,9,5.25,201908
21,1,132,6,133,146,2,24,0,443,821,1264,9,5.4,201908
21,2,262,30,357,426,237,41,11,1364,757,2121,9,5.2,201908
21,3,239,31,468,204,186,50,126,1304,1112,2416,8,5.5,201908
21,4,181,14,188,249,102,55,25,814,471,1285,6,5.25,201908
21,5,171,24,424,330,29,56,78,1112,1164,2276,8,5.666666667,201908
21,6,149,18,330,372,56,50,199,1174,837,2011,6,6,201908
21,7,208,11,234,186,166,48,11,864,1073,1937,9,5.333333333,201908
21,8,232,24,550,75,236,54,125,1296,968,2264,9,5.2,201908
21,9,173,32,525,142,241,81,437,1631,1123,2754,9,6,201908
21,10,188,28,432,53,129,79,475,1384,979,2363,7,5.5,201908
21,11,88,5,156,216,25,22,65,577,391,968,4,6,201908
21,12,283,34,819,396,279,115,428,2354,1761,4115,16,6.5,201908
21,13,159,15,249,26,68,182,88,787,979,1766,8,5.666666667,201908
21,14,172,20,227,64,221,31,67,802,823,1625,12,5.333333333,201908
21,15,226,26,423,341,94,60,122,1292,679,1971,7,5.5,201908
22,1,199,48,247,424,25,319,6,1268,1006,2274,11,5.2,201908
22,2,139,50,296,298,68,438,3,1292,1154,2446,7,5.5,201908
22,3,311,59,845,657,23,786,1,2682,3467,6149,9,5.666666667,201908
22,4,214,38,609,518,24,706,1,2110,2444,4554,9,6.5,201908
22,5,184,26,468,212,65,445,9,1409,1398,2807,10,5.5,201908
23,1,107,4,632,260,10,54,1,1068,449,1517,14,5.6,201908
23,2,110,17,277,444,14,27,9,898,443,1341,8,5.25,201908
23,3,69,10,399,442,14,21,83,1038,269,1307,15,6,201908
23,4,64,5,390,197,46,57,51,810,326,1136,8,5.666666667,201908
24,1,182,60,222,306,33,308,6,1117,1244,2361,10,5.2,201908
24,2,130,22,246,216,12,523,1,1150,1169,2319,6,5.5,201908
24,3,212,50,286,273,76,277,1,1175,1211,2386,9,5.25,201908
24,4,148,24,233,157,35,571,23,1191,974,2165,5,5.5,201908
24,5,218,43,451,480,12,839,3,2046,2267,4313,10,6.333333333,201908
24,6,183,37,387,440,27,759,0,1833,1707,3540,6,6,201908
24,7,283,41,332,444,49,325,0,1474,1412,2886,9,5.25,201908
25,1,170,8,331,331,29,473,8,1350,1530,2880,13,5.75,201908
25,2,266,32,455,434,19,834,0,2040,1806,3846,7,5.5,201908
25,3,195,19,354,348,46,621,16,1599,1822,3421,8,5.6,201908
25,4,172,30,269,444,15,612,2,1544,2016,3560,8,5.333333333,201908
25,5,222,16,581,510,38,827,16,2210,2471,4681,8,5.666666667,201908
25,6,178,25,448,278,63,735,9,1736,1861,3597,8,5.75,201908
25,7,250,32,612,460,27,730,0,2111,2260,4371,6,6,201908
26,1,221,7,378,196,14,616,0,1432,2041,3473,9,5.5,201908
26,2,171,12,337,350,2,304,12,1188,1529,2717,12,5,201908
26,3,203,19,302,365,9,845,11,1754,1713,3467,14,6.5,201908
26,4,168,8,174,210,20,546,4,1130,1404,2534,9,5.2,201908
26,5,108,10,212,194,19,520,0,1063,963,2026,15,6,201908
26,6,140,19,261,177,11,686,0,1294,1359,2653,10,5.333333333,201908
26,7,140,12,254,280,41,444,0,1171,1085,2256,10,5.5,201908
27,1,160,13,286,382,51,457,1,1350,1544,2894,8,5.5,201908
27,2,235,28,394,536,30,406,1,1630,1509,3139,8,5.666666667,201908
27,3,154,14,331,446,23,472,0,1440,1698,3138,7,5.666666667,201908
27,4,176,22,480,705,11,612,15,2021,2142,4163,8,6,201908
27,5,104,5,229,310,11,250,0,909,1167,2076,6,5.333333333,201908
27,6,148,11,310,374,10,429,0,1282,1152,2434,7,5.5,201908
28,1,8,0,4,377,0,6,0,395,886,1281,13,6,201908
28,2,133,30,286,203,23,55,235,965,496,1461,13,5.666666667,201908
28,3,104,14,171,276,1,32,1,599,730,1329,7,5.333333333,201908
28,4,194,57,504,385,83,78,387,1688,452,2140,15,6,201908
28,5,78,44,213,294,16,47,356,1048,435,1483,10,5.5,201908
28,6,78,18,205,296,37,38,10,682,654,1336,14,5.166666667,201908
28,7,84,19,406,514,62,96,136,1317,655,1972,13,6,201908
28,8,68,56,389,276,56,78,148,1071,483,1554,9,6,201908
28,9,69,16,175,201,23,36,149,669,278,947,11,5.75,201908
29,1,225,40,363,375,56,586,1,1646,1683,3329,7,5.5,201908
29,2,212,23,346,538,61,664,49,1893,1879,3772,11,6,201908
29,3,140,14,208,313,29,347,0,1051,1135,2186,5,5.666666667,201908
30,1,109,27,205,198,22,517,7,1085,1249,2334,7,5.333333333,201908
30,2,202,14,198,131,20,635,94,1294,1372,2666,8,5.25,201908
30,3,183,12,346,172,55,848,52,1668,1339,3007,6,5.666666667,201908
30,4,110,4,265,200,46,435,1,1061,1111,2172,8,6,201908
30,5,144,12,269,218,13,683,0,1339,1393,2732,7,5.5,201908
30,6,189,20,412,206,35,546,7,1415,1323,2738,9,5.333333333,201908
30,7,242,23,389,294,30,779,28,1785,1790,3575,11,5.25,201908
30,8,202,27,408,367,71,732,39,1846,2116,3962,11,5.4,201908
30,9,217,12,302,190,56,628,29,1434,1593,3027,8,5.5,201908
30,10,131,9,316,254,32,593,15,1350,1694,3044,7,5.5,201908
30,11,133,19,433,346,11,641,0,1583,1553,3136,5,5.5,201908
30,12,220,13,574,546,34,1050,0,2437,2586,5023,10,6,201908
30,13,265,11,354,331,65,1080,73,2179,1985,4164,10,5.4,201908
30,14,187,11,470,212,41,761,4,1686,1678,3364,8,5.5,201908
30,15,257,22,278,272,61,713,129,1732,1994,3726,11,5.666666667,201908
30,16,187,8,429,324,72,911,45,1976,2088,4064,10,5.333333333,201908
30,17,190,15,370,286,40,689,15,1605,1560,3165,8,5.5,201908
30,18,210,18,155,185,27,398,28,1021,1212,2233,8,5.25,201908
30,19,202,12,364,280,28,748,0,1634,1470,3104,13,5.6,201908
30,20,195,21,352,371,130,536,0,1605,1910,3515,10,5.4,201908
31,1,163,30,343,63,365,289,0,1253,1291,2544,8,5.5,201908
31,2,109,13,178,3,139,456,0,898,1219,2117,6,5.333333333,201908
31,3,392,73,1105,549,201,1214,7,3541,3811,7352,21,6.333333333,201908
31,4,107,17,281,174,96,512,17,1204,1187,2391,4,6,201908
31,5,159,9,174,143,15,779,1,1280,1167,2447,6,5.333333333,201908
32,1,160,38,183,141,29,695,8,1254,1267,2521,12,5.2,201908
32,2,222,35,195,134,89,913,21,1609,1395,3004,13,5.142857143,201908
32,3,180,85,209,265,10,836,5,1590,1679,3269,13,5.4,201908
32,4,201,73,275,266,26,644,19,1504,1383,2887,13,5.4,201908
1,1,114,36,214,317,68,50,25,824,304,1128,13,4.5,201909
1,2,78,31,287,597,34,71,29,1127,787,1914,10,5.333333333,201909
1,3,63,43,374,526,28,66,62,1162,683,1845,9,5,201909
2,1,113,23,341,577,26,75,4,1159,440,1599,11,5,201909
2,2,109,29,380,609,10,89,0,1226,357,1583,8,5.5,201909
2,3,130,27,347,353,17,65,190,1129,538,1667,11,4.666666667,201909
2,4,69,9,401,146,39,36,26,726,70,796,9,5,201909
2,5,155,46,680,301,254,89,113,1638,250,1888,13,5,201909
2,6,98,17,349,407,17,59,4,951,170,1121,7,5,201909
2,7,117,19,436,291,23,55,180,1121,195,1316,12,4.5,201909
2,8,97,14,396,458,10,61,156,1192,389,1581,8,5,201909
3,1,117,11,287,198,14,442,3,1072,1305,2377,12,4.666666667,201909
3,2,102,10,434,169,8,241,0,964,1169,2133,9,4.666666667,201909
4,1,119,11,248,288,45,428,20,1159,1417,2576,11,4.25,201909
4,2,172,10,389,297,21,370,4,1263,1766,3029,14,4.2,201909
5,1,197,14,356,222,23,577,5,1394,1464,2858,9,4.666666667,201909
5,2,105,15,199,240,15,324,0,898,1100,1998,10,4.2,201909
5,3,170,8,238,240,29,515,5,1205,1426,2631,8,4.666666667,201909
5,4,199,34,461,367,25,595,14,1695,2324,4019,9,4.666666667,201909
5,5,163,19,396,337,13,460,32,1420,1909,3329,8,5,201909
5,6,160,13,351,283,10,360,36,1213,1336,2549,11,4.5,201909
5,7,156,14,293,267,2,433,0,1165,1632,2797,11,5,201909
6,1,123,15,303,241,9,619,6,1316,1620,2936,12,5,201909
6,2,122,14,329,101,25,481,4,1076,1358,2434,9,4.666666667,201909
7,1,145,9,187,368,5,96,4,814,943,1757,9,4.25,201909
7,2,280,22,131,557,25,108,0,1123,1017,2140,9,4.25,201909
7,3,191,6,170,290,107,232,2,998,1119,2117,7,4.333333333,201909
7,4,157,10,147,541,8,200,16,1079,1744,2823,11,4.4,201909
7,5,322,10,192,395,23,282,1,1225,1492,2717,11,4.666666667,201909
7,6,240,10,275,317,25,462,12,1341,1307,2648,9,4.666666667,201909
7,7,165,16,229,287,46,294,14,1051,1391,2442,8,4.5,201909
7,8,202,6,199,332,4,342,8,1093,1422,2515,12,4.25,201909
7,9,150,31,275,241,16,404,5,1122,1471,2593,9,4.666666667,201909
7,10,161,9,205,401,5,149,0,930,1394,2324,9,4.5,201909
7,11,180,5,97,100,9,106,1,498,487,985,6,4.333333333,201909
7,12,236,8,345,554,8,265,0,1416,1397,2813,9,4.5,201909
7,13,99,5,78,219,2,54,1,458,981,1439,9,4.25,201909
8,1,121,3,360,151,8,272,6,921,1068,1989,4,5,201909
8,2,246,29,603,376,13,642,2,1911,1864,3775,16,4.5,201909
8,3,178,24,326,243,20,394,8,1193,1356,2549,4,5,201909
8,4,151,16,376,236,26,527,42,1374,1763,3137,11,5,201909
8,5,178,27,328,214,9,441,0,1197,1607,2804,10,4.25,201909
8,6,193,31,399,345,39,734,6,1747,1931,3678,7,5.5,201909
8,7,173,32,206,242,13,756,0,1422,1303,2725,7,4.25,201909
8,8,167,34,397,291,13,686,1,1589,1653,3242,11,6,201909
8,9,212,22,181,95,14,576,7,1107,1408,2515,10,4.2,201909
9,1,63,9,104,103,33,244,2,558,611,1169,5,5,201909
9,2,210,47,658,662,59,902,4,2542,3287,5829,12,5,201909
9,3,108,30,295,298,35,463,14,1243,1492,2735,7,5,201909
9,4,140,15,385,425,47,517,11,1540,1896,3436,11,5,201909
9,5,97,7,236,256,34,407,0,1037,1116,2153,7,5,201909
9,6,92,27,145,133,63,303,7,770,937,1707,7,5,201909
9,7,63,4,274,270,5,401,0,1017,1098,2115,9,5,201909
9,8,82,6,295,289,7,326,6,1011,1184,2195,5,5,201909
9,9,52,4,173,194,29,215,2,669,786,1455,5,4,201909
9,10,74,13,298,285,17,413,0,1100,1235,2335,6,5,201909
9,11,150,12,382,439,50,501,1,1535,1875,3410,7,5,201909
9,12,137,23,593,548,33,589,28,1951,2232,4183,11,5,201909
9,13,93,15,233,233,62,394,13,1043,1255,2298,4,5,201909
9,14,74,7,167,171,37,357,13,826,947,1773,5,5,201909
9,15,162,16,750,714,39,963,4,2648,3117,5765,9,5.5,201909
9,16,161,37,337,430,66,660,1,1692,1976,3668,15,5,201909
9,17,107,8,193,245,17,315,0,885,1005,1890,6,5,201909
9,18,100,24,329,464,41,585,3,1546,1891,3437,12,5,201909
9,19,140,37,356,363,109,459,11,1475,1492,2967,5,5,201909
9,20,44,7,123,127,17,164,1,483,526,1009,5,5,201909
9,21,86,6,208,256,32,359,3,950,1072,2022,3,5,201909
9,22,107,11,240,252,70,371,14,1065,1298,2363,5,5,201909
9,23,97,12,277,321,30,487,2,1226,1587,2813,6,5,201909
9,24,206,26,478,513,69,920,12,2224,2371,4595,12,5,201909
10,1,78,13,126,242,18,17,105,599,545,1144,12,3.833333333,201909
10,2,101,54,306,474,26,49,123,1133,429,1562,9,4.25,201909
10,3,113,60,242,266,22,52,344,1099,661,1760,11,4.4,201909
10,4,145,34,366,755,14,54,42,1410,644,2054,13,6,201909
11,1,180,30,224,232,21,400,1,1088,1269,2357,6,4.666666667,201909
11,2,163,13,245,198,20,389,12,1040,1259,2299,7,5,201909
11,3,107,21,140,159,8,390,5,830,1078,1908,3,5,201909
11,4,170,43,165,218,16,516,0,1128,1128,2256,8,5,201909
11,5,235,42,290,349,20,661,5,1602,1905,3507,7,5,201909
11,6,140,16,217,249,33,408,0,1063,1357,2420,8,5,201909
11,7,211,34,286,361,30,331,4,1257,1497,2754,9,4.5,201909
11,8,162,23,331,344,27,559,0,1446,1590,3036,9,4.5,201909
11,9,189,50,290,271,6,588,11,1405,1924,3329,10,4.666666667,201909
11,10,191,45,247,225,16,644,0,1368,1767,3135,10,4.6,201909
11,11,173,28,270,248,11,423,0,1153,1529,2682,5,5,201909
11,12,191,32,412,390,4,587,0,1616,1866,3482,7,5,201909
11,13,167,22,165,173,19,547,6,1099,1494,2593,8,4.5,201909
11,14,146,19,207,156,13,587,17,1145,1590,2735,8,4.5,201909
11,15,150,37,206,208,2,374,1,978,1080,2058,9,5,201909
12,1,154,25,255,111,31,375,3,954,1038,1992,10,4.2,201909
12,2,184,33,295,296,22,425,2,1257,1589,2846,10,4.5,201909
12,3,183,27,297,310,24,274,0,1115,2137,3252,11,4.2,201909
12,4,165,24,399,528,45,349,0,1510,1464,2974,9,4.666666667,201909
12,5,247,17,279,184,2,209,12,950,1314,2264,10,4.25,201909
12,6,180,19,131,411,26,113,1,881,1444,2325,10,4.25,201909
12,7,180,11,244,271,14,428,20,1168,1691,2859,6,4.5,201909
12,8,183,17,233,256,4,175,0,868,684,1552,9,4.25,201909
12,9,179,29,385,474,18,243,1,1329,1529,2858,9,4.666666667,201909
13,1,126,17,155,197,32,390,6,923,1072,1995,9,4.333333333,201909
13,2,121,30,194,232,44,411,1,1033,1035,2068,6,4.333333333,201909
13,3,162,17,214,233,78,402,0,1106,1053,2159,12,4.25,201909
13,4,229,23,338,293,69,398,20,1370,1611,2981,9,4.666666667,201909
13,5,154,15,287,197,61,700,6,1420,1967,3387,9,4.75,201909
13,6,224,62,711,523,55,621,10,2206,2715,4921,11,4.666666667,201909
13,7,135,25,400,381,32,346,0,1319,1409,2728,8,4.5,201909
14,1,83,8,70,49,4,544,1,759,1095,1854,6,4.5,201909
14,2,124,9,102,85,6,568,0,894,1062,1956,5,4.666666667,201909
14,3,188,31,242,161,36,635,1,1294,1623,2917,8,4.4,201909
14,4,167,12,309,306,19,584,7,1404,1639,3043,10,5,201909
14,5,172,13,381,211,39,445,2,1263,1218,2481,9,4.5,201909
14,6,181,10,373,226,13,504,2,1309,1686,2995,11,5,201909
14,7,111,4,158,76,0,296,0,645,678,1323,6,5,201909
14,8,248,32,571,552,7,1273,2,2685,3638,6323,11,5.25,201909
14,9,152,12,187,237,24,638,3,1253,1576,2829,9,5,201909
14,10,146,12,246,154,7,495,1,1061,1298,2359,7,5,201909
14,11,87,8,105,121,8,308,6,643,812,1455,4,5,201909
14,12,147,16,372,124,6,442,3,1110,1105,2215,9,4.5,201909
14,13,138,18,235,151,17,541,1,1101,1487,2588,6,5,201909
14,14,126,11,209,167,16,626,3,1158,2002,3160,7,5,201909
14,15,196,30,225,136,17,788,3,1395,1674,3069,10,4.6,201909
14,16,104,10,194,115,8,496,2,929,1299,2228,5,5,201909
14,17,141,18,150,83,18,513,7,930,643,1573,7,4.25,201909
14,18,200,33,218,92,25,798,1,1367,1253,2620,9,4.4,201909
14,19,178,61,409,330,29,464,29,1500,1539,3039,8,4.25,201909
14,20,227,12,282,179,23,569,3,1295,1379,2674,10,4.666666667,201909
15,1,159,6,175,78,72,824,2,1316,1595,2911,7,4.333333333,201909
15,2,129,11,265,311,43,360,6,1125,1606,2731,6,5,201909
15,3,149,21,171,179,82,775,4,1381,1700,3081,10,4.666666667,201909
15,4,122,8,205,196,17,486,6,1040,1118,2158,4,5,201909
15,5,115,49,229,246,20,543,4,1206,1322,2528,8,4.666666667,201909
15,6,107,10,381,366,32,400,6,1302,1541,2843,7,5,201909
15,7,90,7,240,226,28,423,0,1014,1252,2266,10,5,201909
15,8,83,14,191,230,27,279,12,836,977,1813,4,5,201909
15,9,190,7,127,128,82,483,7,1024,1068,2092,9,4.75,201909
15,10,95,11,219,219,45,399,6,994,1165,2159,6,5,201909
15,11,119,15,321,302,32,402,2,1193,1432,2625,8,5,201909
15,12,169,17,533,435,47,478,1,1680,1943,3623,8,5,201909
15,13,50,6,121,142,50,303,0,672,820,1492,8,5,201909
15,14,76,16,149,155,10,258,0,664,800,1464,4,5,201909
15,15,122,35,265,395,37,357,18,1229,1345,2574,6,5,201909
15,16,187,25,466,641,27,659,4,2009,2115,4124,8,5,201909
15,17,85,13,216,182,11,400,27,934,1245,2179,8,5,201909
15,18,179,29,275,300,33,554,7,1377,1644,3021,7,4.666666667,201909
15,19,171,23,403,437,25,619,7,1685,1927,3612,10,5,201909
15,20,54,9,216,218,10,277,2,786,876,1662,6,5,201909
15,21,107,8,118,174,25,252,5,689,750,1439,6,4.5,201909
15,22,177,33,399,515,24,803,11,1962,2325,4287,14,5,201909
15,23,151,6,188,238,16,455,0,1054,1375,2429,6,4.333333333,201909
15,24,97,9,227,229,24,260,4,850,1065,1915,4,5,201909
15,25,143,21,286,212,27,261,12,962,1047,2009,6,5,201909
15,26,100,6,164,164,22,359,2,817,960,1777,9,6,201909
15,27,173,18,282,366,19,581,25,1464,1631,3095,9,4.666666667,201909
15,28,150,7,397,239,23,551,3,1370,1580,2950,9,4.666666667,201909
15,29,186,20,352,492,5,533,0,1588,1947,3535,8,5,201909
15,30,228,32,495,475,33,381,9,1653,1783,3436,16,5,201909
15,31,84,25,168,275,6,311,0,869,1065,1934,6,5,201909
15,32,160,14,356,431,44,355,3,1363,1457,2820,9,5,201909
15,33,138,14,278,310,22,408,0,1170,1317,2487,7,5,201909
15,34,115,12,185,314,10,389,2,1027,1184,2211,8,5,201909
15,35,241,13,223,293,8,612,0,1390,1430,2820,9,4.666666667,201909
15,36,246,17,323,352,60,633,0,1631,1702,3333,9,4.5,201909
15,37,175,26,328,402,42,619,21,1613,1720,3333,7,5,201909
15,38,149,26,245,258,19,430,3,1130,2105,3235,6,4.5,201909
15,39,124,24,281,331,31,266,1,1058,1122,2180,4,5,201909
15,40,228,20,292,337,65,948,0,1890,2427,4317,9,5,201909
15,41,237,27,623,518,34,539,4,1982,2305,4287,11,5,201909
16,1,137,14,195,118,18,331,1,814,1120,1934,7,4.333333333,201909
16,2,120,24,106,117,7,406,0,780,1170,1950,9,4.25,201909
16,3,190,19,162,227,9,369,0,976,1089,2065,10,4.25,201909
16,4,152,17,139,94,19,551,0,972,957,1929,8,4.5,201909
16,5,140,18,147,125,18,393,3,844,1021,1865,10,4.666666667,201909
16,6,156,24,204,212,21,282,0,899,1075,1974,12,4.5,201909
16,7,218,26,192,162,17,554,0,1169,1290,2459,9,4.5,201909
16,8,218,20,435,397,13,636,0,1719,2212,3931,12,5,201909
16,9,138,23,204,168,10,502,7,1052,1578,2630,9,5,201909
16,10,175,21,324,285,14,458,0,1277,1709,2986,6,5,201909
16,11,169,19,158,122,49,631,0,1148,1223,2371,10,4.4,201909
16,12,179,14,220,132,20,349,1,915,955,1870,10,4.25,201909
17,1,133,16,309,280,15,586,0,1339,1607,2946,9,6,201909
17,2,136,15,287,263,9,327,1,1038,1230,2268,8,4.666666667,201909
17,3,201,18,371,321,6,483,1,1401,1542,2943,8,4.5,201909
17,4,178,20,351,290,22,583,6,1450,1433,2883,10,4.666666667,201909
17,5,76,5,158,150,9,226,0,624,607,1231,5,4.5,201909
18,1,148,19,152,156,14,352,4,845,1010,1855,7,4.25,201909
18,2,242,32,411,317,59,606,1,1668,1918,3586,8,5,201909
18,3,174,14,367,188,8,504,1,1256,1461,2717,8,4.5,201909
19,1,103,13,212,192,15,719,3,1257,1944,3201,9,5,201909
19,2,167,10,445,256,17,682,0,1577,1939,3516,9,5,201909
19,3,168,16,433,206,20,618,0,1461,1744,3205,7,5,201909
19,4,79,11,121,100,26,448,17,802,1050,1852,5,5,201909
19,5,267,26,403,461,14,941,16,2128,2454,4582,8,5,201909
19,6,69,15,153,137,2,518,0,894,1069,1963,5,5,201909
19,7,164,11,501,222,3,500,0,1401,1354,2755,10,4.5,201909
19,8,81,6,177,166,8,330,3,771,753,1524,7,5,201909
19,9,142,16,183,141,23,489,3,997,1236,2233,9,4.25,201909
19,10,90,9,151,133,12,491,5,891,1215,2106,6,6,201909
19,11,204,37,339,394,16,1282,2,2274,3036,5310,13,5,201909
19,12,163,7,509,202,10,546,2,1439,1863,3302,8,4.666666667,201909
20,1,166,7,246,158,49,243,42,911,1182,2093,7,4.5,201909
20,2,140,12,129,174,24,333,0,812,658,1470,6,4.333333333,201909
20,3,110,8,155,143,74,214,21,725,554,1279,6,4.333333333,201909
20,4,127,6,125,92,48,370,44,812,1178,1990,6,4.333333333,201909
20,5,110,14,237,266,61,213,0,901,914,1815,11,4.25,201909
20,6,183,10,181,272,116,216,0,978,1136,2114,8,4.25,201909
20,7,129,6,169,170,11,436,0,921,1249,2170,7,4.75,201909
20,8,391,24,495,715,41,979,57,2702,3062,5764,14,5.5,201909
20,9,200,17,238,175,56,782,22,1490,1135,2625,8,4.666666667,201909
20,10,113,14,184,157,11,335,0,814,972,1786,9,4.25,201909
21,1,85,3,66,158,2,11,0,325,566,891,9,4.4,201909
21,2,101,13,192,271,73,12,0,662,473,1135,9,4.2,201909
21,3,179,20,351,165,151,37,97,1000,753,1753,8,4.5,201909
21,4,169,10,113,156,90,30,15,583,340,923,6,4.25,201909
21,5,130,19,329,273,26,52,48,877,400,1277,8,4.666666667,201909
21,6,138,20,290,328,51,44,203,1074,523,1597,6,5,201909
21,7,184,17,247,192,150,54,10,854,776,1630,9,4.666666667,201909
21,8,120,12,267,61,71,39,76,646,580,1226,9,4.2,201909
21,9,199,12,443,179,215,77,356,1481,393,1874,9,5,201909
21,10,154,19,318,144,104,70,358,1167,327,1494,7,4.5,201909
21,11,56,14,168,166,24,27,52,507,201,708,5,6,201909
21,12,233,26,697,476,124,78,384,2018,833,2851,16,5.5,201909
21,13,118,7,204,21,53,167,78,648,291,939,8,4.666666667,201909
21,14,120,13,169,68,187,38,27,622,340,962,12,4.333333333,201909
21,15,169,19,432,328,76,60,74,1158,647,1805,7,4.5,201909
22,1,174,36,206,320,21,201,4,962,1462,2424,11,4.2,201909
22,2,127,26,249,194,13,326,1,936,1223,2159,7,4.5,201909
22,3,279,39,681,559,25,714,6,2303,2540,4843,9,4.666666667,201909
22,4,155,27,564,447,21,574,1,1789,2097,3886,9,5.5,201909
22,5,143,24,377,186,58,343,1,1132,1474,2606,10,4.5,201909
23,1,102,10,682,274,16,48,0,1132,333,1465,14,4.6,201909
23,2,65,12,192,348,9,32,12,670,347,1017,8,4.25,201909
23,3,83,6,635,10,11,15,56,816,135,951,15,5,201909
23,4,68,5,352,201,50,44,36,756,243,999,8,4.666666667,201909
24,1,169,55,169,273,20,233,3,922,1024,1946,10,4.2,201909
24,2,111,9,225,131,8,359,0,843,1009,1852,6,4.5,201909
24,3,187,41,175,223,57,262,0,945,985,1930,9,4.25,201909
24,4,122,28,167,133,30,453,39,972,1320,2292,5,4.5,201909
24,5,214,49,405,401,9,642,2,1722,2014,3736,9,5,201909
24,6,205,26,379,347,31,601,0,1589,1828,3417,6,5,201909
24,7,203,34,249,440,68,280,0,1274,1113,2387,9,4.25,201909
25,1,143,7,263,230,13,480,4,1140,1215,2355,13,4.75,201909
25,2,194,17,371,337,16,620,0,1555,1983,3538,7,4.5,201909
25,3,200,21,286,327,32,533,13,1412,1577,2989,8,4.6,201909
25,4,170,20,193,284,12,519,1,1199,1573,2772,8,4.333333333,201909
25,5,195,10,393,427,35,631,3,1694,2191,3885,8,4.666666667,201909
25,6,139,16,305,283,33,536,4,1316,1599,2915,8,4.75,201909
25,7,213,17,440,336,23,634,0,1663,1930,3593,6,5,201909
26,1,177,8,424,170,19,583,0,1381,1780,3161,9,4.5,201909
26,2,247,6,390,339,7,378,11,1378,1761,3139,12,4.4,201909
26,3,177,14,217,249,7,671,12,1347,1747,3094,14,5.5,201909
26,4,156,10,167,189,11,609,1,1143,1326,2469,9,4.2,201909
26,5,141,10,174,204,10,494,0,1033,1309,2342,15,5,201909
26,6,135,15,215,145,7,521,0,1038,1422,2460,10,4.333333333,201909
26,7,167,15,227,183,35,355,0,982,1277,2259,10,4.5,201909
27,1,118,29,297,307,47,368,0,1166,1408,2574,8,4.5,201909
27,2,150,11,279,382,19,304,0,1145,1859,3004,8,4.666666667,201909
27,3,156,8,323,453,15,392,0,1347,1495,2842,7,4.666666667,201909
27,4,152,13,453,540,16,502,18,1694,2479,4173,8,5,201909
27,5,68,3,119,252,6,172,0,620,964,1584,6,4.333333333,201909
27,6,120,17,276,306,8,323,0,1050,786,1836,7,4.5,201909
28,1,14,2,36,360,0,8,0,420,627,1047,13,5,201909
28,2,91,32,284,261,21,57,216,962,374,1336,14,5,201909
28,3,65,15,203,257,4,24,1,569,200,769,7,4.333333333,201909
28,4,147,43,409,330,93,69,300,1391,237,1628,15,5,201909
28,5,70,48,163,240,17,27,255,820,349,1169,10,4.5,201909
28,6,87,30,163,266,30,31,36,643,156,799,14,4.166666667,201909
28,7,69,37,369,469,47,89,138,1218,573,1791,13,5,201909
28,8,53,49,247,366,40,73,123,951,386,1337,9,5,201909
28,9,66,20,242,219,35,29,114,725,194,919,11,4.75,201909
29,1,160,16,281,285,37,430,4,1213,1496,2709,7,4.5,201909
29,2,201,20,277,431,42,536,40,1547,1931,3478,11,5,201909
29,3,109,19,185,277,16,325,0,931,1004,1935,5,4.666666667,201909
30,1,98,8,174,161,8,463,3,915,1038,1953,7,4.333333333,201909
30,2,183,10,186,81,43,465,90,1058,1599,2657,8,4.25,201909
30,3,154,9,285,140,40,570,28,1226,1949,3175,6,4.666666667,201909
30,4,81,5,241,181,18,336,1,863,1190,2053,8,5,201909
30,5,120,11,227,175,15,494,0,1042,1254,2296,7,4.5,201909
30,6,186,13,258,237,57,414,4,1169,1184,2353,9,4.333333333,201909
30,7,157,19,317,160,40,376,31,1100,1141,2241,11,4.25,201909
30,8,182,17,289,243,46,692,11,1480,2330,3810,11,4.4,201909
30,9,188,7,203,170,33,494,18,1113,1276,2389,8,4.5,201909
30,10,127,14,292,291,21,561,23,1329,1606,2935,6,5,201909
30,11,122,11,344,282,7,449,0,1215,1440,2655,5,4.5,201909
30,12,180,12,437,431,23,774,0,1857,2425,4282,10,5,201909
30,13,203,19,247,347,64,673,50,1603,1427,3030,10,4.4,201909
30,14,204,19,336,139,46,609,0,1353,1840,3193,8,4.5,201909
30,15,178,10,221,199,42,747,35,1432,1873,3305,11,4.666666667,201909
30,16,209,12,307,322,58,813,60,1781,2336,4117,10,4.333333333,201909
30,17,147,11,300,268,44,510,11,1291,1358,2649,8,4.5,201909
30,18,179,10,148,151,5,368,18,879,1284,2163,8,4.25,201909
30,19,163,8,265,202,20,545,0,1203,1694,2897,13,4.6,201909
30,20,159,11,281,327,91,481,0,1350,1747,3097,10,4.4,201909
31,1,158,15,262,54,203,383,0,1075,1388,2463,8,4.5,201909
31,2,87,7,133,4,121,360,0,712,870,1582,6,4.333333333,201909
31,3,280,30,805,404,89,1081,1,2690,4070,6760,21,5.333333333,201909
31,4,77,2,207,144,85,436,17,968,1162,2130,4,5,201909
31,5,174,11,178,114,5,504,0,986,1485,2471,6,4.333333333,201909
32,1,162,30,177,126,25,559,7,1086,1497,2583,12,4.2,201909
32,2,150,31,123,78,80,627,11,1100,1428,2528,13,4.142857143,201909
32,3,178,61,235,279,21,604,8,1386,1651,3037,13,4.4,201909
32,4,213,44,258,237,25,629,12,1418,1732,3150,13,5,201909
1,1,85,34,193,293,64,36,33,738,260,998,13,5.5,201910
1,2,65,21,294,628,16,76,31,1131,782,1913,9,6,201910
1,3,69,44,344,533,28,69,69,1156,567,1723,9,6,201910
2,1,88,9,303,503,18,55,10,986,428,1414,11,6,201910
2,2,101,23,402,670,9,108,0,1313,293,1606,8,6.5,201910
2,3,128,25,385,420,31,60,185,1234,573,1807,11,5.666666667,201910
2,4,74,16,356,168,70,32,36,752,68,820,9,6,201910
2,5,183,38,667,405,212,112,132,1749,181,1930,13,6,201910
2,6,142,21,416,432,20,61,6,1098,139,1237,7,6,201910
2,7,131,10,419,327,17,55,119,1078,204,1282,12,5.75,201910
2,8,136,15,477,528,12,58,133,1359,281,1640,8,6,201910
3,1,146,9,324,273,18,473,1,1244,1334,2578,12,6.8,201910
3,2,136,15,513,243,26,248,0,1181,1041,2222,9,5.666666667,201910
4,1,165,21,289,288,44,392,25,1224,1606,2830,11,4.25,201910
4,2,165,16,331,374,45,278,4,1213,1475,2688,14,4.2,201910
5,1,198,12,412,279,47,534,9,1491,1763,3254,9,5.666666667,201910
5,2,244,18,378,346,26,460,0,1472,1258,2730,10,5.2,201910
5,3,148,19,296,353,33,533,10,1392,1436,2828,8,5.666666667,201910
5,4,220,18,481,458,11,714,7,1909,1990,3899,9,5.666666667,201910
5,5,187,26,482,534,28,493,35,1785,1664,3449,9,6,201910
5,6,145,22,363,332,16,361,45,1284,1313,2597,11,5.5,201910
5,7,142,13,333,316,4,464,1,1273,1235,2508,11,6,201910
6,1,157,26,330,287,10,682,13,1505,1612,3117,12,6,201910
6,2,168,17,382,184,35,609,7,1402,1227,2629,9,5.666666667,201910
7,1,187,9,216,460,7,167,32,1078,1325,2403,9,5.25,201910
7,2,280,17,176,775,18,117,1,1384,958,2342,9,5.25,201910
7,3,234,4,199,482,129,268,1,1317,1459,2776,7,5.333333333,201910
7,4,150,17,164,578,16,141,6,1072,1198,2270,11,5.4,201910
7,5,383,14,261,702,23,289,0,1672,1978,3650,11,5.666666667,201910
7,6,237,20,327,412,25,571,15,1607,1270,2877,9,5.666666667,201910
7,7,238,20,319,401,44,349,22,1393,1332,2725,8,5.5,201910
7,8,282,11,206,331,16,413,10,1269,1269,2538,12,5.25,201910
7,9,158,27,306,349,22,450,2,1314,1157,2471,9,5.666666667,201910
7,10,186,5,227,504,14,186,0,1122,1265,2387,9,5.5,201910
7,11,145,2,141,104,7,147,11,557,488,1045,6,5.333333333,201910
7,12,180,9,305,534,7,249,1,1285,1638,2923,9,5.5,201910
7,13,100,25,142,356,1,96,0,720,637,1357,9,5.25,201910
8,1,118,10,399,197,14,323,1,1062,977,2039,4,6,201910
8,2,325,30,745,426,20,632,3,2181,2168,4349,16,5.5,201910
8,3,167,18,432,308,34,371,12,1342,1184,2526,4,6,201910
8,4,172,30,442,296,29,625,41,1635,1765,3400,11,6,201910
8,5,215,27,338,314,11,473,0,1378,1391,2769,10,5.25,201910
8,6,210,31,475,421,39,887,6,2069,1796,3865,7,6.5,201910
8,7,213,58,258,227,127,805,0,1688,1584,3272,7,5.25,201910
8,8,167,35,399,358,5,629,1,1594,1570,3164,10,6,201910
8,9,186,12,183,120,15,595,0,1111,1121,2232,10,5,201910
9,1,88,4,142,124,46,332,4,740,613,1353,5,6,201910
9,2,258,57,829,878,81,1035,4,3142,2872,6014,12,6,201910
9,3,129,49,404,409,52,586,11,1640,1416,3056,7,6,201910
9,4,153,13,449,544,65,511,13,1748,2350,4098,11,6,201910
9,5,107,16,290,313,47,415,0,1188,1068,2256,7,6,201910
9,6,82,13,237,208,93,352,10,995,935,1930,7,6,201910
9,7,80,13,320,331,8,471,0,1223,1069,2292,9,6,201910
9,8,93,17,361,349,18,391,5,1234,1154,2388,5,6,201910
9,9,100,10,292,350,56,352,4,1164,1178,2342,5,6,201910
9,10,91,16,381,346,36,460,3,1333,1162,2495,6,6,201910
9,11,154,17,471,563,45,617,0,1867,1702,3569,7,6,201910
9,12,134,36,645,711,36,668,21,2251,2103,4354,11,6,201910
9,13,110,14,293,300,90,480,16,1303,1148,2451,4,6,201910
9,14,99,9,201,234,33,377,18,971,874,1845,5,6,201910
9,15,187,27,914,860,42,1088,6,3124,2477,5601,9,6.5,201910
9,16,224,43,534,645,72,775,0,2293,2297,4590,15,6,201910
9,17,94,10,234,271,16,341,1,967,899,1866,6,6,201910
9,18,128,31,412,544,41,726,2,1884,1804,3688,12,6,201910
9,19,156,33,363,468,103,474,4,1601,1409,3010,5,6,201910
9,20,51,5,142,166,8,175,0,547,492,1039,5,6,201910
9,21,91,10,253,280,41,360,5,1040,1003,2043,3,6,201910
9,22,120,9,296,330,100,390,24,1269,1240,2509,5,6,201910
9,23,118,16,320,430,48,543,4,1479,1429,2908,6,6,201910
9,24,244,41,531,734,82,1042,3,2677,2586,5263,12,6,201910
10,1,102,31,141,244,51,34,101,704,998,1702,12,4.666666667,201910
10,2,117,37,305,511,31,54,107,1162,404,1566,9,5.25,201910
10,3,120,54,184,233,27,28,277,923,467,1390,11,5.4,201910
10,4,139,32,312,873,9,56,10,1431,540,1971,13,7,201910
11,1,230,41,230,251,32,386,0,1170,1189,2359,6,5.666666667,201910
11,2,202,26,313,206,33,408,13,1201,1214,2415,7,6,201910
11,3,132,11,203,220,12,473,4,1055,871,1926,3,6,201910
11,4,167,35,228,236,15,455,0,1136,1196,2332,8,6,201910
11,5,304,55,420,475,15,753,4,2026,1843,3869,7,6,201910
11,6,155,17,293,271,13,448,1,1198,1105,2303,8,6,201910
11,7,275,37,299,364,22,350,1,1348,1564,2912,9,5.5,201910
11,8,206,19,351,360,20,497,0,1453,1476,2929,9,5.5,201910
11,9,228,59,362,407,15,605,25,1701,1326,3027,10,5.666666667,201910
11,10,243,38,287,256,19,660,6,1509,1586,3095,10,5.6,201910
11,11,186,34,364,327,14,491,0,1416,1800,3216,5,6,201910
11,12,228,34,417,469,9,495,0,1652,1797,3449,7,6,201910
11,13,219,35,229,234,20,597,3,1337,1157,2494,8,5.5,201910
11,14,199,29,248,231,22,582,12,1323,1517,2840,8,5.5,201910
11,15,158,36,247,269,7,390,1,1108,1024,2132,9,6,201910
12,1,188,35,345,130,80,396,9,1183,1049,2232,10,5,201910
12,2,213,32,294,363,11,466,4,1383,1509,2892,10,5.5,201910
12,3,196,30,366,349,24,257,2,1224,1412,2636,11,5.2,201910
12,4,179,42,420,527,32,342,1,1543,1547,3090,9,5.666666667,201910
12,5,255,23,257,274,3,244,6,1062,1123,2185,10,5.25,201910
12,6,209,36,180,541,36,166,1,1169,1334,2503,10,5.25,201910
12,7,229,18,313,352,21,468,24,1425,1300,2725,6,5.5,201910
12,8,184,19,364,344,4,144,0,1059,865,1924,9,5.25,201910
12,9,179,30,370,558,15,235,0,1387,1471,2858,9,5.666666667,201910
13,1,172,17,194,218,44,444,40,1129,1064,2193,9,5.333333333,201910
13,2,135,29,141,212,33,431,4,985,1233,2218,6,5.333333333,201910
13,3,158,22,282,289,76,407,0,1234,1218,2452,12,5.25,201910
13,4,215,24,433,284,69,381,8,1414,1696,3110,9,5.666666667,201910
13,5,185,24,406,276,77,826,5,1799,1793,3592,9,5.75,201910
13,6,254,70,853,639,62,602,3,2483,2590,5073,11,5.666666667,201910
13,7,121,22,391,401,26,308,0,1269,1387,2656,8,5.5,201910
14,1,102,14,86,60,1,687,1,951,1053,2004,6,5.5,201910
14,2,123,15,110,72,2,668,0,990,1024,2014,5,5.666666667,201910
14,3,235,33,326,183,38,778,0,1593,1277,2870,8,5.4,201910
14,4,195,20,361,360,16,613,9,1574,1673,3247,10,6,201910
14,5,195,23,422,277,39,478,1,1435,1875,3310,9,5.5,201910
14,6,233,19,492,288,15,566,5,1618,1687,3305,11,6,201910
14,7,117,5,164,137,0,355,0,778,774,1552,6,6,201910
14,8,306,41,694,731,10,1597,5,3384,3174,6558,11,6.25,201910
14,9,190,32,280,319,28,696,0,1545,1367,2912,9,6,201910
14,10,142,19,355,266,12,628,1,1423,1559,2982,7,6,201910
14,11,121,8,120,119,22,370,6,766,758,1524,4,6,201910
14,12,211,20,463,164,15,469,1,1343,1074,2417,9,5.5,201910
14,13,178,22,285,214,13,580,4,1296,1573,2869,6,6,201910
14,14,169,19,247,251,10,700,2,1398,1594,2992,7,6,201910
14,15,240,28,247,187,27,800,11,1540,1664,3204,10,5.6,201910
14,16,163,14,267,163,21,590,2,1220,1102,2322,5,6,201910
14,17,163,13,175,94,10,565,3,1023,944,1967,7,5.25,201910
14,18,217,24,254,110,14,827,5,1451,1338,2789,9,5.4,201910
14,19,223,41,384,354,28,493,48,1571,1574,3145,8,5.25,201910
14,20,222,22,321,184,15,704,5,1473,1413,2886,10,5.666666667,201910
15,1,171,11,217,53,123,913,5,1493,1314,2807,7,5.333333333,201910
15,2,133,11,276,382,38,350,7,1197,1288,2485,6,6,201910
15,3,196,17,272,241,136,954,8,1824,1851,3675,10,5.666666667,201910
15,4,140,16,258,238,23,537,6,1218,1137,2355,4,6,201910
15,5,154,51,279,289,23,635,3,1434,1373,2807,8,5.666666667,201910
15,6,155,15,389,486,26,483,7,1561,1482,3043,7,6,201910
15,7,129,23,267,303,49,459,0,1230,1108,2338,10,6,201910
15,8,79,11,212,280,21,301,7,911,971,1882,4,6,201910
15,9,284,12,211,155,134,623,13,1432,1377,2809,9,5.75,201910
15,10,126,17,271,284,43,426,10,1177,1080,2257,6,6,201910
15,11,109,22,323,376,46,478,0,1354,1350,2704,8,6,201910
15,12,176,21,553,501,49,482,1,1783,1806,3589,8,5.666666667,201910
15,13,77,8,181,148,53,343,1,811,761,1572,8,6,201910
15,14,80,15,186,194,12,254,0,741,748,1489,4,6,201910
15,15,133,55,322,444,31,440,22,1447,1323,2770,6,6,201910
15,16,219,31,571,749,20,673,1,2264,2135,4399,8,6,201910
15,17,108,8,262,253,18,447,17,1113,1421,2534,8,6,201910
15,18,206,15,277,410,29,633,7,1577,1691,3268,7,5.666666667,201910
15,19,177,30,482,574,25,736,10,2034,1898,3932,10,6,201910
15,20,73,22,226,265,12,362,5,965,926,1891,6,6,201910
15,21,101,11,132,225,20,328,9,826,748,1574,6,5.5,201910
15,22,201,42,568,738,24,873,15,2461,2395,4856,14,6,201910
15,23,157,22,264,346,17,586,0,1392,1695,3087,6,5.333333333,201910
15,24,112,23,256,277,28,273,5,974,997,1971,4,6,201910
15,25,150,20,317,283,41,292,12,1115,1160,2275,6,6,201910
15,26,108,10,234,226,29,396,2,1005,1007,2012,9,7,201910
15,27,196,28,317,469,16,694,32,1752,1678,3430,9,5.666666667,201910
15,28,198,20,515,327,36,607,7,1710,1612,3322,9,5.666666667,201910
15,29,209,30,461,677,12,645,0,2034,1879,3913,8,6,201910
15,30,217,30,581,522,38,384,10,1782,1769,3551,16,6,201910
15,31,107,25,222,308,9,384,1,1056,983,2039,6,6,201910
15,32,167,13,412,456,48,365,2,1463,1372,2835,9,6,201910
15,33,170,11,359,371,24,445,0,1380,1328,2708,7,6,201910
15,34,119,23,250,377,6,460,3,1238,1191,2429,8,6,201910
15,35,272,15,257,317,7,788,0,1656,1555,3211,9,5.666666667,201910
15,36,276,23,390,376,47,717,0,1829,1642,3471,9,5.5,201910
15,37,192,19,377,504,53,635,20,1800,1882,3682,7,6,201910
15,38,128,20,237,388,10,466,4,1253,1478,2731,6,5.5,201910
15,39,123,24,357,359,28,268,1,1160,1060,2220,4,6,201910
15,40,260,23,359,456,70,1019,0,2187,2281,4468,9,6,201910
15,41,225,29,738,670,36,574,5,2277,2221,4498,10,6.333333333,201910
16,1,150,22,240,152,19,426,0,1009,799,1808,7,5.333333333,201910
16,2,96,11,99,109,9,235,0,559,956,1515,9,5.25,201910
16,3,189,22,222,246,17,401,4,1101,1352,2453,10,5.25,201910
16,4,184,25,207,99,23,661,0,1199,1057,2256,8,5.5,201910
16,5,177,20,172,165,15,471,8,1028,1024,2052,10,5.666666667,201910
16,6,156,29,188,187,18,270,0,848,1069,1917,12,5.5,201910
16,7,205,34,199,219,29,493,0,1179,1027,2206,9,5.25,201910
16,8,244,38,511,480,13,681,0,1967,2161,4128,12,6,201910
16,9,211,12,285,246,7,544,3,1308,1204,2512,9,6,201910
16,10,184,14,368,351,12,508,0,1437,1584,3021,6,6,201910
16,11,178,26,208,166,49,759,0,1386,1668,3054,10,5.4,201910
16,12,212,17,270,159,26,453,2,1139,1179,2318,10,5.25,201910
17,1,161,19,411,375,13,632,1,1612,1546,3158,9,7,201910
17,2,127,7,451,284,13,400,6,1288,1184,2472,8,5.666666667,201910
17,3,213,19,470,450,21,556,0,1729,1552,3281,8,5.5,201910
17,4,201,15,418,351,22,638,10,1655,1494,3149,10,5.666666667,201910
17,5,113,7,184,195,17,271,6,793,588,1381,5,5.5,201910
18,1,187,19,191,218,10,348,12,985,978,1963,7,5.25,201910
18,2,241,27,514,452,66,586,0,1886,1792,3678,9,6.333333333,201910
18,3,149,14,309,187,8,372,1,1040,1326,2366,8,5.5,201910
19,1,138,9,278,294,14,800,5,1538,1655,3193,9,6,201910
19,2,219,13,523,283,11,734,1,1784,1856,3640,9,6,201910
19,3,206,15,514,299,43,714,0,1791,2070,3861,7,6,201910
19,4,97,14,138,132,26,547,10,964,888,1852,5,6,201910
19,5,279,19,489,564,19,975,17,2362,2576,4938,8,6,201910
19,6,76,11,206,206,6,524,2,1031,1015,2046,5,6,201910
19,7,145,14,500,213,8,374,0,1254,1312,2566,10,5.5,201910
19,8,78,9,165,196,1,314,8,771,1083,1854,7,6,201910
19,9,126,10,213,180,20,466,1,1016,1176,2192,9,5.25,201910
19,10,106,15,201,192,8,562,8,1092,986,2078,6,7,201910
19,11,220,32,455,525,18,1342,3,2595,2668,5263,13,6,201910
19,12,185,8,605,216,15,504,2,1535,1805,3340,8,5.666666667,201910
20,1,178,17,281,187,43,355,53,1114,1324,2438,7,5.5,201910
20,2,139,6,149,161,6,242,0,703,1436,2139,6,5.333333333,201910
20,3,148,12,236,183,63,278,26,946,742,1688,6,5.333333333,201910
20,4,107,15,125,172,24,310,16,769,952,1721,6,5.333333333,201910
20,5,118,12,237,246,32,203,1,849,1101,1950,11,5.25,201910
20,6,141,7,219,278,241,178,0,1064,1031,2095,8,5.25,201910
20,7,152,9,227,249,19,462,0,1118,1201,2319,7,5.75,201910
20,8,398,36,591,846,37,994,73,2975,3076,6051,14,6.5,201910
20,9,261,11,295,215,51,744,20,1597,1222,2819,8,5.666666667,201910
20,10,176,7,237,266,8,338,2,1034,1507,2541,9,5.25,201910
21,1,107,3,112,176,4,14,0,416,526,942,9,5.4,201910
21,2,140,13,225,298,114,21,2,813,404,1217,9,5.2,201910
21,3,214,20,372,228,154,46,99,1133,497,1630,8,5.5,201910
21,4,153,10,169,203,69,30,31,665,269,934,6,5.25,201910
21,5,119,15,288,271,21,46,86,846,308,1154,8,5.666666667,201910
21,6,156,14,333,428,67,60,269,1327,431,1758,6,6,201910
21,7,255,18,293,228,217,66,22,1099,371,1470,9,5.666666667,201910
21,8,148,10,308,110,101,41,101,819,639,1458,9,5.2,201910
21,9,208,21,458,325,137,69,265,1483,237,1720,9,6,201910
21,10,176,19,417,207,68,64,368,1319,203,1522,7,5.5,201910
21,11,82,9,155,201,22,26,49,544,120,664,5,7,201910
21,12,265,39,734,893,99,89,492,2611,600,3211,16,6.5,201910
21,13,123,10,201,179,58,167,72,810,258,1068,8,5.666666667,201910
21,14,167,14,185,62,240,33,48,749,514,1263,12,5.333333333,201910
21,15,332,32,555,424,124,71,100,1638,366,2004,7,5.5,201910
22,1,150,48,204,318,28,200,4,952,1144,2096,11,5.2,201910
22,2,118,20,337,242,38,382,1,1138,1124,2262,7,5.5,201910
22,3,292,46,840,622,31,720,2,2553,2663,5216,9,5.666666667,201910
22,4,186,24,602,527,22,535,3,1899,2404,4303,9,6.5,201910
22,5,134,24,460,223,53,340,2,1236,1326,2562,10,5.5,201910
23,1,93,6,628,412,16,38,6,1199,242,1441,14,5.6,201910
23,2,136,16,324,491,19,23,11,1020,417,1437,8,5.25,201910
23,3,67,7,298,374,19,8,47,820,108,928,15,5,201910
23,4,73,8,387,405,50,49,29,1001,205,1206,8,5.666666667,201910
24,1,131,45,199,284,11,221,5,896,991,1887,10,5.2,201910
24,2,143,17,257,190,18,483,0,1108,1182,2290,6,5.5,201910
24,3,148,31,184,218,72,232,0,885,869,1754,9,5.25,201910
24,4,129,21,200,193,37,537,21,1138,970,2108,5,5.5,201910
24,5,242,52,473,508,13,751,3,2042,1892,3934,10,6.333333333,201910
24,6,194,24,384,382,36,723,0,1743,1874,3617,6,6,201910
24,7,209,24,254,389,51,265,0,1192,1460,2652,9,5.25,201910
25,1,128,14,238,326,14,365,5,1090,1350,2440,13,5.75,201910
25,2,264,28,387,336,24,733,0,1772,1904,3676,7,5.5,201910
25,3,227,7,375,307,34,523,8,1481,1546,3027,8,5.6,201910
25,4,239,18,248,360,13,559,9,1446,1640,3086,8,5.333333333,201910
25,5,227,17,574,515,46,732,0,2111,2074,4185,8,5.666666667,201910
25,6,140,9,300,330,31,486,1,1297,1458,2755,8,5.75,201910
25,7,308,26,517,434,21,706,0,2012,1946,3958,6,6,201910
26,1,218,11,427,238,23,605,1,1523,1516,3039,9,5.5,201910
26,2,239,10,486,453,2,390,10,1590,1388,2978,12,5.4,201910
26,3,208,18,308,367,10,767,19,1697,1567,3264,14,6.5,201910
26,4,144,12,205,237,10,621,3,1232,1159,2391,9,5.2,201910
26,5,125,10,265,242,15,528,0,1185,1062,2247,15,6,201910
26,6,151,12,257,214,6,647,0,1287,1325,2612,10,5.333333333,201910
26,7,160,15,251,275,42,363,0,1106,1283,2389,10,5.5,201910
27,1,145,7,289,350,27,328,0,1146,1130,2276,8,5.5,201910
27,2,146,7,287,424,34,322,0,1220,1601,2821,8,5.666666667,201910
27,3,168,10,259,479,8,362,1,1287,1485,2772,7,5.666666667,201910
27,4,163,26,483,741,14,526,16,1969,1846,3815,8,6,201910
27,5,94,5,155,288,14,169,0,725,976,1701,6,5.333333333,201910
27,6,117,14,265,364,14,304,0,1078,825,1903,7,5.5,201910
28,1,15,3,44,350,0,14,0,426,477,903,13,6,201910
28,2,101,19,246,337,19,41,192,955,387,1342,13,5.666666667,201910
28,3,61,9,149,222,5,19,0,465,143,608,7,5.333333333,201910
28,4,119,29,292,293,52,33,221,1039,215,1254,15,6,201910
28,5,70,31,152,321,12,29,222,837,263,1100,9,5.25,201910
28,6,58,16,100,190,19,22,31,436,141,577,13,5.166666667,201910
28,7,87,33,330,407,39,64,123,1083,525,1608,13,6,201910
28,8,48,40,252,306,49,55,121,871,328,1199,9,6,201910
28,9,58,13,160,212,24,36,76,579,226,805,11,5.5,201910
29,1,196,24,386,339,49,531,1,1526,1447,2973,7,5.5,201910
29,2,240,20,393,533,30,561,76,1853,1632,3485,11,6,201910
29,3,126,22,197,295,21,338,0,999,972,1971,5,5.666666667,201910
30,1,96,17,207,150,13,413,10,906,1228,2134,7,5.333333333,201910
30,2,153,12,162,96,29,289,66,807,1211,2018,8,5.25,201910
30,3,144,15,307,167,47,547,30,1257,1769,3026,6,5.666666667,201910
30,4,95,13,247,188,31,362,0,936,983,1919,8,6,201910
30,5,111,6,216,238,18,483,0,1072,1072,2144,7,5.5,201910
30,6,184,12,312,202,22,484,1,1217,1516,2733,9,5.333333333,201910
30,7,175,12,225,226,20,421,23,1102,1386,2488,11,5.25,201910
30,8,195,11,320,350,48,624,11,1559,2195,3754,11,5.4,201910
30,9,253,11,280,240,47,607,26,1464,1258,2722,8,5.5,201910
30,10,133,12,300,274,28,444,18,1209,1366,2575,6,6,201910
30,11,103,15,364,306,5,421,0,1214,1319,2533,5,5.5,201910
30,12,176,12,427,459,24,651,1,1750,2109,3859,10,6,201910
30,13,212,17,247,353,64,634,50,1577,1991,3568,10,5.4,201910
30,14,146,7,306,176,63,549,5,1252,1672,2924,8,5.5,201910
30,15,261,7,210,297,27,780,21,1603,1950,3553,11,5.666666667,201910
30,16,218,8,342,367,57,745,40,1777,2255,4032,10,5.333333333,201910
30,17,181,23,288,294,52,546,8,1392,1749,3141,8,5.5,201910
30,18,170,9,129,170,13,332,3,826,1064,1890,8,5.25,201910
30,19,172,7,277,224,14,449,0,1143,1910,3053,13,5.6,201910
30,20,196,12,256,447,115,367,0,1393,1956,3349,10,5.4,201910
31,1,167,21,211,39,178,407,1,1024,1158,2182,8,4.5,201910
31,2,72,9,113,5,122,282,0,603,886,1489,6,4.333333333,201910
31,3,271,36,831,421,119,1022,0,2700,3691,6391,21,5.333333333,201910
31,4,91,11,258,151,67,425,6,1009,892,1901,4,5,201910
31,5,130,7,147,107,17,448,0,856,1101,1957,6,4.333333333,201910
32,1,189,26,178,147,31,577,6,1154,1283,2437,12,5.2,201910
32,2,177,34,182,95,54,611,9,1162,1530,2692,13,5.142857143,201910
32,3,126,41,205,246,10,545,6,1179,1397,2576,13,5.4,201910
32,4,220,53,240,278,16,652,17,1476,1363,2839,13,5.4,201910
1,1,82,33,178,352,45,49,28,767,367,1134,13,5.5,201911
1,2,82,28,274,651,27,58,10,1130,835,1965,10,6.333333333,201911
1,3,71,55,290,514,28,71,59,1088,569,1657,9,6,201911
2,1,88,9,282,490,19,57,8,953,387,1340,11,6,201911
2,2,97,18,310,655,8,85,0,1173,337,1510,7,6,201911
2,3,143,29,372,407,22,75,150,1198,561,1759,11,5.666666667,201911
2,4,93,10,380,181,44,30,26,764,81,845,9,6,201911
2,5,193,39,603,457,183,113,98,1686,242,1928,13,6,201911
2,6,98,15,374,408,28,46,10,979,137,1116,7,6,201911
2,7,163,23,379,330,22,55,129,1101,455,1556,12,5.75,201911
2,8,124,11,448,545,16,70,105,1319,393,1712,8,6,201911
3,1,163,14,317,291,16,476,2,1279,1412,2691,11,5.8,201911
3,2,162,9,517,231,40,225,1,1185,1179,2364,9,5.666666667,201911
4,1,182,15,302,406,42,485,18,1450,1411,2861,11,5.25,201911
4,2,181,15,440,331,61,320,5,1353,1463,2816,14,5.2,201911
5,1,260,15,432,321,28,475,8,1539,1572,3111,9,5.666666667,201911
5,2,175,10,303,279,33,343,0,1143,1417,2560,10,5.2,201911
5,3,166,19,265,285,23,582,15,1355,1624,2979,8,5.666666667,201911
5,4,224,27,509,410,15,688,28,1901,1898,3799,9,5.666666667,201911
5,5,198,18,473,531,23,421,34,1698,1796,3494,9,6,201911
5,6,134,10,310,323,7,355,41,1180,1273,2453,11,5.5,201911
5,7,168,23,291,306,8,404,4,1204,1322,2526,10,5.5,201911
6,1,174,16,310,280,16,580,5,1381,1709,3090,12,6,201911
6,2,158,9,371,190,52,500,7,1287,1359,2646,9,5.666666667,201911
7,1,270,16,257,384,8,128,12,1075,1351,2426,9,5.25,201911
7,2,271,8,164,741,14,105,0,1303,1667,2970,9,4.75,201911
7,3,230,3,280,457,115,263,0,1348,1160,2508,7,5.333333333,201911
7,4,215,16,191,489,49,204,10,1174,1406,2580,11,5.4,201911
7,5,388,5,246,610,12,293,2,1556,1716,3272,11,5.666666667,201911
7,6,207,14,326,358,20,510,16,1451,1682,3133,9,5.666666667,201911
7,7,237,20,309,400,38,319,27,1350,1245,2595,8,5.5,201911
7,8,343,13,304,442,14,456,7,1579,1525,3104,12,5.25,201911
7,9,164,23,279,329,16,398,1,1210,1209,2419,9,5.666666667,201911
7,10,195,12,234,452,29,216,3,1141,1189,2330,9,5.5,201911
7,11,168,5,82,130,5,121,22,533,919,1452,6,5.333333333,201911
7,12,195,8,269,532,8,228,0,1240,1671,2911,9,5.5,201911
7,13,138,38,192,408,88,90,0,954,453,1407,9,5.25,201911
8,1,107,9,415,199,32,240,1,1003,1069,2072,4,6,201911
8,2,293,21,683,449,25,569,0,2040,2335,4375,16,5.5,201911
8,3,162,23,373,330,10,375,11,1284,1291,2575,4,6,201911
8,4,168,16,364,288,29,525,41,1431,1555,2986,11,6,201911
8,5,196,29,329,238,13,486,0,1291,1433,2724,10,5.25,201911
8,6,202,17,437,412,38,693,3,1802,2105,3907,7,6.5,201911
8,7,205,42,244,218,78,516,0,1303,1483,2786,7,5.25,201911
8,8,177,40,350,373,7,594,2,1543,1741,3284,10,6,201911
8,9,258,13,189,160,27,717,1,1365,983,2348,10,5,201911
9,1,66,8,162,164,59,289,3,751,674,1425,5,6,201911
9,2,267,59,738,932,86,1080,10,3172,3086,6258,12,6,201911
9,3,125,37,404,437,41,545,15,1604,1504,3108,7,6,201911
9,4,168,20,453,559,70,444,13,1727,2268,3995,11,6,201911
9,5,121,11,245,262,56,453,0,1148,1241,2389,7,6,201911
9,6,85,15,212,198,102,351,4,967,988,1955,7,6,201911
9,7,87,9,279,317,3,417,0,1112,1108,2220,9,6,201911
9,8,99,19,341,373,14,340,6,1192,1215,2407,5,6,201911
9,9,110,9,243,320,43,318,5,1048,900,1948,5,6,201911
9,10,104,18,349,373,41,425,2,1312,1301,2613,6,6,201911
9,11,152,16,458,524,45,620,3,1818,1794,3612,7,6,201911
9,12,141,25,631,664,37,656,27,2181,2208,4389,11,6,201911
9,13,108,15,259,337,98,433,15,1265,1230,2495,4,6,201911
9,14,99,11,203,245,47,375,8,988,1012,2000,5,6,201911
9,15,157,26,873,804,32,977,3,2872,2709,5581,9,6.5,201911
9,16,191,48,513,745,83,714,2,2296,2016,4312,15,6,201911
9,17,120,10,262,285,22,269,0,968,959,1927,6,6,201911
9,18,138,22,400,567,46,665,1,1839,1875,3714,12,6,201911
9,19,140,46,365,409,82,442,6,1490,1609,3099,5,6,201911
9,20,45,5,127,159,29,136,1,502,524,1026,5,6,201911
9,21,102,9,247,271,46,362,8,1045,1099,2144,3,6,201911
9,22,170,16,279,329,70,362,14,1240,1232,2472,5,6,201911
9,23,126,18,291,462,38,465,5,1405,1460,2865,6,6,201911
9,24,264,24,583,743,85,972,6,2677,2413,5090,12,6,201911
10,1,180,71,225,295,127,50,150,1098,608,1706,12,4.833333333,201911
10,2,128,24,281,418,19,47,73,990,355,1345,9,5.25,201911
10,3,68,50,163,200,17,36,240,774,431,1205,11,5.4,201911
10,4,115,32,318,801,15,53,8,1342,589,1931,12,7,201911
11,1,187,37,222,241,14,431,1,1133,1317,2450,6,5.666666667,201911
11,2,203,23,261,210,37,344,17,1095,1186,2281,7,6,201911
11,3,141,31,193,194,9,447,10,1025,985,2010,3,6,201911
11,4,149,48,199,220,27,386,0,1029,1238,2267,8,6,201911
11,5,281,45,417,484,21,718,11,1977,1702,3679,7,6,201911
11,6,162,24,255,273,33,402,2,1151,1209,2360,8,6,201911
11,7,229,38,318,328,18,292,5,1228,1644,2872,9,5.5,201911
11,8,184,29,311,361,25,494,0,1404,1559,2963,9,5.5,201911
11,9,267,69,357,428,21,507,18,1667,1492,3159,10,5.666666667,201911
11,10,217,46,240,245,23,547,10,1328,1573,2901,10,5.6,201911
11,11,214,44,329,335,15,490,0,1427,1898,3325,5,6,201911
11,12,215,39,460,437,8,514,0,1673,1868,3541,7,6,201911
11,13,235,37,242,236,19,592,6,1367,1362,2729,8,5.5,201911
11,14,179,38,257,234,20,598,13,1339,1389,2728,8,5.5,201911
11,15,135,36,233,239,5,336,0,984,1078,2062,9,6,201911
12,1,141,22,253,112,37,309,2,876,1258,2134,10,5,201911
12,2,201,26,259,359,21,423,4,1293,1536,2829,10,5.5,201911
12,3,199,27,294,350,29,259,0,1158,1244,2402,11,5.2,201911
12,4,175,25,373,502,28,302,0,1405,1557,2962,9,5.666666667,201911
12,5,225,20,238,247,4,210,6,950,1215,2165,10,5.25,201911
12,6,222,26,224,432,35,205,4,1148,1005,2153,10,5.25,201911
12,7,246,20,255,314,22,359,31,1247,1500,2747,6,5.5,201911
12,8,238,31,309,332,2,252,0,1164,1246,2410,9,5.25,201911
12,9,164,29,383,529,22,235,0,1362,1501,2863,9,5.666666667,201911
13,1,257,15,310,201,51,484,29,1347,1146,2493,9,5.333333333,201911
13,2,150,17,119,203,39,363,5,896,1129,2025,6,5.333333333,201911
13,3,207,20,254,342,112,330,4,1269,1249,2518,12,5.25,201911
13,4,205,19,352,286,85,397,23,1367,1502,2869,9,5.666666667,201911
13,5,258,29,402,287,77,803,4,1860,1880,3740,9,5.75,201911
13,6,254,76,803,662,50,555,3,2403,2617,5020,11,5.666666667,201911
13,7,184,37,431,434,50,383,1,1520,1448,2968,8,5.5,201911
14,1,126,19,75,69,11,709,0,1009,1036,2045,6,5.5,201911
14,2,167,18,137,62,8,702,1,1095,1132,2227,5,5.666666667,201911
14,3,263,34,324,141,42,725,1,1530,1366,2896,8,5.4,201911
14,4,200,17,281,384,14,515,4,1415,1556,2971,10,6,201911
14,5,215,25,454,294,40,586,0,1614,1618,3232,9,5.5,201911
14,6,233,11,478,325,19,544,3,1613,1732,3345,11,6,201911
14,7,117,7,146,124,0,338,0,732,801,1533,6,6,201911
14,8,325,42,711,705,13,1468,6,3270,3345,6615,11,6.25,201911
14,9,196,13,269,286,20,665,0,1449,1583,3032,9,6,201911
14,10,154,7,320,257,11,559,1,1309,1508,2817,7,6,201911
14,11,110,9,123,134,14,367,5,762,759,1521,4,6,201911
14,12,248,16,463,167,14,468,2,1378,1112,2490,9,5.5,201911
14,13,199,17,273,226,14,570,2,1301,1281,2582,6,6,201911
14,14,121,16,285,258,21,689,1,1391,1238,2629,7,6,201911
14,15,268,32,227,215,33,759,11,1545,1636,3181,10,5.6,201911
14,16,187,15,236,180,12,595,2,1227,1220,2447,5,6,201911
14,17,198,22,167,103,30,588,4,1112,510,1622,7,5.25,201911
14,18,229,22,295,184,28,870,9,1637,1296,2933,9,5.4,201911
14,19,224,37,364,331,23,577,4,1560,1456,3016,8,5.25,201911
14,20,245,10,313,207,18,644,3,1440,1220,2660,10,5.666666667,201911
15,1,205,8,297,95,128,835,0,1568,1628,3196,7,5.333333333,201911
15,2,140,16,368,365,33,397,6,1325,1345,2670,6,6,201911
15,3,253,15,263,240,106,881,6,1764,2178,3942,10,5.666666667,201911
15,4,146,10,241,273,23,525,3,1221,1203,2424,4,6,201911
15,5,183,112,361,244,19,533,2,1454,1071,2525,8,5.666666667,201911
15,6,131,16,357,424,42,432,10,1412,1443,2855,7,6,201911
15,7,153,17,292,336,35,389,4,1226,1191,2417,10,6,201911
15,8,76,12,233,277,15,270,5,888,906,1794,4,6,201911
15,9,281,13,256,187,130,666,8,1541,1429,2970,9,5.75,201911
15,10,145,11,283,246,62,408,4,1159,1184,2343,6,6,201911
15,11,150,25,366,404,36,472,4,1457,1404,2861,8,6,201911
15,12,243,19,624,522,68,437,0,1913,1937,3850,8,6,201911
15,13,71,12,201,168,54,324,0,830,751,1581,8,6,201911
15,14,100,12,191,208,10,252,0,773,733,1506,4,6,201911
15,15,141,52,325,443,35,403,21,1420,1423,2843,6,6,201911
15,16,258,57,593,746,42,594,5,2295,2207,4502,8,6,201911
15,17,102,15,238,253,16,421,13,1058,1103,2161,8,6,201911
15,18,226,22,342,443,29,605,6,1673,1742,3415,7,5.666666667,201911
15,19,174,39,447,551,22,682,2,1917,1985,3902,10,6,201911
15,20,81,15,242,256,13,337,6,950,874,1824,6,6,201911
15,21,134,11,179,229,23,291,10,877,665,1542,6,5.5,201911
15,22,242,40,519,650,25,896,18,2390,2303,4693,14,6,201911
15,23,224,13,232,354,19,544,0,1386,1249,2635,6,5.333333333,201911
15,24,111,15,279,263,27,251,5,951,892,1843,4,6,201911
15,25,150,30,301,299,51,296,22,1149,1040,2189,6,6,201911
15,26,117,6,234,235,35,373,5,1005,1036,2041,9,7,201911
15,27,209,19,403,470,17,693,22,1833,1913,3746,9,5.666666667,201911
15,28,214,9,490,297,48,517,1,1576,1674,3250,9,5.666666667,201911
15,29,208,23,440,656,10,631,1,1969,1970,3939,8,6,201911
15,30,233,21,560,543,43,399,8,1807,1821,3628,16,6,201911
15,31,139,42,258,331,12,363,0,1145,969,2114,6,6,201911
15,32,170,14,385,507,35,380,1,1492,1480,2972,9,6,201911
15,33,182,14,384,398,26,418,0,1422,1261,2683,7,6,201911
15,34,147,19,272,337,6,450,7,1238,1277,2515,8,6,201911
15,35,303,22,267,359,6,729,0,1686,1440,3126,9,5.666666667,201911
15,36,314,29,406,329,43,665,0,1786,1586,3372,9,5.5,201911
15,37,222,24,380,522,61,660,18,1887,1725,3612,7,6,201911
15,38,159,30,271,342,9,474,4,1289,1368,2657,6,5,201911
15,39,149,23,332,355,17,291,0,1167,1177,2344,4,6,201911
15,40,333,23,380,471,68,909,2,2186,2163,4349,9,6,201911
15,41,253,33,704,626,62,567,3,2248,2150,4398,14,6.333333333,201911
16,1,185,18,216,174,7,364,2,966,1049,2015,7,5.333333333,201911
16,2,111,14,113,161,7,296,0,702,897,1599,9,5.25,201911
16,3,185,23,225,244,21,392,1,1091,1103,2194,10,5.25,201911
16,4,216,14,197,143,19,637,0,1226,1193,2419,8,5.5,201911
16,5,255,24,241,169,21,569,8,1287,1183,2470,10,5.666666667,201911
16,6,184,31,224,231,29,301,1,1001,1134,2135,12,5.5,201911
16,7,170,27,214,208,34,401,0,1054,1061,2115,9,5.5,201911
16,8,251,27,544,471,12,667,0,1972,1973,3945,12,6,201911
16,9,183,26,262,233,14,531,0,1249,1363,2612,9,6,201911
16,10,191,20,335,326,14,430,0,1316,1529,2845,6,6,201911
16,11,198,22,225,142,75,680,0,1342,1573,2915,10,5.4,201911
16,12,164,12,229,179,21,349,6,960,1074,2034,10,5.25,201911
17,1,171,15,442,387,21,577,2,1615,1610,3225,9,7,201911
17,2,146,10,408,360,12,398,3,1337,1434,2771,8,5.666666667,201911
17,3,220,13,412,452,13,535,0,1645,1700,3345,8,5.5,201911
17,4,207,11,452,381,22,559,5,1637,1568,3205,10,5.666666667,201911
17,5,127,7,202,181,27,231,3,778,532,1310,5,5.5,201911
18,1,168,16,144,187,29,302,17,863,977,1840,7,5.25,201911
18,2,242,26,499,380,43,554,1,1745,1945,3690,9,6.333333333,201911
18,3,141,19,335,192,7,341,0,1035,1326,2361,8,5.5,201911
19,1,161,10,306,306,15,804,3,1605,1529,3134,9,6,201911
19,2,235,12,611,358,18,782,0,2016,1874,3890,9,6,201911
19,3,201,9,512,315,37,656,0,1730,1930,3660,7,6,201911
19,4,108,13,167,132,29,502,15,966,1056,2022,5,6,201911
19,5,324,20,515,563,22,976,15,2435,2880,5315,8,6,201911
19,6,83,14,176,220,9,469,0,971,1146,2117,5,6,201911
19,7,223,12,588,234,7,473,0,1537,1659,3196,10,5.5,201911
19,8,95,10,210,201,4,344,2,866,873,1739,7,6,201911
19,9,219,14,288,223,32,551,1,1328,1645,2973,9,5.25,201911
19,10,106,9,195,172,8,524,5,1019,1193,2212,7,8,201911
19,11,290,44,466,470,28,1363,12,2673,2707,5380,13,6,201911
19,12,200,12,623,211,21,521,2,1590,1521,3111,8,5.666666667,201911
20,1,193,15,279,209,34,318,42,1090,1307,2397,7,5.5,201911
20,2,145,7,146,165,17,225,0,705,676,1381,6,5.333333333,201911
20,3,146,13,284,171,59,270,31,974,709,1683,6,5.333333333,201911
20,4,117,11,97,163,33,239,33,693,608,1301,6,5.333333333,201911
20,5,122,16,207,402,25,189,0,961,1357,2318,11,5.25,201911
20,6,146,12,187,246,126,156,1,874,943,1817,8,5.25,201911
20,7,192,23,245,309,17,450,0,1236,1317,2553,7,5.75,201911
20,8,403,26,585,828,33,843,54,2772,2828,5600,14,6.5,201911
20,9,245,21,239,210,60,591,27,1393,1280,2673,8,5.666666667,201911
20,10,223,14,386,241,9,369,0,1242,1514,2756,9,5.25,201911
21,1,96,4,84,179,1,10,0,374,458,832,9,5.4,201911
21,2,202,23,249,282,153,35,4,948,479,1427,9,5.2,201911
21,3,199,22,418,271,150,53,88,1201,484,1685,8,5.5,201911
21,4,98,9,84,132,75,26,26,450,216,666,6,5.25,201911
21,5,137,19,376,331,17,61,95,1036,353,1389,8,5.666666667,201911
21,6,173,15,306,487,61,47,214,1303,471,1774,6,6,201911
21,7,176,8,231,255,84,44,23,821,307,1128,9,5.666666667,201911
21,8,160,15,325,103,156,34,84,877,517,1394,9,5.2,201911
21,9,173,23,450,435,102,68,219,1470,198,1668,9,6,201911
21,10,176,30,416,342,63,59,249,1335,173,1508,7,5.5,201911
21,11,53,8,145,187,13,22,26,454,178,632,5,7,201911
21,12,262,29,657,1133,65,108,385,2639,863,3502,15,6,201911
21,13,151,8,169,228,37,159,61,813,206,1019,8,5.666666667,201911
21,14,144,14,227,138,137,34,85,779,388,1167,12,5.333333333,201911
21,15,239,18,491,386,103,64,103,1404,313,1717,7,5.5,201911
22,1,222,49,209,353,15,234,5,1087,1386,2473,11,5.2,201911
22,2,124,26,301,224,29,344,1,1049,1189,2238,7,5.5,201911
22,3,244,32,767,601,31,524,2,2201,2523,4724,9,5.666666667,201911
22,4,186,34,623,495,27,530,2,1897,2113,4010,9,6.5,201911
22,5,137,15,465,187,45,282,5,1136,1128,2264,10,5.5,201911
23,1,153,4,697,508,9,49,8,1428,250,1678,14,5.6,201911
23,2,132,17,275,422,5,28,19,898,352,1250,9,5.5,201911
23,3,69,3,325,548,6,21,42,1014,171,1185,15,6,201911
23,4,70,7,396,567,62,42,36,1180,462,1642,8,5.666666667,201911
24,1,160,45,202,315,28,237,8,995,1201,2196,10,5.2,201911
24,2,126,18,248,182,15,367,0,956,1089,2045,6,5.5,201911
24,3,196,36,181,199,61,210,0,883,1130,2013,9,5.25,201911
24,4,149,25,168,215,40,455,17,1069,1052,2121,5,5.5,201911
24,5,245,51,530,488,20,656,1,1991,2076,4067,10,6.333333333,201911
24,6,165,31,386,416,16,627,1,1642,1663,3305,6,6,201911
24,7,207,28,374,407,28,259,0,1303,1336,2639,9,5.25,201911
25,1,226,18,339,337,32,499,13,1464,1374,2838,13,5.75,201911
25,2,271,25,424,389,19,699,0,1827,1621,3448,7,5.5,201911
25,3,181,9,347,357,36,423,11,1364,1347,2711,8,5.6,201911
25,4,184,14,233,296,5,436,8,1176,1396,2572,8,5.333333333,201911
25,5,243,13,447,513,41,614,0,1871,2122,3993,8,5.666666667,201911
25,6,216,10,330,305,48,624,5,1538,1802,3340,8,5.75,201911
25,7,242,24,525,422,14,617,0,1844,1999,3843,6,6,201911
26,1,195,9,361,198,3,472,0,1238,1588,2826,9,5.5,201911
26,2,208,5,425,425,7,353,11,1434,1512,2946,12,5.4,201911
26,3,231,10,319,443,13,795,4,1815,1600,3415,14,6.5,201911
26,4,133,10,177,230,13,458,2,1023,1151,2174,9,5.2,201911
26,5,129,8,185,221,14,491,0,1048,1089,2137,15,6,201911
26,6,179,8,273,257,5,612,0,1334,1197,2531,10,5.333333333,201911
26,7,154,14,211,250,38,323,0,990,1056,2046,10,5.5,201911
27,1,219,9,412,388,45,507,1,1581,1499,3080,8,5.5,201911
27,2,192,19,331,467,26,311,0,1346,1563,2909,8,5.666666667,201911
27,3,166,10,264,414,13,355,0,1222,1453,2675,7,5.666666667,201911
27,4,200,17,433,696,17,549,19,1931,2051,3982,8,6,201911
27,5,122,5,168,290,8,257,0,850,1197,2047,6,5.333333333,201911
27,6,172,14,297,401,11,372,0,1267,1292,2559,7,5.5,201911
28,1,23,2,75,384,0,19,0,503,431,934,13,6,201911
28,2,96,17,225,327,18,38,194,915,324,1239,14,6,201911
28,3,90,19,161,211,0,45,0,526,120,646,7,5.333333333,201911
28,4,162,28,297,314,51,50,221,1123,258,1381,15,6,201911
28,5,89,35,165,346,11,45,194,885,356,1241,9,5.25,201911
28,6,83,19,123,287,20,21,30,583,189,772,13,5.166666667,201911
28,7,92,23,349,424,50,64,115,1117,472,1589,13,6,201911
28,8,58,53,228,417,58,76,84,974,357,1331,9,6,201911
28,9,62,15,207,194,23,44,85,630,251,881,11,5.75,201911
29,1,232,41,424,370,67,432,3,1569,1727,3296,7,5.5,201911
29,2,229,26,415,525,45,592,60,1892,1906,3798,11,6,201911
29,3,139,37,229,359,19,373,0,1156,1029,2185,5,5.666666667,201911
30,1,140,9,238,185,12,447,4,1035,1315,2350,7,5.333333333,201911
30,2,170,13,206,109,29,369,59,955,1353,2308,8,5.25,201911
30,3,152,12,328,160,28,540,22,1242,1615,2857,6,5.666666667,201911
30,4,92,4,275,202,38,332,0,943,982,1925,8,6,201911
30,5,145,11,266,261,14,488,0,1185,1280,2465,7,5.5,201911
30,6,182,9,303,207,20,430,10,1161,1682,2843,9,5.333333333,201911
30,7,214,13,288,285,26,560,25,1411,1426,2837,11,5.25,201911
30,8,181,21,337,298,47,529,4,1417,1964,3381,11,5.4,201911
30,9,218,13,267,197,42,493,20,1250,1485,2735,8,5.5,201911
30,10,161,11,327,269,32,487,17,1304,1356,2660,6,6,201911
30,11,119,12,450,297,4,424,0,1306,1374,2680,5,5.5,201911
30,12,233,18,519,546,23,833,3,2175,2030,4205,10,6,201911
30,13,193,8,205,340,36,624,76,1482,2089,3571,10,5.4,201911
30,14,134,9,332,183,59,476,15,1208,1496,2704,8,5.5,201911
30,15,228,15,217,282,28,660,17,1447,1619,3066,11,5.666666667,201911
30,16,150,8,301,301,50,554,41,1405,1790,3195,10,5.333333333,201911
30,17,195,29,296,311,48,623,11,1513,1838,3351,8,5.5,201911
30,18,170,11,131,161,16,317,16,822,1075,1897,8,5.25,201911
30,19,175,12,283,258,12,462,2,1204,1544,2748,13,5.6,201911
30,20,173,16,273,341,101,393,2,1299,1430,2729,10,5.4,201911
31,1,210,15,197,38,214,408,0,1082,1512,2594,8,5.5,201911
31,2,88,11,182,4,191,309,0,785,1025,1810,6,5.333333333,201911
31,3,343,37,1025,576,135,1148,1,3265,3293,6558,21,6.333333333,201911
31,4,103,15,315,182,74,459,19,1167,1083,2250,4,6,201911
31,5,155,9,144,142,33,512,0,995,1288,2283,6,5.333333333,201911
32,1,183,28,157,148,23,597,5,1141,1370,2511,12,5.2,201911
32,2,245,44,208,133,68,777,17,1492,1261,2753,13,5.142857143,201911
32,3,189,53,214,299,9,635,6,1405,2086,3491,13,5.4,201911
32,4,164,41,231,234,18,520,18,1226,1298,2524,13,5.4,201911
1,1,122,30,184,364,35,35,24,794,311,1105,13,4.5,201912
1,2,79,19,212,632,21,66,13,1042,602,1644,10,5.333333333,201912
1,3,53,31,281,462,15,50,35,927,478,1405,9,5,201912
2,1,80,5,207,419,11,36,1,759,346,1105,11,5,201912
2,2,97,14,271,478,8,75,0,943,346,1289,7,5,201912
2,3,106,22,289,361,21,48,131,978,414,1392,11,4.666666667,201912
2,4,75,6,315,209,31,24,24,684,103,787,9,5,201912
2,5,160,27,480,446,145,87,55,1400,291,1691,13,5,201912
2,6,107,9,315,335,8,42,2,818,104,922,7,5,201912
2,7,126,14,296,324,23,44,102,929,225,1154,12,4.75,201912
2,8,112,8,292,514,11,41,91,1069,396,1465,8,5,201912
3,1,170,8,191,248,6,362,1,986,1212,2198,12,5.2,201912
3,2,108,10,430,176,31,219,1,975,1144,2119,9,4.666666667,201912
4,1,130,16,238,317,40,353,15,1109,1225,2334,11,4.25,201912
4,2,123,14,366,299,12,293,6,1113,1318,2431,14,4.2,201912
5,1,192,13,326,255,19,432,6,1243,1632,2875,9,4.666666667,201912
5,2,167,24,237,266,29,291,0,1014,1500,2514,10,4.2,201912
5,3,160,22,220,208,39,388,13,1050,1133,2183,8,4.666666667,201912
5,4,162,21,377,364,17,570,13,1524,1937,3461,9,4.666666667,201912
5,5,167,18,389,440,25,340,24,1403,1631,3034,9,5,201912
5,6,110,7,250,285,9,225,28,914,1219,2133,11,4.5,201912
5,7,128,24,220,268,14,399,4,1057,1284,2341,11,5,201912
6,1,125,21,250,226,4,465,6,1097,1458,2555,12,5,201912
6,2,124,12,303,148,36,414,4,1041,1261,2302,9,4.666666667,201912
7,1,199,14,155,423,5,65,1,862,950,1812,9,4.25,201912
7,2,169,4,66,319,7,56,0,621,987,1608,9,3.5,201912
7,3,229,4,180,231,78,247,1,970,1196,2166,7,4.333333333,201912
7,4,135,13,135,386,7,137,14,827,1128,1955,11,4.4,201912
7,5,325,18,172,407,18,221,1,1162,1432,2594,11,4.666666667,201912
7,6,201,11,224,327,23,347,8,1141,1592,2733,8,4.333333333,201912
7,7,196,25,255,408,52,217,19,1172,1239,2411,8,4.5,201912
7,8,200,7,124,487,5,326,3,1152,1342,2494,12,4.25,201912
7,9,136,23,216,304,16,313,2,1010,1214,2224,9,4.666666667,201912
7,10,188,3,173,537,24,142,1,1068,980,2048,9,4.5,201912
7,11,96,3,91,166,3,66,2,427,261,688,6,4.333333333,201912
7,12,198,11,253,445,5,199,0,1111,1450,2561,9,4.5,201912
7,13,102,19,110,180,0,93,0,504,1023,1527,9,4.25,201912
8,1,129,5,329,168,20,233,5,889,1042,1931,4,5,201912
8,2,252,19,564,367,19,483,0,1704,2062,3766,16,4.5,201912
8,3,158,14,347,302,21,336,14,1192,1394,2586,4,5,201912
8,4,201,17,309,253,20,439,25,1264,1707,2971,11,5,201912
8,5,200,28,274,207,8,341,0,1058,1338,2396,10,4.25,201912
8,6,151,21,391,379,37,595,6,1580,1783,3363,7,5.5,201912
8,7,160,31,177,135,6,386,0,895,936,1831,7,4.25,201912
8,8,181,27,327,323,5,432,0,1295,1451,2746,10,5,201912
8,9,161,6,147,105,7,532,1,959,1216,2175,10,4.2,201912
9,1,76,4,121,133,36,239,3,612,698,1310,5,5,201912
9,2,219,64,640,761,59,784,12,2539,2961,5500,12,5,201912
9,3,87,33,330,351,48,399,12,1260,1478,2738,7,5,201912
9,4,141,15,379,468,53,380,6,1442,1714,3156,11,5,201912
9,5,79,12,210,273,40,347,0,961,1087,2048,7,5,201912
9,6,75,17,175,131,79,265,4,746,1020,1766,7,5,201912
9,7,63,9,235,287,7,317,0,918,1112,2030,9,5,201912
9,8,92,11,260,296,11,328,10,1008,1164,2172,5,5,201912
9,9,75,7,217,243,45,229,2,818,1015,1833,5,5,201912
9,10,97,13,311,326,18,319,2,1086,1262,2348,6,5,201912
9,11,110,13,418,469,34,469,1,1514,1737,3251,7,5,201912
9,12,135,36,527,558,24,481,28,1789,2036,3825,11,5,201912
9,13,77,12,260,234,76,332,11,1002,1160,2162,4,5,201912
9,14,76,6,137,209,40,287,7,762,904,1666,5,5,201912
9,15,141,20,752,727,25,720,5,2390,2544,4934,8,5,201912
9,16,179,40,413,542,76,569,2,1821,2008,3829,15,5,201912
9,17,115,11,198,255,33,229,1,842,869,1711,6,5,201912
9,18,101,28,340,453,45,510,3,1480,1745,3225,12,5,201912
9,19,143,31,292,377,74,343,6,1266,1488,2754,5,5,201912
9,20,39,3,102,103,17,108,1,373,496,869,5,5,201912
9,21,113,13,179,209,28,241,8,791,1008,1799,3,5,201912
9,22,125,11,254,283,60,281,8,1022,1163,2185,5,5,201912
9,23,84,10,271,389,45,406,0,1205,1389,2594,6,5,201912
9,24,214,34,512,643,85,809,4,2301,2438,4739,12,5,201912
10,1,163,27,116,296,9,31,63,705,324,1029,12,4.166666667,201912
10,2,66,26,192,350,13,40,52,739,316,1055,9,4.25,201912
10,3,69,25,74,167,14,20,138,507,204,711,11,4.4,201912
10,4,105,22,217,656,9,34,4,1047,601,1648,12,5.5,201912
11,1,176,31,164,156,18,271,1,817,1047,1864,6,4.666666667,201912
11,2,132,22,214,167,27,280,8,850,1115,1965,7,5,201912
11,3,128,17,165,213,7,377,3,910,1014,1924,3,5,201912
11,4,122,30,154,204,15,345,0,870,1153,2023,8,5,201912
11,5,249,35,360,407,21,514,4,1590,1797,3387,7,5,201912
11,6,115,20,228,225,28,306,2,924,1122,2046,8,5,201912
11,7,209,42,270,465,25,242,3,1256,1254,2510,9,4.5,201912
11,8,167,32,249,343,16,399,0,1206,1417,2623,9,4.5,201912
11,9,199,44,266,304,15,415,14,1257,1577,2834,10,4.666666667,201912
11,10,181,33,240,216,10,455,8,1143,1378,2521,10,4.6,201912
11,11,160,31,266,270,16,335,0,1078,1443,2521,5,5,201912
11,12,178,43,346,378,7,361,0,1313,2108,3421,7,5,201912
11,13,140,26,167,184,22,362,4,905,1216,2121,8,4.5,201912
11,14,137,29,177,180,11,347,3,884,1183,2067,8,4.5,201912
11,15,129,32,175,229,8,243,0,816,1001,1817,9,5,201912
12,1,118,26,189,95,26,245,2,701,947,1648,10,4.2,201912
12,2,201,34,241,321,14,342,1,1154,1175,2329,10,4.5,201912
12,3,181,28,258,344,18,212,0,1041,1321,2362,11,4.2,201912
12,4,127,18,274,447,23,207,0,1096,1322,2418,9,4.666666667,201912
12,5,294,22,211,200,1,258,5,991,1109,2100,10,4.25,201912
12,6,187,22,135,452,30,95,5,926,853,1779,10,4.25,201912
12,7,180,15,197,320,11,346,18,1087,1111,2198,6,4.5,201912
12,8,164,30,203,249,5,206,0,857,809,1666,9,4.25,201912
12,9,144,25,264,485,15,189,0,1122,1231,2353,9,4.666666667,201912
13,1,214,14,232,207,28,382,39,1116,1418,2534,9,4.333333333,201912
13,2,94,13,96,128,27,274,9,641,969,1610,6,4.333333333,201912
13,3,91,9,168,150,74,165,0,657,862,1519,12,4.25,201912
13,4,193,15,289,261,61,274,21,1114,1407,2521,9,4.666666667,201912
13,5,166,16,292,239,51,544,2,1310,1660,2970,9,4.75,201912
13,6,215,60,622,532,36,431,5,1901,2337,4238,11,4.666666667,201912
13,7,127,14,280,341,35,224,0,1021,1233,2254,8,4.5,201912
14,1,107,15,76,47,5,469,0,719,867,1586,6,4.5,201912
14,2,153,13,111,59,9,562,0,907,1079,1986,5,4.666666667,201912
14,3,169,17,163,82,3,595,0,1029,1530,2559,8,4.4,201912
14,4,169,15,302,306,20,445,0,1257,1471,2728,10,5,201912
14,5,138,15,346,178,25,331,0,1033,1330,2363,9,4.5,201912
14,6,192,11,414,236,18,411,0,1282,1671,2953,11,5,201912
14,7,104,4,123,111,0,237,0,579,734,1313,6,5,201912
14,8,243,30,638,567,9,1085,4,2576,3250,5826,11,5.25,201912
14,9,160,17,231,265,15,494,1,1183,1333,2516,9,5,201912
14,10,117,27,279,195,10,426,0,1054,1359,2413,7,5,201912
14,11,90,9,107,101,11,318,9,645,730,1375,4,5,201912
14,12,203,14,385,155,8,345,0,1110,1421,2531,9,4.5,201912
14,13,157,4,269,196,14,434,6,1080,1297,2377,6,5,201912
14,14,116,14,219,226,21,526,1,1123,1340,2463,7,5,201912
14,15,195,26,205,174,19,600,11,1230,1528,2758,10,4.6,201912
14,16,124,11,185,123,18,411,2,874,1111,1985,5,5,201912
14,17,141,19,139,80,9,354,4,746,1061,1807,7,4.25,201912
14,18,204,23,276,149,16,653,3,1324,1538,2862,9,4.4,201912
14,19,158,22,244,200,11,333,7,975,1351,2326,8,4.25,201912
14,20,163,14,227,161,12,500,1,1078,1325,2403,10,4.666666667,201912
15,1,167,12,166,106,79,657,1,1188,1477,2665,7,4.333333333,201912
15,2,117,15,221,273,30,285,4,945,1192,2137,6,5,201912
15,3,187,22,196,200,97,553,7,1262,1745,3007,10,4.666666667,201912
15,4,110,14,207,248,9,403,8,999,1144,2143,4,5,201912
15,5,126,42,254,263,36,415,7,1143,1274,2417,8,4.666666667,201912
15,6,120,11,270,352,40,359,4,1156,1424,2580,7,5,201912
15,7,102,12,222,267,26,323,1,953,1149,2102,10,5,201912
15,8,66,7,159,241,16,217,2,708,945,1653,4,5,201912
15,9,194,6,165,137,109,392,7,1010,1140,2150,9,4.75,201912
15,10,101,10,213,245,42,331,6,948,1063,2011,6,5,201912
15,11,146,12,283,304,33,332,0,1110,1337,2447,8,5,201912
15,12,179,17,478,445,55,367,0,1541,1523,3064,8,5,201912
15,13,58,7,178,159,47,265,1,715,786,1501,8,5,201912
15,14,65,16,124,164,5,202,0,576,773,1349,4,5,201912
15,15,111,32,284,304,19,375,3,1128,1373,2501,6,5,201912
15,16,219,33,433,605,25,485,5,1805,2259,4064,8,5,201912
15,17,98,13,178,213,7,326,14,849,1084,1933,8,5,201912
15,18,162,13,253,307,19,448,4,1206,1503,2709,7,4.666666667,201912
15,19,133,35,367,436,17,500,8,1496,1856,3352,10,5,201912
15,20,68,10,204,196,12,274,0,764,842,1606,6,5,201912
15,21,92,8,156,203,25,228,8,720,867,1587,6,4.5,201912
15,22,184,31,452,554,22,603,9,1855,2522,4377,14,5,201912
15,23,116,21,185,266,18,352,0,958,1055,2013,6,4.333333333,201912
15,24,103,10,228,217,28,215,8,809,940,1749,4,5,201912
15,25,115,23,233,214,45,205,9,844,1038,1882,6,5,201912
15,26,85,6,160,200,23,332,1,807,948,1755,9,6,201912
15,27,175,17,270,364,20,496,21,1363,1613,2976,9,4.666666667,201912
15,28,147,14,383,279,31,413,4,1271,1429,2700,9,4.666666667,201912
15,29,158,25,389,507,10,424,0,1513,1857,3370,8,5,201912
15,30,171,27,395,409,42,329,10,1383,1776,3159,16,5,201912
15,31,103,30,212,242,9,263,0,859,1020,1879,6,5,201912
15,32,146,11,277,386,26,283,2,1131,1513,2644,9,5,201912
15,33,141,15,278,374,18,313,0,1139,1285,2424,7,5,201912
15,34,104,12,172,308,11,311,3,921,1109,2030,8,5,201912
15,35,161,19,209,271,3,529,0,1192,1549,2741,9,4.666666667,201912
15,36,186,17,292,212,62,377,0,1146,1534,2680,9,4.5,201912
15,37,148,23,326,428,41,451,17,1434,1736,3170,7,5,201912
15,38,137,24,251,335,9,359,3,1118,1322,2440,6,4.5,201912
15,39,134,23,245,367,27,242,0,1038,1102,2140,4,5,201912
15,40,221,18,313,361,41,637,0,1591,2404,3995,9,5,201912
15,41,194,38,553,566,30,396,16,1793,2225,4018,14,5.333333333,201912
16,1,100,9,160,103,18,242,0,632,808,1440,7,4.333333333,201912
16,2,95,21,132,144,14,294,0,700,579,1279,9,4.25,201912
16,3,182,20,151,203,17,245,4,822,831,1653,10,4.25,201912
16,4,160,16,150,83,16,505,0,930,1122,2052,8,4.5,201912
16,5,193,19,173,172,22,364,8,951,1111,2062,10,4.666666667,201912
16,6,157,20,177,201,19,253,0,827,898,1725,12,4.5,201912
16,7,207,17,169,160,22,435,0,1010,1008,2018,9,4.5,201912
16,8,233,23,468,400,8,489,0,1621,1887,3508,12,5,201912
16,9,179,23,215,215,19,412,1,1064,1202,2266,9,5,201912
16,10,158,10,292,273,5,346,0,1084,1476,2560,6,5,201912
16,11,200,12,158,103,42,545,0,1060,1271,2331,10,4.4,201912
16,12,133,17,207,123,6,258,1,745,865,1610,10,4.25,201912
17,1,145,14,313,321,14,423,5,1235,1579,2814,9,6,201912
17,2,142,12,311,285,16,288,4,1058,1385,2443,8,4.666666667,201912
17,3,262,17,295,441,10,495,3,1523,1648,3171,8,4.5,201912
17,4,160,6,314,305,21,461,7,1274,1663,2937,10,4.666666667,201912
17,5,53,3,143,127,3,128,2,459,784,1243,5,4.5,201912
18,1,90,13,122,123,10,221,7,586,750,1336,7,4.25,201912
18,2,206,14,357,339,31,441,0,1388,1657,3045,9,5.333333333,201912
18,3,141,11,277,174,9,274,0,886,1128,2014,8,4.5,201912
19,1,149,13,249,254,7,546,2,1220,1382,2602,9,5,201912
19,2,227,15,526,320,8,620,0,1716,1773,3489,9,5,201912
19,3,176,12,435,249,22,510,1,1405,1572,2977,7,5,201912
19,4,86,8,130,100,31,383,16,754,878,1632,5,5,201912
19,5,249,19,400,510,15,750,13,1956,2411,4367,8,5,201912
19,6,73,13,143,173,8,355,0,765,1001,1766,5,5,201912
19,7,153,10,446,168,3,214,0,994,1346,2340,10,4.5,201912
19,8,85,10,150,159,2,242,0,648,781,1429,7,5,201912
19,9,109,12,191,136,15,347,0,810,1095,1905,9,4.25,201912
19,10,86,7,171,173,2,444,2,885,898,1783,6,6,201912
19,11,246,24,397,466,6,1047,2,2188,2390,4578,13,5,201912
19,12,172,9,404,174,15,429,1,1204,1471,2675,8,4.666666667,201912
20,1,137,12,214,159,43,241,43,849,1063,1912,7,4.5,201912
20,2,105,6,86,124,5,153,0,479,772,1251,6,4.333333333,201912
20,3,105,8,103,118,74,120,28,556,902,1458,6,4.333333333,201912
20,4,81,5,67,81,32,164,21,451,759,1210,6,4.333333333,201912
20,5,101,10,133,285,15,145,0,689,1070,1759,11,4.25,201912
20,6,199,7,126,150,120,147,0,749,941,1690,8,4.25,201912
20,7,174,11,213,256,11,326,0,991,963,1954,7,4.75,201912
20,8,330,17,455,633,27,688,46,2196,2732,4928,14,5.5,201912
20,9,190,18,185,190,35,444,17,1079,1285,2364,8,4.666666667,201912
20,10,157,10,150,284,5,212,0,818,951,1769,9,4.25,201912
21,1,91,1,56,150,1,12,0,311,348,659,9,4.4,201912
21,2,116,19,151,203,126,25,3,643,305,948,9,4.2,201912
21,3,135,12,256,228,111,37,59,838,448,1286,8,4.5,201912
21,4,86,5,70,115,48,21,31,376,199,575,6,4.25,201912
21,5,124,15,284,279,17,38,63,820,237,1057,8,4.666666667,201912
21,6,154,17,242,460,49,44,136,1102,560,1662,6,5,201912
21,7,123,14,140,244,85,41,13,660,350,1010,9,4.666666667,201912
21,8,91,5,196,84,48,25,49,498,326,824,9,4.2,201912
21,9,148,10,306,440,74,36,98,1112,282,1394,9,5,201912
21,10,173,11,306,366,52,46,187,1141,180,1321,7,4.5,201912
21,11,35,3,80,158,15,15,26,332,231,563,4,5,201912
21,12,220,15,469,1058,42,71,278,2153,978,3131,15,5,201912
21,13,115,6,156,204,34,121,42,678,86,764,8,4.666666667,201912
21,14,117,11,143,148,67,13,80,579,322,901,12,4.333333333,201912
21,15,138,15,314,305,54,34,38,898,277,1175,7,4.5,201912
22,1,163,40,193,301,22,151,13,883,833,1716,11,4.2,201912
22,2,123,25,229,213,35,243,0,868,1056,1924,7,4.5,201912
22,3,213,38,654,494,17,465,0,1881,2285,4166,9,4.666666667,201912
22,4,137,32,472,410,21,419,4,1495,1848,3343,9,5.5,201912
22,5,125,18,340,174,42,245,0,944,1142,2086,10,4.5,201912
23,1,103,4,613,447,12,34,10,1223,368,1591,14,4.6,201912
23,2,77,13,178,383,2,25,13,691,307,998,8,4.25,201912
23,3,58,6,263,382,3,13,33,758,122,880,15,4,201912
23,4,80,5,373,481,28,35,26,1028,463,1491,8,4.666666667,201912
24,1,113,37,126,202,30,135,6,649,903,1552,10,4.2,201912
24,2,94,17,202,178,8,274,0,773,879,1652,6,4.5,201912
24,3,130,36,160,184,55,166,0,731,877,1608,9,4.25,201912
24,4,120,19,143,158,24,393,10,867,956,1823,5,4.5,201912
24,5,203,42,402,423,19,513,0,1602,1925,3527,10,5.333333333,201912
24,6,143,41,318,320,11,501,0,1334,1981,3315,6,5,201912
24,7,121,33,252,529,68,208,0,1211,1095,2306,9,4.25,201912
25,1,135,15,205,263,15,345,11,989,1256,2245,13,4.75,201912
25,2,186,23,308,319,18,502,0,1356,1899,3255,7,4.5,201912
25,3,178,8,256,255,27,324,3,1051,1312,2363,8,4.6,201912
25,4,156,20,156,301,17,276,11,937,1258,2195,8,4.333333333,201912
25,5,163,8,316,373,25,427,1,1313,1811,3124,8,4.666666667,201912
25,6,148,4,258,275,44,410,18,1157,1344,2501,8,4.75,201912
25,7,209,14,425,399,10,495,1,1553,1782,3335,6,5,201912
26,1,174,5,315,184,13,469,0,1160,1518,2678,9,4.5,201912
26,2,201,9,412,366,4,336,5,1333,1514,2847,12,4.4,201912
26,3,190,12,274,316,18,616,4,1430,1528,2958,14,5.5,201912
26,4,175,17,144,223,21,487,9,1076,1147,2223,9,4.2,201912
26,5,134,9,182,187,20,410,0,942,1122,2064,15,5,201912
26,6,160,7,221,209,6,531,0,1134,1171,2305,10,4.333333333,201912
26,7,148,9,209,195,31,259,0,851,1088,1939,10,4.5,201912
27,1,135,10,191,258,18,245,3,860,1081,1941,8,4.5,201912
27,2,196,21,337,448,27,273,0,1302,1516,2818,8,4.666666667,201912
27,3,137,6,231,388,6,271,1,1040,1379,2419,7,4.666666667,201912
27,4,163,7,320,502,9,356,19,1376,1864,3240,8,5,201912
27,5,98,3,116,234,17,136,0,604,670,1274,6,4.333333333,201912
27,6,130,15,225,352,8,326,1,1057,1493,2550,7,4.5,201912
28,1,28,4,87,359,1,18,0,497,382,879,13,5,201912
28,2,50,16,173,263,8,28,116,654,347,1001,13,4.666666667,201912
28,3,87,8,125,208,1,23,2,454,64,518,7,4.333333333,201912
28,4,102,29,246,352,39,33,132,933,317,1250,15,5,201912
28,5,43,20,112,281,10,30,126,622,370,992,10,4.25,201912
28,6,37,16,94,210,18,12,16,403,124,527,13,4.166666667,201912
28,7,56,29,252,388,34,52,108,919,410,1329,13,5,201912
28,8,49,25,216,297,30,37,68,722,270,992,9,5,201912
28,9,61,14,114,174,17,24,55,459,182,641,11,4.75,201912
29,1,201,23,323,337,31,363,2,1280,1286,2566,7,4.5,201912
29,2,176,18,278,489,28,392,34,1415,1651,3066,11,5,201912
29,3,109,13,159,245,12,231,0,769,916,1685,5,4.666666667,201912
30,1,73,7,147,128,6,187,5,553,910,1463,7,4.333333333,201912
30,2,110,7,144,103,23,178,39,604,930,1534,8,4.25,201912
30,3,124,9,219,145,30,370,28,925,1195,2120,6,4.666666667,201912
30,4,74,5,220,155,37,217,0,708,1003,1711,8,5,201912
30,5,93,5,169,207,6,352,0,832,1058,1890,7,4.5,201912
30,6,169,10,215,228,18,296,4,940,1136,2076,9,4.333333333,201912
30,7,113,15,214,163,16,259,9,789,1046,1835,11,4.25,201912
30,8,152,17,279,273,37,498,3,1259,1507,2766,11,4.4,201912
30,9,174,4,176,164,44,347,16,925,1097,2022,8,4.5,201912
30,10,107,8,218,205,23,275,13,849,1209,2058,6,5,201912
30,11,133,13,325,320,13,416,0,1220,1599,2819,5,4.5,201912
30,12,179,13,478,450,18,644,1,1783,2017,3800,10,5,201912
30,13,146,10,147,232,54,341,35,965,1703,2668,10,4.4,201912
30,14,160,13,271,148,55,419,1,1067,1356,2423,8,4.5,201912
30,15,161,7,187,217,34,522,27,1155,1439,2594,11,4.666666667,201912
30,16,155,7,235,250,34,456,35,1172,1700,2872,10,4.333333333,201912
30,17,145,16,234,232,28,335,6,996,1399,2395,8,4.5,201912
30,18,129,7,122,149,2,229,17,655,665,1320,8,4.25,201912
30,19,125,7,329,202,25,351,0,1039,1170,2209,13,4.6,201912
30,20,146,11,209,322,103,275,0,1066,1223,2289,10,4.4,201912
31,1,133,13,168,28,128,314,1,785,1065,1850,8,4.5,201912
31,2,68,8,145,3,117,210,0,551,896,1447,6,4.333333333,201912
31,3,291,57,788,453,86,866,0,2541,2942,5483,21,5.333333333,201912
31,4,95,4,252,185,74,347,12,969,993,1962,4,5,201912
31,5,119,6,92,131,38,377,1,764,845,1609,6,4.333333333,201912
32,1,148,31,127,112,23,427,5,873,918,1791,12,4.2,201912
32,2,146,25,102,79,35,485,11,883,1005,1888,13,4.142857143,201912
32,3,158,34,174,238,5,533,1,1143,1520,2663,13,4.4,201912
32,4,164,42,212,228,17,452,11,1126,1639,2765,13,4.4,201912
1,1,101,24,183,317,53,26,22,726,330,1056,13,5.5,201913
1,2,80,26,279,713,14,71,12,1195,781,1976,10,7.666666667,201913
1,3,85,36,281,609,24,64,42,1141,549,1690,9,6,201913
2,1,119,18,283,468,8,61,8,965,358,1323,11,6,201913
2,2,104,15,312,617,4,79,0,1131,392,1523,7,6,201913
2,3,151,29,350,460,26,62,173,1251,392,1643,12,6,201913
2,4,73,9,344,242,51,28,31,778,166,944,9,6,201913
2,5,198,30,563,605,139,106,60,1701,396,2097,13,6,201913
2,6,158,10,354,447,18,64,2,1053,179,1232,7,6,201913
2,7,175,22,347,361,25,54,139,1123,306,1429,12,5.75,201913
2,8,135,11,385,617,8,50,97,1303,473,1776,8,6,201913
3,1,175,10,304,256,13,390,1,1149,1139,2288,11,5.8,201913
3,2,160,10,501,248,16,257,2,1194,1017,2211,9,5.666666667,201913
4,1,187,14,353,368,59,428,28,1437,1446,2883,11,5.25,201913
4,2,166,14,365,356,45,246,44,1236,1091,2327,14,5.2,201913
5,1,221,21,379,301,26,501,3,1452,1436,2888,9,5.666666667,201913
5,2,177,20,339,315,32,317,0,1200,1040,2240,10,5.2,201913
5,3,144,21,281,311,22,522,18,1319,1419,2738,8,5.666666667,201913
5,4,251,34,629,486,14,664,20,2098,1773,3871,9,5.666666667,201913
5,5,214,17,476,532,22,394,35,1690,1501,3191,9,6,201913
5,6,170,12,325,371,12,323,41,1254,1102,2356,11,5.5,201913
5,7,184,15,370,291,5,364,2,1231,1086,2317,10,5.5,201913
6,1,171,13,338,259,6,483,5,1275,1321,2596,12,6,201913
6,2,144,16,375,188,40,453,6,1222,1284,2506,9,5.666666667,201913
7,1,230,6,191,500,15,125,10,1077,834,1911,9,5.25,201913
7,2,338,16,205,469,48,76,0,1152,1162,2314,9,5.25,201913
7,3,286,5,224,457,125,261,0,1358,1242,2600,7,5.333333333,201913
7,4,221,18,232,379,12,231,24,1117,1620,2737,11,5.4,201913
7,5,313,9,204,604,14,228,0,1372,1205,2577,11,5.666666667,201913
7,6,231,12,292,395,17,395,13,1355,1404,2759,8,5.333333333,201913
7,7,220,19,301,372,39,250,16,1217,1303,2520,8,5.25,201913
7,8,249,11,172,397,9,224,5,1067,1390,2457,12,5.25,201913
7,9,232,13,367,352,12,382,1,1359,1307,2666,9,5.666666667,201913
7,10,241,11,207,411,28,149,0,1047,1172,2219,9,5.5,201913
7,11,192,4,120,167,8,111,33,635,541,1176,6,5.333333333,201913
7,12,216,8,287,522,6,184,0,1223,1038,2261,9,5.5,201913
7,13,119,8,103,238,0,82,0,550,1144,1694,9,5.25,201913
8,1,159,11,449,193,25,276,2,1115,951,2066,4,6,201913
8,2,309,44,724,471,31,592,2,2173,1918,4091,16,5.5,201913
8,3,176,17,374,352,28,346,19,1312,1369,2681,4,6,201913
8,4,182,20,435,297,31,478,45,1488,2315,3803,11,6,201913
8,5,196,26,327,270,16,364,0,1199,1247,2446,10,5.25,201913
8,6,244,32,423,448,42,656,2,1847,1632,3479,7,6.5,201913
8,7,237,52,211,177,6,520,0,1203,1333,2536,7,5.25,201913
8,8,200,28,336,331,4,502,1,1402,1408,2810,10,6,201913
8,9,204,13,173,130,11,572,0,1103,1173,2276,10,5.2,201913
9,1,78,7,159,169,53,284,9,759,669,1428,5,6,201913
9,2,332,56,794,858,102,884,9,3035,2718,5753,12,5.5,201913
9,3,143,26,401,432,42,490,9,1543,1441,2984,7,6,201913
9,4,203,22,507,547,78,437,12,1806,1673,3479,11,6,201913
9,5,123,15,263,340,48,428,1,1218,1178,2396,7,6,201913
9,6,122,21,213,170,110,272,8,916,886,1802,7,6,201913
9,7,91,9,322,333,5,402,0,1162,1075,2237,9,6,201913
9,8,101,15,307,342,17,342,7,1131,1112,2243,5,6,201913
9,9,96,8,210,295,53,235,1,898,961,1859,5,6,201913
9,10,103,19,401,363,31,362,2,1281,1231,2512,6,6,201913
9,11,171,26,474,580,44,490,1,1786,1695,3481,7,6,201913
9,12,151,36,614,707,33,582,24,2147,1934,4081,11,6,201913
9,13,127,15,318,291,107,403,10,1271,1238,2509,4,6,201913
9,14,94,13,195,218,62,343,16,941,867,1808,5,6,201913
9,15,207,30,913,855,39,928,12,2984,2756,5740,10,7,201913
9,16,220,38,489,660,94,644,2,2147,2283,4430,15,6,201913
9,17,116,12,241,289,20,247,0,925,891,1816,6,6,201913
9,18,151,18,401,554,63,548,1,1736,1662,3398,12,6,201913
9,19,147,32,306,387,88,364,8,1332,1272,2604,5,6,201913
9,20,57,9,129,148,22,156,4,525,492,1017,5,6,201913
9,21,122,10,224,259,38,255,6,914,989,1903,3,6,201913
9,22,150,9,286,310,88,299,15,1157,1164,2321,5,6,201913
9,23,122,15,354,452,46,431,0,1420,1313,2733,6,6,201913
9,24,318,39,604,789,96,902,11,2759,2688,5447,12,6,201913
10,1,74,22,102,267,3,23,67,558,435,993,12,4.666666667,201913
10,2,111,29,218,466,18,43,61,946,343,1289,9,5.25,201913
10,3,113,58,145,289,15,31,198,849,180,1029,11,5.4,201913
10,4,135,33,252,746,1,31,14,1212,638,1850,12,6.5,201913
11,1,206,29,244,240,13,325,2,1059,1151,2210,6,5.666666667,201913
11,2,185,25,275,251,31,316,11,1094,969,2063,7,6,201913
11,3,154,16,195,244,14,420,5,1048,950,1998,3,6,201913
11,4,147,30,182,237,16,389,0,1001,1067,2068,8,6,201913
11,5,291,50,401,522,10,582,4,1860,1986,3846,7,6,201913
11,6,152,11,259,245,28,358,5,1058,1057,2115,8,6,201913
11,7,249,60,364,712,26,299,1,1711,1110,2821,9,5.5,201913
11,8,180,39,320,358,29,413,0,1339,1335,2674,9,5.5,201913
11,9,239,59,298,355,10,410,14,1385,1651,3036,10,5.666666667,201913
11,10,210,36,284,293,26,504,7,1360,1304,2664,10,5.6,201913
11,11,215,36,305,336,22,387,0,1301,1232,2533,5,6,201913
11,12,247,35,458,463,8,514,0,1725,1751,3476,7,6,201913
11,13,221,29,229,224,20,437,4,1164,1263,2427,8,5.5,201913
11,14,163,39,247,206,17,454,0,1126,1333,2459,8,5.5,201913
11,15,165,34,235,262,8,314,1,1019,864,1883,9,6,201913
12,1,213,24,299,157,64,368,4,1129,1108,2237,10,5.2,201913
12,2,269,40,330,431,22,400,13,1505,1225,2730,10,5.5,201913
12,3,201,29,326,418,43,283,0,1300,1177,2477,11,5.2,201913
12,4,151,26,375,529,39,266,0,1386,1484,2870,9,5.666666667,201913
12,5,282,20,278,269,0,271,3,1123,774,1897,10,5.25,201913
12,6,183,27,193,648,49,121,8,1229,950,2179,10,5.25,201913
12,7,264,27,258,330,23,349,22,1273,1094,2367,6,5.5,201913
12,8,150,26,287,297,1,121,0,882,980,1862,9,5.25,201913
12,9,202,24,399,569,17,237,1,1449,1168,2617,9,5.666666667,201913
13,1,166,15,182,180,33,342,25,943,1053,1996,9,5.333333333,201913
13,2,171,14,144,218,34,334,11,926,1026,1952,6,5.333333333,201913
13,3,182,11,259,250,103,343,0,1148,1335,2483,12,5.25,201913
13,4,243,22,333,284,69,305,13,1269,1391,2660,9,5.666666667,201913
13,5,213,14,404,316,74,575,6,1602,1668,3270,9,5.75,201913
13,6,308,72,826,631,47,509,6,2399,2163,4562,11,5.666666667,201913
13,7,133,15,395,376,28,260,0,1207,1274,2481,8,5.5,201913
14,1,152,10,87,81,16,610,1,957,842,1799,6,5.5,201913
14,2,222,19,166,82,10,643,0,1142,1058,2200,5,5.666666667,201913
14,3,248,11,212,68,1,807,0,1347,1274,2621,8,5.4,201913
14,4,232,22,405,414,17,567,4,1661,1621,3282,10,6,201913
14,5,160,10,440,229,27,382,1,1249,1396,2645,9,5.5,201913
14,6,214,16,581,276,30,498,0,1615,1574,3189,11,6,201913
14,7,128,9,195,132,0,301,0,765,688,1453,6,6,201913
14,8,296,40,765,728,6,1238,11,3084,2915,5999,11,6,201913
14,9,193,22,321,284,18,566,4,1408,1306,2714,9,6,201913
14,10,165,24,397,274,12,498,0,1370,1272,2642,7,6,201913
14,11,116,15,160,156,21,317,11,796,698,1494,4,6,201913
14,12,264,17,525,193,13,438,1,1451,1269,2720,9,5.5,201913
14,13,214,14,344,236,9,555,12,1384,1157,2541,6,6,201913
14,14,164,15,303,253,22,602,2,1361,1485,2846,7,6,201913
14,15,260,41,273,222,36,679,9,1520,1546,3066,10,5.6,201913
14,16,184,5,236,184,25,551,2,1187,1054,2241,5,6,201913
14,17,175,11,265,92,18,487,3,1051,1227,2278,7,5.25,201913
14,18,259,21,334,161,20,787,7,1589,1640,3229,9,5.4,201913
14,19,196,27,362,312,12,505,16,1430,1582,3012,8,5.25,201913
14,20,247,12,358,194,14,579,0,1404,1382,2786,10,5.666666667,201913
15,1,225,6,233,118,131,734,0,1447,1567,3014,7,5.333333333,201913
15,2,144,12,320,380,44,358,7,1265,1134,2399,6,6,201913
15,3,237,24,252,247,98,721,2,1581,1568,3149,10,5.666666667,201913
15,4,157,5,211,258,24,477,4,1136,1116,2252,4,6,201913
15,5,148,30,294,294,21,534,0,1321,1449,2770,8,5.666666667,201913
15,6,144,11,362,472,42,415,9,1455,1332,2787,7,6,201913
15,7,146,17,257,333,44,380,1,1178,1055,2233,10,6,201913
15,8,67,15,176,238,22,201,10,729,805,1534,4,6,201913
15,9,227,9,214,196,147,517,9,1319,1437,2756,9,5.75,201913
15,10,149,13,274,339,57,393,6,1231,1098,2329,6,6,201913
15,11,185,12,364,404,68,413,4,1450,1342,2792,8,6,201913
15,12,233,22,565,573,40,447,0,1880,1851,3731,8,6,201913
15,13,81,4,198,203,67,325,0,878,777,1655,8,6,201913
15,14,75,21,186,219,22,226,0,749,666,1415,4,6,201913
15,15,150,49,273,369,40,455,1,1337,1263,2600,6,6,201913
15,16,236,40,476,743,19,515,5,2034,2113,4147,8,6,201913
15,17,102,11,226,294,16,387,19,1055,1002,2057,8,6,201913
15,18,229,14,291,426,25,574,3,1562,1451,3013,7,5.666666667,201913
15,19,197,48,439,626,21,615,12,1958,1772,3730,10,6,201913
15,20,71,13,231,250,10,272,1,848,986,1834,6,6,201913
15,21,106,7,139,249,18,248,15,782,655,1437,6,5.5,201913
15,22,223,40,540,676,25,764,10,2278,2434,4712,14,6,201913
15,23,176,16,262,329,18,488,0,1289,1273,2562,6,5.333333333,201913
15,24,156,15,255,255,19,295,1,996,951,1947,4,6,201913
15,25,171,19,286,295,50,252,16,1089,1165,2254,6,6,201913
15,26,123,6,199,233,33,344,2,940,1025,1965,9,7,201913
15,27,192,27,340,488,20,642,18,1727,1725,3452,9,5.666666667,201913
15,28,199,24,466,365,43,544,3,1644,1592,3236,9,5.666666667,201913
15,29,213,24,480,578,18,556,0,1869,1797,3666,8,6,201913
15,30,220,22,456,477,59,339,4,1577,1591,3168,16,6,201913
15,31,122,37,281,341,10,317,0,1108,1003,2111,6,6,201913
15,32,155,11,341,454,41,315,1,1318,1282,2600,9,6,201913
15,33,153,9,365,404,20,367,0,1318,1377,2695,7,6,201913
15,34,128,10,234,381,5,355,4,1117,1079,2196,8,6,201913
15,35,274,21,280,326,5,603,0,1509,1507,3016,9,5.666666667,201913
15,36,260,22,347,327,82,471,0,1509,1829,3338,9,5.5,201913
15,37,216,18,373,572,56,533,15,1783,1948,3731,7,6,201913
15,38,191,39,283,425,18,465,7,1428,1477,2905,6,5.5,201913
15,39,148,25,305,398,28,260,0,1164,1184,2348,4,6,201913
15,40,316,17,333,407,69,832,0,1974,2142,4116,9,6,201913
15,41,257,29,654,629,50,470,7,2096,2000,4096,14,6.333333333,201913
16,1,148,16,249,189,26,329,1,958,1111,2069,7,5.333333333,201913
16,2,123,11,110,141,16,246,0,647,572,1219,9,5.25,201913
16,3,179,21,184,264,20,323,2,993,992,1985,10,5.25,201913
16,4,195,32,218,110,22,578,0,1155,1230,2385,8,5.5,201913
16,5,223,25,204,218,37,466,1,1174,1089,2263,10,5.666666667,201913
16,6,230,33,234,267,27,302,0,1093,1083,2176,12,5.5,201913
16,7,217,24,221,224,46,391,0,1123,1287,2410,9,5.5,201913
16,8,267,39,595,468,9,553,0,1931,1796,3727,12,6,201913
16,9,221,29,308,259,10,497,1,1325,1180,2505,9,6,201913
16,10,214,18,304,302,23,342,0,1203,1253,2456,6,6,201913
16,11,223,16,236,148,60,543,0,1226,1427,2653,10,5.4,201913
16,12,201,21,226,149,18,328,1,944,999,1943,10,5.25,201913
17,1,139,14,394,393,11,423,0,1374,1246,2620,9,7,201913
17,2,134,16,305,300,6,283,5,1049,992,2041,8,5.666666667,201913
17,3,205,18,303,389,9,386,1,1311,1407,2718,8,5.5,201913
17,4,185,11,358,282,15,455,4,1310,1378,2688,10,5.666666667,201913
17,5,103,7,162,167,13,206,2,660,538,1198,5,5.5,201913
18,1,175,30,183,202,33,309,13,945,818,1763,7,5.25,201913
18,2,232,24,434,417,55,517,0,1679,1584,3263,8,6,201913
18,3,164,12,370,214,9,357,1,1127,1187,2314,8,5.5,201913
19,1,204,17,315,286,11,690,0,1523,1461,2984,9,6,201913
19,2,259,22,575,404,11,660,0,1931,1888,3819,9,6,201913
19,3,243,14,551,314,20,571,0,1713,1701,3414,7,6,201913
19,4,101,18,139,148,21,454,17,898,952,1850,5,6,201913
19,5,315,23,516,641,15,779,10,2299,2182,4481,8,6,201913
19,6,81,6,209,222,6,413,0,937,983,1920,5,6,201913
19,7,202,12,477,203,6,378,0,1278,1216,2494,10,5.5,201913
19,8,107,6,179,183,5,269,0,749,754,1503,7,6,201913
19,9,184,22,225,197,27,524,5,1184,1281,2465,9,5.25,201913
19,10,117,17,183,200,11,507,7,1042,1062,2104,6,7,201913
19,11,295,36,556,510,18,1202,5,2622,2686,5308,13,6,201913
19,12,178,11,597,221,16,450,3,1476,1731,3207,8,5.666666667,201913
20,1,188,16,234,225,51,244,50,1008,989,1997,7,5.5,201913
20,2,136,9,176,142,6,164,0,633,488,1121,6,5.333333333,201913
20,3,112,6,134,112,87,148,19,618,837,1455,6,5.333333333,201913
20,4,100,5,87,102,24,209,29,556,784,1340,6,5.333333333,201913
20,5,148,21,222,599,43,205,0,1238,921,2159,11,5.25,201913
20,6,136,13,165,258,209,112,0,893,1406,2299,8,5.25,201913
20,7,170,12,208,319,14,437,0,1160,1081,2241,7,5.75,201913
20,8,401,34,511,759,28,742,84,2559,2776,5335,13,6,201913
20,9,191,12,195,219,59,412,15,1103,1335,2438,8,5.666666667,201913
20,10,176,7,188,253,17,265,0,906,804,1710,9,5.25,201913
21,1,93,5,71,225,0,20,0,414,304,718,9,5.4,201913
21,2,176,12,255,256,121,22,8,850,264,1114,9,5.2,201913
21,3,191,24,332,163,105,45,74,934,430,1364,8,5.5,201913
21,4,93,7,87,172,43,22,34,458,303,761,6,5.25,201913
21,5,200,22,290,406,22,59,111,1110,536,1646,8,5.666666667,201913
21,6,184,16,288,516,44,44,179,1271,607,1878,6,6,201913
21,7,141,14,227,241,88,35,32,778,323,1101,9,5.666666667,201913
21,8,174,22,320,141,114,25,116,912,588,1500,9,5.2,201913
21,9,191,21,337,590,68,54,134,1395,388,1783,9,6,201913
21,10,164,18,325,441,54,64,212,1278,336,1614,7,5.5,201913
21,11,57,5,105,194,14,17,26,418,283,701,4,6,201913
21,12,267,17,523,1248,38,112,295,2500,1242,3742,16,6.5,201913
21,13,144,19,172,298,27,144,84,888,265,1153,8,5.666666667,201913
21,14,180,16,177,191,103,35,73,775,265,1040,12,5.333333333,201913
21,15,184,22,366,343,74,39,55,1083,300,1383,7,5.5,201913
22,1,195,44,223,360,20,198,11,1051,1258,2309,11,5.2,201913
22,2,158,35,291,284,36,329,0,1133,1041,2174,7,5.5,201913
22,3,237,32,736,633,19,493,0,2150,2043,4193,9,5.666666667,201913
22,4,195,23,585,463,21,458,2,1747,1732,3479,9,6.5,201913
22,5,179,16,434,218,38,308,1,1194,1187,2381,10,5.5,201913
23,1,121,8,643,86,14,46,20,938,412,1350,14,5.6,201913
23,2,93,16,195,179,4,20,11,518,404,922,8,5.25,201913
23,3,73,4,294,5,9,9,40,434,358,792,15,6,201913
23,4,104,2,455,23,39,42,22,687,583,1270,8,5.666666667,201913
24,1,140,30,203,237,19,200,2,831,1087,1918,10,5.2,201913
24,2,162,24,219,171,9,315,0,900,948,1848,6,5,201913
24,3,175,54,212,283,58,201,1,984,950,1934,9,5.25,201913
24,4,174,22,212,172,57,416,41,1094,1201,2295,5,5.5,201913
24,5,250,49,544,507,15,619,1,1985,1821,3806,10,6.333333333,201913
24,6,174,29,387,385,28,522,0,1525,1762,3287,6,6,201913
24,7,195,33,258,505,51,184,0,1226,1386,2612,9,5.25,201913
25,1,183,10,280,265,16,418,5,1177,1347,2524,13,5.75,201913
25,2,235,21,367,381,13,563,0,1580,1687,3267,7,5.5,201913
25,3,162,16,325,303,38,372,8,1224,1405,2629,8,5.6,201913
25,4,191,25,213,337,11,382,20,1179,1287,2466,8,5.333333333,201913
25,5,173,11,436,534,34,479,0,1667,2052,3719,8,5.666666667,201913
25,6,186,15,348,316,36,457,3,1361,1548,2909,8,5.75,201913
25,7,232,17,489,494,11,539,0,1782,1731,3513,6,6,201913
26,1,190,14,369,215,13,470,2,1273,1296,2569,9,5.5,201913
26,2,229,17,457,449,4,345,4,1505,1380,2885,12,5.4,201913
26,3,244,21,330,436,23,691,7,1752,1732,3484,14,6.5,201913
26,4,158,10,177,197,38,532,1,1113,1183,2296,9,5.2,201913
26,5,145,3,203,233,20,430,0,1034,955,1989,15,6,201913
26,6,189,15,288,276,4,582,0,1354,1314,2668,10,5.333333333,201913
26,7,159,13,216,271,33,291,0,983,1009,1992,10,5.5,201913
27,1,162,4,216,281,51,260,0,974,1023,1997,8,5.5,201913
27,2,255,23,353,505,25,282,0,1443,1393,2836,8,5.666666667,201913
27,3,170,10,284,488,21,327,0,1300,1323,2623,7,5.666666667,201913
27,4,218,21,393,633,13,429,15,1722,1748,3470,8,6,201913
27,5,106,5,97,268,11,107,0,594,896,1490,6,5.333333333,201913
27,6,225,15,292,398,11,398,0,1339,1337,2676,7,5.5,201913
28,1,40,7,114,458,1,25,0,645,478,1123,13,6,201913
28,2,103,22,236,322,21,33,138,875,305,1180,14,6,201913
28,3,68,11,124,200,3,19,0,425,65,490,7,5.333333333,201913
28,4,143,33,347,408,50,47,168,1196,354,1550,15,6,201913
28,5,74,14,132,305,10,40,147,722,347,1069,10,5.5,201913
28,6,66,18,153,246,23,21,33,560,158,718,13,5.166666667,201913
28,7,82,30,327,470,31,58,88,1086,419,1505,13,6,201913
28,8,70,51,239,411,39,53,96,959,362,1321,9,6,201913
28,9,76,9,178,226,23,35,63,610,211,821,11,5.75,201913
29,1,230,26,360,376,50,449,6,1497,1350,2847,7,5.5,201913
29,2,258,25,331,567,28,487,44,1740,1633,3373,11,6,201913
29,3,148,12,171,313,11,256,0,911,1070,1981,5,5.666666667,201913
30,1,101,11,174,167,15,236,7,711,903,1614,7,5.333333333,201913
30,2,165,6,157,107,33,234,62,764,764,1528,8,5.25,201913
30,3,144,5,257,168,32,408,39,1053,1142,2195,6,5.666666667,201913
30,4,119,4,285,219,33,295,0,955,855,1810,8,6,201913
30,5,140,15,210,225,88,424,0,1102,1098,2200,7,5.5,201913
30,6,186,12,266,209,34,271,5,983,1150,2133,9,5.333333333,201913
30,7,173,10,200,202,12,336,16,949,1269,2218,11,5.25,201913
30,8,223,19,324,328,52,510,25,1481,1388,2869,11,5.4,201913
30,9,248,7,213,203,48,429,25,1173,1359,2532,8,5.5,201913
30,10,153,14,336,293,31,446,18,1291,1229,2520,6,6,201913
30,11,151,9,373,356,9,402,0,1300,1433,2733,5,5.5,201913
30,12,227,15,567,561,30,702,0,2102,2070,4172,10,6,201913
30,13,214,10,185,326,47,449,30,1261,1575,2836,10,5.4,201913
30,14,171,14,240,169,53,387,2,1036,1419,2455,8,5.5,201913
30,15,260,15,203,262,34,684,41,1499,1351,2850,11,5.666666667,201913
30,16,182,8,255,277,48,535,34,1339,1411,2750,10,5.333333333,201913
30,17,184,13,256,304,45,446,17,1265,1305,2570,8,5.5,201913
30,18,186,6,146,135,8,289,17,787,820,1607,8,5.25,201913
30,19,173,10,208,197,15,417,4,1024,1073,2097,13,5.6,201913
30,20,150,10,222,411,114,306,0,1213,1226,2439,10,5.4,201913
31,1,198,12,181,37,197,385,0,1010,1100,2110,8,5.5,201913
31,2,125,10,154,6,169,401,0,865,865,1730,6,5.333333333,201913
31,3,379,36,1016,614,130,1009,1,3185,2990,6175,21,6.333333333,201913
31,4,127,8,290,216,67,402,12,1122,1231,2353,4,6,201913
31,5,170,11,121,174,43,437,0,956,1436,2392,6,5.333333333,201913
32,1,205,32,169,157,28,479,16,1086,1261,2347,12,5.2,201913
32,2,197,44,162,107,63,497,10,1080,1350,2430,13,5.142857143,201913
32,3,214,48,207,272,8,509,1,1259,1161,2420,13,5.4,201913
32,4,226,41,235,254,18,520,18,1312,1084,2396,13,5.4,201913
1,1,89,29,219,325,52,28,9,751,331,1082,13,5.5,201914
1,2,95,26,274,681,15,71,14,1176,721,1897,10,7.666666667,201914
1,3,62,37,287,640,23,69,26,1144,613,1757,9,6,201914
2,1,91,16,195,434,12,31,4,783,359,1142,11,6,201914
2,2,110,17,253,542,5,62,0,989,311,1300,7,6,201914
2,3,180,11,353,473,17,71,135,1240,493,1733,12,6,201914
2,4,84,6,347,238,54,28,36,793,156,949,9,6,201914
2,5,181,19,485,599,135,93,51,1563,448,2011,13,6,201914
2,6,135,9,312,465,11,48,5,985,268,1253,7,6,201914
2,7,120,7,302,380,14,38,94,955,264,1219,12,5.75,201914
2,8,133,11,349,597,8,64,68,1230,582,1812,8,6,201914
3,1,164,12,273,276,6,402,1,1134,1180,2314,11,5.8,201914
3,2,171,10,532,258,23,204,0,1198,1127,2325,9,5.333333333,201914
4,1,182,13,262,431,33,424,22,1367,1305,2672,11,5.25,201914
4,2,153,15,380,332,70,234,25,1209,1338,2547,14,5,201914
5,1,198,17,361,300,27,423,5,1331,1312,2643,9,5.666666667,201914
5,2,155,18,325,342,35,286,1,1162,1137,2299,10,5.2,201914
5,3,169,22,284,348,32,511,28,1394,1198,2592,8,5.666666667,201914
5,4,243,25,564,471,10,659,11,1983,1799,3782,9,5.666666667,201914
5,5,216,27,399,519,26,405,34,1626,1711,3337,9,6,201914
5,6,125,21,376,366,16,299,40,1243,1168,2411,11,5.5,201914
5,7,169,14,362,317,1,371,1,1235,1170,2405,11,6,201914
6,1,193,17,352,272,9,468,7,1318,1368,2686,12,6,201914
6,2,140,22,334,182,32,448,12,1170,1240,2410,9,5.666666667,201914
7,1,184,5,189,361,6,84,8,837,1097,1934,9,5.25,201914
7,2,195,9,142,863,244,67,0,1520,856,2376,9,5.25,201914
7,3,253,3,369,472,244,281,1,1623,981,2604,7,5.333333333,201914
7,4,220,16,241,511,29,203,52,1272,1035,2307,11,5.4,201914
7,5,272,9,174,709,21,177,0,1362,1237,2599,11,5.666666667,201914
7,6,273,11,338,395,18,380,13,1428,1378,2806,9,5.666666667,201914
7,7,231,23,259,502,34,243,13,1305,1335,2640,8,5.5,201914
7,8,316,10,189,494,16,264,49,1338,1454,2792,12,5.25,201914
7,9,198,19,267,396,17,364,2,1263,1313,2576,9,5.666666667,201914
7,10,197,11,171,396,17,120,0,912,1260,2172,9,5.5,201914
7,11,194,3,104,105,9,106,17,538,378,916,6,5.333333333,201914
7,12,243,7,304,549,7,176,0,1286,1118,2404,9,5.5,201914
7,13,116,11,89,252,1,72,0,541,490,1031,9,5.25,201914
8,1,132,11,420,207,19,290,3,1082,1104,2186,4,6,201914
8,2,267,30,739,417,29,532,1,2015,1981,3996,16,5.5,201914
8,3,175,18,414,357,34,360,15,1373,1360,2733,4,6,201914
8,4,162,17,458,306,26,452,23,1444,1887,3331,11,6,201914
8,5,164,36,276,252,15,276,0,1019,1270,2289,10,5.25,201914
8,6,196,24,435,422,33,604,9,1723,1827,3550,7,6.5,201914
8,7,251,37,235,226,8,582,0,1339,1292,2631,7,5.25,201914
8,8,170,18,380,353,7,454,1,1383,1423,2806,11,7,201914
8,9,207,16,113,118,13,551,0,1018,1012,2030,10,5.2,201914
9,1,76,14,160,141,46,267,2,706,734,1440,5,6,201914
9,2,300,72,754,935,104,863,4,3032,3174,6206,12,6,201914
9,3,127,28,398,462,41,433,20,1509,1497,3006,7,6,201914
9,4,172,21,484,612,87,435,12,1823,1739,3562,11,6,201914
9,5,117,15,281,374,49,374,0,1210,1162,2372,7,6,201914
9,6,95,24,225,186,94,294,6,924,929,1853,7,6,201914
9,7,72,6,290,340,2,358,0,1068,1079,2147,9,6,201914
9,8,79,15,339,318,14,315,15,1095,1131,2226,5,6,201914
9,9,93,5,199,285,25,197,3,807,841,1648,5,6,201914
9,10,105,14,344,348,32,362,2,1207,1243,2450,6,6,201914
9,11,160,19,517,553,55,502,2,1808,1789,3597,7,6,201914
9,12,136,33,637,737,37,582,25,2187,2199,4386,11,6,201914
9,13,142,17,321,328,91,338,15,1252,1161,2413,4,6,201914
9,14,112,8,225,234,52,291,9,931,878,1809,5,6,201914
9,15,186,25,890,915,38,896,10,2960,2822,5782,9,6.5,201914
9,16,231,49,486,679,96,600,0,2141,1973,4114,15,6,201914
9,17,120,6,248,294,30,271,0,969,974,1943,6,6,201914
9,18,149,24,443,534,48,527,4,1729,1793,3522,12,6,201914
9,19,167,41,386,441,88,433,14,1570,1621,3191,5,6,201914
9,20,60,7,156,153,13,133,3,525,468,993,5,6,201914
9,21,119,9,185,265,26,244,8,856,919,1775,3,6,201914
9,22,150,12,358,361,83,376,16,1356,1184,2540,5,6,201914
9,23,127,18,325,466,50,380,5,1371,1347,2718,6,6,201914
9,24,292,36,635,847,81,897,8,2796,2533,5329,12,6,201914
10,1,137,38,108,246,18,32,96,675,453,1128,12,4.833333333,201914
10,2,95,24,204,413,18,29,63,846,364,1210,9,5.25,201914
10,3,101,38,149,223,20,33,166,730,159,889,11,5.4,201914
10,4,107,12,220,742,8,40,8,1137,648,1785,12,6.5,201914
11,1,194,32,229,258,14,285,1,1013,1197,2210,6,5.666666667,201914
11,2,191,21,256,248,25,295,18,1054,1070,2124,7,6,201914
11,3,153,23,214,253,9,371,6,1029,1021,2050,3,6,201914
11,4,190,27,245,291,26,372,0,1151,1016,2167,8,6,201914
11,5,300,37,398,512,23,571,6,1847,2203,4050,7,6,201914
11,6,174,18,256,260,28,330,2,1068,1101,2169,8,6,201914
11,7,228,46,349,666,27,311,2,1629,1098,2727,9,5.5,201914
11,8,185,39,306,388,22,386,0,1326,1430,2756,9,5.5,201914
11,9,213,52,366,408,11,448,22,1520,1433,2953,10,5.666666667,201914
11,10,182,28,259,229,18,465,5,1186,1279,2465,10,5.6,201914
11,11,198,39,313,337,15,371,0,1273,1345,2618,5,6,201914
11,12,187,39,444,475,11,449,0,1605,1657,3262,7,6,201914
11,13,184,38,210,234,14,401,7,1088,1187,2275,8,5.5,201914
11,14,170,25,230,202,12,424,0,1063,1105,2168,8,5.5,201914
11,15,139,29,239,286,7,296,0,996,1016,2012,9,6,201914
12,1,196,33,277,159,36,325,1,1027,994,2021,10,5.2,201914
12,2,201,26,284,389,22,413,11,1346,1330,2676,10,5.5,201914
12,3,185,23,275,371,20,186,0,1060,893,1953,11,5.2,201914
12,4,138,33,349,504,29,254,6,1313,1394,2707,9,5.666666667,201914
12,5,199,26,190,237,1,198,5,856,856,1712,10,5,201914
12,6,320,35,228,547,34,188,2,1354,1309,2663,10,5.25,201914
12,7,281,15,245,388,14,389,30,1362,1331,2693,6,5.5,201914
12,8,215,19,198,328,0,168,0,928,1039,1967,9,5.25,201914
12,9,208,23,363,572,18,207,0,1391,1227,2618,9,5.666666667,201914
13,1,249,20,203,293,34,397,18,1214,1265,2479,9,5.333333333,201914
13,2,154,14,149,214,32,296,3,862,866,1728,6,5.333333333,201914
13,3,172,13,196,253,70,255,0,959,995,1954,12,5.25,201914
13,4,223,12,313,272,58,308,12,1198,1300,2498,9,5.666666667,201914
13,5,235,14,393,319,86,681,8,1736,1623,3359,9,5.75,201914
13,6,270,59,746,651,55,536,9,2326,2447,4773,11,5.666666667,201914
13,7,153,18,460,399,32,233,0,1295,1311,2606,8,5.5,201914
14,1,129,17,77,73,11,607,0,914,837,1751,6,5.5,201914
14,2,198,14,158,88,10,666,1,1135,1009,2144,5,5.666666667,201914
14,3,316,10,189,99,9,734,0,1357,1438,2795,8,5.4,201914
14,4,213,18,414,407,13,479,4,1548,1366,2914,10,6,201914
14,5,177,17,498,222,38,504,1,1457,1358,2815,9,5.5,201914
14,6,226,12,580,274,15,480,2,1589,1670,3259,11,6,201914
14,7,144,9,177,131,0,304,0,765,664,1429,6,6,201914
14,8,330,32,816,712,12,1219,6,3127,3188,6315,11,6.25,201914
14,9,205,16,270,285,38,516,0,1330,1464,2794,9,6,201914
14,10,190,18,392,259,13,515,0,1387,1277,2664,7,6,201914
14,11,113,17,136,175,15,336,6,798,776,1574,4,6,201914
14,12,271,22,516,179,19,424,0,1431,1497,2928,9,5.5,201914
14,13,222,23,321,221,17,519,1,1324,1281,2605,6,6,201914
14,14,174,14,249,286,26,621,1,1371,1196,2567,7,6,201914
14,15,286,28,285,223,33,652,3,1510,1693,3203,10,5.6,201914
14,16,177,17,249,191,25,499,2,1160,1046,2206,5,6,201914
14,17,135,10,210,81,20,407,6,869,1061,1930,7,5.25,201914
14,18,215,21,220,143,20,599,3,1221,1440,2661,9,5.4,201914
14,19,172,28,260,256,21,442,15,1194,1424,2618,8,5.25,201914
14,20,230,16,401,246,11,536,1,1441,1240,2681,10,5.666666667,201914
15,1,196,10,249,85,148,676,4,1368,1486,2854,7,5.333333333,201914
15,2,155,14,274,366,48,315,4,1176,1199,2375,6,6,201914
15,3,214,14,258,279,129,683,5,1582,1504,3086,10,5.666666667,201914
15,4,165,13,274,328,19,477,8,1284,1132,2416,4,6,201914
15,5,201,22,302,319,23,503,2,1372,1275,2647,8,5.666666667,201914
15,6,132,10,371,447,35,381,6,1382,1437,2819,7,6,201914
15,7,108,15,285,357,47,404,0,1216,1155,2371,10,6,201914
15,8,72,12,183,257,22,199,10,755,768,1523,4,6,201914
15,9,274,12,199,141,163,571,5,1365,1396,2761,9,5.75,201914
15,10,153,17,266,315,66,372,2,1191,1104,2295,6,6,201914
15,11,182,14,330,460,60,440,3,1489,1311,2800,8,6,201914
15,12,224,20,543,551,41,384,0,1763,1876,3639,8,6,201914
15,13,85,10,178,208,78,333,2,894,805,1699,8,6,201914
15,14,108,14,164,226,10,224,0,746,699,1445,4,6,201914
15,15,140,33,351,398,24,435,1,1382,1326,2708,6,6,201914
15,16,233,29,473,655,18,513,5,1926,1913,3839,8,5.5,201914
15,17,121,14,252,320,18,391,20,1136,1008,2144,8,6,201914
15,18,247,20,323,477,15,565,5,1652,1513,3165,7,5.666666667,201914
15,19,201,39,415,575,18,614,5,1867,1858,3725,10,6,201914
15,20,45,8,150,164,5,188,3,563,658,1221,6,5,201914
15,21,112,12,107,244,22,221,13,731,854,1585,6,5.5,201914
15,22,251,45,579,700,28,724,15,2342,2172,4514,14,6,201914
15,23,175,18,260,361,14,467,0,1295,1373,2668,6,5.333333333,201914
15,24,148,21,298,294,32,255,3,1051,878,1929,4,6,201914
15,25,171,29,279,306,51,249,9,1094,996,2090,6,6,201914
15,26,122,10,221,245,42,379,5,1024,928,1952,9,7,201914
15,27,219,21,316,510,13,535,36,1650,1582,3232,9,5.666666667,201914
15,28,202,19,446,291,67,452,1,1478,1393,2871,9,5.666666667,201914
15,29,201,27,485,633,11,522,1,1880,1792,3672,8,6,201914
15,30,238,31,502,480,46,307,6,1610,1635,3245,16,6,201914
15,31,110,30,212,257,12,230,0,851,788,1639,6,5,201914
15,32,159,11,332,457,45,300,13,1317,1339,2656,9,6,201914
15,33,183,16,389,393,34,396,0,1411,1285,2696,7,6,201914
15,34,149,15,236,379,5,328,8,1120,1113,2233,8,6,201914
15,35,278,13,301,354,8,596,3,1553,1593,3146,9,5.666666667,201914
15,36,219,24,297,279,60,394,0,1273,1366,2639,9,5.5,201914
15,37,216,16,371,497,47,553,16,1716,2220,3936,7,6,201914
15,38,175,20,278,396,11,462,6,1348,1408,2756,6,5.5,201914
15,39,164,27,297,359,20,256,0,1123,1156,2279,4,6,201914
15,40,269,22,352,441,71,754,5,1914,2040,3954,9,6,201914
15,41,286,30,667,633,48,451,9,2124,2022,4146,14,6.333333333,201914
16,1,122,10,205,151,17,278,0,783,787,1570,7,5.333333333,201914
16,2,127,16,122,183,5,242,0,695,672,1367,9,5.25,201914
16,3,214,29,194,244,15,317,1,1014,1216,2230,10,5.25,201914
16,4,214,10,223,116,16,499,0,1078,1039,2117,8,5.5,201914
16,5,192,15,225,197,20,413,3,1065,1102,2167,10,5.666666667,201914
16,6,169,20,205,244,21,229,0,888,885,1773,12,5.5,201914
16,7,245,23,197,200,35,388,0,1088,1191,2279,9,5.5,201914
16,8,273,27,559,527,19,567,0,1972,1930,3902,12,6,201914
16,9,203,22,292,256,15,422,5,1215,1274,2489,9,6,201914
16,10,165,13,319,342,9,386,0,1234,1261,2495,6,6,201914
16,11,223,26,212,159,72,505,0,1197,1413,2610,10,5.4,201914
16,12,193,12,220,163,10,272,2,872,821,1693,10,5.25,201914
17,1,175,15,414,435,24,499,4,1566,1636,3202,9,7,201914
17,2,157,13,328,333,20,259,6,1116,1206,2322,8,5.666666667,201914
17,3,266,15,406,454,9,416,0,1566,1837,3403,8,5.5,201914
17,4,201,10,397,345,23,495,0,1471,1757,3228,10,5.666666667,201914
17,5,80,13,173,177,8,184,4,639,696,1335,5,5.5,201914
18,1,138,17,146,159,17,232,11,720,808,1528,7,5.25,201914
18,2,251,26,433,369,65,451,0,1595,1565,3160,9,6.333333333,201914
18,3,183,10,346,177,8,324,0,1048,1153,2201,8,5.5,201914
19,1,170,9,304,314,11,639,6,1453,1457,2910,9,6,201914
19,2,274,16,576,360,11,682,0,1919,1960,3879,9,6,201914
19,3,243,21,588,304,23,610,2,1791,1800,3591,7,6,201914
19,4,118,14,152,144,26,455,20,929,943,1872,5,6,201914
19,5,297,17,574,569,24,828,13,2322,2382,4704,8,6,201914
19,6,80,11,224,217,5,430,1,968,914,1882,5,6,201914
19,7,159,10,558,215,3,283,0,1228,1164,2392,10,5.5,201914
19,8,103,13,206,220,3,304,0,849,736,1585,7,6,201914
19,9,195,7,288,224,21,426,1,1162,1289,2451,9,5.25,201914
19,10,86,14,212,208,11,501,9,1041,1079,2120,6,7,201914
19,11,341,36,564,605,34,1196,21,2797,2413,5210,13,6,201914
19,12,215,19,609,264,15,516,1,1639,1441,3080,8,5.666666667,201914
20,1,208,15,302,236,45,275,42,1123,926,2049,7,5.5,201914
20,2,220,17,254,246,15,253,0,1005,509,1514,6,5.333333333,201914
20,3,120,18,136,117,93,142,21,647,757,1404,6,5.333333333,201914
20,4,63,3,91,76,26,156,12,427,420,847,6,5.333333333,201914
20,5,127,13,161,438,32,174,0,945,999,1944,11,5.25,201914
20,6,161,10,161,256,151,103,0,842,936,1778,8,5.25,201914
20,7,190,10,248,353,11,378,3,1193,1144,2337,7,5.75,201914
20,8,415,38,543,950,27,739,75,2787,2808,5595,13,6,201914
20,9,239,20,162,248,62,401,17,1149,1493,2642,8,5.666666667,201914
20,10,221,10,214,288,15,274,0,1022,778,1800,9,5.25,201914
21,1,122,3,86,187,2,16,0,416,269,685,9,5.4,201914
21,2,150,13,153,205,72,33,5,631,217,848,9,5.2,201914
21,3,214,18,289,318,81,43,57,1020,289,1309,8,5.5,201914
21,4,113,12,105,146,23,13,34,446,260,706,6,5.25,201914
21,5,163,15,266,365,14,35,49,907,396,1303,8,5.666666667,201914
21,6,189,12,260,549,23,38,156,1227,508,1735,6,6,201914
21,7,119,16,169,230,78,41,17,670,321,991,9,5.666666667,201914
21,8,179,6,249,109,104,21,96,764,362,1126,9,5.2,201914
21,9,165,19,287,481,70,48,130,1200,488,1688,9,6,201914
21,10,149,18,278,431,39,46,179,1140,651,1791,7,5.5,201914
21,11,65,5,89,207,10,14,32,422,213,635,5,7,201914
21,12,229,21,457,1198,33,75,230,2243,1317,3560,16,6.5,201914
21,13,152,17,218,330,65,117,67,966,379,1345,8,5.666666667,201914
21,14,150,20,172,173,76,31,82,704,224,928,12,5.333333333,201914
21,15,237,18,406,380,81,54,45,1221,315,1536,7,5.5,201914
22,1,158,46,226,362,25,200,10,1027,872,1899,11,5.2,201914
22,2,152,33,359,283,45,295,2,1169,1074,2243,7,5.5,201914
22,3,269,40,751,589,23,448,0,2120,2253,4373,9,5.666666667,201914
22,4,157,31,596,484,19,434,0,1721,1763,3484,9,6.5,201914
22,5,116,14,444,246,39,282,2,1143,1142,2285,10,5.5,201914
23,1,144,92,626,402,18,44,14,1340,498,1838,14,5.6,201914
23,2,117,12,254,366,18,31,15,813,434,1247,9,5.5,201914
23,3,68,8,260,532,11,16,30,925,592,1517,15,6,201914
23,4,105,10,471,576,20,29,39,1250,581,1831,8,5.666666667,201914
24,1,120,32,156,229,9,165,3,714,754,1468,10,5.2,201914
24,2,121,26,226,188,14,340,0,915,854,1769,6,5.5,201914
24,3,182,34,200,281,86,196,2,981,819,1800,9,5.25,201914
24,4,137,22,186,181,36,371,28,961,1034,1995,5,5.5,201914
24,5,285,40,476,490,11,602,0,1904,1897,3801,9,6,201914
24,6,195,43,350,379,30,541,0,1538,1578,3116,6,6,201914
24,7,240,31,382,499,37,212,0,1401,1208,2609,9,5.25,201914
25,1,153,2,252,265,17,322,6,1017,1052,2069,13,5.75,201914
25,2,240,25,349,416,14,523,0,1567,1522,3089,7,5.5,201914
25,3,179,17,296,276,31,315,4,1118,1194,2312,8,5.6,201914
25,4,134,21,201,295,13,322,1,987,1084,2071,8,5.333333333,201914
25,5,143,5,340,434,24,402,0,1348,1433,2781,8,5.666666667,201914
25,6,211,14,354,290,47,506,3,1425,1338,2763,8,5.75,201914
25,7,244,18,505,493,12,505,0,1777,1733,3510,6,6,201914
26,1,243,12,447,241,20,511,0,1474,1187,2661,9,5.5,201914
26,2,232,12,476,415,4,386,10,1535,1418,2953,12,5.4,201914
26,3,229,18,314,456,18,728,5,1768,1794,3562,15,7,201914
26,4,145,14,169,216,16,372,2,934,1070,2004,9,5.2,201914
26,5,160,9,201,208,20,426,0,1024,1000,2024,15,6,201914
26,6,167,7,270,233,1,538,0,1216,1265,2481,10,5.333333333,201914
26,7,161,13,241,260,21,291,0,987,1030,2017,10,5.5,201914
27,1,209,12,320,332,56,308,2,1239,1465,2704,8,5.5,201914
27,2,202,18,371,547,12,271,0,1421,1195,2616,8,5.666666667,201914
27,3,203,10,214,418,4,244,1,1094,1102,2196,7,5.666666667,201914
27,4,232,15,441,751,12,467,29,1947,1721,3668,8,6,201914
27,5,124,5,212,301,6,141,0,789,847,1636,6,5.333333333,201914
27,6,149,16,272,392,16,295,0,1140,1006,2146,7,5.5,201914
28,1,41,17,109,410,0,27,0,604,445,1049,13,6,201914
28,2,87,16,211,339,5,36,135,829,354,1183,14,6,201914
28,3,78,13,86,204,4,12,0,397,93,490,7,5.333333333,201914
28,4,129,23,240,372,55,43,145,1007,411,1418,15,6,201914
28,5,68,22,103,322,8,29,104,656,373,1029,10,5.5,201914
28,6,96,18,142,236,12,18,33,555,156,711,13,5.166666667,201914
28,7,102,25,271,481,34,60,100,1073,475,1548,13,6,201914
28,8,75,22,235,390,40,41,77,880,277,1157,9,6,201914
28,9,51,11,161,206,19,31,47,526,183,709,11,5.75,201914
29,1,227,40,399,419,52,372,0,1509,1481,2990,7,5.5,201914
29,2,267,23,331,524,32,460,52,1689,1812,3501,11,6,201914
29,3,135,21,171,298,15,269,0,909,947,1856,5,5.666666667,201914
30,1,130,20,200,204,15,268,0,837,886,1723,7,5.333333333,201914
30,2,194,11,150,106,25,293,30,809,789,1598,8,5.25,201914
30,3,171,9,269,198,32,482,52,1213,1150,2363,6,5.666666667,201914
30,4,93,2,273,210,32,275,0,885,867,1752,8,5.5,201914
30,5,149,4,225,278,23,381,0,1060,1210,2270,7,5.5,201914
30,6,158,8,230,221,22,248,10,897,890,1787,9,5.333333333,201914
30,7,276,24,287,294,35,492,18,1426,1252,2678,11,5.25,201914
30,8,196,17,264,352,48,428,3,1308,1383,2691,11,5.4,201914
30,9,247,12,243,201,51,495,27,1276,1187,2463,8,5.5,201914
30,10,167,12,283,263,36,392,19,1172,1192,2364,6,6,201914
30,11,151,8,359,339,11,389,0,1257,1528,2785,5,5.5,201914
30,12,235,13,510,551,31,677,0,2017,2026,4043,10,6,201914
30,13,282,16,240,315,58,584,67,1562,1552,3114,10,5.4,201914
30,14,157,8,263,220,44,331,1,1024,1161,2185,8,5.5,201914
30,15,306,20,235,258,46,553,47,1465,1475,2940,11,5.666666667,201914
30,16,186,7,317,295,60,457,40,1362,1511,2873,10,5.333333333,201914
30,17,202,23,309,269,30,402,5,1240,1276,2516,8,5.5,201914
30,18,173,8,113,157,20,265,13,749,767,1516,8,5.25,201914
30,19,208,11,240,225,12,393,0,1089,1028,2117,13,5.6,201914
30,20,207,17,316,381,91,350,0,1362,1176,2538,10,5.4,201914
31,1,157,16,182,33,180,347,3,918,1042,1960,8,5.5,201914
31,2,98,6,127,8,154,237,0,630,872,1502,6,5.333333333,201914
31,3,394,38,968,596,124,925,0,3045,3009,6054,21,6.333333333,201914
31,4,120,13,297,189,71,348,10,1048,1127,2175,4,6,201914
31,5,142,7,124,156,53,365,0,847,1358,2205,6,5.333333333,201914
32,1,196,33,207,198,37,449,12,1132,923,2055,12,5.2,201914
32,2,197,18,187,118,68,502,21,1111,1175,2286,13,5.142857143,201914
32,3,194,75,264,286,7,507,0,1333,1111,2444,13,5.4,201914
32,4,265,70,267,289,26,512,17,1446,1053,2499,13,5.4,201914
1,1,90,27,144,321,26,21,13,642,373,1015,13,5.5,201915
1,2,65,18,238,758,10,62,13,1164,816,1980,10,6.333333333,201915
1,3,50,33,246,607,16,56,29,1037,679,1716,9,6,201915
2,1,74,8,169,419,8,28,6,712,431,1143,11,6,201915
2,2,88,13,233,514,11,72,0,931,453,1384,8,6.5,201915
2,3,136,11,304,435,19,52,122,1079,554,1633,11,5,201915
2,4,71,7,311,207,36,13,14,659,198,857,9,6,201915
2,5,167,26,475,598,113,86,43,1508,600,2108,13,6,201915
2,6,118,11,314,395,13,49,7,907,327,1234,7,6,201915
2,7,103,17,274,311,8,25,88,826,451,1277,12,5.25,201915
2,8,113,9,277,547,10,46,66,1068,630,1698,8,6,201915
3,1,149,12,251,234,11,361,0,1018,1159,2177,11,5.8,201915
3,2,137,13,526,262,26,186,0,1150,1234,2384,9,5.666666667,201915
4,1,172,11,252,364,60,311,17,1187,1278,2465,11,5.25,201915
4,2,173,14,353,347,23,240,16,1166,1312,2478,14,5.2,201915
5,1,193,12,389,301,28,397,5,1325,1450,2775,9,5.666666667,201915
5,2,149,13,276,258,39,313,1,1049,1340,2389,10,5.2,201915
5,3,162,13,268,302,28,493,24,1290,1568,2858,8,5.666666667,201915
5,4,180,27,509,410,13,558,14,1711,1998,3709,9,5.666666667,201915
5,5,185,18,417,493,11,284,21,1429,1784,3213,9,6,201915
5,6,110,21,322,312,13,240,42,1060,1367,2427,11,5.5,201915
5,7,159,28,320,329,3,376,4,1219,1340,2559,10,5.5,201915
6,1,167,16,296,240,11,403,9,1142,1273,2415,12,6,201915
6,2,134,16,331,172,34,385,6,1078,1325,2403,9,5.666666667,201915
7,1,164,9,149,465,15,58,5,865,804,1669,9,5.25,201915
7,2,310,9,177,533,35,101,0,1165,1296,2461,9,5.25,201915
7,3,211,8,203,208,98,163,1,892,2025,2917,7,5.333333333,201915
7,4,155,12,105,354,5,80,10,721,1117,1838,11,5.4,201915
7,5,258,1,154,457,10,167,1,1048,1241,2289,11,5.666666667,201915
7,6,253,10,300,377,23,353,20,1336,1402,2738,9,5.666666667,201915
7,7,226,21,280,373,28,246,10,1184,1298,2482,8,5.5,201915
7,8,208,7,181,350,7,222,11,986,1317,2303,12,5.25,201915
7,9,196,25,281,389,12,335,5,1243,1269,2512,9,5.666666667,201915
7,10,208,6,157,537,10,139,0,1057,1745,2802,9,5.5,201915
7,11,95,1,54,46,9,48,7,260,590,850,6,5.333333333,201915
7,12,200,5,272,539,6,177,0,1199,1311,2510,9,5.5,201915
7,13,116,7,111,225,1,58,0,518,794,1312,9,5.25,201915
8,1,133,8,404,178,22,260,1,1006,1085,2091,4,6,201915
8,2,242,26,666,456,24,488,1,1903,2122,4025,16,5.5,201915
8,3,117,9,272,237,12,237,11,895,1264,2159,4,6,201915
8,4,163,17,476,316,53,421,46,1492,1631,3123,11,6,201915
8,5,156,28,239,205,11,257,0,896,1180,2076,10,5.25,201915
8,6,179,24,398,406,30,497,4,1538,1723,3261,7,6.5,201915
8,7,186,41,222,209,4,555,0,1217,1618,2835,7,5.25,201915
8,8,157,30,348,353,11,444,0,1343,1395,2738,10,6,201915
8,9,187,12,127,117,15,460,6,924,1198,2122,10,5,201915
9,1,79,9,158,153,60,220,2,681,713,1394,5,6,201915
9,2,269,71,729,915,83,817,9,2893,2881,5774,12,6,201915
9,3,140,31,413,440,63,399,19,1505,1595,3100,7,6,201915
9,4,156,15,458,551,68,375,10,1633,1819,3452,11,6,201915
9,5,103,12,257,304,57,321,0,1054,1178,2232,7,6,201915
9,6,81,16,197,187,96,257,5,839,876,1715,7,6,201915
9,7,85,7,270,372,10,303,0,1047,1052,2099,9,6,201915
9,8,101,16,331,281,16,296,4,1045,1118,2163,5,6,201915
9,9,102,7,215,298,30,212,4,868,1014,1882,5,6,201915
9,10,92,11,297,355,22,303,0,1080,1258,2338,6,6,201915
9,11,151,18,483,534,35,486,2,1709,1742,3451,7,6,201915
9,12,115,28,538,668,42,453,23,1867,2135,4002,11,6,201915
9,13,123,13,267,311,69,307,8,1098,1235,2333,4,6,201915
9,14,102,15,173,235,46,280,10,861,947,1808,5,6,201915
9,15,191,21,893,872,28,805,3,2813,3445,6258,9,6.5,201915
9,16,196,39,448,616,86,474,0,1859,2133,3992,15,6,201915
9,17,107,8,187,336,24,255,0,917,952,1869,6,6,201915
9,18,134,17,395,561,44,475,0,1626,1751,3377,12,6,201915
9,19,156,32,393,501,86,351,4,1523,1469,2992,5,6,201915
9,20,51,3,158,158,25,107,3,505,522,1027,5,6,201915
9,21,101,10,163,254,38,194,6,766,896,1662,3,6,201915
9,22,149,13,342,375,79,357,23,1338,1219,2557,5,6,201915
9,23,122,14,256,456,44,337,0,1229,1418,2647,6,6,201915
9,24,270,31,620,815,80,742,4,2562,2728,5290,12,6,201915
10,1,62,18,89,264,22,22,55,532,340,872,12,3.5,201915
10,2,94,17,179,352,18,46,31,737,366,1103,9,3.75,201915
10,3,70,27,127,164,16,33,126,563,216,779,11,4.2,201915
10,4,125,25,179,740,5,38,4,1116,769,1885,13,7,201915
11,1,168,32,197,247,27,263,1,935,1028,1963,6,5.666666667,201915
11,2,184,18,203,205,23,228,25,886,1041,1927,7,6,201915
11,3,114,23,222,234,8,336,8,945,1041,1986,3,6,201915
11,4,164,33,176,179,21,295,0,868,951,1819,7,6,201915
11,5,259,50,400,486,13,532,0,1740,1912,3652,7,6,201915
11,6,124,13,234,258,28,316,3,976,1042,2018,8,6,201915
11,7,199,27,281,407,21,217,2,1154,1689,2843,9,5.25,201915
11,8,151,34,269,332,26,336,0,1148,1387,2535,9,5.5,201915
11,9,236,66,349,415,8,468,19,1561,1503,3064,10,5.666666667,201915
11,10,171,31,230,247,21,407,13,1120,1316,2436,10,5.6,201915
11,11,197,45,320,268,16,362,0,1208,1373,2581,5,6,201915
11,12,195,28,377,452,11,352,0,1415,1666,3081,7,6,201915
11,13,160,42,204,193,19,328,11,957,1113,2070,8,5.5,201915
11,14,133,43,228,203,17,372,1,997,1135,2132,8,5.5,201915
11,15,144,33,222,284,10,300,1,994,1040,2034,9,6,201915
12,1,161,29,241,119,51,222,4,827,977,1804,10,5,201915
12,2,184,33,250,316,7,277,3,1070,1220,2290,10,5.5,201915
12,3,211,23,300,321,11,214,0,1080,1495,2575,11,5.2,201915
12,4,181,25,335,503,15,251,1,1311,1425,2736,9,5.666666667,201915
12,5,247,31,215,278,3,247,4,1025,1302,2327,10,5.25,201915
12,6,219,24,204,357,108,110,2,1024,1216,2240,10,5.25,201915
12,7,295,22,247,353,18,344,40,1319,1776,3095,6,5.5,201915
12,8,224,26,263,332,2,164,0,1011,938,1949,9,5.25,201915
12,9,205,31,284,487,17,173,0,1197,1399,2596,9,5.666666667,201915
13,1,188,22,215,214,37,369,48,1093,1076,2169,9,5.333333333,201915
13,2,123,10,124,166,36,259,2,720,861,1581,6,5.333333333,201915
13,3,149,16,210,262,72,270,0,979,1156,2135,12,5.25,201915
13,4,223,29,311,268,97,318,18,1264,1399,2663,9,5.666666667,201915
13,5,182,27,357,287,84,507,10,1454,1590,3044,9,5.75,201915
13,6,232,70,636,662,52,480,2,2134,2449,4583,11,5.666666667,201915
13,7,139,14,344,374,19,200,0,1090,1298,2388,8,5.5,201915
14,1,151,17,105,61,11,549,0,894,871,1765,6,5.25,201915
14,2,200,9,165,86,13,582,1,1056,1125,2181,5,5.666666667,201915
14,3,231,12,206,91,5,699,0,1244,1463,2707,8,5.4,201915
14,4,217,16,373,388,23,500,1,1518,1661,3179,10,6,201915
14,5,171,12,370,225,33,330,1,1142,1394,2536,9,5.5,201915
14,6,214,14,527,289,6,437,1,1488,1605,3093,11,6,201915
14,7,121,11,180,134,0,257,0,703,796,1499,6,6,201915
14,8,362,44,772,715,15,1057,10,2975,3087,6062,11,6.25,201915
14,9,182,12,242,269,35,477,0,1217,1419,2636,9,6,201915
14,10,170,19,333,271,6,460,0,1259,1394,2653,7,6,201915
14,11,123,9,164,166,18,306,5,791,805,1596,4,6,201915
14,12,242,11,496,172,13,370,1,1305,1378,2683,9,5.5,201915
14,13,199,19,289,217,9,445,1,1179,1388,2567,6,6,201915
14,14,160,11,275,266,20,504,2,1238,1375,2613,7,6,201915
14,15,224,28,213,211,30,539,4,1249,1430,2679,10,5.6,201915
14,16,187,17,250,208,33,457,4,1156,1254,2410,5,6,201915
14,17,158,23,171,97,21,391,1,862,845,1707,7,5.25,201915
14,18,199,17,269,138,25,568,5,1221,1486,2707,9,5.4,201915
14,19,198,38,373,251,26,400,12,1298,1377,2675,8,5.25,201915
14,20,237,10,350,171,8,487,0,1263,1337,2600,10,5.666666667,201915
15,1,200,12,200,85,114,557,1,1169,1463,2632,7,5.333333333,201915
15,2,127,10,248,348,38,235,8,1014,1229,2243,6,6,201915
15,3,211,28,233,275,130,575,14,1466,1773,3239,10,5.666666667,201915
15,4,182,11,275,276,17,459,12,1232,1211,2443,4,6,201915
15,5,142,29,275,273,19,368,2,1108,1261,2369,8,5.666666667,201915
15,6,131,5,334,494,42,335,4,1345,1389,2734,7,6,201915
15,7,136,8,259,306,34,321,0,1064,1114,2178,10,6,201915
15,8,89,9,170,266,16,175,7,732,718,1450,4,6,201915
15,9,276,12,144,149,163,460,8,1212,1209,2421,9,5.75,201915
15,10,139,8,254,262,65,293,6,1027,1183,2210,6,6,201915
15,11,160,14,320,431,57,330,4,1316,1393,2709,8,6,201915
15,12,183,10,524,509,43,335,0,1604,1955,3559,8,6,201915
15,13,73,7,192,185,74,302,0,833,840,1673,8,6,201915
15,14,74,20,187,245,14,211,0,751,703,1454,4,6,201915
15,15,136,28,338,394,34,416,3,1349,1379,2728,6,6,201915
15,16,214,32,427,639,19,426,3,1760,2109,3869,8,6,201915
15,17,101,12,215,341,17,315,11,1012,1054,2066,8,6,201915
15,18,204,19,288,421,29,413,1,1375,1538,2913,7,5.666666667,201915
15,19,153,37,455,582,22,518,2,1769,1871,3640,10,6,201915
15,20,94,8,228,283,11,276,0,900,953,1853,6,6,201915
15,21,104,9,129,202,19,203,14,680,759,1439,6,5.5,201915
15,22,248,29,549,720,24,638,16,2224,2399,4623,14,6,201915
15,23,144,21,250,369,16,362,0,1162,1186,2348,6,5.333333333,201915
15,24,128,25,271,264,28,241,1,958,972,1930,4,6,201915
15,25,133,36,269,276,53,205,10,982,1069,2051,6,6,201915
15,26,137,5,196,235,40,295,2,910,958,1868,9,7,201915
15,27,192,17,305,439,17,498,24,1492,1703,3195,9,5.666666667,201915
15,28,219,15,419,312,46,445,0,1456,1615,3071,9,5.666666667,201915
15,29,183,37,432,604,8,426,4,1694,1768,3462,8,6,201915
15,30,227,22,461,511,42,281,10,1554,1608,3162,16,6,201915
15,31,92,19,154,207,14,190,0,676,1252,1928,6,6,201915
15,32,164,17,295,412,28,223,6,1145,1304,2449,9,6,201915
15,33,157,18,346,401,29,335,0,1286,1313,2599,7,6,201915
15,34,140,8,201,320,12,319,3,1003,1133,2136,8,6,201915
15,35,276,26,266,373,4,570,0,1515,1684,3199,9,5.666666667,201915
15,36,211,23,254,264,60,378,1,1191,1587,2778,9,5.5,201915
15,37,186,17,355,512,41,444,20,1575,2460,4035,7,6,201915
15,38,144,27,265,380,15,360,6,1197,1254,2451,6,5.5,201915
15,39,135,20,306,350,29,228,2,1070,1100,2170,4,6,201915
15,40,291,23,320,436,73,648,1,1792,1957,3749,9,6,201915
15,41,190,29,607,556,42,351,10,1785,2081,3866,14,6.333333333,201915
16,1,121,8,188,182,9,213,0,721,841,1562,7,5.333333333,201915
16,2,125,16,124,156,11,205,0,637,831,1468,9,5.25,201915
16,3,192,17,147,221,10,187,1,775,903,1678,10,5.25,201915
16,4,182,23,195,132,19,483,0,1034,1063,2097,8,5.5,201915
16,5,172,16,171,193,15,353,5,925,984,1909,10,5.666666667,201915
16,6,197,29,179,213,27,212,0,857,1026,1883,12,5.5,201915
16,7,256,19,218,232,29,356,0,1110,1142,2252,9,5.5,201915
16,8,236,29,536,487,6,499,0,1793,1956,3749,12,6,201915
16,9,200,26,253,259,10,442,3,1193,1216,2409,9,6,201915
16,10,139,16,316,341,13,307,0,1132,1217,2349,6,6,201915
16,11,236,19,201,159,49,495,0,1159,1431,2590,10,5.4,201915
16,12,188,13,217,128,13,208,1,768,741,1509,10,5.25,201915
17,1,164,15,452,400,23,445,4,1503,1473,2976,9,7,201915
17,2,133,8,338,290,17,230,4,1020,1008,2028,8,5.666666667,201915
17,3,232,10,401,429,11,359,0,1442,1543,2985,8,5.5,201915
17,4,221,17,446,378,27,421,4,1514,1460,2974,10,5.666666667,201915
17,5,80,11,151,160,7,125,3,537,636,1173,5,5.5,201915
18,1,145,14,118,129,12,241,3,662,963,1625,7,5.25,201915
18,2,237,25,394,381,55,386,0,1478,1683,3161,9,6.333333333,201915
18,3,138,13,326,198,5,319,0,999,1258,2257,8,5.5,201915
19,1,166,15,345,326,17,587,4,1460,1561,3021,9,6,201915
19,2,235,16,588,358,6,609,0,1812,1961,3773,9,6,201915
19,3,222,16,547,294,19,567,0,1665,1756,3421,7,6,201915
19,4,105,19,158,140,31,390,20,863,920,1783,5,6,201915
19,5,314,15,483,586,25,749,18,2190,2307,4497,8,6,201915
19,6,82,6,175,223,3,413,1,903,1011,1914,5,6,201915
19,7,185,15,552,236,9,325,0,1322,1285,2607,10,5.5,201915
19,8,93,11,188,153,0,253,0,698,782,1480,7,6,201915
19,9,184,12,209,179,29,380,1,994,1087,2081,9,5.25,201915
19,10,108,11,188,195,7,468,3,980,1100,2080,6,7,201915
19,11,346,44,534,580,28,1185,17,2734,2659,5393,13,6,201915
19,12,211,11,648,207,10,403,3,1493,1329,2822,8,5.666666667,201915
20,1,122,11,231,166,41,199,36,806,953,1759,7,5.5,201915
20,2,145,10,168,168,9,190,0,690,646,1336,6,5.333333333,201915
20,3,92,10,135,118,55,123,35,568,803,1371,6,5.333333333,201915
20,4,74,6,78,68,25,161,20,432,516,948,6,5.333333333,201915
20,5,92,7,149,171,36,123,0,578,822,1400,11,5.25,201915
20,6,193,21,190,278,130,217,0,1029,1302,2331,8,5.25,201915
20,7,179,14,220,288,11,320,3,1035,1237,2272,7,5.75,201915
20,8,368,43,436,802,38,690,57,2434,2557,4991,14,6.5,201915
20,9,207,13,264,266,47,412,26,1235,1410,2645,8,5.666666667,201915
20,10,154,13,254,303,10,207,0,941,1188,2129,9,5.25,201915
21,1,76,2,59,162,0,9,1,309,267,576,9,4.2,201915
21,2,95,5,154,163,31,15,2,465,200,665,9,3.6,201915
21,3,153,11,131,153,45,30,28,551,277,828,8,4.5,201915
21,4,52,2,56,102,22,11,25,270,187,457,6,3.75,201915
21,5,94,17,137,290,6,31,24,599,390,989,8,5,201915
21,6,88,7,150,424,13,18,90,790,590,1380,6,6,201915
21,7,81,9,112,192,52,20,6,472,339,811,9,5,201915
21,8,136,10,213,92,96,23,70,640,215,855,9,3.6,201915
21,9,107,5,182,398,49,46,73,860,626,1486,9,6,201915
21,10,87,11,162,401,13,42,102,818,646,1464,7,4.5,201915
21,11,22,7,49,150,8,15,17,268,297,565,4,6,201915
21,12,148,13,304,948,32,61,152,1658,1467,3125,15,6,201915
21,13,135,11,144,259,32,96,46,723,386,1109,8,5,201915
21,14,78,11,132,158,40,18,51,488,328,816,12,4,201915
21,15,109,11,185,279,26,28,27,665,399,1064,7,4.5,201915
22,1,121,36,206,269,19,100,2,753,929,1682,11,4.2,201915
22,2,103,18,281,235,33,244,0,914,1048,1962,7,5,201915
22,3,200,42,618,504,23,436,0,1823,2092,3915,9,4.666666667,201915
22,4,145,27,489,396,22,298,1,1378,1517,2895,9,5.5,201915
22,5,113,22,327,183,49,176,1,871,1067,1938,10,5,201915
23,1,110,8,611,421,12,47,20,1229,475,1704,14,4.8,201915
23,2,66,14,159,328,4,12,8,591,373,964,9,4,201915
23,3,63,7,265,476,6,13,24,854,757,1611,15,6,201915
23,4,75,5,368,507,29,26,30,1040,611,1651,8,5,201915
24,1,125,48,177,232,18,162,5,767,858,1625,10,5.2,201915
24,2,78,14,180,128,5,181,0,586,818,1404,6,5.5,201915
24,3,143,44,187,232,68,173,0,847,1019,1866,9,5.25,201915
24,4,148,18,190,166,49,346,21,938,1178,2116,5,5.5,201915
24,5,227,37,469,486,13,475,1,1708,1930,3638,10,6.333333333,201915
24,6,182,42,310,380,14,476,0,1404,1515,2919,6,6,201915
24,7,125,22,218,392,9,160,0,926,1382,2308,9,5.25,201915
25,1,115,11,224,256,12,323,4,945,1010,1955,13,5.75,201915
25,2,220,34,363,369,15,441,0,1442,1618,3060,7,5.5,201915
25,3,176,19,235,284,28,319,6,1067,1349,2416,8,5.6,201915
25,4,154,18,148,286,10,270,1,887,1290,2177,8,5.333333333,201915
25,5,120,12,256,368,20,328,2,1106,1415,2521,8,5.666666667,201915
25,6,181,12,290,276,40,437,2,1238,1418,2656,8,5.75,201915
25,7,223,18,393,473,10,435,0,1552,1820,3372,6,6,201915
26,1,196,6,330,233,7,426,0,1198,1521,2719,9,5.5,201915
26,2,230,15,415,377,5,361,8,1411,1730,3141,12,5.4,201915
26,3,224,19,299,401,14,609,14,1580,1710,3290,15,7,201915
26,4,118,14,149,235,23,393,3,935,1127,2062,9,5.2,201915
26,5,174,12,248,227,13,374,0,1048,1171,2219,15,6,201915
26,6,183,15,302,240,10,600,0,1350,1409,2759,10,5.333333333,201915
26,7,134,15,185,240,25,243,0,842,1005,1847,10,5.5,201915
27,1,125,7,199,219,55,208,0,813,1218,2031,8,5.5,201915
27,2,191,16,303,469,17,248,0,1244,1612,2856,8,5.666666667,201915
27,3,183,17,219,439,8,260,2,1128,1403,2531,7,5.666666667,201915
27,4,225,18,455,697,21,446,21,1883,1932,3815,8,6,201915
27,5,97,2,192,241,7,108,0,647,708,1355,6,5.333333333,201915
27,6,155,13,270,359,13,273,0,1083,1188,2271,7,5.5,201915
28,1,42,7,94,461,1,18,0,623,490,1113,13,6,201915
28,2,98,13,226,327,16,37,146,863,365,1228,14,5.333333333,201915
28,3,59,7,91,166,2,17,0,342,94,436,7,4,201915
28,4,106,15,221,340,46,43,152,923,448,1371,15,6,201915
28,5,45,19,82,321,6,28,79,580,383,963,10,4,201915
28,6,43,11,84,147,10,6,10,311,139,450,13,3.5,201915
28,7,99,19,258,463,21,47,74,981,575,1556,13,6,201915
28,8,64,25,228,379,30,51,45,822,424,1246,9,6,201915
28,9,57,5,150,197,19,27,46,501,221,722,11,5.25,201915
29,1,205,19,340,343,56,314,2,1279,1508,2787,7,5.5,201915
29,2,235,22,311,517,29,392,47,1553,1851,3404,11,6,201915
29,3,110,16,168,336,10,182,0,822,1052,1874,5,5.666666667,201915
30,1,139,16,227,177,13,320,3,895,849,1744,7,5.333333333,201915
30,2,210,18,156,129,33,178,45,769,862,1631,8,5.25,201915
30,3,224,16,280,152,47,366,31,1116,1108,2224,6,5.666666667,201915
30,4,107,9,247,198,31,242,0,834,956,1790,8,6,201915
30,5,117,9,214,246,13,334,0,933,1237,2170,7,5.5,201915
30,6,202,15,208,218,32,276,3,954,1178,2132,9,5.333333333,201915
30,7,128,9,145,161,20,218,12,693,998,1691,11,5.25,201915
30,8,234,13,309,293,54,497,7,1407,1526,2933,11,5.4,201915
30,9,245,7,184,182,35,393,19,1065,1162,2227,8,5.5,201915
30,10,179,14,258,277,27,333,18,1106,1284,2390,6,6,201915
30,11,126,10,369,327,15,255,0,1102,1222,2324,5,5.5,201915
30,12,209,16,469,493,30,570,0,1787,2096,3883,10,6,201915
30,13,197,12,163,334,40,335,32,1113,1322,2435,10,5.4,201915
30,14,190,18,296,145,45,399,3,1096,1283,2379,8,5.5,201915
30,15,257,10,270,290,39,565,38,1469,1378,2847,11,5.666666667,201915
30,16,174,7,256,318,30,466,35,1286,1608,2894,10,5.333333333,201915
30,17,199,18,241,275,24,354,10,1121,1274,2395,8,5.5,201915
30,18,165,8,189,258,14,213,10,857,825,1682,8,5.25,201915
30,19,156,6,273,225,16,340,0,1016,1285,2301,13,5.6,201915
30,20,166,24,233,314,133,296,0,1166,1311,2477,10,5.4,201915
31,1,232,23,202,39,222,361,0,1079,1140,2219,8,5.5,201915
31,2,113,8,140,13,123,251,0,648,676,1324,6,5.333333333,201915
31,3,355,49,961,554,99,809,0,2827,3157,5984,21,6.333333333,201915
31,4,99,13,251,202,58,327,6,956,1018,1974,4,6,201915
31,5,120,14,151,166,40,272,0,763,1086,1849,6,5.333333333,201915
32,1,191,30,172,170,30,373,5,971,1113,2084,12,5.2,201915
32,2,178,21,154,91,43,449,13,949,1230,2179,13,5.142857143,201915
32,3,191,49,237,298,11,497,2,1285,1379,2664,13,5.4,201915
32,4,240,51,202,272,18,509,7,1299,1683,2982,13,5.4,201915
1,1,21,5,35,127,4,6,3,201,135,336,9,2,201916
1,2,45,10,98,378,5,33,17,586,515,1101,9,3,201916
1,3,46,18,147,376,7,30,19,643,350,993,9,3,201916
2,1,40,6,104,208,6,22,4,390,183,573,11,3,201916
2,2,70,5,127,296,2,38,0,538,204,742,7,3,201916
2,3,73,12,187,252,4,29,63,620,226,846,10,2,201916
2,4,40,4,131,121,14,11,8,329,62,391,9,3,201916
2,5,105,13,261,307,68,32,31,817,274,1091,13,3,201916
2,6,69,5,153,242,5,19,5,498,143,641,7,3,201916
2,7,66,5,123,183,7,19,35,438,152,590,10,2.25,201916
2,8,61,9,170,284,3,29,36,592,333,925,8,3,201916
3,1,98,3,143,120,7,167,2,540,591,1131,12,3.6,201916
3,2,88,5,302,114,4,89,0,602,667,1269,9,3,201916
4,1,127,8,152,208,25,221,5,746,794,1540,11,3,201916
4,2,105,6,181,183,13,102,12,602,679,1281,14,3,201916
5,1,129,5,230,224,14,225,4,831,983,1814,9,3,201916
5,2,111,7,99,140,19,128,0,504,810,1314,10,3,201916
5,3,111,7,169,173,19,197,8,684,778,1462,7,3,201916
5,4,123,15,248,240,13,329,11,979,1157,2136,9,3,201916
5,5,112,4,223,269,15,151,12,786,863,1649,9,3,201916
5,6,82,6,170,223,4,138,18,641,659,1300,11,3,201916
5,7,94,10,139,168,3,188,1,603,664,1267,10,3,201916
6,1,91,5,138,136,1,229,1,601,728,1329,12,3.2,201916
6,2,93,7,169,107,13,206,8,603,664,1267,9,3,201916
7,1,142,1,82,138,10,50,2,425,720,1145,9,3,201916
7,2,161,8,70,336,45,39,0,659,857,1516,9,3,201916
7,3,110,1,89,95,26,72,0,393,1008,1401,7,3,201916
7,4,94,3,66,145,3,75,6,392,615,1007,11,3,201916
7,5,117,1,70,351,6,71,0,616,664,1280,11,3,201916
7,6,159,6,138,194,6,150,3,656,748,1404,9,3.333333333,201916
7,7,163,7,134,178,25,92,16,615,769,1384,8,3,201916
7,8,132,6,91,186,8,111,1,535,624,1159,12,3,201916
7,9,116,10,146,158,5,183,0,618,704,1322,9,3,201916
7,10,107,2,64,167,10,51,0,401,564,965,9,3,201916
7,11,64,0,44,33,1,37,6,185,386,571,6,3,201916
7,12,114,1,114,226,2,72,0,529,668,1197,9,3,201916
7,13,72,4,58,134,0,43,0,311,678,989,9,3,201916
8,1,99,5,230,116,10,124,2,586,599,1185,4,3,201916
8,2,205,13,332,239,11,264,0,1064,1138,2202,16,3,201916
8,3,128,14,203,190,17,153,9,714,663,1377,4,3,201916
8,4,118,9,275,207,24,266,22,921,830,1751,11,3,201916
8,5,117,20,134,141,8,203,0,623,697,1320,10,3,201916
8,6,142,15,226,253,23,312,2,973,987,1960,7,3.5,201916
8,7,115,19,137,135,7,303,0,716,990,1706,7,3,201916
8,8,131,10,219,185,6,231,0,782,773,1555,11,4,201916
8,9,108,5,70,54,8,206,0,451,555,1006,10,3,201916
9,1,63,4,78,92,33,145,3,418,411,829,5,3,201916
9,2,214,36,414,562,34,474,3,1737,1786,3523,12,3,201916
9,3,97,16,238,264,33,249,13,910,826,1736,7,3,201916
9,4,107,8,227,311,28,224,10,915,1029,1944,11,3,201916
9,5,83,4,141,221,33,230,0,712,703,1415,7,3,201916
9,6,73,6,103,101,76,149,4,512,515,1027,7,3,201916
9,7,74,1,148,154,1,152,0,530,592,1122,9,3,201916
9,8,68,9,178,179,5,137,3,579,609,1188,5,3,201916
9,9,78,2,120,171,24,93,2,490,602,1092,5,3,201916
9,10,77,6,197,189,22,172,1,664,695,1359,6,3,201916
9,11,89,6,226,313,23,262,1,920,1048,1968,7,3,201916
9,12,95,14,310,353,25,288,14,1099,1145,2244,11,3,201916
9,13,75,12,135,174,41,167,7,611,667,1278,4,3,201916
9,14,70,9,110,145,18,152,4,508,498,1006,5,3,201916
9,15,130,14,454,545,24,487,7,1661,1746,3407,9,3.5,201916
9,16,176,14,244,385,42,298,0,1159,1123,2282,15,3,201916
9,17,62,2,126,166,13,138,0,507,577,1084,6,3,201916
9,18,103,19,211,313,19,272,1,938,917,1855,12,3,201916
9,19,124,19,200,299,54,200,4,900,830,1730,5,3,201916
9,20,27,4,69,73,12,48,0,233,290,523,5,3,201916
9,21,78,9,100,160,17,117,3,484,458,942,3,3,201916
9,22,115,5,156,198,50,162,8,694,700,1394,5,3,201916
9,23,78,7,174,275,31,212,3,780,741,1521,6,3,201916
9,24,171,15,293,482,53,404,3,1421,1540,2961,12,3,201916
10,1,27,3,25,108,4,3,30,200,138,338,4,1,201916
10,2,51,7,89,179,7,23,30,386,179,565,4,0.75,201916
10,3,17,2,38,68,6,6,22,159,91,250,6,1.2,201916
10,4,54,12,88,331,1,16,5,507,332,839,12,3.5,201916
11,1,119,13,112,141,17,104,1,507,572,1079,6,3,201916
11,2,108,8,114,135,7,115,11,498,584,1082,7,3,201916
11,3,82,11,109,108,5,201,3,519,604,1123,3,3,201916
11,4,109,16,86,148,7,154,0,520,577,1097,8,3.333333333,201916
11,5,160,17,206,235,18,327,0,963,968,1931,7,3,201916
11,6,79,3,125,140,12,155,2,516,574,1090,8,3,201916
11,7,142,19,183,219,8,120,2,693,955,1648,9,3,201916
11,8,94,12,122,177,7,143,0,555,609,1164,9,3,201916
11,9,145,33,196,192,6,215,6,793,986,1779,10,3,201916
11,10,138,21,117,121,6,165,6,574,828,1402,10,3,201916
11,11,134,20,205,165,11,236,0,771,655,1426,5,3,201916
11,12,147,10,239,225,8,180,0,809,1007,1816,7,3,201916
11,13,122,15,105,113,6,155,5,521,554,1075,8,3,201916
11,14,124,14,97,110,8,137,0,490,656,1146,8,3,201916
11,15,64,19,97,134,3,155,0,472,546,1018,9,3,201916
12,1,80,18,135,85,12,118,2,450,530,980,10,3,201916
12,2,121,19,141,238,9,171,7,706,851,1557,10,3,201916
12,3,118,12,143,185,17,86,0,561,876,1437,11,3,201916
12,4,96,14,168,261,19,95,0,653,798,1451,9,3,201916
12,5,130,13,110,128,4,103,8,496,667,1163,10,3,201916
12,6,113,10,70,227,20,51,0,491,836,1327,10,3,201916
12,7,139,12,137,172,5,166,24,655,801,1456,6,3,201916
12,8,136,7,137,200,1,95,0,576,813,1389,9,3,201916
12,9,100,12,165,260,8,75,0,620,773,1393,9,3,201916
13,1,142,12,98,111,31,199,25,618,402,1020,9,3,201916
13,2,109,14,84,112,24,132,1,476,495,971,6,3,201916
13,3,125,17,107,161,66,173,0,649,828,1477,12,3,201916
13,4,170,12,189,183,35,150,8,747,708,1455,9,3,201916
13,5,161,9,185,162,35,257,7,816,887,1703,9,3,201916
13,6,199,42,357,376,22,202,4,1202,1270,2472,11,3,201916
13,7,87,11,221,206,16,103,0,644,766,1410,8,3,201916
14,1,86,9,75,55,11,258,0,494,549,1043,6,3,201916
14,2,102,9,106,67,1,281,1,567,691,1258,5,3,201916
14,3,163,6,126,73,2,399,0,769,791,1560,8,3,201916
14,4,116,13,179,191,14,221,0,734,934,1668,10,3,201916
14,5,84,11,188,147,14,143,0,587,741,1328,9,3,201916
14,6,102,5,237,149,9,213,0,715,892,1607,11,3,201916
14,7,88,1,90,52,0,124,0,355,382,737,6,3,201916
14,8,192,16,372,424,8,584,0,1596,1635,3231,11,3.25,201916
14,9,104,8,140,141,12,249,0,654,759,1413,9,3,201916
14,10,102,10,200,150,6,242,0,710,750,1460,7,3,201916
14,11,82,6,95,94,10,181,10,478,425,903,4,3,201916
14,12,139,6,228,122,6,192,0,693,818,1511,9,3,201916
14,13,115,5,170,129,4,253,1,677,708,1385,6,3,201916
14,14,103,5,159,137,14,257,2,677,651,1328,7,3,201916
14,15,146,12,109,130,16,225,1,639,801,1440,10,3,201916
14,16,97,14,123,92,14,252,2,594,573,1167,5,3,201916
14,17,71,8,92,48,8,161,5,393,580,973,7,3,201916
14,18,137,11,128,67,21,262,4,630,781,1411,9,3,201916
14,19,125,10,207,144,8,196,4,694,1076,1770,8,3,201916
14,20,150,9,174,114,2,196,0,645,862,1507,10,3,201916
15,1,122,0,106,52,74,266,0,620,823,1443,7,3,201916
15,2,105,9,141,197,18,133,4,607,612,1219,6,3,201916
15,3,166,12,101,180,72,280,6,817,808,1625,10,3,201916
15,4,123,5,159,180,14,244,4,729,695,1424,4,3,201916
15,5,119,11,124,174,18,194,3,643,733,1376,8,3,201916
15,6,129,8,195,258,26,163,2,781,777,1558,7,3,201916
15,7,115,2,118,195,17,223,0,670,650,1320,10,3,201916
15,8,58,4,95,160,8,95,5,425,408,833,4,3,201916
15,9,186,7,117,98,99,220,4,731,774,1505,9,3,201916
15,10,96,2,128,161,31,137,3,558,661,1219,6,3,201916
15,11,113,7,178,250,13,184,2,747,824,1571,8,3,201916
15,12,144,6,275,262,26,172,0,885,998,1883,8,3,201916
15,13,59,3,75,111,41,152,1,442,460,902,8,3,201916
15,14,60,10,99,121,5,112,0,407,422,829,4,3,201916
15,15,85,28,196,222,16,234,1,782,711,1493,6,3,201916
15,16,167,16,197,334,11,201,2,928,1073,2001,8,3,201916
15,17,93,7,141,166,10,179,11,607,603,1210,8,3,201916
15,18,155,16,150,241,8,186,4,760,868,1628,7,3,201916
15,19,140,17,227,307,12,312,7,1022,1057,2079,10,3,201916
15,20,51,9,124,147,5,119,0,455,472,927,6,3,201916
15,21,81,1,62,118,13,98,5,378,562,940,6,3,201916
15,22,192,28,252,428,15,361,5,1281,1216,2497,14,3,201916
15,23,109,16,110,206,11,163,0,615,647,1262,6,3,201916
15,24,77,10,128,161,11,104,3,494,506,1000,4,3,201916
15,25,90,14,130,149,17,88,6,494,568,1062,6,3,201916
15,26,102,5,112,122,14,146,4,505,551,1056,9,4,201916
15,27,126,13,166,277,11,252,21,866,1008,1874,9,3,201916
15,28,165,14,223,197,26,253,1,879,989,1868,9,3,201916
15,29,150,9,210,360,7,206,0,942,1088,2030,8,3,201916
15,30,140,14,245,271,26,142,2,840,882,1722,16,3,201916
15,31,82,18,89,143,12,141,0,485,398,883,6,3,201916
15,32,88,6,140,258,13,131,0,636,723,1359,9,3,201916
15,33,87,8,180,208,15,167,0,665,672,1337,7,3,201916
15,34,87,6,99,183,1,142,2,520,573,1093,8,3,201916
15,35,182,11,138,247,3,293,0,874,953,1827,9,3,201916
15,36,139,7,122,180,30,156,0,634,698,1332,9,3,201916
15,37,146,16,168,307,20,233,10,900,1312,2212,7,3,201916
15,38,91,15,113,206,6,152,3,586,610,1196,6,3,201916
15,39,100,11,178,201,12,114,0,616,681,1297,4,3,201916
15,40,182,6,169,216,42,263,0,878,943,1821,9,3,201916
15,41,177,15,301,316,28,202,6,1045,1156,2201,14,3.333333333,201916
16,1,94,2,112,73,2,108,0,391,459,850,7,3,201916
16,2,99,8,55,81,2,127,0,372,445,817,9,3,201916
16,3,138,4,91,130,16,87,1,467,630,1097,10,3,201916
16,4,127,13,88,82,11,164,0,485,804,1289,8,3,201916
16,5,122,5,104,104,14,135,4,488,591,1079,10,3,201916
16,6,143,19,92,125,10,131,0,520,600,1120,12,3,201916
16,7,148,10,87,124,18,149,0,536,668,1204,9,3,201916
16,8,160,13,273,249,4,273,0,972,1058,2030,12,3,201916
16,9,138,8,125,161,5,168,1,606,700,1306,9,3,201916
16,10,95,5,167,150,5,139,0,561,681,1242,6,3,201916
16,11,146,5,93,72,34,224,1,575,652,1227,10,3,201916
16,12,108,7,93,80,19,117,2,426,760,1186,10,3,201916
17,1,124,6,213,271,10,243,2,869,802,1671,9,4,201916
17,2,108,7,162,217,6,115,3,618,700,1318,8,3,201916
17,3,163,8,219,249,4,201,1,845,855,1700,8,3,201916
17,4,143,4,213,237,8,212,1,818,829,1647,10,3,201916
17,5,69,7,85,92,8,80,0,341,443,784,5,3,201916
18,1,78,10,94,88,8,124,3,405,574,979,7,3,201916
18,2,149,13,195,194,25,188,0,764,952,1716,9,3.333333333,201916
18,3,74,4,145,93,0,130,1,447,560,1007,8,3,201916
19,1,75,6,115,96,9,175,0,476,431,907,5,1.5,201916
19,2,178,10,325,223,3,355,0,1094,1076,2170,9,3,201916
19,3,154,7,315,170,15,301,0,962,897,1859,7,3,201916
19,4,61,4,83,79,10,229,5,471,445,916,5,3,201916
19,5,171,12,232,264,17,339,3,1038,1312,2350,8,3,201916
19,6,45,6,117,136,7,209,0,520,512,1032,5,3,201916
19,7,103,8,241,133,5,169,0,659,750,1409,10,3,201916
19,8,63,5,89,93,0,115,0,365,464,829,7,3,201916
19,9,59,3,84,89,9,138,2,384,508,892,9,3,201916
19,10,77,6,103,99,4,233,5,527,531,1058,6,4,201916
19,11,221,12,257,304,18,551,12,1375,1636,3011,13,3,201916
19,12,116,3,356,126,11,207,4,823,965,1788,8,3,201916
20,1,140,6,157,161,33,125,32,654,594,1248,7,3,201916
20,2,97,6,88,89,8,93,1,382,670,1052,6,3,201916
20,3,86,3,113,86,34,92,23,437,761,1198,6,3,201916
20,4,48,7,39,35,13,70,4,216,180,396,6,3,201916
20,5,96,3,130,201,17,78,0,525,817,1342,11,3,201916
20,6,59,7,55,119,113,36,0,389,406,795,8,3,201916
20,7,114,12,129,152,9,149,1,566,802,1368,7,3,201916
20,8,280,23,281,476,24,324,25,1433,1657,3090,14,3.5,201916
20,9,134,3,132,121,36,249,16,691,1031,1722,8,3,201916
20,10,102,4,102,181,6,141,0,536,653,1189,9,3,201916
21,1,0,0,0,105,0,0,0,105,73,178,2,1.2,201916
21,2,0,0,0,24,0,0,0,24,41,65,1,0.6,201916
21,3,0,0,0,95,0,0,0,95,95,190,2,1.5,201916
21,4,0,0,0,37,0,0,0,37,39,76,1,0.75,201916
21,5,1,0,0,112,1,1,0,115,154,269,2,2,201916
21,6,0,0,0,176,0,0,0,176,283,459,1,3,201916
21,7,0,0,0,89,0,0,0,89,113,202,2,2,201916
21,8,0,0,0,61,0,0,0,61,54,115,1,0.6,201916
21,9,0,0,0,193,0,0,0,193,238,431,2,3,201916
21,10,0,0,0,154,0,0,0,154,201,355,1,1.5,201916
21,11,0,0,0,74,0,0,0,74,103,177,1,3,201916
21,12,0,0,0,309,0,0,0,309,539,848,2,3,201916
21,13,0,0,0,116,0,0,0,116,147,263,2,2,201916
21,14,0,0,0,81,0,0,0,81,77,158,2,1,201916
21,15,0,0,0,112,0,0,0,112,159,271,1,1.5,201916
22,1,114,21,114,171,11,86,2,519,671,1190,11,3,201916
22,2,107,12,170,141,14,153,1,598,678,1276,7,3,201916
22,3,220,26,439,365,18,280,0,1348,1410,2758,9,3,201916
22,4,108,26,318,254,21,248,0,975,1078,2053,8,3,201916
22,5,87,9,309,111,20,111,0,647,792,1439,10,3,201916
23,1,59,2,277,233,10,23,5,609,228,837,10,1.8,201916
23,2,18,4,51,137,0,6,6,222,149,371,4,0.75,201916
23,3,24,2,107,164,3,5,5,310,203,513,15,2,201916
23,4,46,5,231,334,12,14,14,656,277,933,6,2,201916
24,1,72,24,89,150,17,80,4,436,575,1011,10,3,201916
24,2,63,8,118,73,8,120,0,390,514,904,6,3,201916
24,3,88,10,110,98,39,84,0,429,455,884,9,3,201916
24,4,99,6,103,116,20,195,17,556,577,1133,5,3,201916
24,5,197,23,221,281,6,299,0,1027,1094,2121,10,3.333333333,201916
24,6,122,14,211,210,17,252,0,826,872,1698,6,3,201916
24,7,154,16,142,248,19,111,0,690,743,1433,9,3,201916
25,1,91,9,108,143,13,168,7,539,676,1215,13,3,201916
25,2,121,19,170,200,6,232,0,748,928,1676,7,3,201916
25,3,78,9,122,136,22,125,4,496,688,1184,8,3,201916
25,4,67,5,88,107,1,169,1,438,637,1075,8,3,201916
25,5,77,3,130,179,12,144,1,546,740,1286,8,3,201916
25,6,99,4,132,127,9,184,1,556,771,1327,8,3,201916
25,7,131,10,219,225,3,186,0,774,971,1745,6,3,201916
26,1,137,3,179,154,15,253,0,741,847,1588,9,3,201916
26,2,115,10,233,240,10,203,7,818,903,1721,12,3,201916
26,3,129,14,140,207,8,330,8,836,1041,1877,14,3.5,201916
26,4,80,10,84,109,11,166,2,462,751,1213,9,3,201916
26,5,64,2,101,96,4,155,0,422,678,1100,15,3.5,201916
26,6,119,5,156,163,3,275,0,721,669,1390,10,3,201916
26,7,58,6,65,114,10,101,0,354,550,904,10,3,201916
27,1,102,5,141,123,22,113,0,506,550,1056,8,3,201916
27,2,119,10,129,283,13,103,0,657,848,1505,8,3,201916
27,3,118,8,101,194,2,130,0,553,622,1175,7,3,201916
27,4,148,9,268,350,11,252,6,1044,1200,2244,8,3.5,201916
27,5,68,2,50,173,7,57,0,357,494,851,6,3,201916
27,6,98,7,128,206,5,120,0,564,720,1284,7,3,201916
28,1,27,5,48,221,0,9,0,310,205,515,13,3,201916
28,2,38,3,82,194,6,14,49,386,190,576,11,2,201916
28,3,23,4,20,66,0,3,0,116,74,190,3,1,201916
28,4,71,10,117,207,19,19,43,486,185,671,15,3,201916
28,5,24,8,49,176,1,12,40,310,163,473,4,0.75,201916
28,6,12,1,16,72,0,3,4,108,51,159,4,0.5,201916
28,7,41,6,133,258,13,19,42,512,265,777,13,3,201916
28,8,29,11,61,167,12,15,30,325,140,465,9,3,201916
28,9,37,3,48,105,8,10,17,228,74,302,9,2.25,201916
29,1,172,23,186,210,24,198,2,815,944,1759,7,3,201916
29,2,199,7,179,354,18,224,38,1019,872,1891,11,3.333333333,201916
29,3,96,13,80,184,4,117,0,494,529,1023,5,3,201916
30,1,58,6,66,72,3,105,3,313,383,696,7,3,201916
30,2,119,5,77,86,16,124,30,457,507,964,8,3,201916
30,3,110,8,130,116,25,166,28,583,635,1218,6,3,201916
30,4,84,5,112,130,24,149,0,504,474,978,8,3,201916
30,5,93,7,124,138,10,199,0,571,626,1197,7,3,201916
30,6,102,8,135,109,17,143,0,514,484,998,9,3,201916
30,7,94,4,95,107,7,151,16,474,473,947,11,3,201916
30,8,139,8,178,214,28,232,15,814,955,1769,11,3,201916
30,9,175,7,120,107,34,211,12,666,755,1421,8,3,201916
30,10,117,10,165,168,21,202,11,694,771,1465,6,3,201916
30,11,65,4,179,216,3,156,0,623,720,1343,5,3,201916
30,12,158,5,245,306,20,274,0,1008,1141,2149,10,3,201916
30,13,138,10,104,184,22,197,22,677,616,1293,10,3,201916
30,14,108,4,131,96,26,161,5,531,592,1123,8,3,201916
30,15,199,7,127,177,17,324,12,863,860,1723,11,3,201916
30,16,112,2,134,224,21,209,22,724,789,1513,10,3,201916
30,17,112,8,133,146,25,165,4,593,1027,1620,8,3,201916
30,18,134,5,100,118,7,140,13,517,483,1000,8,3,201916
30,19,133,1,145,130,11,207,0,627,674,1301,13,3,201916
30,20,113,9,139,214,76,127,0,678,876,1554,10,3,201916
31,1,165,8,140,18,149,201,0,681,712,1393,8,3,201916
31,2,52,6,49,8,76,115,0,306,342,648,6,3,201916
31,3,291,28,554,314,55,476,0,1718,1902,3620,20,3,201916
31,4,79,7,151,109,47,182,5,580,641,1221,4,3,201916
31,5,95,6,77,91,23,160,0,452,644,1096,6,3,201916
32,1,119,15,84,108,8,204,4,542,697,1239,12,3,201916
32,2,138,14,86,50,19,203,4,514,864,1378,13,3,201916
32,3,80,14,85,129,2,150,0,460,653,1113,13,3,201916
32,4,118,30,106,151,5,188,6,604,868,1472,12,3,201916
1,1,48,8,80,168,4,16,3,327,240,567,7,6,201917
1,2,56,26,168,664,8,48,15,985,677,1662,10,6.333333333,201917
1,3,65,25,197,553,23,30,24,917,572,1489,9,6,201917
2,1,72,10,165,426,7,31,2,713,331,1044,11,6,201917
2,2,125,14,215,480,5,59,0,898,333,1231,7,6,201917
2,3,141,24,290,389,16,43,107,1010,413,1423,10,6,201917
2,4,72,6,277,195,49,17,28,644,188,832,9,6,201917
2,5,176,17,477,555,124,82,62,1493,560,2053,13,6,201917
2,6,101,11,271,405,7,52,6,853,278,1131,7,6,201917
2,7,137,4,244,345,11,32,81,854,336,1190,10,6,201917
2,8,109,11,304,560,6,48,63,1101,627,1728,8,6,201917
3,1,168,10,290,261,12,322,0,1063,1018,2081,11,5.8,201917
3,2,173,7,537,245,30,175,0,1167,1315,2482,9,5.666666667,201917
4,1,212,14,260,408,37,308,29,1268,1579,2847,11,5.25,201917
4,2,191,10,380,309,49,177,34,1150,1304,2454,14,5.2,201917
5,1,252,17,377,336,15,432,15,1444,1444,2888,9,5.666666667,201917
5,2,165,17,239,294,20,254,0,989,1371,2360,10,5.2,201917
5,3,163,23,190,316,27,335,15,1069,962,2031,7,5.333333333,201917
5,4,251,28,580,530,9,591,11,2000,2138,4138,9,5.666666667,201917
5,5,204,18,419,529,20,267,33,1490,1360,2850,9,6,201917
5,6,149,11,280,312,8,186,40,986,1162,2148,11,5.5,201917
5,7,201,13,292,335,1,346,4,1192,1085,2277,10,5.5,201917
6,1,180,18,306,259,6,382,6,1157,1239,2396,11,5.8,201917
6,2,165,11,311,195,32,278,8,1000,1163,2163,9,5.666666667,201917
7,1,193,4,125,299,15,62,9,707,1249,1956,9,5.25,201917
7,2,259,3,109,429,30,60,0,890,1691,2581,9,5.25,201917
7,3,159,4,139,212,104,121,5,744,1373,2117,7,5.333333333,201917
7,4,217,16,206,461,7,227,7,1141,1227,2368,11,5.4,201917
7,5,207,7,127,421,13,131,0,906,1511,2417,11,5.666666667,201917
7,6,246,11,310,371,14,332,10,1294,1793,3087,8,5.333333333,201917
7,7,242,18,262,370,75,182,12,1161,1719,2880,8,5.5,201917
7,8,361,7,192,453,10,308,1,1332,1585,2917,12,5.25,201917
7,9,269,8,259,351,10,335,4,1236,1341,2577,9,5.666666667,201917
7,10,267,5,191,320,11,101,0,895,948,1843,9,5.25,201917
7,11,138,1,97,83,7,72,5,403,693,1096,6,5.333333333,201917
7,12,236,4,262,537,8,137,0,1184,1337,2521,9,5.5,201917
7,13,132,10,111,196,3,81,0,533,681,1214,9,5.25,201917
8,1,187,10,403,205,24,202,2,1033,1314,2347,4,6,201917
8,2,334,21,670,384,24,419,0,1852,2051,3903,16,5.25,201917
8,3,214,21,377,326,21,267,18,1244,1368,2612,4,6,201917
8,4,209,21,412,343,23,406,34,1448,1877,3325,11,6,201917
8,5,165,20,271,253,15,268,0,992,1121,2113,10,5.25,201917
8,6,237,36,416,438,42,525,8,1702,1918,3620,7,6.5,201917
8,7,234,20,240,234,14,423,0,1165,1521,2686,7,5.25,201917
8,8,226,26,396,429,12,406,0,1495,1627,3122,10,6,201917
8,9,163,19,147,93,12,371,1,806,1180,1986,10,5.2,201917
9,1,109,9,144,149,68,229,4,712,854,1566,5,6,201917
9,2,350,73,701,940,105,711,10,2890,3412,6302,12,6,201917
9,3,162,30,426,511,50,392,22,1593,1755,3348,7,6,201917
9,4,228,20,381,512,83,341,9,1574,1975,3549,11,6,201917
9,5,135,12,261,375,55,356,0,1194,1142,2336,7,6,201917
9,6,136,13,250,175,101,276,6,957,702,1659,7,6,201917
9,7,136,11,262,373,5,263,1,1051,732,1783,9,6,201917
9,8,93,17,301,374,15,201,5,1006,1228,2234,5,6,201917
9,9,143,5,228,347,38,200,5,966,970,1936,5,6,201917
9,10,117,17,325,367,23,287,5,1141,1336,2477,6,6,201917
9,11,179,14,395,604,53,411,3,1659,1929,3588,7,6,201917
9,12,170,25,538,682,35,474,25,1949,1993,3942,11,6,201917
9,13,136,13,246,357,77,287,11,1127,1276,2403,4,6,201917
9,14,124,10,190,224,47,279,21,895,966,1861,5,6,201917
9,15,231,35,872,948,43,773,18,2920,2946,5866,9,6.5,201917
9,16,293,45,447,655,65,533,0,2038,2405,4443,15,6,201917
9,17,164,4,239,343,14,265,1,1030,1102,2132,6,6,201917
9,18,198,17,377,556,38,457,6,1649,1856,3505,12,6,201917
9,19,218,38,349,480,90,357,16,1548,1812,3360,5,6,201917
9,20,69,7,120,174,14,119,1,504,437,941,5,6,201917
9,21,146,10,134,273,33,218,2,816,750,1566,3,6,201917
9,22,200,5,270,375,72,266,25,1213,1596,2809,5,6,201917
9,23,162,14,296,538,56,345,0,1411,1540,2951,6,6,201917
9,24,359,25,562,849,78,703,5,2581,3184,5765,12,6,201917
10,1,50,5,41,203,1,5,34,339,212,551,5,6.5,201917
10,2,85,13,129,343,14,24,33,641,225,866,4,6,201917
10,3,29,13,45,139,7,9,39,281,122,403,6,6,201917
10,4,106,25,157,632,7,31,10,968,549,1517,11,6,201917
11,1,233,33,209,273,12,255,1,1016,1054,2070,6,5.666666667,201917
11,2,228,26,252,240,24,266,16,1052,953,2005,7,6,201917
11,3,158,20,204,265,12,335,5,999,667,1666,3,6,201917
11,4,202,35,147,234,19,292,1,930,1339,2269,8,6,201917
11,5,311,49,445,543,16,489,6,1859,1738,3597,7,6,201917
11,6,180,18,230,304,32,297,1,1062,884,1946,8,6,201917
11,7,206,35,291,577,13,216,1,1339,1771,3110,9,5.5,201917
11,8,220,29,272,395,18,344,0,1278,1430,2708,9,5.5,201917
11,9,293,49,280,398,13,360,30,1423,1644,3067,10,5.666666667,201917
11,10,292,57,251,265,22,402,6,1295,1222,2517,10,5.6,201917
11,11,249,49,308,345,20,361,0,1332,1367,2699,5,6,201917
11,12,313,35,453,476,28,372,0,1677,1590,3267,7,6,201917
11,13,270,35,183,227,17,270,16,1018,1117,2135,8,5.5,201917
11,14,190,28,212,219,14,334,0,997,1213,2210,8,5.5,201917
11,15,192,35,210,305,6,268,0,1016,938,1954,9,6,201917
12,1,165,27,211,145,33,180,4,765,1340,2105,10,5.2,201917
12,2,209,27,267,370,12,268,2,1155,1397,2552,10,5.5,201917
12,3,148,14,191,276,12,169,0,810,1107,1917,11,5.2,201917
12,4,179,10,313,661,22,180,1,1366,1409,2775,9,5.666666667,201917
12,5,266,25,183,202,4,205,11,896,1262,2158,10,5.25,201917
12,6,171,33,90,373,36,105,8,816,1660,2476,10,5.25,201917
12,7,231,8,240,328,12,273,16,1108,1306,2414,6,5.5,201917
12,8,142,20,166,271,1,95,0,695,1012,1707,9,5.25,201917
12,9,175,20,266,480,27,138,0,1106,1424,2530,9,5.666666667,201917
13,1,248,26,180,257,37,341,21,1110,1352,2462,9,5.333333333,201917
13,2,165,26,144,191,39,255,2,822,880,1702,6,5.333333333,201917
13,3,186,21,174,205,106,231,0,923,1143,2066,12,5.25,201917
13,4,254,16,288,289,58,222,2,1129,1158,2287,9,5.666666667,201917
13,5,284,20,415,301,83,503,11,1617,1813,3430,9,5.75,201917
13,6,332,63,668,647,48,388,3,2149,2539,4688,11,5.666666667,201917
13,7,201,20,359,445,31,244,0,1300,1318,2618,8,5.5,201917
14,1,144,14,100,86,9,458,0,811,937,1748,6,5.5,201917
14,2,190,11,180,91,16,479,0,967,1192,2159,5,5.666666667,201917
14,3,296,11,228,105,8,646,0,1294,1298,2592,8,5.4,201917
14,4,225,15,355,361,11,355,4,1326,1654,2980,10,6,201917
14,5,161,16,341,269,28,328,0,1143,1720,2863,9,5.5,201917
14,6,209,14,490,280,16,390,1,1400,1547,2947,11,6,201917
14,7,124,6,148,149,0,248,0,675,773,1448,6,6,201917
14,8,361,21,737,690,15,982,3,2809,3130,5939,11,6,201917
14,9,220,10,219,299,33,359,0,1140,1387,2527,9,6,201917
14,10,196,15,358,309,5,390,0,1273,1370,2643,7,6,201917
14,11,131,9,142,160,18,301,14,775,807,1582,4,6,201917
14,12,252,18,406,201,10,318,0,1205,1376,2581,9,5.5,201917
14,13,207,14,303,268,18,427,8,1245,1305,2550,6,6,201917
14,14,165,10,262,252,23,428,3,1143,1164,2307,7,6,201917
14,15,268,22,221,244,23,495,11,1284,1325,2609,10,5.6,201917
14,16,211,11,235,200,14,384,4,1059,1343,2402,5,6,201917
14,17,143,17,164,100,19,310,3,756,1149,1905,7,5.25,201917
14,18,197,17,238,146,20,499,7,1124,1758,2882,9,5.4,201917
14,19,175,24,312,277,25,331,5,1149,1369,2518,8,5.25,201917
14,20,252,12,318,190,9,371,2,1154,1612,2766,10,5.666666667,201917
15,1,203,10,208,82,137,492,0,1132,1587,2719,7,5.333333333,201917
15,2,194,7,246,363,30,255,8,1103,1305,2408,6,6,201917
15,3,305,19,221,310,155,561,21,1592,1288,2880,10,5.666666667,201917
15,4,198,10,272,377,24,379,5,1265,1508,2773,4,6,201917
15,5,222,23,259,323,33,393,2,1255,1822,3077,8,5.666666667,201917
15,6,198,5,295,490,31,294,4,1317,1715,3032,7,6,201917
15,7,197,7,254,366,39,341,0,1204,968,2172,10,6,201917
15,8,124,11,167,279,15,164,5,765,948,1713,4,6,201917
15,9,312,5,170,203,129,351,1,1171,1399,2570,9,5.75,201917
15,10,145,12,261,274,41,273,3,1009,1218,2227,6,6,201917
15,11,208,15,305,432,60,316,2,1338,1475,2813,8,6,201917
15,12,300,14,471,511,49,282,0,1627,1971,3598,8,6,201917
15,13,109,11,178,193,59,259,0,809,874,1683,8,6,201917
15,14,113,12,179,242,7,190,0,743,823,1566,4,6,201917
15,15,185,40,295,439,41,392,5,1397,1717,3114,6,6,201917
15,16,295,29,414,667,26,357,4,1792,1939,3731,8,6,201917
15,17,144,15,188,301,11,296,11,966,1173,2139,8,6,201917
15,18,273,7,264,480,26,378,4,1432,1666,3098,7,5.666666667,201917
15,19,216,32,387,599,28,508,10,1780,2075,3855,10,6,201917
15,20,107,10,201,320,12,241,2,893,534,1427,6,6,201917
15,21,110,7,114,220,21,155,11,638,873,1511,6,5.5,201917
15,22,295,56,484,649,17,534,12,2047,2544,4591,14,6,201917
15,23,248,18,244,357,17,366,0,1250,1469,2719,6,5.333333333,201917
15,24,195,16,286,290,34,237,4,1062,1309,2371,4,6,201917
15,25,202,21,258,293,58,182,11,1025,1351,2376,6,6,201917
15,26,143,7,177,197,30,236,2,792,759,1551,9,6,201917
15,27,230,15,325,484,20,466,47,1587,1818,3405,9,5.666666667,201917
15,28,270,16,456,360,45,381,3,1531,1616,3147,9,5.666666667,201917
15,29,239,27,398,609,9,420,0,1702,2050,3752,8,6,201917
15,30,280,24,380,498,54,258,9,1503,1781,3284,16,6,201917
15,31,131,25,195,276,13,215,0,855,1019,1874,6,6,201917
15,32,178,7,253,461,30,219,3,1151,1288,2439,9,6,201917
15,33,201,11,325,384,19,254,0,1194,2116,3310,7,6,201917
15,34,157,16,202,476,10,305,4,1170,1140,2310,8,6,201917
15,35,327,17,283,423,10,498,0,1558,1495,3053,9,5.666666667,201917
15,36,237,13,225,275,70,254,1,1075,1481,2556,9,5.5,201917
15,37,268,16,337,574,48,440,15,1698,1999,3697,7,6,201917
15,38,186,28,197,365,17,280,7,1080,1235,2315,6,5.5,201917
15,39,180,28,239,355,24,152,0,978,1247,2225,4,6,201917
15,40,344,30,326,479,89,610,1,1879,2097,3976,9,6,201917
15,41,305,25,547,672,52,342,10,1953,1442,3395,14,6.333333333,201917
16,1,148,10,201,160,4,222,2,747,1047,1794,7,5.333333333,201917
16,2,135,15,94,129,3,153,0,529,684,1213,9,5.25,201917
16,3,233,20,193,283,17,229,3,978,987,1965,10,5.25,201917
16,4,220,20,176,152,21,339,0,928,1098,2026,8,5.5,201917
16,5,227,28,220,208,20,364,12,1079,1109,2188,10,5.666666667,201917
16,6,238,20,183,265,29,212,0,947,1030,1977,12,5.5,201917
16,7,219,17,179,230,17,257,0,919,960,1879,9,5.5,201917
16,8,329,21,579,555,9,460,0,1953,1581,3534,12,6,201917
16,9,268,19,237,301,15,397,4,1241,1120,2361,9,6,201917
16,10,186,16,308,279,12,297,0,1098,1052,2150,6,6,201917
16,11,273,22,183,177,56,394,0,1105,1322,2427,10,5.4,201917
16,12,171,20,191,158,9,199,2,750,930,1680,10,5.25,201917
17,1,194,16,400,455,26,411,1,1503,1476,2979,9,7,201917
17,2,204,11,308,327,24,209,3,1086,1189,2275,8,5.666666667,201917
17,3,302,14,397,490,12,321,0,1536,1525,3061,8,5.5,201917
17,4,276,13,370,412,26,377,4,1478,1810,3288,10,5.666666667,201917
17,5,107,6,118,151,13,115,0,510,404,914,5,5.5,201917
18,1,158,16,127,165,20,198,14,698,927,1625,7,5.25,201917
18,2,236,21,388,399,48,339,0,1431,1652,3083,9,6.333333333,201917
18,3,171,9,263,199,8,288,0,938,1060,1998,8,5.5,201917
19,1,188,18,323,338,11,577,2,1457,1330,2787,9,6,201917
19,2,294,16,591,403,16,585,0,1905,1659,3564,9,6,201917
19,3,252,12,591,348,24,525,0,1752,1611,3363,7,6,201917
19,4,109,9,156,164,38,389,20,885,954,1839,5,6,201917
19,5,327,26,473,611,10,718,18,2183,1754,3937,8,6,201917
19,6,83,8,188,247,5,353,1,885,834,1719,5,6,201917
19,7,154,6,421,179,6,198,0,964,1275,2239,10,5.5,201917
19,8,100,4,175,184,3,240,0,706,866,1572,7,6,201917
19,9,188,10,202,191,24,366,1,982,1222,2204,9,5.25,201917
19,10,118,7,215,206,11,402,10,969,1093,2062,6,7,201917
19,11,347,34,530,616,19,1075,18,2639,2551,5190,13,6,201917
19,12,212,10,594,206,13,383,2,1420,1527,2947,8,5.666666667,201917
20,1,217,19,225,216,30,208,21,936,1186,2122,7,5.5,201917
20,2,125,6,75,117,9,125,0,457,872,1329,6,5.333333333,201917
20,3,147,7,152,153,39,130,20,648,784,1432,6,5.333333333,201917
20,4,91,8,60,61,33,142,22,417,520,937,6,5.333333333,201917
20,5,120,10,187,309,25,143,0,794,1079,1873,11,5.25,201917
20,6,209,11,197,309,128,161,0,1015,1215,2230,8,5.25,201917
20,7,194,17,176,277,16,259,1,940,1068,2008,7,5.75,201917
20,8,490,32,475,813,39,626,49,2524,2628,5152,14,6.5,201917
20,9,284,26,223,203,57,344,28,1165,1607,2772,8,5.666666667,201917
20,10,177,13,172,240,9,204,0,815,1216,2031,9,5.25,201917
21,1,0,0,3,176,0,2,0,181,184,365,2,6,201917
21,2,0,0,0,38,0,0,0,38,47,85,1,6,201917
21,3,0,0,0,219,0,0,0,219,183,402,2,6,201917
21,4,0,0,0,63,0,0,0,63,68,131,1,6,201917
21,5,5,0,4,243,1,9,0,262,300,562,2,6,201917
21,6,0,0,0,414,0,0,0,414,306,720,1,6,201917
21,7,0,0,0,201,0,0,0,201,229,430,2,6,201917
21,8,0,0,0,84,0,0,0,84,75,159,1,6,201917
21,9,0,0,0,422,0,0,0,422,437,859,2,6,201917
21,10,0,0,0,268,0,0,0,268,337,605,1,6,201917
21,11,0,0,0,150,0,0,0,150,147,297,1,6,201917
21,12,0,0,0,636,0,0,0,636,805,1441,2,6,201917
21,13,0,0,0,221,0,0,0,221,276,497,2,6,201917
21,14,0,0,0,111,0,0,0,111,127,238,3,6.5,201917
21,15,0,0,0,246,0,0,0,246,171,417,2,7,201917
22,1,179,38,165,298,17,160,6,863,1015,1878,11,5.2,201917
22,2,178,37,295,258,27,251,2,1048,1223,2271,7,5.5,201917
22,3,308,50,756,684,19,444,0,2261,2122,4383,9,5.666666667,201917
22,4,201,31,591,535,31,435,1,1825,1876,3701,9,6.5,201917
22,5,187,19,458,238,54,250,10,1216,1146,2362,10,5.5,201917
23,1,99,4,538,437,9,38,16,1141,452,1593,10,6,201917
23,2,37,4,68,277,2,10,12,410,223,633,4,6,201917
23,3,80,1,254,454,5,10,30,834,588,1422,15,6,201917
23,4,63,7,362,518,28,24,32,1034,565,1599,6,6,201917
24,1,128,46,170,250,18,171,0,783,891,1674,10,5.2,201917
24,2,171,18,193,155,7,251,1,796,1000,1796,6,5.5,201917
24,3,142,25,141,206,40,134,1,689,1011,1700,9,5.25,201917
24,4,178,28,168,212,28,317,25,956,952,1908,5,5.5,201917
24,5,320,59,470,538,15,547,1,1950,2128,4078,10,6.333333333,201917
24,6,273,37,341,415,36,469,0,1571,1354,2925,7,7,201917
24,7,234,29,280,388,17,156,0,1104,1554,2658,9,5.25,201917
25,1,158,13,242,241,10,265,7,936,1201,2137,13,5.75,201917
25,2,221,26,323,359,14,365,0,1308,1826,3134,7,5.5,201917
25,3,194,5,245,311,20,243,9,1027,1248,2275,8,5.6,201917
25,4,166,11,145,259,8,245,0,834,1037,1871,8,5.333333333,201917
25,5,162,5,299,429,23,311,1,1230,1327,2557,8,5.666666667,201917
25,6,162,6,250,272,33,345,4,1072,1533,2605,8,5.75,201917
25,7,228,17,379,458,9,366,0,1457,1704,3161,6,6,201917
26,1,213,8,331,253,3,370,0,1178,1124,2302,9,5.5,201917
26,2,243,13,436,463,9,272,8,1444,1665,3109,12,5.4,201917
26,3,242,24,303,427,12,591,13,1612,1673,3285,14,6.5,201917
26,4,117,12,132,216,7,287,4,775,897,1672,9,5.2,201917
26,5,117,6,163,202,17,313,0,818,837,1655,15,6,201917
26,6,197,8,274,278,6,488,0,1251,1207,2458,10,5.333333333,201917
26,7,144,15,185,249,24,178,0,795,911,1706,10,5.5,201917
27,1,216,7,278,340,69,263,1,1174,1873,3047,8,5.5,201917
27,2,218,21,219,489,17,181,0,1145,1575,2720,8,5.666666667,201917
27,3,217,8,182,380,14,218,0,1019,1133,2152,7,5.666666667,201917
27,4,295,20,453,763,19,402,30,1982,1763,3745,8,6,201917
27,5,164,8,126,315,12,110,0,735,1124,1859,6,5.333333333,201917
27,6,198,6,224,356,8,239,0,1031,1068,2099,7,5.5,201917
28,1,39,10,110,387,3,12,0,561,399,960,13,6,201917
28,2,78,7,140,326,9,17,117,694,375,1069,11,6,201917
28,3,26,6,47,131,1,7,0,218,101,319,3,6,201917
28,4,107,15,194,387,36,27,97,863,346,1209,15,6,201917
28,5,33,15,77,308,7,24,71,535,313,848,4,6,201917
28,6,21,4,21,121,1,10,12,190,101,291,4,6,201917
28,7,66,12,153,408,13,40,80,772,409,1181,13,6,201917
28,8,19,9,66,149,12,12,18,285,183,468,11,4,201917
28,9,74,8,120,193,11,15,27,448,166,614,9,6,201917
29,1,313,16,367,403,50,363,2,1514,1638,3152,7,5.5,201917
29,2,360,17,308,600,33,398,69,1785,1926,3711,11,6,201917
29,3,199,12,171,371,13,256,0,1022,1216,2238,5,5.666666667,201917
30,1,110,11,152,190,8,176,4,651,852,1503,7,5.333333333,201917
30,2,153,10,142,120,18,187,23,653,705,1358,8,5.25,201917
30,3,148,10,226,171,27,276,24,882,1185,2067,6,5.666666667,201917
30,4,145,7,252,240,33,239,0,916,879,1795,8,6,201917
30,5,182,13,199,263,20,302,0,979,1246,2225,7,5.5,201917
30,6,157,14,185,207,30,218,4,815,809,1624,9,5.333333333,201917
30,7,261,14,289,266,32,338,20,1220,1438,2658,11,5.25,201917
30,8,243,16,298,362,61,368,4,1352,1457,2809,11,5.4,201917
30,9,265,5,216,227,49,408,27,1197,1149,2346,8,5.5,201917
30,10,183,12,293,319,37,371,37,1252,1192,2444,6,6,201917
30,11,122,17,299,361,7,260,0,1066,1292,2358,5,5.5,201917
30,12,237,14,507,592,24,493,1,1868,2157,4025,10,6,201917
30,13,226,15,188,284,48,347,48,1156,1547,2703,10,5.4,201917
30,14,155,4,195,166,36,268,7,831,1044,1875,8,5.5,201917
30,15,343,11,236,340,42,544,37,1553,1500,3053,11,5.666666667,201917
30,16,194,3,249,310,37,383,41,1217,1322,2539,10,5.333333333,201917
30,17,217,18,221,281,26,369,8,1140,1566,2706,8,5.5,201917
30,18,195,6,105,170,7,238,11,732,793,1525,8,5.25,201917
30,19,175,5,210,203,6,250,0,849,1163,2012,13,5.6,201917
30,20,205,10,214,375,77,279,0,1160,1374,2534,10,5.4,201917
31,1,256,13,191,39,188,265,0,952,1093,2045,8,5.5,201917
31,2,86,9,120,4,143,160,0,522,770,1292,6,5.333333333,201917
31,3,513,45,991,589,99,847,0,3084,3484,6568,21,6.333333333,201917
31,4,161,12,282,216,79,339,20,1109,929,2038,4,6,201917
31,5,201,8,134,204,55,334,0,936,858,1794,6,5.333333333,201917
32,1,186,29,172,168,23,367,13,958,1166,2124,12,5.2,201917
32,2,247,22,149,111,44,299,18,890,1239,2129,13,5.142857143,201917
32,3,172,38,201,258,2,322,1,994,1259,2253,13,5.4,201917
32,4,248,29,193,261,23,374,15,1143,1422,2565,13,5.4,201917
1,1,43,9,72,148,7,9,5,293,120,413,8,5.333333333,201918
1,2,52,28,154,524,14,44,10,826,496,1322,10,5.333333333,201918
1,3,42,25,153,417,11,20,23,691,431,1122,9,5,201918
2,1,56,17,135,291,6,25,1,531,225,756,11,5,201918
2,2,68,11,181,422,8,37,0,727,275,1002,7,5,201918
2,3,92,13,245,336,3,40,90,819,304,1123,10,5,201918
2,4,42,7,214,146,34,22,23,488,87,575,9,5,201918
2,5,127,16,400,470,82,61,46,1202,329,1531,13,5,201918
2,6,93,3,245,316,9,38,4,708,205,913,7,5,201918
2,7,65,10,181,299,10,23,46,634,240,874,10,5,201918
2,8,97,11,273,462,8,41,40,932,362,1294,8,5,201918
3,1,137,10,228,205,12,250,3,845,1016,1861,11,4.4,201918
3,2,115,15,414,221,19,137,0,921,908,1829,9,4.666666667,201918
4,1,159,13,194,332,26,229,22,975,939,1914,11,4.25,201918
4,2,150,16,265,270,23,164,28,916,1081,1997,14,4.2,201918
5,1,165,13,313,256,17,246,4,1014,1052,2066,9,4.666666667,201918
5,2,119,6,157,219,23,132,0,656,733,1389,10,4.2,201918
5,3,149,22,164,275,19,295,7,931,1189,2120,9,4.333333333,201918
5,4,181,22,432,458,10,405,9,1517,1458,2975,9,4.666666667,201918
5,5,163,12,294,425,19,206,23,1142,1346,2488,9,5,201918
5,6,122,13,219,307,9,169,26,865,868,1733,11,4.5,201918
5,7,157,18,255,273,0,274,4,981,1108,2089,11,5,201918
6,1,149,13,252,220,5,284,12,935,954,1889,11,4.8,201918
6,2,146,10,278,190,31,288,11,954,989,1943,9,4.666666667,201918
7,1,107,4,69,205,3,46,6,440,549,989,9,4.25,201918
7,2,165,5,93,262,18,33,0,576,1473,2049,9,4.25,201918
7,3,212,6,157,262,95,135,1,868,702,1570,7,4.333333333,201918
7,4,123,7,116,265,10,72,7,600,989,1589,11,4.4,201918
7,5,230,9,109,346,18,141,1,854,833,1687,11,4.666666667,201918
7,6,187,7,236,298,16,213,10,967,1071,2038,8,4.333333333,201918
7,7,226,13,220,356,25,163,17,1020,790,1810,8,4.5,201918
7,8,203,7,154,314,9,202,2,891,794,1685,12,4.25,201918
7,9,137,10,238,303,12,212,3,915,815,1730,9,4.666666667,201918
7,10,178,12,180,285,18,90,0,763,736,1499,9,4.5,201918
7,11,161,5,67,87,4,60,11,395,218,613,6,4.333333333,201918
7,12,173,7,203,493,5,127,0,1008,1068,2076,9,4.5,201918
7,13,72,7,67,217,1,64,0,428,368,796,9,4.25,201918
8,1,122,8,335,167,25,177,3,837,731,1568,4,5,201918
8,2,222,23,494,341,16,318,0,1414,1648,3062,16,4.5,201918
8,3,123,12,355,293,19,238,16,1056,899,1955,4,5,201918
8,4,139,15,353,242,23,262,30,1064,1210,2274,11,5,201918
8,5,144,14,187,229,15,211,0,800,866,1666,10,4.25,201918
8,6,154,13,354,393,31,410,3,1358,1317,2675,7,5.5,201918
8,7,141,20,160,168,5,233,0,727,742,1469,7,4.25,201918
8,8,160,13,339,314,11,299,0,1136,1070,2206,10,5,201918
8,9,142,11,112,116,13,261,1,656,1079,1735,10,4.2,201918
9,1,72,8,129,104,38,137,6,494,468,962,5,5,201918
9,2,232,65,545,773,62,543,10,2230,2232,4462,12,5,201918
9,3,111,25,319,418,43,283,11,1210,1259,2469,7,5,201918
9,4,146,16,288,452,66,241,11,1220,1161,2381,11,5,201918
9,5,82,9,192,298,34,238,0,853,964,1817,7,5,201918
9,6,66,10,169,164,90,153,6,658,892,1550,7,5,201918
9,7,81,8,200,279,0,218,0,786,1011,1797,9,5,201918
9,8,69,9,265,279,14,161,5,802,837,1639,5,5,201918
9,9,79,9,188,247,29,150,1,703,605,1308,5,5,201918
9,10,74,18,288,286,21,223,0,910,903,1813,6,5,201918
9,11,103,12,307,460,25,278,2,1187,1247,2434,7,5,201918
9,12,101,26,466,550,32,335,18,1528,1700,3228,11,5,201918
9,13,95,8,206,249,66,183,12,819,849,1668,4,5,201918
9,14,92,3,175,218,36,198,17,739,743,1482,5,5,201918
9,15,156,13,731,741,23,496,6,2166,2598,4764,9,5.5,201918
9,16,163,59,358,530,67,357,1,1535,1938,3473,15,5,201918
9,17,79,8,195,266,13,189,0,750,712,1462,6,5,201918
9,18,130,25,298,493,28,279,1,1254,1313,2567,12,5,201918
9,19,147,31,218,384,58,241,4,1083,1130,2213,5,5,201918
9,20,39,6,92,115,13,71,0,336,409,745,5,5,201918
9,21,73,14,123,233,26,144,5,618,753,1371,3,5,201918
9,22,127,9,244,311,48,182,20,941,829,1770,5,5,201918
9,23,98,10,212,418,36,253,0,1027,1022,2049,6,5,201918
9,24,200,24,463,661,59,458,2,1867,2178,4045,12,5,201918
10,1,29,5,34,180,2,9,29,288,182,470,5,5.5,201918
10,2,74,14,106,230,12,11,31,478,265,743,4,5,201918
10,3,45,6,42,106,4,7,32,242,85,327,6,5,201918
10,4,62,16,111,506,8,15,5,723,461,1184,11,5,201918
11,1,184,22,166,217,15,169,1,774,700,1474,6,4.666666667,201918
11,2,182,19,196,185,21,170,10,783,738,1521,7,5,201918
11,3,132,16,170,223,11,223,3,778,955,1733,3,5,201918
11,4,163,17,161,211,10,205,1,768,1036,1804,8,5,201918
11,5,243,44,360,466,19,359,1,1492,1678,3170,7,5,201918
11,6,115,12,177,212,23,197,3,739,893,1632,8,5,201918
11,7,190,33,242,454,24,147,0,1090,1002,2092,9,4.5,201918
11,8,138,25,189,278,18,196,0,844,903,1747,9,4.25,201918
11,9,194,50,238,330,8,265,17,1102,1164,2266,10,4.666666667,201918
11,10,203,24,221,217,17,303,5,990,1002,1992,10,4.6,201918
11,11,136,29,288,243,20,257,0,973,1154,2127,5,5,201918
11,12,175,22,334,355,13,234,0,1133,1251,2384,7,5,201918
11,13,143,26,133,151,10,235,2,700,856,1556,8,4.5,201918
11,14,143,22,175,166,9,247,0,762,600,1362,8,4.5,201918
11,15,120,15,175,221,13,161,0,705,847,1552,9,5,201918
12,1,132,14,184,119,59,169,2,679,574,1253,10,4.2,201918
12,2,188,32,174,288,9,210,1,902,936,1838,10,4.5,201918
12,3,141,13,187,301,11,132,1,786,1218,2004,11,4.2,201918
12,4,115,30,283,637,19,162,0,1246,1039,2285,9,4.666666667,201918
12,5,204,24,168,199,7,155,6,763,774,1537,10,4.25,201918
12,6,106,16,81,442,23,56,7,731,834,1565,10,4.25,201918
12,7,184,15,198,299,6,196,17,915,866,1781,6,4.5,201918
12,8,141,17,148,226,1,80,0,613,769,1382,9,4.25,201918
12,9,132,16,229,415,25,118,0,935,878,1813,9,4.666666667,201918
13,1,152,14,160,183,38,307,76,930,1072,2002,9,4.333333333,201918
13,2,101,16,100,119,32,192,8,568,584,1152,6,4.333333333,201918
13,3,102,12,129,196,64,163,0,666,763,1429,12,4.25,201918
13,4,161,16,235,242,58,204,33,949,1019,1968,9,4.666666667,201918
13,5,188,20,313,285,66,363,9,1244,1211,2455,9,4.75,201918
13,6,216,54,522,568,41,299,8,1708,1627,3335,11,4.666666667,201918
13,7,105,21,280,319,24,151,0,900,935,1835,8,4.5,201918
14,1,133,17,74,68,12,379,0,683,690,1373,6,4.5,201918
14,2,188,11,131,85,10,366,1,792,968,1760,5,4.666666667,201918
14,3,189,8,163,95,6,444,0,905,1243,2148,8,4.4,201918
14,4,162,16,253,322,9,323,5,1090,1261,2351,10,5,201918
14,5,152,11,401,186,28,233,0,1011,934,1945,9,4.5,201918
14,6,199,11,444,252,8,301,1,1216,1099,2315,11,5,201918
14,7,117,3,151,125,0,171,0,567,553,1120,6,5,201918
14,8,227,28,535,605,12,776,0,2183,2337,4520,10,5,201918
14,9,145,6,205,263,28,296,0,943,856,1799,9,5,201918
14,10,145,9,301,248,7,340,0,1050,1030,2080,7,5,201918
14,11,90,5,123,141,24,220,13,616,708,1324,4,5,201918
14,12,203,11,349,185,4,246,0,998,1196,2194,9,4.5,201918
14,13,167,13,265,189,7,329,3,973,1027,2000,6,5,201918
14,14,125,10,237,236,18,394,2,1022,1178,2200,7,5,201918
14,15,179,20,180,178,16,388,2,963,1022,1985,10,4.6,201918
14,16,125,10,214,137,21,293,2,802,814,1616,5,5,201918
14,17,124,7,132,91,15,271,2,642,877,1519,7,4.25,201918
14,18,206,14,203,115,10,370,4,922,1354,2276,9,4.4,201918
14,19,129,27,256,196,11,299,8,926,1237,2163,8,4.25,201918
14,20,181,11,215,183,5,275,0,870,1102,1972,10,4.666666667,201918
15,1,156,9,129,94,94,314,0,796,1142,1938,7,4.333333333,201918
15,2,139,11,216,309,32,183,3,893,822,1715,6,5,201918
15,3,207,18,175,264,102,340,14,1120,1506,2626,10,4.666666667,201918
15,4,116,4,179,238,18,235,3,793,752,1545,4,5,201918
15,5,116,19,164,217,20,224,1,761,1293,2054,8,4.666666667,201918
15,6,113,3,231,400,23,203,2,975,817,1792,7,5,201918
15,7,114,9,221,295,28,213,2,882,1226,2108,10,5,201918
15,8,84,9,127,197,16,128,9,570,547,1117,4,5,201918
15,9,226,3,115,165,107,214,1,831,965,1796,9,4.75,201918
15,10,90,5,194,224,39,156,0,708,791,1499,6,5,201918
15,11,126,12,255,396,62,208,2,1061,1049,2110,8,5,201918
15,12,156,24,395,481,38,206,1,1301,1181,2482,8,5,201918
15,13,75,11,132,178,47,184,0,627,689,1316,8,5,201918
15,14,66,10,114,164,7,131,0,492,504,996,4,4,201918
15,15,111,43,203,346,21,280,2,1006,967,1973,6,5,201918
15,16,171,30,311,532,15,241,2,1302,1353,2655,8,5,201918
15,17,109,19,189,271,8,189,13,798,788,1586,8,5,201918
15,18,150,12,212,352,20,269,4,1019,1126,2145,7,4.666666667,201918
15,19,150,26,314,492,17,335,1,1335,1392,2727,10,5,201918
15,20,61,6,164,238,8,139,0,616,644,1260,6,5,201918
15,21,65,6,83,182,18,118,5,477,535,1012,6,4.5,201918
15,22,193,35,439,633,20,427,8,1755,1294,3049,14,5,201918
15,23,137,17,162,252,8,209,0,785,1051,1836,6,4.333333333,201918
15,24,85,19,222,227,24,163,7,747,868,1615,4,5,201918
15,25,133,21,219,243,57,152,7,832,868,1700,6,5,201918
15,26,95,1,172,214,32,195,0,709,832,1541,9,6,201918
15,27,164,14,273,421,13,335,19,1239,1192,2431,9,4.666666667,201918
15,28,178,19,336,267,33,274,1,1108,1314,2422,9,4.666666667,201918
15,29,162,22,330,481,2,317,0,1314,1265,2579,8,5,201918
15,30,149,24,337,374,30,186,6,1106,1077,2183,16,5,201918
15,31,102,41,160,219,11,156,0,689,602,1291,6,5,201918
15,32,93,13,188,354,18,143,4,813,930,1743,9,5,201918
15,33,141,13,317,264,34,201,0,970,1428,2398,7,5,201918
15,34,105,14,156,338,8,180,6,807,869,1676,8,5,201918
15,35,183,17,205,307,7,322,0,1041,1084,2125,9,4.666666667,201918
15,36,161,17,212,235,32,224,0,881,1107,1988,9,4.5,201918
15,37,156,24,261,446,33,272,13,1205,1198,2403,7,5,201918
15,38,123,16,205,281,5,180,3,813,995,1808,6,4.5,201918
15,39,96,18,220,293,26,132,0,785,801,1586,4,5,201918
15,40,218,13,263,368,43,430,1,1336,1255,2591,9,5,201918
15,41,204,16,361,520,33,244,9,1387,1807,3194,14,5.333333333,201918
16,1,149,13,157,138,9,194,1,661,675,1336,7,4.333333333,201918
16,2,104,17,63,127,5,152,0,468,413,881,9,4.25,201918
16,3,148,19,127,179,16,172,0,661,673,1334,10,4.25,201918
16,4,168,6,165,104,12,289,0,744,966,1710,8,4.5,201918
16,5,160,20,202,161,13,249,3,808,875,1683,10,4.666666667,201918
16,6,117,21,126,167,22,149,0,602,688,1290,12,4.5,201918
16,7,175,20,116,130,14,167,0,622,915,1537,9,4.5,201918
16,8,174,21,453,405,12,323,0,1388,1704,3092,12,5,201918
16,9,176,17,205,235,5,268,0,906,1071,1977,9,5,201918
16,10,105,15,243,278,13,201,0,855,1045,1900,6,5,201918
16,11,222,15,189,118,52,331,0,927,911,1838,10,4.4,201918
16,12,142,9,137,117,11,157,3,576,537,1113,10,4.25,201918
17,1,119,19,270,350,10,300,0,1068,1359,2427,9,6,201918
17,2,133,4,311,288,13,161,6,916,942,1858,8,4.666666667,201918
17,3,203,14,292,376,7,249,1,1142,1297,2439,8,4.5,201918
17,4,166,8,272,302,21,245,1,1015,1318,2333,10,4.666666667,201918
17,5,71,10,98,156,5,96,0,436,545,981,5,4.5,201918
18,1,85,19,98,118,15,125,6,466,607,1073,7,4.25,201918
18,2,198,16,291,306,40,248,0,1099,1123,2222,9,5.333333333,201918
18,3,140,9,274,188,7,210,0,828,876,1704,8,4.5,201918
19,1,136,11,259,260,7,410,1,1084,1223,2307,9,5,201918
19,2,240,14,542,331,10,432,0,1569,1896,3465,9,5,201918
19,3,208,13,476,252,18,397,1,1365,1520,2885,7,5,201918
19,4,71,14,151,123,21,290,21,691,747,1438,5,5,201918
19,5,218,16,447,526,16,541,12,1776,2075,3851,8,5,201918
19,6,51,10,140,136,6,208,1,552,587,1139,5,5,201918
19,7,157,3,373,166,2,175,0,876,828,1704,10,4.5,201918
19,8,75,8,126,160,1,173,0,543,495,1038,7,5,201918
19,9,185,9,180,171,13,267,0,825,655,1480,9,4.25,201918
19,10,97,8,204,183,4,332,6,834,718,1552,6,6,201918
19,11,254,44,439,464,28,833,17,2079,2469,4548,13,5,201918
19,12,161,9,446,198,13,262,0,1089,1253,2342,8,4.666666667,201918
20,1,170,16,190,190,60,160,36,822,712,1534,7,4.5,201918
20,2,97,6,87,149,9,104,0,452,517,969,6,4.333333333,201918
20,3,97,11,109,99,44,87,16,463,718,1181,6,4.333333333,201918
20,4,68,11,52,61,18,106,20,336,381,717,6,4.333333333,201918
20,5,89,8,124,190,15,101,0,527,690,1217,11,4.25,201918
20,6,113,13,112,205,145,46,0,634,621,1255,8,4.25,201918
20,7,130,12,154,310,19,195,1,821,884,1705,7,4.75,201918
20,8,328,29,358,779,23,437,46,2000,2002,4002,13,5,201918
20,9,221,8,165,179,51,249,18,891,1168,2059,8,4.666666667,201918
20,10,117,10,161,237,20,144,0,689,786,1475,9,4.25,201918
21,1,1,0,2,120,0,1,0,124,138,262,2,5,201918
21,2,0,0,0,29,0,0,0,29,41,70,1,5,201918
21,3,0,0,0,125,0,0,0,125,146,271,2,5,201918
21,4,0,0,0,41,0,0,0,41,44,85,1,5,201918
21,5,0,1,2,220,0,4,0,227,278,505,2,5,201918
21,6,0,0,0,275,0,0,0,275,321,596,1,4,201918
21,7,0,0,0,145,0,0,0,145,157,302,2,5,201918
21,8,0,0,0,73,0,0,0,73,90,163,1,5,201918
21,9,0,0,0,306,0,0,0,306,321,627,2,5,201918
21,10,0,0,0,216,0,0,0,216,263,479,1,4,201918
21,11,0,0,0,115,0,0,0,115,157,272,1,5,201918
21,12,0,0,0,479,0,0,0,479,509,988,2,4.5,201918
21,13,0,0,0,175,0,0,0,175,255,430,2,5,201918
21,14,1,0,1,96,0,0,0,98,91,189,2,5,201918
21,15,0,0,0,176,0,0,0,176,246,422,2,6,201918
22,1,183,28,207,279,44,108,7,856,908,1764,11,4.2,201918
22,2,119,15,230,202,37,133,3,739,779,1518,7,4.5,201918
22,3,222,37,576,470,13,301,0,1619,1526,3145,9,4.666666667,201918
22,4,161,28,453,365,29,261,2,1299,1269,2568,9,5.5,201918
22,5,111,16,354,184,50,183,5,903,916,1819,10,4.5,201918
23,1,59,4,475,318,4,29,8,897,321,1218,10,5,201918
23,2,23,4,67,216,1,7,7,325,171,496,4,5,201918
23,3,48,1,190,379,2,10,28,658,419,1077,15,5,201918
23,4,41,2,275,346,17,28,12,721,382,1103,6,5,201918
24,1,95,33,92,184,25,122,4,555,451,1006,10,4.2,201918
24,2,106,14,189,127,8,155,0,599,667,1266,6,4.5,201918
24,3,146,26,125,189,47,106,0,639,669,1308,9,4.25,201918
24,4,118,13,149,166,30,235,16,727,764,1491,5,4.5,201918
24,5,214,28,359,449,11,345,0,1406,1409,2815,10,5.333333333,201918
24,6,161,31,306,327,17,341,0,1183,1476,2659,6,5,201918
24,7,180,18,198,329,21,146,0,892,977,1869,9,4.25,201918
25,1,119,6,194,211,8,231,6,775,1024,1799,13,4.75,201918
25,2,203,17,288,342,16,307,0,1173,1436,2609,7,4.5,201918
25,3,145,10,194,287,22,172,11,841,724,1565,8,4.6,201918
25,4,101,10,129,210,6,150,0,606,752,1358,8,4.333333333,201918
25,5,130,8,214,294,18,232,0,896,922,1818,8,4.666666667,201918
25,6,157,10,199,244,31,276,2,919,894,1813,8,4.75,201918
25,7,235,11,306,433,12,322,1,1320,1138,2458,6,5,201918
26,1,153,4,249,208,4,284,0,902,1099,2001,9,4.5,201918
26,2,197,6,381,376,6,233,5,1204,1070,2274,12,4.4,201918
26,3,193,15,239,359,11,411,5,1233,1403,2636,14,5.5,201918
26,4,117,16,131,184,13,258,5,724,697,1421,9,4.2,201918
26,5,96,5,116,182,7,213,0,619,850,1469,15,5,201918
26,6,149,6,254,237,3,344,0,993,1256,2249,10,4.333333333,201918
26,7,131,6,145,209,25,134,0,650,567,1217,10,4.5,201918
27,1,158,6,213,297,49,218,0,941,795,1736,8,4.5,201918
27,2,161,14,230,354,30,161,0,950,825,1775,8,4.666666667,201918
27,3,152,6,151,338,6,140,1,794,930,1724,7,4.666666667,201918
27,4,185,3,323,607,10,285,14,1427,1872,3299,8,5,201918
27,5,115,4,143,252,3,104,0,621,488,1109,6,4.333333333,201918
27,6,136,19,209,321,6,199,0,890,1326,2216,7,4.5,201918
28,1,26,7,86,296,0,13,0,428,218,646,13,5,201918
28,2,55,5,105,258,6,26,84,539,224,763,11,5,201918
28,3,22,1,27,85,3,7,0,145,70,215,3,5,201918
28,4,84,10,169,337,21,32,81,734,274,1008,15,5,201918
28,5,44,8,53,232,6,9,36,388,226,614,4,5,201918
28,6,17,4,25,90,2,5,3,146,66,212,4,5,201918
28,7,56,9,208,372,19,29,32,725,341,1066,13,5,201918
28,8,35,16,96,219,15,25,29,435,180,615,12,7,201918
28,9,42,2,88,142,13,18,21,326,128,454,9,5,201918
29,1,201,22,256,366,48,253,2,1148,1080,2228,7,4.5,201918
29,2,185,14,222,424,22,249,32,1148,1249,2397,11,5,201918
29,3,123,19,118,287,14,180,0,741,696,1437,5,4.666666667,201918
30,1,104,12,140,106,12,133,2,509,712,1221,7,4.333333333,201918
30,2,101,3,109,78,33,106,19,449,582,1031,8,3.5,201918
30,3,118,13,164,148,40,268,22,773,754,1527,6,4.666666667,201918
30,4,86,8,207,172,31,133,0,637,729,1366,8,5,201918
30,5,106,8,183,197,10,261,0,765,795,1560,7,4.5,201918
30,6,143,8,170,182,28,167,4,702,732,1434,9,4.333333333,201918
30,7,150,16,208,180,20,281,17,872,1026,1898,11,4.25,201918
30,8,160,22,209,319,47,324,10,1091,1106,2197,11,4.4,201918
30,9,177,11,182,165,34,247,12,828,961,1789,8,4.5,201918
30,10,96,4,197,228,17,182,14,738,904,1642,6,5,201918
30,11,111,9,221,290,10,222,0,863,1124,1987,5,4.5,201918
30,12,163,4,359,430,17,352,2,1327,1445,2772,10,5,201918
30,13,161,16,130,251,30,252,40,880,912,1792,10,4.4,201918
30,14,127,6,203,132,31,264,3,766,872,1638,8,4.5,201918
30,15,187,10,186,234,29,400,23,1069,1347,2416,11,4.666666667,201918
30,16,113,4,176,243,32,264,36,868,1206,2074,10,4.333333333,201918
30,17,174,19,185,282,63,252,8,983,774,1757,8,4.5,201918
30,18,133,10,79,155,9,147,5,538,671,1209,8,4.25,201918
30,19,124,2,233,163,19,213,0,754,714,1468,13,4.6,201918
30,20,120,11,180,255,67,151,1,785,916,1701,10,4.4,201918
31,1,123,11,126,39,180,156,0,635,722,1357,8,4.5,201918
31,2,56,4,94,5,89,95,0,343,391,734,6,4.333333333,201918
31,3,345,44,694,408,81,467,0,2039,2397,4436,20,4.666666667,201918
31,4,85,15,211,173,63,193,13,753,893,1646,4,5,201918
31,5,100,3,100,117,42,211,0,573,638,1211,6,4.333333333,201918
32,1,139,31,165,121,23,238,16,733,811,1544,12,4.2,201918
32,2,165,20,107,82,38,247,12,671,709,1380,13,4.142857143,201918
32,3,114,37,148,222,5,230,6,762,1022,1784,13,4.4,201918
32,4,144,19,143,193,19,268,10,796,1242,2038,13,4.4,201918
1,1,39,7,62,170,11,9,4,302,223,525,9,6.666666667,201919
1,2,59,18,183,546,14,33,16,869,613,1482,10,6.333333333,201919
1,3,39,26,174,472,9,29,15,764,477,1241,9,6,201919
2,1,55,8,142,322,5,26,2,560,308,868,11,6,201919
2,2,59,17,206,424,6,55,0,767,354,1121,7,6,201919
2,3,113,8,292,358,4,34,102,911,370,1281,10,6,201919
2,4,65,8,243,192,35,16,31,590,136,726,9,6,201919
2,5,160,16,387,483,95,66,42,1249,517,1766,13,6,201919
2,6,93,6,240,355,14,45,11,764,269,1033,7,6,201919
2,7,97,8,182,329,14,27,55,712,351,1063,10,6,201919
2,8,101,4,240,498,10,26,34,913,497,1410,8,6,201919
3,1,209,14,303,359,13,363,3,1264,927,2191,12,5.666666667,201919
3,2,170,5,516,239,20,171,0,1121,998,2119,9,5.666666667,201919
4,1,178,17,206,368,56,245,32,1102,1258,2360,11,5.25,201919
4,2,181,10,394,312,37,193,6,1133,1058,2191,14,5.2,201919
5,1,204,17,402,320,22,284,8,1257,1294,2551,9,5.666666667,201919
5,2,142,14,232,265,17,190,0,860,761,1621,10,5.2,201919
5,3,157,8,238,372,19,335,11,1140,1301,2441,9,5.333333333,201919
5,4,209,11,494,502,9,436,11,1672,1674,3346,9,5.666666667,201919
5,5,176,11,349,510,23,211,21,1301,1254,2555,9,6,201919
5,6,133,8,258,322,9,152,31,913,854,1767,11,5.5,201919
5,7,175,14,298,309,2,283,2,1083,1113,2196,10,5.5,201919
6,1,129,10,279,225,10,261,13,927,1020,1947,12,6,201919
6,2,171,15,347,211,34,322,6,1106,838,1944,9,5.666666667,201919
7,1,259,6,160,244,23,80,18,790,588,1378,9,5.25,201919
7,2,234,7,166,701,27,114,0,1249,589,1838,9,5.25,201919
7,3,217,7,226,268,130,133,2,983,761,1744,7,5.333333333,201919
7,4,102,10,93,294,4,75,28,606,602,1208,11,5.4,201919
7,5,242,5,207,432,8,111,0,1005,795,1800,11,5.666666667,201919
7,6,296,8,280,440,10,250,11,1295,1066,2361,9,5.666666667,201919
7,7,249,16,232,379,10,148,8,1042,1051,2093,8,5.5,201919
7,8,259,5,130,513,17,164,4,1092,958,2050,12,5.25,201919
7,9,193,18,264,359,16,270,0,1120,1202,2322,9,5.666666667,201919
7,10,215,12,188,684,8,96,0,1203,503,1706,9,5.5,201919
7,11,125,2,39,72,5,41,18,302,262,564,6,5.333333333,201919
7,12,193,3,214,450,5,113,0,978,1058,2036,9,5.5,201919
7,13,83,7,62,255,3,40,0,450,430,880,9,5.25,201919
8,1,133,5,383,197,29,165,2,914,874,1788,4,6,201919
8,2,262,27,570,381,17,349,1,1607,1580,3187,16,5.5,201919
8,3,166,14,352,324,24,241,26,1147,1082,2229,4,6,201919
8,4,197,19,372,303,22,336,20,1269,1221,2490,11,6,201919
8,5,180,23,191,201,23,195,0,813,1009,1822,10,5.25,201919
8,6,234,24,360,417,29,410,6,1480,1399,2879,7,6.5,201919
8,7,196,49,168,188,7,291,0,899,1055,1954,7,5.25,201919
8,8,197,30,386,334,8,291,0,1246,1250,2496,10,6,201919
8,9,145,11,100,130,7,350,1,744,1107,1851,10,5.2,201919
9,1,82,10,149,142,66,182,3,634,600,1234,5,6,201919
9,2,285,64,637,879,84,546,11,2506,2534,5040,12,6,201919
9,3,128,22,330,437,53,320,11,1301,1305,2606,7,6,201919
9,4,181,17,391,544,66,210,2,1411,1324,2735,11,6,201919
9,5,130,9,271,319,29,248,0,1006,974,1980,7,6,201919
9,6,67,17,170,185,92,184,7,722,913,1635,7,6,201919
9,7,103,9,249,339,0,218,0,918,1030,1948,9,6,201919
9,8,80,17,283,337,12,198,8,935,861,1796,5,6,201919
9,9,100,6,219,271,37,134,10,777,804,1581,5,6,201919
9,10,118,14,324,372,20,238,4,1090,914,2004,6,6,201919
9,11,127,17,407,501,35,312,6,1405,1400,2805,7,6,201919
9,12,161,23,587,685,30,343,17,1846,1646,3492,11,6,201919
9,13,138,6,257,323,61,228,11,1024,1024,2048,4,6,201919
9,14,111,7,207,214,30,207,8,784,761,1545,5,6,201919
9,15,228,22,789,919,31,591,15,2595,2583,5178,9,6.5,201919
9,16,229,32,416,636,62,390,3,1768,1525,3293,15,6,201919
9,17,117,5,221,284,11,177,0,815,842,1657,6,6,201919
9,18,168,11,323,535,26,296,1,1360,1381,2741,12,6,201919
9,19,166,41,273,470,57,265,12,1284,1257,2541,5,6,201919
9,20,57,7,105,133,9,75,1,387,447,834,5,6,201919
9,21,96,6,161,259,18,142,7,689,765,1454,3,6,201919
9,22,123,11,252,312,52,197,15,962,1062,2024,5,6,201919
9,23,113,13,270,480,46,249,0,1171,1213,2384,6,6,201919
9,24,317,10,559,810,85,562,7,2350,1930,4280,12,6,201919
10,1,50,6,34,174,1,9,25,299,172,471,5,6.5,201919
10,2,70,11,122,301,10,21,32,567,225,792,4,6,201919
10,3,24,6,34,108,0,7,45,224,116,340,6,6,201919
10,4,97,11,161,502,3,26,5,805,452,1257,12,6.5,201919
11,1,197,31,172,249,21,154,0,824,825,1649,6,5.666666667,201919
11,2,176,18,240,218,13,219,19,903,1016,1919,7,6,201919
11,3,154,20,190,252,9,232,5,862,989,1851,3,6,201919
11,4,163,31,143,193,16,231,0,777,937,1714,8,6,201919
11,5,262,37,361,484,11,408,2,1565,1620,3185,7,6,201919
11,6,126,16,204,235,23,206,3,813,920,1733,8,6,201919
11,7,204,50,230,380,12,160,3,1039,1065,2104,9,5.5,201919
11,8,164,16,228,324,23,256,0,1011,1091,2102,9,5.5,201919
11,9,216,67,317,360,15,335,12,1322,1224,2546,10,5.666666667,201919
11,10,226,24,232,246,18,358,13,1117,1051,2168,10,5.6,201919
11,11,174,23,298,336,14,243,0,1088,1113,2201,5,6,201919
11,12,211,30,333,421,15,287,0,1297,1301,2598,7,6,201919
11,13,175,26,176,202,12,212,7,810,909,1719,8,5.5,201919
11,14,168,33,229,207,25,306,0,968,966,1934,8,5.5,201919
11,15,146,26,197,241,4,164,0,778,840,1618,9,6,201919
12,1,112,21,152,113,13,156,7,574,695,1269,10,5.2,201919
12,2,191,31,201,349,17,196,7,992,1057,2049,10,5.5,201919
12,3,179,18,372,369,10,154,0,1102,951,2053,11,5.2,201919
12,4,117,25,242,506,29,155,0,1074,1106,2180,9,5.666666667,201919
12,5,212,19,179,246,7,203,5,871,601,1472,10,5.25,201919
12,6,158,20,115,476,9,80,11,869,603,1472,10,5.25,201919
12,7,205,23,212,331,12,218,63,1064,935,1999,6,5.5,201919
12,8,166,11,142,238,0,108,0,665,994,1659,9,5,201919
12,9,152,15,279,434,17,132,0,1029,1037,2066,9,5.666666667,201919
13,1,141,13,112,184,32,239,21,742,957,1699,9,5.333333333,201919
13,2,109,16,97,164,24,168,4,582,764,1346,6,5.333333333,201919
13,3,122,17,133,197,71,177,0,717,859,1576,12,5.25,201919
13,4,167,10,245,238,55,176,16,907,1138,2045,9,5.666666667,201919
13,5,220,15,311,322,67,349,2,1286,1336,2622,9,5.75,201919
13,6,229,43,564,606,32,309,10,1793,1940,3733,11,5.666666667,201919
13,7,104,9,265,311,14,158,0,861,1020,1881,8,5.5,201919
14,1,154,21,111,87,10,439,0,822,877,1699,6,5.5,201919
14,2,207,16,164,113,9,477,1,987,849,1836,5,5.666666667,201919
14,3,297,11,218,109,1,553,0,1189,1372,2561,8,5.4,201919
14,4,182,14,295,356,9,332,5,1193,1101,2294,10,6,201919
14,5,149,9,340,214,25,220,1,958,926,1884,9,5.5,201919
14,6,207,8,487,295,25,299,1,1322,1269,2591,11,6,201919
14,7,122,11,161,172,0,190,0,656,601,1257,6,6,201919
14,8,317,38,745,810,19,909,5,2843,2465,5308,11,6.25,201919
14,9,172,14,207,275,24,315,3,1010,977,1987,9,6,201919
14,10,209,18,385,322,11,455,3,1403,1093,2496,7,6,201919
14,11,119,11,161,176,14,265,7,753,687,1440,4,6,201919
14,12,226,9,464,169,11,277,0,1156,1254,2410,9,5.5,201919
14,13,198,9,308,261,12,390,3,1181,1101,2282,6,6,201919
14,14,175,16,268,250,15,430,6,1160,1194,2354,7,6,201919
14,15,252,21,165,173,16,324,6,957,1236,2193,10,5.6,201919
14,16,173,16,243,168,26,340,1,967,885,1852,5,6,201919
14,17,164,13,229,103,17,314,3,843,711,1554,7,5.25,201919
14,18,262,25,268,144,31,431,11,1172,1465,2637,9,5.4,201919
14,19,217,37,299,271,16,349,20,1209,1390,2599,8,5.25,201919
14,20,147,7,256,185,11,321,4,931,1273,2204,10,5.666666667,201919
15,1,180,14,154,107,119,341,0,915,1144,2059,7,5.333333333,201919
15,2,145,7,218,357,26,177,3,933,949,1882,6,6,201919
15,3,280,17,192,286,160,411,15,1361,1417,2778,10,5.666666667,201919
15,4,201,8,210,316,32,346,3,1116,1213,2329,4,6,201919
15,5,188,16,217,273,16,250,0,960,1133,2093,8,5.666666667,201919
15,6,149,21,253,477,42,262,7,1211,1260,2471,7,6,201919
15,7,136,9,232,329,30,243,0,979,1088,2067,10,6,201919
15,8,82,5,137,221,18,131,4,598,608,1206,4,6,201919
15,9,222,7,108,187,103,228,5,860,919,1779,9,5.75,201919
15,10,110,11,216,246,30,215,1,829,854,1683,6,6,201919
15,11,168,12,237,430,45,228,3,1123,1167,2290,8,6,201919
15,12,229,14,444,476,45,239,1,1448,1369,2817,8,6,201919
15,13,94,9,159,179,63,178,0,682,700,1382,8,6,201919
15,14,88,11,152,234,12,140,0,637,698,1335,4,6,201919
15,15,155,27,290,365,24,274,1,1136,1167,2303,6,6,201919
15,16,184,27,294,559,15,251,8,1338,1520,2858,8,6,201919
15,17,122,15,205,269,16,224,14,865,860,1725,8,6,201919
15,18,206,11,232,408,30,286,2,1175,1169,2344,7,5.666666667,201919
15,19,167,34,340,539,8,363,6,1457,1459,2916,10,6,201919
15,20,91,8,201,259,9,164,0,732,859,1591,6,6,201919
15,21,92,7,91,182,11,130,10,523,586,1109,6,5.5,201919
15,22,264,37,492,725,23,497,16,2054,2103,4157,14,6,201919
15,23,149,14,176,265,22,225,1,852,951,1803,6,5.333333333,201919
15,24,129,17,225,277,23,140,2,813,708,1521,4,6,201919
15,25,158,16,203,292,52,141,10,872,730,1602,6,6,201919
15,26,121,4,200,225,25,205,1,781,788,1569,9,7,201919
15,27,219,13,293,455,12,322,18,1332,1512,2844,9,5.666666667,201919
15,28,222,14,484,322,37,313,2,1394,1191,2585,9,5.666666667,201919
15,29,155,20,284,517,11,277,0,1264,1386,2650,8,6,201919
15,30,203,11,339,463,41,208,9,1274,1340,2614,16,6,201919
15,31,105,35,176,255,13,185,0,769,729,1498,6,6,201919
15,32,140,9,239,377,18,173,3,959,904,1863,9,6,201919
15,33,162,11,292,366,26,208,0,1065,1172,2237,7,6,201919
15,34,139,10,166,391,13,229,7,955,1005,1960,8,6,201919
15,35,244,13,211,321,10,313,0,1112,1444,2556,9,5.666666667,201919
15,36,223,16,186,236,39,197,0,897,1126,2023,9,5.5,201919
15,37,183,19,267,434,32,333,13,1281,1427,2708,7,6,201919
15,38,143,21,176,329,6,208,3,886,1004,1890,6,5,201919
15,39,108,16,182,300,16,126,0,748,776,1524,4,6,201919
15,40,261,15,205,336,53,401,0,1271,1474,2745,9,6,201919
15,41,246,19,459,497,37,253,4,1515,1837,3352,14,6.333333333,201919
16,1,120,9,187,141,16,189,2,664,732,1396,7,5.333333333,201919
16,2,131,18,94,169,12,242,0,666,623,1289,9,5.25,201919
16,3,144,18,129,229,12,164,0,696,726,1422,10,5.25,201919
16,4,181,23,192,112,19,314,0,841,819,1660,8,5.5,201919
16,5,185,19,186,166,21,264,4,845,1074,1919,10,5.666666667,201919
16,6,182,21,119,193,29,175,0,719,692,1411,12,5.5,201919
16,7,145,18,109,166,19,190,0,647,910,1557,9,5.5,201919
16,8,224,23,430,460,9,339,0,1485,1672,3157,12,6,201919
16,9,187,16,218,261,13,247,3,945,1055,2000,9,6,201919
16,10,153,5,232,231,12,218,0,851,991,1842,6,6,201919
16,11,199,24,130,151,52,279,0,835,791,1626,10,5.4,201919
16,12,192,13,188,134,21,243,3,794,739,1533,10,5.25,201919
17,1,184,13,336,402,12,327,0,1274,1317,2591,9,7,201919
17,2,161,18,336,336,16,181,3,1051,1099,2150,8,5.666666667,201919
17,3,252,14,421,485,10,327,1,1510,1355,2865,8,5.5,201919
17,4,228,12,322,333,29,304,7,1235,1125,2360,10,5.666666667,201919
17,5,102,6,134,188,6,122,0,558,757,1315,5,5.5,201919
18,1,99,16,79,134,5,152,3,488,696,1184,7,5.25,201919
18,2,178,25,301,364,41,247,0,1156,1155,2311,9,6.333333333,201919
18,3,137,8,282,183,7,217,0,834,883,1717,8,5.5,201919
19,1,176,20,283,309,4,465,5,1262,1307,2569,9,6,201919
19,2,255,14,605,426,18,493,0,1811,1734,3545,9,6,201919
19,3,250,19,576,331,22,423,1,1622,1688,3310,7,6,201919
19,4,104,13,165,160,27,298,18,785,791,1576,5,6,201919
19,5,283,25,486,637,17,597,14,2059,2021,4080,8,6,201919
19,6,78,23,165,179,2,215,3,665,614,1279,5,6,201919
19,7,178,9,392,179,5,246,0,1009,995,2004,10,5.5,201919
19,8,65,7,163,186,5,203,0,629,521,1150,7,6,201919
19,9,111,9,164,140,20,200,0,644,623,1267,9,5.25,201919
19,10,102,4,203,235,9,336,9,898,851,1749,6,7,201919
19,11,348,35,525,594,29,901,13,2445,2354,4799,13,6,201919
19,12,187,9,471,228,13,312,4,1224,1362,2586,8,5.666666667,201919
20,1,191,12,157,187,33,111,37,728,897,1625,7,5.5,201919
20,2,200,14,240,251,15,210,0,930,401,1331,6,5.333333333,201919
20,3,131,1,136,138,75,102,32,615,428,1043,6,5.333333333,201919
20,4,93,12,82,122,24,154,56,543,464,1007,6,5.333333333,201919
20,5,128,8,205,300,116,92,0,849,725,1574,11,5.25,201919
20,6,270,15,210,243,189,196,0,1123,696,1819,8,5.25,201919
20,7,194,6,194,296,18,236,2,946,953,1899,7,5.75,201919
20,8,389,22,396,798,29,474,53,2161,2204,4365,14,6.5,201919
20,9,219,12,181,229,61,202,20,924,986,1910,8,5.666666667,201919
20,10,247,4,198,242,27,235,0,953,795,1748,9,5.25,201919
21,1,1,0,2,150,0,0,0,153,167,320,2,6,201919
21,2,0,0,0,31,0,0,0,31,28,59,1,6,201919
21,3,0,0,0,158,0,0,0,158,154,312,2,6,201919
21,4,0,0,0,51,0,0,0,51,67,118,1,6,201919
21,5,1,0,4,239,1,2,0,247,239,486,2,6,201919
21,6,0,0,1,362,0,0,0,363,366,729,1,6,201919
21,7,0,0,0,223,0,0,0,223,170,393,2,6,201919
21,8,0,0,0,102,0,0,0,102,78,180,1,6,201919
21,9,0,0,0,451,0,0,0,451,326,777,2,6,201919
21,10,0,0,0,338,0,0,0,338,312,650,1,6,201919
21,11,0,0,0,126,0,0,0,126,132,258,1,6,201919
21,12,0,0,0,622,0,0,0,622,665,1287,2,6,201919
21,13,0,0,0,187,0,0,0,187,208,395,2,6,201919
21,14,0,0,0,138,1,0,0,139,106,245,2,6,201919
21,15,0,0,0,220,0,0,0,220,228,448,1,6,201919
22,1,168,36,162,353,24,123,2,868,787,1655,11,5.2,201919
22,2,142,18,280,300,32,202,1,975,988,1963,7,5.5,201919
22,3,233,32,657,518,20,337,0,1797,1793,3590,9,5.666666667,201919
22,4,156,23,505,461,32,280,2,1459,1468,2927,10,7,201919
22,5,135,12,383,208,37,204,2,981,1052,2033,10,5.5,201919
23,1,78,3,508,365,7,37,18,1016,284,1300,10,6,201919
23,2,29,6,53,206,4,11,7,316,218,534,4,6,201919
23,3,51,3,214,387,3,5,17,680,313,993,15,6,201919
23,4,41,9,277,436,29,22,19,833,393,1226,6,6,201919
24,1,203,52,188,319,26,143,6,937,459,1396,10,5.2,201919
24,2,136,17,195,163,9,229,0,749,606,1355,6,5.5,201919
24,3,139,28,211,255,44,163,2,842,742,1584,9,5.25,201919
24,4,131,18,172,200,31,203,33,788,564,1352,5,5.5,201919
24,5,259,34,425,489,19,356,0,1582,1612,3194,10,6.333333333,201919
24,6,164,32,292,349,23,328,0,1188,1309,2497,6,6,201919
24,7,191,24,184,438,55,142,0,1034,1085,2119,9,5.25,201919
25,1,142,8,191,254,12,219,4,830,851,1681,13,5.75,201919
25,2,164,21,296,324,11,298,0,1114,1299,2413,7,5.5,201919
25,3,162,19,200,286,16,229,8,920,1027,1947,8,5.6,201919
25,4,127,7,115,190,3,204,0,646,763,1409,8,5.333333333,201919
25,5,162,8,207,316,15,192,0,900,998,1898,8,5.666666667,201919
25,6,141,11,223,215,28,271,2,891,957,1848,8,5.75,201919
25,7,215,15,311,364,5,271,0,1181,1252,2433,6,6,201919
26,1,200,5,282,253,8,303,1,1052,1116,2168,9,5.5,201919
26,2,227,10,352,360,5,264,4,1222,1338,2560,12,5.4,201919
26,3,233,9,250,448,7,491,6,1444,1587,3031,14,6.5,201919
26,4,156,13,145,181,20,296,9,820,812,1632,9,5.2,201919
26,5,136,7,151,190,5,266,0,755,727,1482,15,6,201919
26,6,200,8,275,267,2,389,0,1141,1113,2254,10,5.333333333,201919
26,7,159,8,141,187,19,151,0,665,701,1366,10,5.5,201919
27,1,150,7,193,295,70,196,0,911,1056,1967,8,5.5,201919
27,2,213,19,274,402,29,140,2,1079,1069,2148,8,5.666666667,201919
27,3,176,8,142,354,5,171,0,856,924,1780,7,5.666666667,201919
27,4,229,8,357,652,12,292,5,1555,1556,3111,8,6,201919
27,5,99,1,106,257,4,94,0,561,343,904,6,5.333333333,201919
27,6,209,16,247,423,8,212,0,1115,1096,2211,7,5.5,201919
28,1,36,4,86,327,0,16,0,469,326,795,13,6,201919
28,2,54,10,137,266,7,24,93,591,275,866,11,6,201919
28,3,26,4,40,112,3,6,0,191,57,248,3,6,201919
28,4,81,8,166,307,31,31,72,696,330,1026,15,6,201919
28,5,33,6,56,289,4,17,36,441,306,747,4,6,201919
28,6,20,2,24,100,0,4,5,155,93,248,4,6,201919
28,7,72,14,226,438,16,28,47,841,413,1254,13,6,201919
28,8,29,11,111,239,10,26,28,454,287,741,11,7,201919
28,9,54,3,127,163,17,16,20,400,141,541,9,6,201919
29,1,231,17,325,375,29,233,1,1211,1184,2395,7,5.5,201919
29,2,223,16,232,494,27,291,47,1330,1337,2667,11,6,201919
29,3,127,25,144,286,7,167,0,756,805,1561,5,5.666666667,201919
30,1,72,7,103,100,4,108,2,396,539,935,7,5.333333333,201919
30,2,123,13,114,104,17,152,29,552,707,1259,8,5.25,201919
30,3,122,6,249,130,36,210,21,774,1002,1776,6,5.666666667,201919
30,4,72,6,224,187,34,172,1,696,847,1543,8,6,201919
30,5,104,9,177,235,65,219,0,809,787,1596,7,5.5,201919
30,6,154,11,178,174,10,176,5,708,956,1664,9,5.333333333,201919
30,7,171,10,316,167,20,176,15,875,755,1630,11,5.25,201919
30,8,195,11,282,323,72,337,16,1236,1142,2378,11,5.4,201919
30,9,161,6,159,176,39,234,20,795,990,1785,8,5.5,201919
30,10,116,8,230,259,24,216,20,873,1235,2108,6,6,201919
30,11,133,14,262,297,8,234,0,948,1120,2068,5,5.5,201919
30,12,201,7,396,446,14,341,0,1405,1418,2823,10,5.5,201919
30,13,163,7,119,252,55,232,45,873,1121,1994,10,5.4,201919
30,14,156,5,217,180,53,282,5,898,879,1777,8,5.5,201919
30,15,229,11,204,274,33,460,36,1247,1365,2612,11,5.666666667,201919
30,16,168,12,205,292,41,322,35,1075,1131,2206,10,5.333333333,201919
30,17,146,18,179,326,26,209,6,910,1068,1978,8,5.5,201919
30,18,198,11,114,203,11,238,11,786,911,1697,8,5.25,201919
30,19,126,7,376,191,11,209,1,921,813,1734,13,5.6,201919
30,20,142,9,236,308,132,227,0,1054,933,1987,10,5.4,201919
31,1,169,8,131,28,179,178,1,694,907,1601,8,5.5,201919
31,2,79,3,103,7,105,163,0,460,778,1238,6,5.333333333,201919
31,3,449,44,862,589,120,619,0,2683,2439,5122,21,6.333333333,201919
31,4,118,5,256,187,72,229,16,883,999,1882,4,6,201919
31,5,166,15,110,155,43,249,0,738,884,1622,6,5.333333333,201919
32,1,160,22,130,172,40,304,8,836,773,1609,12,5.2,201919
32,2,184,24,146,89,64,288,10,805,807,1612,13,5.142857143,201919
32,3,186,41,202,298,7,347,0,1081,1028,2109,13,5.4,201919
32,4,172,47,176,244,21,295,16,971,1146,2117,13,5.4,201919
1,1,54,11,99,232,3,15,3,417,161,578,7,6,201920
1,2,59,19,223,711,20,48,13,1093,586,1679,10,6.333333333,201920
1,3,58,38,228,644,18,34,23,1043,546,1589,9,6,201920
2,1,80,12,179,413,2,31,5,722,246,968,11,6,201920
2,2,90,11,235,587,8,54,0,985,276,1261,7,6,201920
2,3,136,11,310,479,16,50,107,1109,417,1526,10,6,201920
2,4,88,10,264,205,50,28,25,670,110,780,9,6,201920
2,5,154,17,429,595,95,73,51,1414,501,1915,13,6,201920
2,6,120,9,290,440,9,41,8,917,327,1244,7,6,201920
2,7,108,7,233,368,11,34,49,810,351,1161,10,6,201920
2,8,123,11,298,563,7,40,55,1097,511,1608,8,6,201920
3,1,252,10,324,371,13,367,1,1338,1069,2407,12,5.666666667,201920
3,2,171,9,497,241,23,161,0,1102,1144,2246,9,5.666666667,201920
4,1,214,14,215,388,41,273,23,1168,1275,2443,11,5.25,201920
4,2,174,10,416,421,98,180,43,1342,1052,2394,14,5.2,201920
5,1,236,11,447,349,21,297,5,1366,1493,2859,9,5.666666667,201920
5,2,161,11,247,295,33,162,0,909,962,1871,10,5.2,201920
5,3,213,18,327,341,33,370,10,1312,1337,2649,11,5.333333333,201920
5,4,273,25,611,554,18,486,25,1992,1971,3963,9,5.666666667,201920
5,5,215,14,410,519,24,239,21,1442,1413,2855,9,6,201920
5,6,162,12,286,357,12,206,23,1058,952,2010,11,5.5,201920
5,7,235,15,280,355,3,265,4,1157,1285,2442,10,5.5,201920
6,1,218,14,284,243,5,328,3,1095,1088,2183,11,5.8,201920
6,2,217,11,361,223,26,370,2,1210,1111,2321,9,5.666666667,201920
7,1,195,9,152,346,19,68,4,793,630,1423,9,5.25,201920
7,2,316,13,183,916,178,67,0,1673,427,2100,9,5.25,201920
7,3,193,3,244,175,197,135,2,949,1047,1996,7,5.333333333,201920
7,4,200,17,180,348,12,135,86,978,628,1606,11,5.4,201920
7,5,351,4,149,577,13,168,0,1262,1014,2276,11,5.666666667,201920
7,6,300,10,249,402,21,270,13,1265,1127,2392,9,5.666666667,201920
7,7,255,22,227,405,68,174,5,1156,1247,2403,8,5.25,201920
7,8,275,15,174,440,11,224,10,1149,1286,2435,12,5.25,201920
7,9,244,22,256,380,9,236,0,1147,1307,2454,9,5.666666667,201920
7,10,313,4,273,548,34,158,1,1331,874,2205,9,5.5,201920
7,11,112,2,57,152,32,63,15,433,354,787,6,5.333333333,201920
7,12,284,10,253,596,3,145,0,1291,1023,2314,9,5.5,201920
7,13,240,6,113,196,0,75,0,630,1011,1641,9,5.25,201920
8,1,165,2,408,165,18,185,1,944,952,1896,4,6,201920
8,2,322,23,673,440,25,338,0,1821,1749,3570,16,5.5,201920
8,3,212,18,394,370,18,229,17,1258,1236,2494,4,6,201920
8,4,209,18,433,319,23,347,37,1386,1427,2813,11,6,201920
8,5,206,22,240,238,14,182,0,902,739,1641,10,5.25,201920
8,6,264,23,418,408,41,449,0,1603,1649,3252,7,6.5,201920
8,7,223,48,173,175,9,389,0,1017,1019,2036,7,5.25,201920
8,8,205,27,359,380,13,359,0,1343,1334,2677,11,7,201920
8,9,175,12,117,98,12,298,9,721,959,1680,10,5,201920
9,1,100,10,159,177,48,185,4,683,625,1308,5,6,201920
9,2,339,75,659,992,101,599,6,2771,2666,5437,12,6,201920
9,3,162,19,362,483,58,355,12,1451,1372,2823,7,6,201920
9,4,224,14,404,556,90,272,7,1567,1532,3099,11,6,201920
9,5,134,13,267,366,52,261,0,1093,1103,2196,7,6,201920
9,6,110,21,196,184,123,191,10,835,817,1652,7,6,201920
9,7,132,9,287,379,2,223,0,1032,951,1983,9,6,201920
9,8,94,9,297,356,10,198,7,971,984,1955,5,6,201920
9,9,121,6,220,324,37,158,3,869,859,1728,5,6,201920
9,10,125,21,297,370,27,246,2,1088,1075,2163,6,6,201920
9,11,200,26,474,585,36,338,3,1662,1499,3161,7,6,201920
9,12,171,21,563,678,34,341,18,1826,1887,3713,11,6,201920
9,13,143,12,237,357,72,228,12,1061,1002,2063,4,6,201920
9,14,114,8,185,269,44,238,12,870,858,1728,5,6,201920
9,15,233,18,839,981,27,601,9,2708,2785,5493,9,6.5,201920
9,16,277,35,465,666,53,426,0,1922,1943,3865,15,6,201920
9,17,160,6,248,300,17,175,0,906,897,1803,6,6,201920
9,18,216,18,340,596,44,358,3,1575,1480,3055,12,6,201920
9,19,208,40,347,549,72,280,2,1498,1372,2870,5,6,201920
9,20,56,10,109,148,23,69,3,418,434,852,5,6,201920
9,21,131,9,212,296,30,177,6,861,752,1613,3,6,201920
9,22,167,8,263,371,74,213,19,1115,1131,2246,5,6,201920
9,23,179,11,319,530,28,273,1,1341,1199,2540,6,6,201920
9,24,373,25,617,924,92,586,10,2627,2361,4988,12,6,201920
10,1,47,6,52,236,2,14,30,387,214,601,4,6,201920
10,2,62,10,119,359,14,30,39,633,289,922,4,6,201920
10,3,23,11,41,158,3,8,36,280,107,387,6,6,201920
10,4,112,13,182,705,1,28,10,1051,504,1555,11,6,201920
11,1,225,27,226,256,18,205,4,961,915,1876,6,5.666666667,201920
11,2,223,22,247,240,26,210,17,985,948,1933,7,6,201920
11,3,165,12,232,278,13,265,3,968,910,1878,3,6,201920
11,4,192,29,143,240,9,228,4,845,854,1699,8,6,201920
11,5,285,48,412,459,18,391,7,1620,1747,3367,7,6,201920
11,6,159,10,228,265,24,234,0,920,929,1849,8,6,201920
11,7,253,36,266,456,24,178,3,1216,1129,2345,9,5.5,201920
11,8,196,35,274,342,13,285,0,1145,1211,2356,9,5.5,201920
11,9,291,55,328,413,16,328,19,1450,1349,2799,10,5.666666667,201920
11,10,226,32,255,256,18,304,8,1099,1116,2215,10,5.6,201920
11,11,223,36,322,383,10,264,0,1238,1184,2422,5,6,201920
11,12,220,27,406,488,12,250,2,1405,1395,2800,7,6,201920
11,13,165,31,195,222,7,208,16,844,818,1662,8,5.5,201920
11,14,188,26,211,226,23,298,0,972,934,1906,8,5.5,201920
11,15,159,41,187,237,14,199,0,837,945,1782,9,6,201920
12,1,199,21,219,152,21,191,3,806,815,1621,10,5.2,201920
12,2,248,35,245,425,28,261,18,1260,1034,2294,10,5.5,201920
12,3,190,30,261,473,17,153,0,1124,923,2047,11,5,201920
12,4,167,24,351,549,33,225,0,1349,1282,2631,9,5.666666667,201920
12,5,212,32,184,268,3,164,19,882,807,1689,10,5.25,201920
12,6,163,14,98,425,27,72,5,804,696,1500,10,5.25,201920
12,7,283,17,286,374,18,294,43,1315,1258,2573,6,5.5,201920
12,8,223,26,234,318,3,154,0,958,820,1778,9,5.25,201920
12,9,174,18,334,558,22,157,0,1263,1204,2467,9,5.666666667,201920
13,1,208,11,174,243,27,212,8,883,886,1769,9,5.333333333,201920
13,2,169,11,107,191,24,189,10,701,832,1533,6,5.333333333,201920
13,3,157,19,210,296,91,174,0,947,1028,1975,12,5.25,201920
13,4,211,13,280,278,60,207,9,1058,1078,2136,9,5.666666667,201920
13,5,261,17,366,344,72,397,6,1463,1506,2969,9,5.75,201920
13,6,266,59,619,649,59,296,16,1964,2111,4075,11,5.666666667,201920
13,7,130,19,333,343,35,161,0,1021,1174,2195,8,5.5,201920
14,1,189,15,103,99,14,480,0,900,758,1658,6,5.5,201920
14,2,224,14,169,114,5,441,2,969,935,1904,5,5.666666667,201920
14,3,320,12,237,128,5,580,0,1282,1228,2510,8,5.4,201920
14,4,202,11,280,335,15,310,8,1161,1188,2349,10,6,201920
14,5,250,14,464,263,38,407,2,1438,863,2301,9,5.5,201920
14,6,235,12,520,299,22,367,0,1455,1368,2823,11,6,201920
14,7,149,6,188,161,0,201,0,705,694,1399,6,6,201920
14,8,402,39,719,774,15,867,1,2817,2841,5658,11,6.25,201920
14,9,154,20,190,295,21,258,2,940,1154,2094,9,6,201920
14,10,257,15,380,335,5,421,1,1414,1313,2727,7,6,201920
14,11,143,10,156,200,21,271,14,815,761,1576,4,6,201920
14,12,287,18,474,230,13,290,1,1313,1357,2670,9,5.5,201920
14,13,215,16,300,239,15,373,5,1163,1230,2393,6,6,201920
14,14,188,13,271,295,19,389,5,1180,1102,2282,7,6,201920
14,15,268,27,266,215,24,467,3,1270,1262,2532,10,5.6,201920
14,16,158,19,238,189,28,327,0,959,986,1945,5,6,201920
14,17,175,24,203,86,26,313,4,831,1187,2018,7,5.25,201920
14,18,251,21,219,124,26,427,9,1077,1209,2286,9,5.4,201920
14,19,172,25,253,268,14,261,7,1000,1402,2402,8,5.25,201920
14,20,217,12,298,183,6,339,3,1058,1292,2350,10,5.666666667,201920
15,1,199,7,214,92,221,422,2,1157,1099,2256,7,5.333333333,201920
15,2,172,9,242,336,28,199,3,989,1083,2072,6,6,201920
15,3,261,19,216,307,158,431,20,1412,1352,2764,10,5.333333333,201920
15,4,228,19,243,351,37,334,8,1220,1037,2257,4,6,201920
15,5,174,25,241,310,21,272,0,1043,1228,2271,8,5.666666667,201920
15,6,189,8,302,447,42,218,6,1212,1235,2447,7,6,201920
15,7,174,19,230,361,40,277,0,1101,1067,2168,10,6,201920
15,8,104,16,179,237,26,135,3,700,671,1371,4,6,201920
15,9,280,3,159,180,117,317,8,1064,1163,2227,9,5.75,201920
15,10,147,9,250,256,56,201,1,920,907,1827,6,6,201920
15,11,197,14,280,477,52,233,2,1255,1288,2543,8,6,201920
15,12,245,15,469,512,30,235,0,1506,1511,3017,8,6,201920
15,13,106,6,170,221,53,207,0,763,764,1527,8,6,201920
15,14,108,27,137,233,8,149,1,663,669,1332,4,6,201920
15,15,200,34,328,423,29,296,4,1314,1229,2543,6,6,201920
15,16,271,19,359,643,27,305,3,1627,1588,3215,8,6,201920
15,17,150,15,198,318,12,223,17,933,988,1921,8,6,201920
15,18,241,13,272,468,22,336,1,1353,1402,2755,7,5.666666667,201920
15,19,222,37,446,638,19,416,10,1788,1640,3428,10,6,201920
15,20,94,11,204,281,12,197,3,802,930,1732,6,6,201920
15,21,110,12,77,184,20,143,8,554,651,1205,6,5.5,201920
15,22,292,40,502,802,28,529,27,2220,2226,4446,14,6,201920
15,23,213,13,221,385,14,295,0,1141,1262,2403,6,5.333333333,201920
15,24,142,26,248,290,26,168,1,901,871,1772,4,6,201920
15,25,179,30,269,326,40,197,13,1054,989,2043,6,6,201920
15,26,187,15,235,283,35,251,2,1008,906,1914,9,7,201920
15,27,223,14,359,508,20,373,26,1523,1531,3054,9,5.666666667,201920
15,28,243,23,425,379,47,354,2,1473,1494,2967,9,5.666666667,201920
15,29,283,14,438,667,12,376,0,1790,1539,3329,8,6,201920
15,30,273,29,443,566,53,245,10,1619,1389,3008,16,6,201920
15,31,171,27,188,305,16,196,0,903,834,1737,6,6,201920
15,32,164,14,253,429,28,190,5,1083,1162,2245,9,6,201920
15,33,192,9,359,393,25,239,0,1217,1181,2398,7,6,201920
15,34,159,17,205,394,10,261,7,1053,1024,2077,8,6,201920
15,35,309,12,253,350,5,386,0,1315,1469,2784,9,5.666666667,201920
15,36,258,19,209,280,43,213,0,1022,1119,2141,9,5.5,201920
15,37,225,13,307,473,45,314,20,1397,1525,2922,7,6,201920
15,38,209,19,246,366,10,238,6,1094,1324,2418,6,5.5,201920
15,39,157,32,302,376,26,161,1,1055,949,2004,4,6,201920
15,40,297,17,292,434,53,462,0,1555,1584,3139,9,5.666666667,201920
15,41,260,32,504,610,39,295,13,1753,1762,3515,13,6,201920
16,1,163,14,181,163,8,194,0,723,809,1532,7,5.333333333,201920
16,2,116,18,82,146,10,163,0,535,496,1031,9,5.25,201920
16,3,221,18,193,300,15,258,2,1007,967,1974,10,5.25,201920
16,4,183,24,184,105,18,292,0,806,1060,1866,8,5.5,201920
16,5,193,22,161,186,15,267,1,845,890,1735,10,5.666666667,201920
16,6,190,23,157,256,33,180,0,839,989,1828,12,5.5,201920
16,7,226,25,173,221,25,345,0,1015,1064,2079,9,5.5,201920
16,8,299,34,514,561,11,388,1,1808,1778,3586,12,6,201920
16,9,228,22,253,283,18,346,0,1150,1092,2242,9,6,201920
16,10,165,11,291,281,14,205,0,967,999,1966,7,6.5,201920
16,11,200,23,195,161,57,396,0,1032,1142,2174,10,5.4,201920
16,12,211,19,200,153,12,225,3,823,892,1715,10,5.25,201920
17,1,197,19,406,422,17,336,0,1397,1332,2729,9,7,201920
17,2,164,14,344,357,19,208,7,1113,1059,2172,8,5.666666667,201920
17,3,333,18,434,466,12,324,2,1589,1483,3072,8,5.5,201920
17,4,274,18,344,397,23,298,7,1361,1479,2840,10,5.666666667,201920
17,5,127,7,197,196,2,137,0,666,641,1307,5,5.5,201920
18,1,170,18,158,195,19,208,5,773,752,1525,7,5.25,201920
18,2,254,22,390,445,51,296,0,1458,1309,2767,8,6,201920
18,3,145,12,301,173,6,223,0,860,1021,1881,8,5.5,201920
19,1,232,11,318,344,17,469,5,1396,1407,2803,9,6,201920
19,2,287,12,632,438,17,492,1,1879,1902,3781,9,6,201920
19,3,288,13,529,350,21,442,0,1643,1720,3363,7,6,201920
19,4,136,6,165,160,38,294,27,826,835,1661,5,6,201920
19,5,323,19,540,654,25,614,19,2194,2260,4454,8,6,201920
19,6,61,10,172,180,6,244,1,674,659,1333,5,6,201920
19,7,216,18,510,246,10,263,1,1264,1347,2611,10,5.5,201920
19,8,84,3,174,176,3,147,0,587,722,1309,7,6,201920
19,9,155,15,186,192,32,361,0,941,732,1673,9,5.25,201920
19,10,130,7,226,209,4,363,7,946,1048,1994,7,8,201920
19,11,384,47,523,616,24,875,15,2484,2302,4786,13,6,201920
19,12,224,14,569,219,14,278,4,1322,1560,2882,8,5.666666667,201920
20,1,200,17,205,163,42,202,22,851,874,1725,7,5.5,201920
20,2,160,11,143,182,8,170,0,674,467,1141,6,5.333333333,201920
20,3,107,9,152,154,60,98,28,608,562,1170,6,5.333333333,201920
20,4,166,13,136,176,32,234,8,765,670,1435,6,5.333333333,201920
20,5,163,17,240,275,121,135,0,951,536,1487,11,5.25,201920
20,6,225,11,174,295,266,90,0,1061,899,1960,8,5.25,201920
20,7,178,11,144,334,10,189,2,868,910,1778,7,5.75,201920
20,8,475,29,523,816,32,579,48,2502,2482,4984,13,6,201920
20,9,367,27,389,215,66,351,29,1444,950,2394,8,5.666666667,201920
20,10,237,22,270,314,14,255,0,1112,942,2054,9,5.25,201920
21,1,3,0,0,171,0,1,0,175,186,361,2,6,201920
21,2,0,0,0,33,0,0,0,33,35,68,1,6,201920
21,3,0,0,0,183,0,0,0,183,181,364,2,6,201920
21,4,0,0,0,63,0,0,0,63,58,121,1,6,201920
21,5,4,0,6,276,0,9,0,295,280,575,2,6,201920
21,6,0,0,0,409,0,0,0,409,371,780,1,6,201920
21,7,0,0,0,266,0,0,0,266,222,488,2,6,201920
21,8,0,0,0,99,0,0,0,99,96,195,1,6,201920
21,9,0,0,1,511,0,0,0,512,527,1039,2,6,201920
21,10,0,0,0,399,0,0,0,399,358,757,1,6,201920
21,11,0,0,0,174,0,0,0,174,138,312,1,6,201920
21,12,0,0,0,808,0,0,0,808,633,1441,3,6.5,201920
21,13,0,0,0,234,0,0,0,234,242,476,2,6,201920
21,14,1,0,0,151,0,1,0,153,157,310,2,6,201920
21,15,0,0,0,296,0,0,0,296,219,515,1,6,201920
22,1,200,45,198,307,16,141,6,913,924,1837,11,5.2,201920
22,2,175,26,309,274,36,197,0,1017,869,1886,7,5.5,201920
22,3,336,32,748,618,28,404,0,2166,2279,4445,9,5.666666667,201920
22,4,192,26,507,527,17,273,4,1546,1608,3154,9,6.5,201920
22,5,157,16,388,225,46,177,16,1025,1152,2177,10,5.5,201920
23,1,108,2,530,372,8,36,20,1076,438,1514,11,6.333333333,201920
23,2,48,7,99,225,3,11,7,400,207,607,4,6,201920
23,3,74,4,262,454,8,15,24,841,495,1336,15,6,201920
23,4,61,6,296,390,22,23,23,821,476,1297,6,8,201920
24,1,153,42,160,228,31,107,3,724,666,1390,10,5.2,201920
24,2,160,18,201,170,9,216,0,774,819,1593,6,5.5,201920
24,3,191,20,166,194,48,147,1,767,784,1551,9,5.25,201920
24,4,178,22,217,198,42,314,33,1004,1137,2141,5,5.5,201920
24,5,267,31,471,529,12,439,0,1749,1756,3505,10,6.333333333,201920
24,6,198,26,339,412,28,381,0,1384,1419,2803,6,6,201920
24,7,232,30,208,293,19,154,0,936,1317,2253,9,5.25,201920
25,1,152,12,255,251,16,277,6,969,972,1941,13,5.75,201920
25,2,270,20,340,416,15,409,0,1470,1848,3318,7,5.5,201920
25,3,225,17,247,390,28,249,6,1162,1083,2245,8,5.6,201920
25,4,163,18,138,239,15,245,0,818,909,1727,8,5.333333333,201920
25,5,186,11,284,443,12,258,2,1196,1165,2361,8,5.666666667,201920
25,6,235,5,340,349,38,340,8,1315,1303,2618,8,5.75,201920
25,7,311,10,398,507,13,401,0,1640,1542,3182,6,6,201920
26,1,189,11,305,241,6,333,0,1085,1128,2213,9,5.5,201920
26,2,249,12,389,406,2,228,10,1296,1296,2592,12,5.4,201920
26,3,213,16,342,480,11,545,7,1614,1577,3191,14,6.5,201920
26,4,117,7,121,218,7,226,6,702,745,1447,9,5.2,201920
26,5,139,8,195,221,10,322,0,895,890,1785,15,6,201920
26,6,181,11,302,290,5,399,0,1188,1125,2313,10,5.333333333,201920
26,7,143,9,195,259,27,182,0,815,910,1725,10,5.5,201920
27,1,207,11,324,374,55,255,0,1226,1086,2312,8,5.5,201920
27,2,284,18,290,451,36,169,0,1248,1029,2277,8,5.666666667,201920
27,3,223,9,189,408,6,234,0,1069,935,2004,7,5.666666667,201920
27,4,260,14,401,742,17,296,10,1740,1948,3688,8,6,201920
27,5,107,3,154,305,13,124,0,706,421,1127,6,5.333333333,201920
27,6,176,11,201,359,7,207,0,961,1288,2249,7,5.5,201920
28,1,50,8,96,432,1,22,0,609,341,950,13,6,201920
28,2,78,3,112,337,15,24,95,664,278,942,11,6,201920
28,3,37,5,40,116,0,9,0,207,106,313,3,6,201920
28,4,91,11,170,384,17,27,85,785,344,1129,15,6,201920
28,5,35,13,90,348,10,22,57,575,328,903,4,6,201920
28,6,22,5,29,120,2,7,21,206,96,302,4,6,201920
28,7,93,21,212,446,17,31,35,855,428,1283,13,6,201920
28,8,55,7,133,352,22,34,45,648,227,875,11,7,201920
28,9,52,5,115,187,21,18,27,425,162,587,9,6,201920
29,1,285,34,368,400,44,258,3,1392,1195,2587,7,5.5,201920
29,2,306,23,294,559,25,329,41,1577,1683,3260,11,6,201920
29,3,182,33,191,384,24,235,0,1049,855,1904,5,5.666666667,201920
30,1,85,3,116,127,2,116,5,454,648,1102,7,5.333333333,201920
30,2,172,11,126,104,31,156,37,637,719,1356,8,4.75,201920
30,3,147,8,210,154,27,228,39,813,1006,1819,6,5.666666667,201920
30,4,117,9,250,210,36,199,0,821,803,1624,8,6,201920
30,5,165,12,193,291,19,258,0,938,835,1773,7,5.5,201920
30,6,164,12,235,165,24,174,4,778,929,1707,9,5.333333333,201920
30,7,188,13,189,230,45,266,19,950,1118,2068,11,5.25,201920
30,8,253,23,334,352,59,359,14,1394,1276,2670,11,5.4,201920
30,9,232,10,192,181,29,281,22,947,982,1929,8,5.5,201920
30,10,146,7,266,284,31,226,22,982,1056,2038,7,6.5,201920
30,11,105,6,257,308,2,205,0,883,1015,1898,5,5.5,201920
30,12,229,17,487,530,20,434,1,1718,1683,3401,10,6,201920
30,13,231,16,218,299,51,281,50,1146,1163,2309,10,5.4,201920
30,14,178,3,268,184,47,270,8,958,824,1782,8,5.5,201920
30,15,357,22,293,303,29,505,40,1549,1449,2998,11,5.666666667,201920
30,16,175,13,237,326,42,372,36,1201,980,2181,10,5.333333333,201920
30,17,209,21,259,333,37,306,4,1169,1428,2597,8,5.5,201920
30,18,168,8,104,181,16,264,18,759,631,1390,8,5.25,201920
30,19,179,5,225,218,7,249,0,883,978,1861,13,5.6,201920
30,20,174,15,233,370,75,205,0,1072,1312,2384,10,5.4,201920
31,1,204,14,175,39,215,206,0,853,1084,1937,8,5.5,201920
31,2,80,7,99,10,148,108,0,452,564,1016,6,5.333333333,201920
31,3,474,42,910,588,107,573,0,2694,2750,5444,20,6,201920
31,4,108,8,236,205,69,250,8,884,1078,1962,4,6,201920
31,5,165,4,115,156,33,301,0,774,1004,1778,6,5.333333333,201920
32,1,217,24,170,169,25,275,8,888,919,1807,12,5.2,201920
32,2,227,36,144,133,60,308,14,922,990,1912,13,5.142857143,201920
32,3,212,37,194,294,6,280,0,1023,907,1930,13,5.4,201920
32,4,171,44,205,273,14,270,17,994,904,1898,13,5.4,201920
1,1,30,10,73,143,6,16,6,284,256,540,8,6,201921
1,2,73,21,219,425,21,38,19,816,616,1432,10,6.333333333,201921
1,3,50,18,221,369,12,33,11,714,624,1338,9,6,201921
2,1,74,5,165,295,3,23,1,566,366,932,11,6,201921
2,2,85,7,170,420,5,53,0,740,385,1125,7,6,201921
2,3,121,13,278,330,7,38,78,865,491,1356,10,6,201921
2,4,73,8,178,154,47,18,8,486,89,575,9,6,201921
2,5,105,13,334,339,72,40,20,923,671,1594,13,6,201921
2,6,101,11,273,315,12,34,4,750,352,1102,7,6,201921
2,7,82,9,173,232,6,37,45,584,376,960,10,6,201921
2,8,110,4,229,376,6,29,27,781,520,1301,8,6,201921
3,1,169,14,263,319,12,309,2,1088,1062,2150,12,5.666666667,201921
3,2,146,11,525,222,18,185,0,1107,1101,2208,9,5.666666667,201921
4,1,161,14,277,361,34,254,34,1135,1063,2198,11,5.25,201921
4,2,215,15,397,350,30,206,46,1259,1184,2443,14,5.2,201921
5,1,214,14,425,309,21,306,6,1295,1443,2738,9,5.666666667,201921
5,2,176,15,226,290,17,185,0,909,925,1834,10,5.2,201921
5,3,158,8,264,291,29,268,15,1033,1001,2034,11,5.333333333,201921
5,4,192,19,512,458,16,390,8,1595,1660,3255,9,5.666666667,201921
5,5,192,17,377,493,16,209,15,1319,1287,2606,9,6,201921
5,6,129,16,321,301,15,165,41,988,1087,2075,11,5.5,201921
5,7,174,12,304,351,3,216,2,1062,1013,2075,10,5.5,201921
6,1,170,18,240,215,8,291,6,948,1041,1989,12,6,201921
6,2,193,15,351,213,36,312,9,1129,945,2074,9,5.666666667,201921
7,1,198,8,115,284,17,57,5,684,428,1112,9,5.25,201921
7,2,251,9,133,737,36,68,0,1234,1513,2747,9,5.25,201921
7,3,198,3,139,343,92,115,0,890,1106,1996,7,5.333333333,201921
7,4,197,22,172,326,7,148,46,918,979,1897,11,5.4,201921
7,5,313,7,141,479,18,144,0,1102,1076,2178,11,5.666666667,201921
7,6,239,16,309,372,13,248,7,1204,1198,2402,9,5.666666667,201921
7,7,250,16,285,385,53,199,3,1191,978,2169,8,5.5,201921
7,8,309,9,213,554,14,242,6,1347,1075,2422,12,5.25,201921
7,9,228,14,277,398,18,273,4,1212,1180,2392,9,5.666666667,201921
7,10,228,6,234,529,18,103,0,1118,873,1991,9,5.5,201921
7,11,155,5,91,121,23,84,9,488,439,927,6,5.333333333,201921
7,12,218,10,212,575,6,139,1,1161,1069,2230,9,5.5,201921
7,13,129,11,84,279,0,84,0,587,865,1452,9,5.25,201921
8,1,135,5,380,214,22,164,4,924,898,1822,4,6,201921
8,2,273,27,634,420,24,298,0,1676,1661,3337,16,5.5,201921
8,3,184,14,360,345,16,230,20,1169,1216,2385,4,6,201921
8,4,224,17,412,315,29,317,36,1350,1364,2714,11,6,201921
8,5,139,17,212,223,14,215,1,821,828,1649,10,5.25,201921
8,6,237,16,383,415,40,383,6,1480,1514,2994,7,6.5,201921
8,7,206,28,193,239,15,352,0,1033,1168,2201,7,5.25,201921
8,8,184,25,358,375,16,279,1,1238,1335,2573,10,6,201921
8,9,223,17,169,135,15,357,11,927,1001,1928,10,5.2,201921
9,1,98,5,173,137,64,197,7,681,658,1339,5,6,201921
9,2,288,67,697,1036,88,525,10,2711,2705,5416,12,6,201921
9,3,148,27,389,465,58,303,12,1402,1345,2747,7,6,201921
9,4,175,21,427,573,89,262,11,1558,1465,3023,11,6,201921
9,5,124,20,273,383,47,227,0,1074,1056,2130,7,6,201921
9,6,83,12,192,185,93,180,6,751,747,1498,7,6,201921
9,7,92,10,292,430,0,225,1,1050,961,2011,9,6,201921
9,8,69,14,293,387,8,192,9,972,939,1911,5,6,201921
9,9,92,7,241,315,41,169,6,871,787,1658,5,6,201921
9,10,93,16,323,386,18,233,1,1070,1086,2156,6,6,201921
9,11,168,16,465,531,38,331,2,1551,1514,3065,7,6,201921
9,12,115,26,568,674,35,325,41,1784,1839,3623,11,6,201921
9,13,114,15,270,352,70,199,7,1027,1014,2041,4,6,201921
9,14,94,3,197,278,38,210,11,831,835,1666,5,6,201921
9,15,236,26,821,1009,32,578,12,2714,2655,5369,9,6.5,201921
9,16,207,30,474,733,63,400,0,1907,2800,4707,15,6,201921
9,17,110,9,234,254,27,178,0,812,878,1690,6,6,201921
9,18,157,19,411,606,43,335,3,1574,1499,3073,12,6,201921
9,19,167,30,348,521,51,277,12,1406,1426,2832,5,6,201921
9,20,43,6,140,122,18,72,1,402,423,825,5,6,201921
9,21,124,9,190,290,20,184,4,821,756,1577,3,6,201921
9,22,150,8,267,347,57,204,17,1050,1072,2122,5,6,201921
9,23,135,16,308,519,43,260,0,1281,1270,2551,6,6,201921
9,24,305,33,666,887,101,585,12,2589,2489,5078,12,6,201921
10,1,32,12,45,146,1,12,20,268,272,540,5,6.5,201921
10,2,74,15,104,218,18,15,31,475,295,770,4,6,201921
10,3,33,9,39,78,3,11,36,209,138,347,6,6,201921
10,4,95,15,168,420,10,31,5,744,613,1357,12,6.5,201921
11,1,212,38,236,232,22,187,1,928,1060,1988,6,5.666666667,201921
11,2,209,22,222,221,18,205,16,913,887,1800,7,6,201921
11,3,176,21,235,255,14,222,3,926,918,1844,3,6,201921
11,4,164,35,136,245,8,220,1,809,836,1645,8,6,201921
11,5,298,26,365,477,22,365,2,1555,1570,3125,7,6,201921
11,6,163,11,222,227,20,212,5,860,881,1741,8,6,201921
11,7,200,43,231,390,16,139,5,1024,1226,2250,9,5.5,201921
11,8,164,25,285,328,23,275,0,1100,1039,2139,9,5.5,201921
11,9,254,50,365,365,18,299,30,1381,1389,2770,10,5.666666667,201921
11,10,191,26,232,224,25,291,10,999,1102,2101,10,5.6,201921
11,11,194,24,298,284,10,216,0,1026,1161,2187,5,6,201921
11,12,201,22,391,469,9,265,0,1357,1377,2734,7,6,201921
11,13,172,19,163,208,20,231,5,818,746,1564,8,5.5,201921
11,14,168,22,218,226,14,222,0,870,876,1746,8,5.5,201921
11,15,153,29,217,259,8,172,0,838,832,1670,9,6,201921
12,1,158,29,230,138,71,164,5,795,762,1557,10,5.2,201921
12,2,192,29,236,338,13,208,1,1017,1037,2054,10,5.5,201921
12,3,207,34,266,403,14,154,0,1078,928,2006,11,5.2,201921
12,4,133,25,299,545,24,172,0,1198,1235,2433,9,5.666666667,201921
12,5,250,29,194,349,1,155,11,989,750,1739,10,5.25,201921
12,6,145,21,111,480,22,59,3,841,751,1592,10,5.25,201921
12,7,206,16,242,370,11,212,30,1087,1067,2154,6,5.5,201921
12,8,247,27,261,335,3,115,0,988,770,1758,9,5.25,201921
12,9,153,18,311,503,38,151,0,1174,1118,2292,9,5.666666667,201921
13,1,195,17,113,222,24,214,64,849,1099,1948,9,5.333333333,201921
13,2,126,14,116,179,49,175,2,661,639,1300,6,5.333333333,201921
13,3,189,26,200,318,84,219,0,1036,854,1890,12,5.25,201921
13,4,197,16,297,306,64,198,7,1085,1024,2109,9,5.666666667,201921
13,5,227,16,351,294,79,378,9,1354,1348,2702,9,5.75,201921
13,6,256,47,652,624,73,290,9,1951,1896,3847,11,5.666666667,201921
13,7,132,27,378,354,24,161,0,1076,968,2044,8,5.5,201921
14,1,199,20,126,76,5,423,1,850,862,1712,6,5.5,201921
14,2,193,15,166,107,19,406,1,907,1043,1950,5,5.666666667,201921
14,3,299,12,252,103,3,528,0,1197,1464,2661,8,5.4,201921
14,4,156,15,271,336,11,259,9,1057,1252,2309,10,6,201921
14,5,207,13,475,282,18,311,1,1307,1243,2550,9,5.5,201921
14,6,197,10,500,341,13,327,1,1389,1379,2768,11,6,201921
14,7,142,9,207,158,0,190,0,706,580,1286,6,6,201921
14,8,331,28,686,733,13,767,0,2558,2723,5281,11,6,201921
14,9,133,6,182,252,18,263,1,855,948,1803,9,6,201921
14,10,193,18,383,333,8,382,0,1317,1403,2720,7,6,201921
14,11,138,9,180,186,16,254,16,799,781,1580,4,6,201921
14,12,287,10,490,237,5,334,0,1363,1138,2501,9,5.5,201921
14,13,210,17,289,247,10,363,4,1140,1118,2258,6,6,201921
14,14,159,8,283,303,19,402,4,1178,1257,2435,7,6,201921
14,15,220,38,208,229,21,403,6,1125,1078,2203,10,5.6,201921
14,16,178,18,300,206,14,332,6,1054,973,2027,5,6,201921
14,17,180,23,197,96,11,303,4,814,986,1800,7,5.25,201921
14,18,206,16,243,157,16,406,4,1048,1134,2182,9,5.4,201921
14,19,150,23,249,233,14,224,4,897,970,1867,8,5.25,201921
14,20,207,12,315,196,6,298,1,1035,1038,2073,10,5.666666667,201921
15,1,219,8,153,102,131,434,1,1048,1247,2295,7,5.333333333,201921
15,2,106,5,276,399,29,177,5,997,917,1914,6,6,201921
15,3,259,14,242,322,110,445,12,1404,1375,2779,10,5.666666667,201921
15,4,187,15,242,368,28,297,6,1143,1142,2285,4,6,201921
15,5,152,26,259,292,18,245,0,992,1089,2081,8,5.666666667,201921
15,6,154,4,292,484,36,258,4,1232,1175,2407,7,6,201921
15,7,131,14,242,343,40,226,0,996,1082,2078,10,6,201921
15,8,74,26,166,217,20,115,5,623,659,1282,4,6,201921
15,9,279,11,168,185,108,248,6,1005,1213,2218,9,5.75,201921
15,10,96,8,237,270,42,235,2,890,897,1787,6,6,201921
15,11,157,20,349,478,56,237,3,1300,1138,2438,8,6,201921
15,12,199,10,467,534,32,224,0,1466,1431,2897,8,6,201921
15,13,92,12,158,204,69,228,0,763,720,1483,8,6,201921
15,14,75,21,187,241,12,158,2,696,617,1313,4,6,201921
15,15,136,43,303,455,31,256,3,1227,1252,2479,6,6,201921
15,16,200,28,418,635,24,291,2,1598,1507,3105,8,6,201921
15,17,103,17,227,335,10,261,22,975,894,1869,8,6,201921
15,18,197,22,294,449,20,350,4,1336,1270,2606,7,5.666666667,201921
15,19,183,34,431,650,18,343,6,1665,1692,3357,10,6,201921
15,20,69,13,227,261,16,155,0,741,776,1517,6,6,201921
15,21,115,5,100,227,17,155,7,626,711,1337,6,5.5,201921
15,22,265,48,524,801,28,500,16,2182,2158,4340,14,6,201921
15,23,158,19,213,365,22,301,0,1078,891,1969,6,5.333333333,201921
15,24,110,34,213,247,31,174,4,813,888,1701,4,6,201921
15,25,137,19,281,320,41,196,12,1006,876,1882,6,6,201921
15,26,119,3,223,276,44,215,0,880,850,1730,9,7,201921
15,27,172,25,373,489,18,374,31,1482,1474,2956,9,5.666666667,201921
15,28,199,25,460,325,52,261,2,1324,1306,2630,9,5.666666667,201921
15,29,212,17,433,638,8,335,0,1643,1535,3178,8,6,201921
15,30,219,13,497,518,42,257,10,1556,1393,2949,16,6,201921
15,31,118,33,215,323,17,176,0,882,825,1707,6,6,201921
15,32,129,7,263,416,23,195,2,1035,976,2011,9,6,201921
15,33,152,16,334,375,23,239,0,1139,1203,2342,7,6,201921
15,34,110,21,245,417,12,233,7,1045,952,1997,8,6,201921
15,35,267,18,295,441,10,445,0,1476,1479,2955,9,5.666666667,201921
15,36,251,20,245,294,39,231,0,1080,1088,2168,9,5.5,201921
15,37,216,9,312,519,35,339,8,1438,1373,2811,7,6,201921
15,38,146,15,213,358,11,224,1,968,991,1959,6,5.5,201921
15,39,122,29,296,371,20,163,0,1001,961,1962,4,6,201921
15,40,269,19,332,442,52,480,0,1594,1533,3127,9,6,201921
15,41,240,19,562,587,41,276,6,1731,1752,3483,13,6,201921
16,1,129,15,180,181,10,160,1,676,620,1296,7,5.333333333,201921
16,2,114,13,80,148,4,154,0,513,685,1198,9,5.25,201921
16,3,170,17,170,280,19,207,1,864,808,1672,10,5.25,201921
16,4,172,21,196,116,22,275,0,802,875,1677,8,5.5,201921
16,5,164,28,190,179,19,234,5,819,850,1669,10,5.666666667,201921
16,6,191,30,159,233,27,181,0,821,765,1586,12,5.5,201921
16,7,229,23,185,206,35,303,0,981,1114,2095,9,5.5,201921
16,8,265,32,558,501,15,326,1,1698,1583,3281,12,6,201921
16,9,231,29,256,270,16,304,1,1107,1042,2149,9,6,201921
16,10,139,17,266,294,11,213,0,940,905,1845,6,6,201921
16,11,224,14,163,153,75,391,0,1020,975,1995,10,5.4,201921
16,12,176,7,153,165,20,203,1,725,590,1315,10,5.25,201921
17,1,176,16,401,435,24,328,0,1380,1337,2717,9,7,201921
17,2,132,12,361,372,9,194,6,1086,1025,2111,8,5.666666667,201921
17,3,223,18,394,461,15,281,4,1396,1351,2747,8,5.5,201921
17,4,210,12,388,394,24,328,9,1365,1221,2586,10,5.666666667,201921
17,5,125,9,127,189,25,126,0,601,535,1136,5,5.5,201921
18,1,149,18,147,174,19,207,2,716,638,1354,7,5.25,201921
18,2,219,17,337,366,46,264,0,1249,1262,2511,9,6.333333333,201921
18,3,154,11,299,211,9,244,0,928,862,1790,8,5.5,201921
19,1,191,11,308,282,12,478,5,1287,1300,2587,9,6,201921
19,2,228,18,647,409,10,528,0,1840,1855,3695,9,6,201921
19,3,231,13,601,330,25,408,0,1608,1591,3199,7,6,201921
19,4,89,9,185,157,32,305,21,798,815,1613,5,6,201921
19,5,294,26,513,686,30,625,14,2188,2013,4201,8,6,201921
19,6,79,8,162,214,4,234,0,701,688,1389,5,6,201921
19,7,175,10,471,197,7,226,1,1087,992,2079,10,5.5,201921
19,8,82,10,174,166,0,158,0,590,613,1203,7,6,201921
19,9,205,11,198,177,15,280,0,886,1016,1902,9,5.25,201921
19,10,125,10,197,215,7,332,8,894,929,1823,6,7,201921
19,11,396,46,606,695,21,869,18,2651,2571,5222,13,6,201921
19,12,174,11,665,198,9,302,3,1362,1513,2875,8,5.666666667,201921
20,1,156,16,196,201,29,160,18,776,973,1749,7,5.5,201921
20,2,168,11,281,149,13,151,0,773,524,1297,6,5.333333333,201921
20,3,113,8,151,141,53,100,35,601,557,1158,6,5.333333333,201921
20,4,89,18,112,138,27,165,21,570,583,1153,6,5.333333333,201921
20,5,119,9,200,237,37,132,0,734,812,1546,11,5.25,201921
20,6,196,5,157,239,70,113,2,782,1144,1926,8,5.25,201921
20,7,167,14,156,260,5,203,0,805,830,1635,7,5.75,201921
20,8,376,40,473,887,29,472,54,2331,2346,4677,13,6,201921
20,9,274,13,194,264,65,347,27,1184,888,2072,8,5.666666667,201921
20,10,195,16,207,307,13,213,1,952,772,1724,9,5.25,201921
21,1,0,0,0,37,0,0,0,37,165,202,2,6,201921
21,2,0,0,0,29,0,0,0,29,37,66,1,6,201921
21,3,0,0,0,44,0,0,0,44,217,261,2,6,201921
21,4,0,0,0,18,0,0,0,18,80,98,1,6,201921
21,5,2,1,6,86,0,3,0,98,280,378,2,6,201921
21,6,0,0,0,140,0,0,0,140,490,630,1,6,201921
21,7,0,0,0,79,0,0,0,79,321,400,2,6,201921
21,8,0,0,0,37,0,0,0,37,125,162,1,6,201921
21,9,0,0,0,156,0,0,0,156,652,808,2,6,201921
21,10,0,0,0,98,0,0,0,98,298,396,1,6,201921
21,11,0,0,0,60,0,0,0,60,137,197,1,6,201921
21,12,0,0,0,238,0,0,0,238,745,983,3,6.5,201921
21,13,0,0,0,72,0,0,0,72,284,356,2,6,201921
21,14,0,1,0,27,0,0,0,28,170,198,2,6,201921
21,15,0,0,0,70,0,0,0,70,336,406,1,6,201921
22,1,192,42,232,349,38,123,3,979,977,1956,11,5.2,201921
22,2,154,19,285,260,32,166,1,917,921,1838,7,5.5,201921
22,3,202,16,659,621,17,340,0,1855,1901,3756,9,5.666666667,201921
22,4,163,33,525,451,26,268,1,1467,1467,2934,9,6.5,201921
22,5,168,23,412,214,42,161,4,1024,943,1967,10,5.5,201921
23,1,73,2,450,244,16,28,15,828,417,1245,10,6,201921
23,2,29,3,67,147,2,9,3,260,190,450,4,6,201921
23,3,63,3,216,243,7,12,9,553,613,1166,15,6,201921
23,4,58,4,247,125,35,23,16,508,480,988,5,7,201921
24,1,122,43,109,193,19,103,0,589,691,1280,10,5.2,201921
24,2,138,15,217,211,5,181,0,767,697,1464,6,5.5,201921
24,3,148,23,131,178,28,121,0,629,854,1483,9,5.25,201921
24,4,145,22,223,203,31,281,47,952,844,1796,5,5.5,201921
24,5,257,30,478,513,13,389,0,1680,1569,3249,10,6.333333333,201921
24,6,159,38,348,388,17,360,0,1310,1300,2610,6,6,201921
24,7,216,19,198,261,30,159,0,883,977,1860,9,5.25,201921
25,1,128,8,205,286,16,212,4,859,955,1814,13,5.75,201921
25,2,223,20,355,419,9,338,0,1364,1716,3080,7,5.5,201921
25,3,185,10,261,270,23,247,8,1004,1171,2175,8,5.6,201921
25,4,133,15,164,278,7,242,0,839,737,1576,8,5.333333333,201921
25,5,162,8,228,393,13,259,0,1063,1044,2107,8,5.666666667,201921
25,6,181,13,309,282,40,370,3,1198,1128,2326,8,5.75,201921
25,7,255,14,408,473,10,362,0,1522,1409,2931,6,6,201921
26,1,216,7,372,282,5,367,0,1249,1292,2541,9,5.5,201921
26,2,189,15,397,396,1,225,9,1232,1336,2568,12,5.4,201921
26,3,223,8,366,460,9,543,5,1614,1595,3209,14,6.5,201921
26,4,148,21,169,239,12,264,5,858,936,1794,9,5.2,201921
26,5,127,3,193,233,14,262,0,832,648,1480,14,5.5,201921
26,6,159,14,316,370,3,433,0,1295,1217,2512,10,5.333333333,201921
26,7,152,9,185,242,39,198,0,825,721,1546,10,5.5,201921
27,1,184,15,255,291,78,219,0,1042,1219,2261,8,5.5,201921
27,2,208,14,240,364,16,186,1,1029,1047,2076,8,5.666666667,201921
27,3,180,13,191,472,7,225,0,1088,949,2037,7,5.666666667,201921
27,4,224,18,378,746,19,314,14,1713,1583,3296,8,6,201921
27,5,150,3,169,340,11,145,0,818,913,1731,6,5.333333333,201921
27,6,142,5,220,359,12,158,0,896,952,1848,7,5.5,201921
28,1,30,9,101,216,1,11,0,368,335,703,13,6,201921
28,2,59,4,156,177,6,20,78,500,347,847,11,6,201921
28,3,31,2,34,87,0,1,0,155,108,263,3,6,201921
28,4,70,4,149,222,19,19,47,530,372,902,15,6,201921
28,5,19,5,56,182,5,13,43,323,408,731,5,7,201921
28,6,25,1,18,75,4,6,13,142,111,253,4,6,201921
28,7,76,17,198,286,18,34,53,682,448,1130,13,6,201921
28,8,30,9,83,181,10,8,15,336,294,630,12,8,201921
28,9,32,1,93,95,11,14,12,258,162,420,9,6,201921
29,1,234,23,362,418,31,262,3,1333,1203,2536,7,5.5,201921
29,2,217,22,276,501,29,280,39,1364,1363,2727,11,5.666666667,201921
29,3,127,27,190,383,16,188,0,931,823,1754,5,5.666666667,201921
30,1,106,5,109,178,8,123,1,530,700,1230,7,5.333333333,201921
30,2,158,5,108,109,48,185,33,646,512,1158,8,5.25,201921
30,3,113,7,221,164,20,202,25,752,749,1501,6,5.666666667,201921
30,4,92,6,230,191,18,197,0,734,770,1504,8,6,201921
30,5,121,2,208,234,32,241,0,838,893,1731,7,5.5,201921
30,6,124,12,181,168,17,152,4,658,944,1602,9,5.333333333,201921
30,7,162,15,183,198,31,216,15,820,742,1562,11,5.25,201921
30,8,179,9,235,322,42,264,9,1060,1441,2501,11,5.4,201921
30,9,234,9,197,196,43,256,21,956,980,1936,8,5.5,201921
30,10,131,7,248,271,26,248,19,950,879,1829,6,6,201921
30,11,105,7,276,319,9,191,0,907,839,1746,5,5.5,201921
30,12,205,19,442,542,38,397,0,1643,1562,3205,10,6,201921
30,13,183,14,165,294,43,242,36,977,868,1845,10,5.4,201921
30,14,119,5,210,183,59,237,5,818,879,1697,8,5.5,201921
30,15,222,6,219,341,28,453,62,1331,1205,2536,11,5.666666667,201921
30,16,147,11,216,299,30,322,38,1063,1091,2154,10,5.333333333,201921
30,17,147,17,201,265,28,272,23,953,1138,2091,8,5.5,201921
30,18,188,9,122,217,12,227,12,787,745,1532,8,5.25,201921
30,19,171,10,263,193,11,249,3,900,921,1821,13,5.6,201921
30,20,132,9,193,338,93,191,0,956,844,1800,10,5.4,201921
31,1,197,20,239,34,206,284,0,980,964,1944,8,5.5,201921
31,2,103,7,109,7,119,146,0,491,754,1245,6,5.333333333,201921
31,3,379,37,860,574,106,608,0,2564,2626,5190,20,6,201921
31,4,100,11,279,204,50,222,10,876,940,1816,4,6,201921
31,5,155,7,136,189,27,216,0,730,851,1581,6,5.333333333,201921
32,1,166,24,151,180,24,275,16,836,869,1705,12,5.2,201921
32,2,202,22,159,106,31,255,10,785,767,1552,13,5.142857143,201921
32,3,193,40,202,270,10,274,0,989,1022,2011,13,5.4,201921
32,4,239,27,209,223,21,264,8,991,1136,2127,13,5.4,201921
1,1,35,12,63,72,13,9,4,208,55,263,7,5,201922
1,2,58,16,164,188,23,21,15,485,283,768,9,5,201922
1,3,50,14,178,191,19,21,9,482,225,707,9,5,201922
2,1,85,2,179,205,4,31,2,508,132,640,11,6,201922
2,2,104,8,163,313,5,49,0,642,132,774,7,6,201922
2,3,134,10,265,208,26,35,66,744,121,865,10,6,201922
2,4,79,7,254,118,33,12,15,518,4,522,9,6,201922
2,5,161,20,382,257,72,57,25,974,318,1292,13,6,201922
2,6,124,8,271,208,12,33,3,659,196,855,7,6,201922
2,7,102,9,185,156,12,29,39,532,107,639,10,6,201922
2,8,116,8,272,258,13,29,34,730,490,1220,8,6,201922
3,1,211,20,360,305,14,357,3,1270,1376,2646,12,5.666666667,201922
3,2,127,10,574,220,21,190,1,1143,1086,2229,9,5.666666667,201922
4,1,158,19,211,361,57,188,32,1026,1109,2135,11,5.25,201922
4,2,173,6,294,338,34,183,36,1064,1036,2100,14,5.2,201922
5,1,234,12,362,342,17,283,7,1257,1243,2500,9,5.666666667,201922
5,2,160,17,253,370,26,199,0,1025,815,1840,10,5.2,201922
5,3,174,13,257,346,28,261,13,1092,1168,2260,11,5.333333333,201922
5,4,246,21,515,496,10,359,11,1658,1664,3322,9,5.666666667,201922
5,5,137,9,331,387,12,177,13,1066,1329,2395,9,6,201922
5,6,133,12,302,306,9,167,38,967,930,1897,11,5.5,201922
5,7,178,14,277,329,2,211,4,1015,1027,2042,10,5.5,201922
6,1,167,11,280,262,6,319,11,1056,1084,2140,12,6,201922
6,2,164,13,380,208,25,300,15,1105,1147,2252,9,5.666666667,201922
7,1,230,9,135,294,15,89,12,784,1112,1896,9,5.25,201922
7,2,340,7,175,596,25,82,1,1226,1106,2332,9,5.25,201922
7,3,241,4,423,273,248,168,0,1357,956,2313,7,5.333333333,201922
7,4,86,4,96,234,0,79,15,514,794,1308,11,5.4,201922
7,5,252,7,129,442,15,136,0,981,1291,2272,11,5.666666667,201922
7,6,259,10,248,397,15,251,11,1191,1293,2484,9,5.666666667,201922
7,7,272,25,314,413,37,170,8,1239,1287,2526,8,5.5,201922
7,8,286,6,185,519,10,220,5,1231,1159,2390,12,5.25,201922
7,9,220,14,304,397,16,304,1,1256,1077,2333,9,5.666666667,201922
7,10,205,4,202,564,8,99,0,1082,1181,2263,9,5.5,201922
7,11,151,4,59,86,12,98,4,414,312,726,6,5.333333333,201922
7,12,249,8,273,478,5,120,0,1133,1386,2519,9,5.5,201922
7,13,113,9,103,237,2,60,0,524,570,1094,9,5.25,201922
8,1,114,5,312,128,11,97,3,670,775,1445,4,4,201922
8,2,271,28,679,435,30,395,4,1842,1741,3583,16,5.5,201922
8,3,190,16,400,397,15,297,24,1339,1176,2515,4,6,201922
8,4,218,29,446,327,36,383,48,1487,1383,2870,11,6,201922
8,5,169,14,256,246,20,217,0,922,907,1829,10,5.25,201922
8,6,205,23,418,417,38,368,7,1476,1516,2992,7,6.5,201922
8,7,221,43,181,215,1,411,0,1072,1057,2129,7,5.25,201922
8,8,188,15,364,377,6,303,2,1255,1220,2475,11,7,201922
8,9,217,12,115,128,6,315,7,800,806,1606,10,5.2,201922
9,1,111,3,188,145,55,194,3,699,646,1345,5,6,201922
9,2,295,68,807,998,103,598,15,2884,2734,5618,12,6,201922
9,3,142,26,340,473,52,292,11,1336,1344,2680,7,6,201922
9,4,180,15,378,568,79,244,8,1472,1537,3009,11,6,201922
9,5,133,9,288,357,40,247,0,1074,1094,2168,7,6,201922
9,6,107,10,183,173,111,174,6,764,1000,1764,7,6,201922
9,7,98,8,293,386,1,226,0,1012,1027,2039,9,6,201922
9,8,111,12,313,394,13,186,9,1038,950,1988,5,6,201922
9,9,111,10,204,315,31,151,3,825,870,1695,5,6,201922
9,10,95,8,346,375,19,226,2,1071,1101,2172,6,6,201922
9,11,158,10,442,588,43,337,0,1578,1592,3170,7,6,201922
9,12,146,18,557,692,25,281,25,1744,1829,3573,11,6,201922
9,13,128,13,276,352,64,196,14,1043,1043,2086,4,6,201922
9,14,110,12,223,240,44,201,17,847,839,1686,5,6,201922
9,15,225,22,866,978,37,546,7,2681,2733,5414,9,6.5,201922
9,16,264,32,478,737,65,363,0,1939,2300,4239,15,6,201922
9,17,116,9,257,365,21,188,0,956,456,1412,6,6,201922
9,18,190,21,370,547,34,348,2,1512,1509,3021,12,6,201922
9,19,178,46,321,515,68,248,5,1381,1378,2759,5,6,201922
9,20,47,4,109,126,15,70,2,373,382,755,5,6,201922
9,21,109,9,197,304,33,163,3,818,835,1653,3,6,201922
9,22,145,9,260,376,53,186,20,1049,1023,2072,5,6,201922
9,23,123,8,292,478,44,240,5,1190,1312,2502,6,6,201922
9,24,316,28,636,942,102,561,3,2588,2470,5058,12,6,201922
10,1,30,6,27,83,2,8,24,180,155,335,4,6,201922
10,2,43,9,101,118,9,13,25,318,93,411,4,6,201922
10,3,28,5,24,39,4,8,22,130,66,196,6,6,201922
10,4,56,4,117,168,2,11,6,364,327,691,11,6,201922
11,1,165,36,200,286,23,204,4,918,865,1783,6,5.666666667,201922
11,2,198,23,237,229,25,235,13,960,981,1941,7,6,201922
11,3,144,22,211,262,11,219,4,873,915,1788,3,6,201922
11,4,156,26,171,258,15,215,0,841,812,1653,8,6,201922
11,5,255,52,396,460,23,367,3,1556,1594,3150,7,6,201922
11,6,139,10,205,224,19,194,2,793,868,1661,8,6,201922
11,7,202,27,215,369,23,155,1,992,1220,2212,9,5.5,201922
11,8,182,19,226,345,17,223,0,1012,1164,2176,9,5.5,201922
11,9,219,47,343,398,14,273,14,1308,1320,2628,10,5.666666667,201922
11,10,190,26,226,224,17,250,12,945,1136,2081,10,5.6,201922
11,11,190,34,290,302,16,237,0,1069,1055,2124,5,6,201922
11,12,201,44,445,472,11,278,1,1452,1371,2823,7,6,201922
11,13,178,24,179,226,16,215,16,854,847,1701,8,5.5,201922
11,14,166,22,230,229,12,277,0,936,978,1914,8,5.5,201922
11,15,156,27,197,289,7,145,0,821,837,1658,9,6,201922
12,1,151,18,187,155,27,119,2,659,692,1351,10,5.2,201922
12,2,196,28,248,359,10,187,8,1036,1072,2108,10,5.5,201922
12,3,179,25,321,371,11,148,0,1055,1400,2455,11,5.2,201922
12,4,114,19,300,518,33,145,0,1129,1535,2664,9,5.666666667,201922
12,5,228,16,181,251,1,158,5,840,1081,1921,10,5.25,201922
12,6,160,10,107,322,17,71,8,695,909,1604,10,5.25,201922
12,7,205,17,234,367,12,206,22,1063,1318,2381,6,5.5,201922
12,8,211,23,230,294,2,125,0,885,757,1642,9,5.25,201922
12,9,157,25,247,470,13,130,0,1042,1171,2213,9,5.666666667,201922
13,1,158,17,151,212,35,241,27,841,998,1839,9,5.333333333,201922
13,2,117,14,105,170,37,189,5,637,637,1274,6,5.333333333,201922
13,3,153,14,166,232,106,172,0,843,1038,1881,12,5.25,201922
13,4,203,18,300,297,51,176,14,1059,1132,2191,9,5.666666667,201922
13,5,189,16,296,309,67,363,9,1249,1393,2642,9,5.75,201922
13,6,283,51,721,511,66,289,7,1928,1945,3873,11,5.666666667,201922
13,7,154,24,300,346,35,150,0,1009,1079,2088,8,5.5,201922
14,1,207,14,121,87,10,381,0,820,816,1636,6,5.5,201922
14,2,187,6,159,95,12,367,0,826,920,1746,5,5.666666667,201922
14,3,243,8,231,117,3,485,1,1088,1188,2276,8,5.4,201922
14,4,139,8,250,357,11,243,5,1013,1197,2210,10,6,201922
14,5,140,20,359,235,26,201,0,981,1159,2140,9,5.5,201922
14,6,219,10,435,305,16,248,0,1233,1510,2743,11,6,201922
14,7,137,8,180,165,0,194,0,684,714,1398,6,6,201922
14,8,341,29,650,734,12,678,1,2445,2638,5083,10,6,201922
14,9,125,14,186,268,13,231,0,837,833,1670,9,6,201922
14,10,186,16,395,314,7,374,0,1292,1339,2631,7,6,201922
14,11,138,7,163,202,16,250,12,788,761,1549,4,6,201922
14,12,259,13,429,220,11,296,0,1228,1402,2630,9,5.5,201922
14,13,207,11,272,237,8,327,5,1067,1171,2238,6,6,201922
14,14,168,14,269,332,12,369,6,1170,1210,2380,7,6,201922
14,15,195,29,193,199,18,337,2,973,1177,2150,10,5.6,201922
14,16,171,10,268,213,28,297,5,992,957,1949,5,6,201922
14,17,157,24,194,118,7,283,4,787,993,1780,7,5.25,201922
14,18,274,18,236,140,32,368,8,1076,1304,2380,9,5.4,201922
14,19,173,22,233,259,7,252,11,957,1205,2162,8,5.25,201922
14,20,183,7,254,208,9,309,3,973,1235,2208,10,5.666666667,201922
15,1,167,10,176,89,124,306,0,872,950,1822,7,5.333333333,201922
15,2,106,16,287,359,21,191,7,987,997,1984,6,6,201922
15,3,223,12,216,295,124,452,22,1344,1352,2696,10,5.666666667,201922
15,4,191,12,259,326,21,304,4,1117,1149,2266,4,6,201922
15,5,168,24,264,323,25,286,4,1094,1045,2139,8,5.666666667,201922
15,6,156,12,334,455,36,212,6,1211,1206,2417,7,6,201922
15,7,137,16,273,332,41,241,1,1041,1018,2059,10,6,201922
15,8,82,8,153,225,5,142,5,620,672,1292,4,6,201922
15,9,222,9,142,213,100,243,11,940,1051,1991,9,5.75,201922
15,10,133,11,231,265,43,242,10,935,831,1766,6,6,201922
15,11,172,15,311,393,38,244,1,1174,1295,2469,8,6,201922
15,12,211,15,508,511,40,208,0,1493,1564,3057,8,6,201922
15,13,83,6,186,209,75,202,0,761,738,1499,8,6,201922
15,14,89,15,169,236,6,146,4,665,677,1342,4,6,201922
15,15,188,39,302,417,29,307,2,1284,1244,2528,6,6,201922
15,16,186,26,389,647,25,297,6,1576,1639,3215,8,6,201922
15,17,103,13,207,289,12,247,9,880,972,1852,8,6,201922
15,18,230,20,281,460,22,320,1,1334,1321,2655,7,5.666666667,201922
15,19,212,35,437,640,24,373,10,1731,1661,3392,10,6,201922
15,20,85,9,207,306,9,155,0,771,745,1516,6,6,201922
15,21,112,13,134,218,20,131,12,640,664,1304,6,5.5,201922
15,22,238,38,532,752,20,456,11,2047,2166,4213,14,6,201922
15,23,148,15,186,331,18,282,1,981,1018,1999,6,5.333333333,201922
15,24,124,30,243,271,18,148,3,837,864,1701,4,6,201922
15,25,164,11,244,254,44,145,11,873,879,1752,6,6,201922
15,26,132,10,242,287,37,248,4,960,1006,1966,9,7,201922
15,27,188,22,414,504,31,394,34,1587,1407,2994,9,5.666666667,201922
15,28,198,11,460,354,35,305,1,1364,1459,2823,9,5.666666667,201922
15,29,199,27,409,601,11,326,3,1576,1740,3316,8,6,201922
15,30,192,27,422,514,44,233,5,1437,1577,3014,16,6,201922
15,31,123,27,199,278,22,170,0,819,914,1733,6,6,201922
15,32,164,15,253,413,29,171,4,1049,1040,2089,9,6,201922
15,33,167,9,345,361,16,205,0,1103,1176,2279,7,6,201922
15,34,126,17,209,390,17,220,6,985,1044,2029,8,6,201922
15,35,310,15,264,411,6,456,0,1462,1534,2996,9,5.666666667,201922
15,36,225,20,219,258,36,209,0,967,1205,2172,9,5.5,201922
15,37,206,18,360,544,36,331,23,1518,1446,2964,7,6,201922
15,38,170,16,234,347,14,227,3,1011,994,2005,6,5.5,201922
15,39,142,25,268,345,15,161,0,956,941,1897,4,6,201922
15,40,299,27,323,456,65,586,0,1756,1559,3315,9,6,201922
15,41,272,30,522,572,32,281,8,1717,1662,3379,13,6,201922
16,1,167,11,164,154,11,188,0,695,912,1607,7,5.333333333,201922
16,2,145,20,99,170,7,211,0,652,669,1321,9,5.25,201922
16,3,231,17,158,292,19,173,0,890,917,1807,10,5.25,201922
16,4,187,25,211,163,30,355,0,971,922,1893,8,5.5,201922
16,5,222,67,218,149,122,188,5,971,1079,2050,10,5.666666667,201922
16,6,180,27,169,252,15,184,0,827,848,1675,12,5.5,201922
16,7,208,19,145,190,19,231,0,812,716,1528,9,5.5,201922
16,8,268,25,505,474,4,302,2,1580,1685,3265,12,6,201922
16,9,206,17,276,261,11,316,7,1094,1094,2188,9,6,201922
16,10,112,12,232,263,6,168,0,793,940,1733,6,6,201922
16,11,244,15,189,148,59,366,0,1021,1315,2336,10,5.4,201922
16,12,240,20,224,160,28,229,0,901,992,1893,10,5.25,201922
17,1,205,17,396,398,13,292,0,1321,1361,2682,9,7,201922
17,2,151,13,318,351,19,152,6,1010,1153,2163,8,5.666666667,201922
17,3,229,19,425,505,12,284,4,1478,1542,3020,8,5.5,201922
17,4,244,19,379,401,13,245,0,1301,1473,2774,10,5.666666667,201922
17,5,92,4,155,165,8,111,0,535,676,1211,5,5.5,201922
18,1,138,17,124,139,16,136,2,572,554,1126,7,5.25,201922
18,2,237,24,356,339,38,265,0,1259,1330,2589,9,6.333333333,201922
18,3,145,9,311,198,6,175,0,844,1019,1863,8,5.5,201922
19,1,180,15,310,337,15,405,5,1267,1393,2660,9,6,201922
19,2,283,10,667,424,10,475,0,1869,1831,3700,9,6,201922
19,3,268,9,597,340,20,438,1,1673,1615,3288,7,6,201922
19,4,141,8,164,150,24,280,26,793,806,1599,5,6,201922
19,5,341,32,576,643,19,520,18,2149,2204,4353,8,6,201922
19,6,73,13,190,246,4,230,0,756,880,1636,5,6,201922
19,7,178,11,422,208,6,236,0,1061,1103,2164,10,5.5,201922
19,8,84,12,167,160,1,157,0,581,632,1213,7,6,201922
19,9,194,11,201,227,24,238,1,896,770,1666,9,5.25,201922
19,10,127,13,198,187,9,314,7,855,882,1737,6,7,201922
19,11,348,44,648,716,33,800,11,2600,2770,5370,13,6,201922
19,12,171,9,579,205,7,251,2,1224,1313,2537,8,5.666666667,201922
20,1,171,11,210,233,46,196,30,897,809,1706,7,5.5,201922
20,2,181,20,225,217,17,176,0,836,730,1566,6,5.333333333,201922
20,3,146,11,173,152,71,110,29,692,633,1325,6,5.333333333,201922
20,4,177,10,114,213,38,206,20,778,585,1363,6,5.333333333,201922
20,5,135,12,187,388,42,122,0,886,831,1717,11,5.25,201922
20,6,139,11,227,219,220,100,2,918,1293,2211,8,5.25,201922
20,7,149,14,160,268,9,188,0,788,943,1731,7,5.75,201922
20,8,382,28,420,875,26,451,37,2219,2565,4784,14,6.5,201922
20,9,279,19,188,234,37,265,29,1051,976,2027,8,5.666666667,201922
20,10,238,11,169,248,8,206,0,880,887,1767,9,5.25,201922
21,1,0,0,0,1,0,0,0,1,41,42,2,6,201922
21,2,0,0,0,0,0,0,0,0,59,59,1,6,201922
21,3,0,0,0,0,0,0,0,0,72,72,2,6,201922
21,4,0,0,0,0,0,0,0,0,43,43,1,6,201922
21,5,5,0,5,5,0,1,0,16,251,267,2,6,201922
21,6,0,0,0,0,0,0,0,0,181,181,1,5,201922
21,7,0,0,0,0,0,0,0,0,194,194,2,6,201922
21,8,0,0,0,0,0,0,0,0,58,58,1,6,201922
21,9,0,0,0,0,0,0,0,0,217,217,2,6,201922
21,10,0,0,0,0,0,0,0,0,334,334,1,5,201922
21,11,0,0,0,0,0,0,0,0,121,121,1,6,201922
21,12,0,0,0,0,0,0,0,0,545,545,2,5.5,201922
21,13,0,0,0,0,0,0,0,0,216,216,2,6,201922
21,14,0,0,0,0,0,0,0,0,55,55,2,6,201922
21,15,0,0,0,0,0,0,0,0,125,125,1,6,201922
22,1,150,33,127,319,13,99,1,742,909,1651,11,5.2,201922
22,2,177,17,311,276,25,159,4,969,997,1966,7,5.5,201922
22,3,225,31,665,554,17,320,0,1812,2044,3856,9,5.666666667,201922
22,4,164,36,541,452,23,246,1,1463,1514,2977,9,6.5,201922
22,5,133,24,361,241,60,191,9,1019,1064,2083,10,5.5,201922
23,1,57,4,309,141,10,20,15,556,366,922,10,6,201922
23,2,21,1,45,106,3,4,6,186,189,375,4,6,201922
23,3,30,1,61,41,2,6,6,147,691,838,15,6,201922
23,4,34,0,135,0,5,12,10,196,191,387,5,7,201922
24,1,163,37,136,249,20,98,2,705,826,1531,10,5.2,201922
24,2,154,18,237,184,2,199,1,795,742,1537,6,5.5,201922
24,3,138,33,121,180,47,102,0,621,717,1338,9,5.25,201922
24,4,193,15,173,200,34,292,23,930,743,1673,5,5.5,201922
24,5,292,31,404,558,16,404,0,1705,1732,3437,10,6.333333333,201922
24,6,216,26,353,435,25,351,0,1406,1323,2729,7,7,201922
24,7,266,27,240,420,26,137,0,1116,1087,2203,9,5.25,201922
25,1,163,10,199,264,19,231,5,891,925,1816,13,5.75,201922
25,2,264,25,341,430,17,343,0,1420,1425,2845,7,5.5,201922
25,3,218,18,279,380,33,252,9,1189,937,2126,8,5.6,201922
25,4,191,9,156,251,10,240,0,857,660,1517,8,5.333333333,201922
25,5,181,10,223,335,13,218,0,980,1103,2083,8,5.666666667,201922
25,6,182,10,288,274,44,274,2,1074,1120,2194,8,5.75,201922
25,7,259,18,370,479,12,305,0,1443,1483,2926,6,6,201922
26,1,230,8,326,295,7,329,0,1195,1098,2293,9,5.5,201922
26,2,249,11,444,473,5,270,11,1463,1326,2789,12,5.4,201922
26,3,246,9,315,524,9,498,13,1614,1555,3169,14,6.5,201922
26,4,158,9,140,225,22,297,8,859,912,1771,9,5.2,201922
26,5,143,10,206,227,15,262,0,863,893,1756,15,6,201922
26,6,186,12,329,326,0,425,0,1278,1179,2457,10,5.333333333,201922
26,7,139,14,164,247,42,183,0,789,789,1578,10,5.5,201922
27,1,135,9,234,246,57,170,2,853,1026,1879,8,5.5,201922
27,2,183,17,250,465,26,154,1,1096,1321,2417,8,5.666666667,201922
27,3,194,14,202,438,4,192,0,1044,1035,2079,7,5.666666667,201922
27,4,276,18,465,818,28,321,7,1933,1648,3581,8,6,201922
27,5,82,2,135,200,5,94,0,518,602,1120,6,5.333333333,201922
27,6,148,11,209,396,10,185,0,959,1085,2044,7,5.5,201922
28,1,35,6,88,135,5,14,0,283,263,546,13,6,201922
28,2,70,11,145,117,9,18,69,439,149,588,11,6,201922
28,3,25,4,24,63,1,4,0,121,79,200,3,6,201922
28,4,52,5,87,125,11,16,34,330,207,537,15,6,201922
28,5,12,2,18,50,1,9,17,109,188,297,4,6,201922
28,6,20,6,15,38,1,4,0,84,36,120,4,6,201922
28,7,51,7,144,175,16,25,24,442,239,681,13,6,201922
28,8,21,8,49,77,4,12,7,178,173,351,11,7,201922
28,9,31,0,63,61,8,7,5,175,58,233,9,6,201922
29,1,230,35,346,423,54,273,4,1365,1425,2790,7,5.5,201922
29,2,201,19,256,508,30,258,47,1319,1541,2860,11,6,201922
29,3,118,15,201,368,17,185,0,904,834,1738,5,5.666666667,201922
30,1,115,4,150,155,0,117,3,544,414,958,7,5.333333333,201922
30,2,157,11,104,108,22,159,36,597,613,1210,8,5.25,201922
30,3,171,6,275,168,25,212,24,881,874,1755,6,5.666666667,201922
30,4,88,5,199,182,29,159,0,662,765,1427,8,6,201922
30,5,158,11,190,284,10,248,0,901,1053,1954,7,5.5,201922
30,6,177,7,193,189,29,190,2,787,814,1601,9,5.333333333,201922
30,7,208,17,300,207,50,208,20,1010,963,1973,11,5.25,201922
30,8,190,8,277,333,41,266,18,1133,1153,2286,11,5.4,201922
30,9,220,5,198,236,30,277,25,991,943,1934,8,5.5,201922
30,10,134,9,247,253,29,222,29,923,941,1864,7,6.5,201922
30,11,113,3,292,347,8,202,0,965,1102,2067,5,5.5,201922
30,12,209,15,443,532,16,356,1,1572,1789,3361,10,6,201922
30,13,171,16,163,282,65,249,45,991,1070,2061,10,5.4,201922
30,14,127,10,214,192,52,243,6,844,1074,1918,8,5.5,201922
30,15,265,16,246,286,37,415,31,1296,1440,2736,11,5.666666667,201922
30,16,167,12,264,399,66,364,43,1315,1145,2460,10,5.333333333,201922
30,17,133,17,198,322,25,225,17,937,910,1847,8,5.5,201922
30,18,193,6,138,211,5,218,10,781,837,1618,8,5.25,201922
30,19,178,8,329,197,9,256,20,997,1018,2015,13,5.6,201922
30,20,139,7,219,330,80,192,0,967,1210,2177,10,5.4,201922
31,1,200,16,205,49,203,236,0,909,764,1673,8,5.5,201922
31,2,77,8,67,3,113,106,0,374,449,823,6,5.333333333,201922
31,3,354,35,858,613,92,565,0,2517,2683,5200,21,6.333333333,201922
31,4,91,15,256,200,58,193,16,829,854,1683,4,6,201922
31,5,131,11,101,172,31,192,0,638,815,1453,6,5.333333333,201922
32,1,180,26,169,166,21,218,8,788,885,1673,12,5.2,201922
32,2,168,21,114,94,40,228,6,671,917,1588,13,5.142857143,201922
32,3,221,34,186,279,6,299,0,1025,1151,2176,13,5.4,201922
32,4,196,27,170,249,15,246,12,915,962,1877,13,5.4,201922
1,1,112,26,188,173,26,117,6,648,85,733,8,6.333333333,201923
1,2,264,59,576,411,50,348,19,1727,458,2185,10,6.333333333,201923
1,3,156,64,501,361,26,294,18,1420,180,1600,9,6,201923
2,1,211,12,362,297,20,209,0,1111,29,1140,11,6,201923
2,2,226,13,346,389,11,257,0,1242,27,1269,8,6.5,201923
2,3,220,17,412,316,19,230,40,1254,17,1271,10,6,201923
2,4,215,10,524,176,57,138,11,1131,9,1140,9,6,201923
2,5,356,25,793,354,100,339,10,1977,48,2025,13,6,201923
2,6,201,16,450,299,16,180,3,1165,17,1182,7,6,201923
2,7,244,6,447,253,23,223,71,1267,23,1290,10,6,201923
2,8,251,21,554,420,13,157,31,1447,52,1499,8,6,201923
3,1,206,19,347,320,11,299,0,1202,1230,2432,12,5.666666667,201923
3,2,145,19,522,243,15,173,0,1117,1151,2268,9,5.666666667,201923
4,1,210,19,261,398,47,248,51,1234,1217,2451,11,5.25,201923
4,2,145,5,361,407,64,160,63,1205,1393,2598,14,5.2,201923
5,1,217,10,407,334,18,251,13,1250,1184,2434,9,5.666666667,201923
5,2,155,13,211,283,24,181,0,867,717,1584,10,5.2,201923
5,3,207,13,278,384,27,292,17,1218,1042,2260,11,5.333333333,201923
5,4,243,21,524,481,11,364,14,1658,1648,3306,9,5.666666667,201923
5,5,183,18,345,416,13,162,20,1157,1190,2347,9,9,201923
5,6,147,11,271,315,9,156,42,951,1052,2003,11,5.5,201923
5,7,208,13,325,338,2,228,3,1117,947,2064,11,6,201923
6,1,161,27,271,233,13,268,7,980,961,1941,12,6,201923
6,2,139,17,401,205,41,246,8,1057,1053,2110,9,5.666666667,201923
7,1,241,4,166,279,14,45,6,755,953,1708,9,5.25,201923
7,2,281,20,124,874,30,97,0,1426,1867,3293,9,5.25,201923
7,3,229,1,186,183,98,139,2,838,1044,1882,7,5.333333333,201923
7,4,135,8,111,256,3,92,48,653,1227,1880,11,5.4,201923
7,5,294,16,147,416,14,140,0,1027,1209,2236,11,5.666666667,201923
7,6,277,10,315,439,16,233,12,1302,1421,2723,9,5.666666667,201923
7,7,203,25,280,396,32,183,10,1129,1110,2239,8,5.5,201923
7,8,251,5,201,385,9,230,10,1091,1437,2528,12,5.25,201923
7,9,168,14,298,413,16,225,3,1137,1152,2289,9,5.666666667,201923
7,10,257,5,183,461,14,106,0,1026,1347,2373,9,5.5,201923
7,11,128,1,73,86,17,94,10,409,481,890,6,5.333333333,201923
7,12,283,10,244,601,6,130,0,1274,1227,2501,9,5.5,201923
7,13,112,1,91,151,3,41,0,399,790,1189,9,5.25,201923
8,1,142,8,365,219,23,152,2,911,898,1809,4,6,201923
8,2,319,52,681,401,23,323,0,1799,1770,3569,16,5.5,201923
8,3,199,22,387,352,17,232,18,1227,1275,2502,4,6,201923
8,4,199,27,436,315,30,302,41,1350,1471,2821,11,6,201923
8,5,171,34,245,238,21,219,0,928,976,1904,10,5.25,201923
8,6,234,22,372,418,46,353,2,1447,1432,2879,7,6.5,201923
8,7,191,32,178,213,3,299,0,916,1030,1946,7,5.25,201923
8,8,189,31,353,385,18,288,0,1264,1249,2513,10,6,201923
8,9,161,12,134,125,8,274,0,714,754,1468,10,5.2,201923
9,1,72,6,160,157,42,162,2,601,665,1266,5,6,201923
9,2,283,94,726,974,86,544,11,2718,2674,5392,12,6,201923
9,3,144,31,369,503,66,296,24,1433,1497,2930,7,6,201923
9,4,195,16,372,507,72,233,17,1412,1528,2940,11,6,201923
9,5,137,13,259,309,58,220,0,996,1044,2040,7,6,201923
9,6,115,9,183,194,119,169,7,796,679,1475,7,6,201923
9,7,108,10,324,374,2,173,0,991,1059,2050,9,6,201923
9,8,82,22,302,326,19,185,13,949,952,1901,5,6,201923
9,9,99,5,214,334,36,165,2,855,858,1713,5,6,201923
9,10,103,19,312,352,26,202,2,1016,1028,2044,6,6,201923
9,11,140,8,393,556,44,338,0,1479,1539,3018,7,6,201923
9,12,127,30,511,658,25,294,29,1674,1763,3437,11,6,201923
9,13,112,13,289,350,60,214,19,1057,1022,2079,4,6,201923
9,14,110,10,186,268,50,226,11,861,817,1678,5,6,201923
9,15,207,29,846,966,42,498,8,2596,2690,5286,9,6.5,201923
9,16,243,59,481,731,60,394,0,1968,1943,3911,15,6,201923
9,17,129,5,244,322,33,184,0,917,1118,2035,6,6,201923
9,18,166,23,353,591,57,297,3,1490,1563,3053,12,6,201923
9,19,145,41,269,476,55,219,7,1212,1335,2547,5,6,201923
9,20,48,6,100,141,8,52,1,356,374,730,5,6,201923
9,21,111,10,185,294,28,161,7,796,847,1643,3,6,201923
9,22,138,8,237,335,81,157,28,984,1044,2028,5,6,201923
9,23,143,11,291,501,41,266,8,1261,1234,2495,6,6,201923
9,24,280,36,588,922,107,533,11,2477,2581,5058,12,6,201923
10,1,167,20,190,178,4,204,74,837,52,889,4,6,201923
10,2,127,18,187,203,15,150,19,719,12,731,4,6,201923
10,3,116,16,122,125,9,127,29,544,18,562,6,6,201923
10,4,253,48,349,412,14,212,5,1293,64,1357,11,6,201923
11,1,190,30,171,252,22,176,1,842,897,1739,6,5.666666667,201923
11,2,181,15,228,247,33,209,15,928,978,1906,7,6,201923
11,3,135,17,228,262,8,191,7,848,910,1758,3,6,201923
11,4,163,19,165,225,17,247,0,836,824,1660,8,6,201923
11,5,257,38,350,453,20,308,4,1430,1503,2933,7,6,201923
11,6,112,13,179,183,20,153,4,664,793,1457,8,6,201923
11,7,211,39,213,327,12,162,0,964,1209,2173,9,5.5,201923
11,8,170,30,260,382,33,243,0,1118,1025,2143,9,5.5,201923
11,9,198,63,330,393,25,275,20,1304,1386,2690,10,5.666666667,201923
11,10,175,28,255,291,24,310,18,1101,983,2084,10,5.6,201923
11,11,178,38,299,319,21,215,0,1070,1096,2166,5,6,201923
11,12,194,25,446,444,14,237,0,1360,1354,2714,7,6,201923
11,13,165,29,161,215,20,215,10,815,889,1704,8,5.25,201923
11,14,192,22,218,201,19,229,0,881,935,1816,8,5.5,201923
11,15,130,33,204,228,5,166,1,767,826,1593,9,6,201923
12,1,178,10,181,159,14,147,2,691,699,1390,10,5.2,201923
12,2,162,28,216,321,17,159,27,930,1140,2070,10,5.5,201923
12,3,164,25,218,387,10,108,0,912,841,1753,11,5.2,201923
12,4,134,29,313,570,31,162,0,1239,1223,2462,9,5.666666667,201923
12,5,209,19,157,227,5,127,12,756,1006,1762,10,5.25,201923
12,6,176,17,124,279,26,80,3,705,776,1481,10,5.25,201923
12,7,193,13,220,331,11,206,41,1015,1106,2121,6,5.5,201923
12,8,184,18,202,298,7,116,0,825,1124,1949,9,5.25,201923
12,9,174,26,235,510,18,148,0,1111,1148,2259,9,5.666666667,201923
13,1,181,10,165,238,35,238,44,911,918,1829,9,5.333333333,201923
13,2,130,10,112,161,20,175,1,609,750,1359,6,5.333333333,201923
13,3,170,18,166,260,79,141,0,834,958,1792,12,5.25,201923
13,4,187,14,282,292,60,168,8,1011,962,1973,9,5.666666667,201923
13,5,222,15,401,369,80,378,13,1478,1494,2972,9,5.75,201923
13,6,234,61,623,512,102,249,5,1786,1897,3683,11,5.666666667,201923
13,7,127,12,279,345,37,138,0,938,978,1916,8,5.5,201923
14,1,192,12,110,91,10,366,0,781,933,1714,6,5.5,201923
14,2,209,21,143,97,22,317,2,811,901,1712,5,5.666666667,201923
14,3,222,11,214,99,6,387,1,940,1210,2150,8,5.4,201923
14,4,167,11,261,364,11,248,4,1066,1045,2111,10,6,201923
14,5,174,10,387,279,21,279,1,1151,1366,2517,9,5.5,201923
14,6,219,19,478,327,16,261,0,1320,1238,2558,11,6,201923
14,7,149,9,148,157,0,168,0,631,741,1372,6,6,201923
14,8,334,35,725,720,16,635,2,2467,2613,5080,11,6.25,201923
14,9,152,18,188,262,14,220,1,855,943,1798,11,6,201923
14,10,224,21,434,380,6,344,1,1410,1376,2786,7,6,201923
14,11,137,10,190,178,19,229,15,778,782,1560,4,6,201923
14,12,259,13,476,193,10,264,2,1217,1288,2505,9,5.5,201923
14,13,202,18,286,237,16,303,0,1062,1143,2205,6,6,201923
14,14,173,7,263,329,15,327,4,1118,1240,2358,7,6,201923
14,15,197,26,196,241,24,334,4,1022,1090,2112,10,5.6,201923
14,16,209,20,256,165,28,303,2,983,1045,2028,5,6,201923
14,17,131,11,210,94,23,225,5,699,788,1487,7,5.25,201923
14,18,293,17,292,137,36,361,10,1146,1196,2342,9,5.4,201923
14,19,219,24,231,269,20,264,20,1047,1020,2067,8,5.25,201923
14,20,180,14,281,208,5,240,0,928,1050,1978,10,5.666666667,201923
15,1,132,4,137,98,116,271,1,759,898,1657,7,5.333333333,201923
15,2,132,6,270,362,29,173,5,977,941,1918,6,6,201923
15,3,233,19,235,350,146,455,15,1453,1411,2864,10,5.666666667,201923
15,4,170,20,255,363,25,278,6,1117,1159,2276,4,6,201923
15,5,139,26,228,285,17,233,2,930,1034,1964,8,5.666666667,201923
15,6,157,13,301,427,37,241,6,1182,1190,2372,7,6,201923
15,7,142,13,238,294,28,217,0,932,943,1875,10,6,201923
15,8,87,17,182,210,11,105,4,616,619,1235,4,6,201923
15,9,222,9,128,188,102,250,6,905,879,1784,9,5.75,201923
15,10,120,8,209,255,37,183,3,815,861,1676,6,6,201923
15,11,185,12,283,415,47,207,0,1149,1210,2359,8,6,201923
15,12,212,16,439,536,30,200,0,1433,1525,2958,8,6,201923
15,13,86,6,176,201,72,200,1,742,762,1504,8,6,201923
15,14,88,19,157,228,9,135,3,639,685,1324,4,6,201923
15,15,174,42,303,411,27,247,4,1208,1232,2440,6,6,201923
15,16,203,31,386,593,22,223,5,1463,1469,2932,8,6,201923
15,17,102,24,198,275,18,206,17,840,912,1752,8,6,201923
15,18,209,15,291,490,25,341,5,1376,1309,2685,7,5.666666667,201923
15,19,201,45,410,633,20,336,12,1657,1737,3394,10,6,201923
15,20,69,10,190,272,10,172,2,725,766,1491,6,6,201923
15,21,96,9,124,209,24,109,13,584,525,1109,6,5.5,201923
15,22,255,43,548,762,16,419,8,2051,2062,4113,14,6,201923
15,23,167,18,248,359,15,309,0,1116,1038,2154,6,5.333333333,201923
15,24,124,25,257,249,29,142,3,829,823,1652,4,6,201923
15,25,134,23,225,288,43,139,15,867,998,1865,6,6,201923
15,26,107,4,231,275,38,227,0,882,896,1778,9,7,201923
15,27,199,17,360,505,19,388,33,1521,1449,2970,9,5.666666667,201923
15,28,185,18,487,360,44,310,0,1404,1449,2853,9,5.666666667,201923
15,29,189,19,427,581,4,299,1,1520,1568,3088,8,6,201923
15,30,191,27,385,478,38,206,8,1333,1378,2711,16,6,201923
15,31,125,47,208,251,22,180,0,833,872,1705,6,6,201923
15,32,140,10,244,436,25,161,3,1019,1050,2069,9,6,201923
15,33,146,7,309,365,29,227,0,1083,1099,2182,7,6,201923
15,34,135,16,212,410,11,221,6,1011,1009,2020,8,6,201923
15,35,240,18,253,376,10,347,0,1244,1370,2614,9,5.666666667,201923
15,36,213,16,216,227,33,204,0,909,988,1897,9,5.5,201923
15,37,194,24,313,527,48,277,20,1403,1433,2836,7,6,201923
15,38,146,25,231,354,19,222,7,1004,1037,2041,6,5.5,201923
15,39,116,24,250,341,13,117,1,862,910,1772,4,6,201923
15,40,283,20,298,450,81,569,0,1701,1595,3296,9,6,201923
15,41,237,27,502,579,42,235,7,1629,1725,3354,13,6,201923
16,1,147,10,188,174,26,180,0,725,688,1413,7,5.333333333,201923
16,2,90,16,102,148,3,143,0,502,529,1031,9,5.25,201923
16,3,202,16,172,249,22,181,0,842,904,1746,10,5.25,201923
16,4,172,15,196,145,20,299,0,847,750,1597,8,5.5,201923
16,5,197,22,199,237,16,271,7,949,944,1893,10,5.666666667,201923
16,6,153,12,182,240,27,167,0,781,767,1548,12,5.5,201923
16,7,190,15,157,207,44,255,0,868,869,1737,9,5.5,201923
16,8,254,24,503,466,6,334,5,1592,1683,3275,12,6,201923
16,9,199,23,257,264,8,298,7,1056,1125,2181,9,6,201923
16,10,128,11,235,261,10,174,0,819,895,1714,6,6,201923
16,11,176,20,165,139,51,343,1,895,980,1875,10,5.4,201923
16,12,196,18,172,192,14,217,1,810,806,1616,10,5.25,201923
17,1,163,26,390,379,22,268,0,1248,1377,2625,9,7,201923
17,2,117,14,319,364,19,180,0,1013,1069,2082,8,5.666666667,201923
17,3,257,18,409,505,14,273,1,1477,1568,3045,8,5.5,201923
17,4,203,7,344,371,30,259,3,1217,1244,2461,10,5.666666667,201923
17,5,104,3,142,153,12,107,0,521,599,1120,5,5.5,201923
18,1,153,16,150,176,23,146,6,670,780,1450,7,5.25,201923
18,2,239,19,360,405,40,273,0,1336,1252,2588,9,6.333333333,201923
18,3,200,13,350,222,10,239,0,1034,948,1982,8,5.5,201923
19,1,188,11,318,342,18,377,6,1260,1341,2601,9,6,201923
19,2,233,16,511,325,17,373,0,1475,1856,3331,9,6,201923
19,3,253,23,591,393,28,396,0,1684,1593,3277,7,6,201923
19,4,112,17,161,172,34,281,29,806,772,1578,5,6,201923
19,5,321,30,532,611,18,508,17,2037,2179,4216,8,6,201923
19,6,88,17,222,226,5,254,0,812,785,1597,5,6,201923
19,7,178,7,458,195,6,161,0,1005,997,2002,10,5.5,201923
19,8,90,6,182,202,1,162,0,643,606,1249,7,6,201923
19,9,173,13,182,153,9,211,1,742,704,1446,9,5.25,201923
19,10,128,11,174,217,5,308,8,851,949,1800,6,7,201923
19,11,418,56,574,699,27,865,13,2652,2814,5466,13,6,201923
19,12,202,17,559,221,15,262,1,1277,1286,2563,8,5.666666667,201923
20,1,195,6,208,185,30,151,21,796,757,1553,7,5.5,201923
20,2,99,8,92,119,2,111,1,432,879,1311,6,5.333333333,201923
20,3,94,9,135,124,41,80,24,507,697,1204,6,5.333333333,201923
20,4,113,7,88,132,21,159,15,535,530,1065,6,5.333333333,201923
20,5,144,5,193,239,70,92,0,743,847,1590,11,5.25,201923
20,6,114,8,137,232,146,84,0,721,1010,1731,8,5.25,201923
20,7,149,10,172,238,15,165,0,749,891,1640,7,5.75,201923
20,8,431,39,466,884,37,390,55,2302,2362,4664,14,6.5,201923
20,9,245,24,224,230,43,324,15,1105,964,2069,8,5.666666667,201923
20,10,181,10,252,264,11,188,2,908,1016,1924,9,5.25,201923
21,1,191,14,139,227,3,149,1,724,7,731,2,6,201923
21,2,116,7,80,74,7,50,0,334,3,337,1,6,201923
21,3,126,8,123,117,18,136,1,529,3,532,2,6,201923
21,4,33,2,32,18,5,43,0,133,1,134,1,6,201923
21,5,211,9,232,236,13,179,13,893,30,923,2,6,201923
21,6,49,4,81,118,17,85,26,380,13,393,1,6,201923
21,7,157,7,125,212,43,107,7,658,22,680,2,6,201923
21,8,59,3,58,60,5,59,16,260,3,263,1,6,201923
21,9,147,14,256,281,33,136,14,881,26,907,2,6,201923
21,10,83,5,75,108,5,61,19,356,19,375,1,6,201923
21,11,39,6,88,66,6,38,5,248,2,250,1,6,201923
21,12,123,14,272,316,20,157,33,935,49,984,2,6,201923
21,13,144,19,183,138,13,167,44,708,3,711,2,6,201923
21,14,73,6,85,81,22,133,5,405,5,410,2,6,201923
21,15,77,9,136,148,8,76,3,457,7,464,1,6,201923
22,1,122,55,142,331,15,117,1,783,895,1678,11,5.2,201923
22,2,124,17,241,261,45,167,0,855,924,1779,7,5.5,201923
22,3,217,30,614,596,19,285,0,1761,1780,3541,9,5.666666667,201923
22,4,192,26,564,502,24,263,0,1571,1469,3040,9,6.5,201923
22,5,168,19,323,249,43,183,16,1001,1039,2040,10,5.5,201923
23,1,163,5,639,201,20,111,22,1161,55,1216,10,6,201923
23,2,110,13,170,197,7,62,2,561,22,583,4,6,201923
23,3,171,5,445,239,25,125,15,1025,64,1089,15,4,201923
23,4,151,3,495,275,43,133,12,1112,9,1121,4,6,201923
24,1,128,34,119,198,13,73,1,566,721,1287,10,5.2,201923
24,2,127,13,203,149,5,171,0,668,785,1453,6,5.5,201923
24,3,171,27,179,240,49,127,1,794,850,1644,9,5.25,201923
24,4,130,11,167,195,28,213,24,768,972,1740,5,5.5,201923
24,5,265,25,465,531,15,342,0,1643,1607,3250,9,6,201923
24,6,178,22,317,396,21,249,0,1183,1294,2477,6,6,201923
24,7,203,37,181,422,36,132,0,1011,1099,2110,9,5.25,201923
25,1,165,12,238,262,13,227,5,922,967,1889,13,5.75,201923
25,2,247,24,338,456,12,361,0,1438,1369,2807,7,5.5,201923
25,3,205,17,243,332,30,243,6,1076,1243,2319,8,5.6,201923
25,4,155,14,147,246,19,208,0,789,875,1664,8,5.333333333,201923
25,5,165,12,253,384,22,208,0,1044,1084,2128,8,5.666666667,201923
25,6,221,11,317,300,37,297,7,1190,1160,2350,8,5.75,201923
25,7,232,18,366,479,15,323,0,1433,1513,2946,6,6,201923
26,1,178,13,302,231,7,297,0,1028,1067,2095,9,5.5,201923
26,2,221,13,405,413,1,227,3,1283,1179,2462,12,5.4,201923
26,3,233,22,299,519,13,487,10,1583,1676,3259,13,6,201923
26,4,169,22,144,264,10,298,5,912,755,1667,9,5.2,201923
26,5,173,10,169,231,18,290,0,891,932,1823,15,6,201923
26,6,192,9,298,300,3,360,0,1162,1260,2422,10,5.333333333,201923
26,7,153,9,162,255,24,157,0,760,799,1559,10,5.5,201923
27,1,166,11,229,343,71,188,2,1010,1227,2237,8,5.25,201923
27,2,236,11,297,466,23,179,1,1213,1195,2408,8,5.666666667,201923
27,3,219,8,207,451,8,211,0,1104,1079,2183,7,5.666666667,201923
27,4,201,12,441,766,15,315,8,1758,1662,3420,8,6,201923
27,5,106,6,133,307,14,121,0,687,745,1432,6,5.333333333,201923
27,6,183,23,257,442,10,251,0,1166,1099,2265,7,5.5,201923
28,1,286,34,495,450,9,260,2,1536,38,1574,13,6,201923
28,2,168,22,302,259,12,155,71,989,30,1019,11,6,201923
28,3,54,8,80,91,1,93,3,330,4,334,3,6,201923
28,4,273,32,350,301,31,242,89,1318,14,1332,15,6,201923
28,5,85,9,117,203,10,146,35,605,11,616,4,6,201923
28,6,54,14,77,75,9,47,4,280,4,284,4,6,201923
28,7,136,22,284,301,29,185,18,975,63,1038,13,6,201923
28,8,63,15,140,187,16,102,5,528,42,570,12,8,201923
28,9,136,10,298,173,18,220,26,881,4,885,9,6,201923
29,1,184,28,295,430,44,238,4,1223,1303,2526,7,5.5,201923
29,2,210,18,263,505,32,270,42,1340,1369,2709,10,5.666666667,201923
29,3,123,20,115,298,9,148,0,713,904,1617,5,5.666666667,201923
30,1,103,12,121,167,13,117,2,535,597,1132,7,5.333333333,201923
30,2,162,12,116,136,32,167,59,684,693,1377,8,5.25,201923
30,3,147,8,198,171,41,225,34,824,734,1558,6,5.666666667,201923
30,4,84,5,247,175,22,145,0,678,715,1393,8,6,201923
30,5,115,7,188,250,15,221,0,796,876,1672,7,5.5,201923
30,6,128,3,192,208,25,142,4,702,699,1401,9,5.333333333,201923
30,7,190,11,213,245,40,284,23,1006,1081,2087,11,5.25,201923
30,8,190,13,247,338,35,308,4,1135,1319,2454,11,5.4,201923
30,9,185,13,191,198,36,289,28,940,988,1928,8,5.5,201923
30,10,111,8,244,322,23,227,20,955,916,1871,6,6,201923
30,11,139,19,272,361,16,209,0,1016,997,2013,5,5.5,201923
30,12,184,12,436,581,24,365,0,1602,1685,3287,10,6,201923
30,13,164,13,153,283,27,288,60,988,1123,2111,10,5.4,201923
30,14,145,5,235,177,63,208,9,842,962,1804,8,5.5,201923
30,15,243,10,268,326,33,429,40,1349,1460,2809,11,5.666666667,201923
30,16,179,6,246,342,44,295,56,1168,1151,2319,10,5.333333333,201923
30,17,186,17,234,308,30,295,8,1078,1146,2224,8,5.5,201923
30,18,133,6,105,164,9,171,11,599,681,1280,8,5,201923
30,19,164,5,239,237,5,277,1,928,962,1890,13,5.6,201923
30,20,172,5,226,398,95,196,0,1092,1121,2213,10,5.4,201923
31,1,192,18,206,37,214,202,0,869,778,1647,8,5.5,201923
31,2,83,10,152,13,159,128,0,545,537,1082,6,5.333333333,201923
31,3,337,49,966,614,100,510,0,2576,2341,4917,20,6,201923
31,4,109,9,244,244,51,210,11,878,911,1789,4,6,201923
31,5,149,8,118,196,33,248,0,752,695,1447,6,5.333333333,201923
32,1,156,21,170,191,21,261,17,837,867,1704,12,5.2,201923
32,2,211,26,145,134,33,251,16,816,752,1568,13,5.142857143,201923
32,3,163,45,178,277,5,251,1,920,1083,2003,13,5.4,201923
32,4,146,29,206,235,11,238,15,880,897,1777,13,5.4,201923
1,1,329,68,354,328,49,257,9,1394,2268,3662,13,5.5,201924
1,2,361,58,704,486,62,473,16,2160,4313,6473,10,7.666666667,201924
1,3,238,64,616,366,23,429,7,1743,3858,5601,9,6,201924
2,1,246,13,358,293,9,217,0,1136,2684,3820,11,6,201924
2,2,244,13,353,356,4,303,0,1273,413,1686,7,6,201924
2,3,306,22,508,367,17,377,31,1628,483,2111,12,6,201924
2,4,226,7,577,212,64,184,9,1279,828,2107,9,6,201924
2,5,397,27,815,401,89,377,6,2112,474,2586,13,6,201924
2,6,306,15,542,326,13,219,0,1421,346,1767,7,6,201924
2,7,305,14,523,319,18,283,71,1533,554,2087,12,5.75,201924
2,8,313,13,635,459,20,251,23,1714,471,2185,8,6,201924
3,1,203,15,306,333,22,255,0,1134,977,2111,12,5.666666667,201924
3,2,187,18,516,234,21,125,0,1101,1029,2130,9,5.666666667,201924
4,1,170,15,202,360,38,208,39,1032,821,1853,11,5.25,201924
4,2,155,8,313,293,21,171,49,1010,1047,2057,14,5.2,201924
5,1,234,11,394,319,25,256,9,1248,1173,2421,9,5.666666667,201924
5,2,187,16,234,377,20,150,0,984,987,1971,10,5.2,201924
5,3,219,17,295,339,26,255,13,1164,963,2127,11,5.333333333,201924
5,4,255,19,471,483,16,333,10,1587,1542,3129,9,5.666666667,201924
5,5,190,9,339,443,10,175,22,1188,981,2169,9,9,201924
5,6,130,21,282,364,13,153,28,991,805,1796,11,5.5,201924
5,7,228,14,282,367,6,240,2,1139,1015,2154,10,5.5,201924
6,1,154,14,240,250,9,247,12,926,979,1905,12,6,201924
6,2,166,10,349,203,27,304,8,1067,1130,2197,9,5.666666667,201924
7,1,252,4,127,277,11,44,2,717,597,1314,9,5.25,201924
7,2,165,10,253,534,21,52,0,1035,893,1928,9,5.25,201924
7,3,264,5,236,259,146,152,1,1063,1070,2133,7,5.333333333,201924
7,4,238,15,203,346,8,162,98,1070,667,1737,11,5.4,201924
7,5,318,5,170,581,16,134,1,1225,734,1959,11,5.666666667,201924
7,6,285,14,308,460,34,261,6,1368,1089,2457,9,5.666666667,201924
7,7,241,7,232,359,76,162,12,1089,939,2028,8,5.5,201924
7,8,242,7,160,488,11,188,5,1101,838,1939,12,5.25,201924
7,9,227,17,280,421,13,227,2,1187,1060,2247,9,5.666666667,201924
7,10,186,7,157,359,15,80,0,804,1231,2035,9,5.5,201924
7,11,101,4,70,97,14,77,7,370,581,951,6,5.333333333,201924
7,12,280,8,274,562,11,140,0,1275,856,2131,9,5.5,201924
7,13,125,12,119,261,3,50,0,570,293,863,9,5.25,201924
8,1,140,5,297,192,32,137,9,812,636,1448,4,6,201924
8,2,308,26,569,426,17,68,173,1587,1294,2881,16,5.5,201924
8,3,194,21,373,349,27,209,10,1183,939,2122,4,6,201924
8,4,179,23,368,280,26,282,38,1196,1181,2377,11,6,201924
8,5,212,27,244,221,12,216,0,932,694,1626,10,5.25,201924
8,6,249,20,372,404,32,314,0,1391,1175,2566,7,6.5,201924
8,7,199,46,168,183,6,266,0,868,871,1739,7,5.25,201924
8,8,216,24,337,357,9,247,3,1193,991,2184,10,6,201924
8,9,239,17,165,118,11,359,8,917,765,1682,10,5.2,201924
9,1,103,7,180,177,50,163,4,684,678,1362,5,6,201924
9,2,321,58,778,999,91,492,7,2746,2515,5261,12,6,201924
9,3,171,25,369,451,53,324,17,1410,1202,2612,7,6,201924
9,4,209,12,400,570,59,231,10,1491,1210,2701,11,6,201924
9,5,139,10,287,358,49,202,0,1045,921,1966,7,6,201924
9,6,114,9,187,186,107,176,6,785,639,1424,7,6,201924
9,7,107,9,282,410,0,219,0,1027,919,1946,9,6,201924
9,8,99,10,308,382,10,168,7,984,901,1885,5,6,201924
9,9,140,8,227,302,29,140,1,847,741,1588,5,6,201924
9,10,134,14,304,356,15,215,2,1040,919,1959,6,6,201924
9,11,156,19,461,571,44,303,0,1554,1431,2985,7,6,201924
9,12,171,15,580,647,27,283,25,1748,1541,3289,11,6,201924
9,13,119,10,268,354,71,203,22,1047,927,1974,4,6,201924
9,14,116,5,193,270,40,205,9,838,790,1628,5,6,201924
9,15,248,25,782,1004,34,469,7,2569,2363,4932,9,6.5,201924
9,16,251,39,420,729,68,342,0,1849,1869,3718,15,6,201924
9,17,125,13,205,335,26,188,1,893,939,1832,6,6,201924
9,18,155,17,312,614,38,271,2,1409,1341,2750,12,6,201924
9,19,180,24,339,508,65,226,9,1351,1222,2573,5,6,201924
9,20,53,9,91,131,12,65,3,364,355,719,5,6,201924
9,21,133,10,168,273,25,145,5,759,728,1487,3,6,201924
9,22,157,8,212,362,62,192,22,1015,928,1943,5,6,201924
9,23,153,16,312,528,39,236,5,1289,1106,2395,6,6,201924
9,24,322,22,592,823,97,457,4,2317,2395,4712,12,6,201924
10,1,379,94,412,370,41,357,136,1789,1808,3597,12,5.166666667,201924
10,2,306,25,380,315,12,351,14,1403,1422,2825,9,5.25,201924
10,3,293,43,296,299,24,319,73,1347,1864,3211,11,5.4,201924
10,4,357,43,448,503,11,334,6,1702,3102,4804,12,7,201924
11,1,233,32,191,205,9,147,3,820,770,1590,6,5.666666667,201924
11,2,209,20,241,206,16,193,23,908,814,1722,7,6,201924
11,3,194,21,211,279,7,199,13,924,800,1724,3,6,201924
11,4,183,24,153,249,25,210,3,847,812,1659,8,6,201924
11,5,280,42,379,479,23,309,1,1513,1337,2850,7,6,201924
11,6,132,14,198,247,22,174,3,790,663,1453,8,6,201924
11,7,230,57,262,594,34,185,1,1363,921,2284,9,5.5,201924
11,8,226,34,247,356,24,224,0,1111,907,2018,9,5.5,201924
11,9,269,52,330,401,11,227,29,1319,1190,2509,10,5.666666667,201924
11,10,247,35,247,239,19,295,11,1093,841,1934,10,5.6,201924
11,11,200,43,341,361,20,238,0,1203,946,2149,5,6,201924
11,12,224,20,394,498,10,237,0,1383,1230,2613,7,6,201924
11,13,206,38,177,190,14,249,14,888,724,1612,8,5.5,201924
11,14,177,28,215,200,15,248,0,883,790,1673,8,5.5,201924
11,15,168,21,196,266,5,158,0,814,699,1513,9,6,201924
12,1,170,18,186,150,69,156,4,753,674,1427,10,5.2,201924
12,2,276,30,224,380,17,217,4,1148,924,2072,10,5.5,201924
12,3,160,17,244,419,22,119,0,981,857,1838,11,5.2,201924
12,4,206,25,308,476,20,158,0,1193,1054,2247,9,5.666666667,201924
12,5,257,30,324,308,2,157,6,1084,747,1831,10,5.25,201924
12,6,300,25,185,620,21,77,9,1237,669,1906,10,5.25,201924
12,7,377,22,264,356,12,208,59,1298,1141,2439,6,5.5,201924
12,8,236,20,206,321,6,113,0,902,884,1786,9,5.25,201924
12,9,198,13,243,453,22,123,0,1052,997,2049,9,5.666666667,201924
13,1,212,22,147,301,25,194,24,925,817,1742,9,5.333333333,201924
13,2,104,3,105,162,28,158,2,562,487,1049,6,5.333333333,201924
13,3,160,11,191,263,82,123,0,830,633,1463,12,5.25,201924
13,4,194,19,281,317,47,174,8,1040,797,1837,9,5.666666667,201924
13,5,256,26,344,332,78,335,12,1383,935,2318,9,5.75,201924
13,6,276,40,676,569,93,268,5,1927,1461,3388,11,5.666666667,201924
13,7,156,16,322,365,19,113,0,991,843,1834,8,5.5,201924
14,1,175,15,128,91,10,344,0,763,821,1584,6,5.5,201924
14,2,217,14,174,108,11,343,0,867,866,1733,5,5.666666667,201924
14,3,291,11,222,96,1,422,0,1043,944,1987,8,5.4,201924
14,4,182,10,255,348,18,242,4,1059,1000,2059,10,6,201924
14,5,207,9,406,259,23,230,0,1134,1157,2291,9,5.5,201924
14,6,245,11,419,335,9,225,0,1244,1063,2307,11,6,201924
14,7,156,5,165,157,0,155,0,638,594,1232,6,6,201924
14,8,385,41,705,728,5,620,0,2484,2111,4595,11,6.25,201924
14,9,138,8,181,248,16,198,3,792,723,1515,11,6,201924
14,10,236,20,377,360,8,345,3,1349,1185,2534,7,6,201924
14,11,128,10,160,229,25,198,19,769,688,1457,4,6,201924
14,12,274,14,439,229,12,252,3,1223,1195,2418,9,5.5,201924
14,13,239,15,301,256,7,313,1,1132,886,2018,6,6,201924
14,14,171,13,245,296,16,310,2,1053,1165,2218,7,6,201924
14,15,258,32,207,203,20,350,3,1073,981,2054,10,5.6,201924
14,16,187,18,267,181,24,269,6,952,822,1774,5,6,201924
14,17,181,6,213,109,13,198,8,728,811,1539,7,5.25,201924
14,18,233,30,265,165,41,371,12,1117,1018,2135,9,5.4,201924
14,19,217,23,237,269,19,236,6,1007,961,1968,8,5.25,201924
14,20,214,16,276,210,6,257,3,982,984,1966,10,5.666666667,201924
15,1,211,5,182,117,124,312,2,953,967,1920,7,5.333333333,201924
15,2,143,14,259,345,38,176,7,982,885,1867,6,6,201924
15,3,306,21,214,313,127,443,21,1445,1331,2776,10,5.666666667,201924
15,4,189,11,260,338,24,304,5,1131,954,2085,4,6,201924
15,5,175,19,235,319,26,225,2,1001,899,1900,8,5.666666667,201924
15,6,183,9,310,490,35,201,6,1234,1097,2331,7,6,201924
15,7,167,14,233,310,33,192,0,949,930,1879,10,6,201924
15,8,105,10,172,218,11,94,7,617,551,1168,4,6,201924
15,9,279,11,161,192,106,255,10,1014,948,1962,9,5.75,201924
15,10,135,7,220,280,55,171,4,872,853,1725,6,6,201924
15,11,179,23,301,433,51,236,7,1230,1044,2274,8,6,201924
15,12,240,16,493,474,39,198,0,1460,1276,2736,8,6,201924
15,13,108,5,212,253,60,214,0,852,636,1488,8,6,201924
15,14,95,18,159,232,10,116,0,630,619,1249,4,6,201924
15,15,179,38,305,461,28,248,3,1262,1140,2402,6,6,201924
15,16,213,35,399,574,10,237,2,1470,1278,2748,8,6,201924
15,17,125,12,192,305,8,221,19,882,795,1677,8,6,201924
15,18,233,15,255,426,19,274,3,1225,1212,2437,7,5.666666667,201924
15,19,213,32,414,616,17,332,2,1626,1530,3156,10,6,201924
15,20,74,14,212,273,13,170,0,756,761,1517,6,6,201924
15,21,97,16,96,166,20,92,6,493,501,994,6,5.5,201924
15,22,249,38,476,750,16,456,19,2004,1897,3901,14,6,201924
15,23,200,10,234,385,13,241,0,1083,1006,2089,6,5.333333333,201924
15,24,105,30,256,243,22,150,1,807,854,1661,4,6,201924
15,25,170,26,256,281,41,143,10,927,951,1878,6,6,201924
15,26,149,7,249,237,46,221,0,909,820,1729,9,7,201924
15,27,249,22,349,512,25,333,39,1529,1357,2886,9,5.666666667,201924
15,28,241,15,490,318,59,291,2,1416,1165,2581,9,5.666666667,201924
15,29,202,26,405,634,5,341,0,1613,1448,3061,8,6,201924
15,30,253,28,446,493,29,190,9,1448,1325,2773,16,6,201924
15,31,144,45,251,307,19,191,0,957,708,1665,6,6,201924
15,32,143,10,265,393,28,146,3,988,837,1825,9,6,201924
15,33,194,6,343,363,26,185,0,1117,936,2053,7,6,201924
15,34,140,20,182,411,10,217,9,989,884,1873,8,6,201924
15,35,317,14,281,425,13,404,0,1454,1310,2764,9,5.666666667,201924
15,36,273,21,208,272,31,220,0,1025,944,1969,9,5.5,201924
15,37,239,26,296,516,14,314,23,1428,1324,2752,7,6,201924
15,38,173,23,249,400,12,282,8,1147,1048,2195,6,5.5,201924
15,39,152,28,265,354,16,135,0,950,839,1789,4,6,201924
15,40,283,27,348,409,72,471,1,1611,1408,3019,9,6,201924
15,41,293,21,555,579,42,262,7,1759,1529,3288,13,6,201924
16,1,138,13,183,145,10,155,0,644,689,1333,7,5.333333333,201924
16,2,148,16,110,157,34,196,0,661,573,1234,9,5.25,201924
16,3,208,17,158,266,26,149,0,824,698,1522,10,5.25,201924
16,4,183,18,179,161,22,284,0,847,674,1521,8,5.5,201924
16,5,219,25,178,184,19,216,11,852,719,1571,10,5.666666667,201924
16,6,200,28,164,257,26,148,0,823,670,1493,12,5.5,201924
16,7,201,21,167,196,26,236,0,847,774,1621,9,5.5,201924
16,8,261,25,466,518,10,353,5,1638,1408,3046,12,6,201924
16,9,211,21,234,301,13,288,7,1075,1003,2078,9,6,201924
16,10,170,10,257,286,11,201,0,935,731,1666,6,6,201924
16,11,202,19,215,143,63,197,81,920,982,1902,10,5.4,201924
16,12,157,19,190,164,14,163,6,713,780,1493,10,5.25,201924
17,1,182,23,411,437,14,276,4,1347,1095,2442,9,7,201924
17,2,172,5,307,358,9,151,0,1002,816,1818,8,5.666666667,201924
17,3,282,23,410,504,7,287,1,1514,1266,2780,8,5.5,201924
17,4,209,14,354,383,28,265,4,1257,1106,2363,10,5.666666667,201924
17,5,93,8,115,168,8,87,0,479,541,1020,5,5.5,201924
18,1,169,10,144,208,11,167,4,713,550,1263,7,5.25,201924
18,2,275,22,323,377,43,217,2,1259,1071,2330,8,6,201924
18,3,144,17,289,178,4,181,0,813,743,1556,8,5.5,201924
19,1,203,15,308,296,8,451,9,1290,1165,2455,9,6,201924
19,2,227,15,463,299,9,347,0,1360,1556,2916,9,6,201924
19,3,278,19,590,351,29,418,0,1685,1523,3208,7,6,201924
19,4,123,9,210,152,40,263,13,810,723,1533,5,6,201924
19,5,357,22,507,668,27,495,8,2084,1844,3928,8,6,201924
19,6,124,10,170,226,3,218,1,752,777,1529,5,6,201924
19,7,206,6,504,219,4,251,0,1190,1053,2243,10,5.5,201924
19,8,102,10,151,149,2,133,0,547,524,1071,7,6,201924
19,9,167,19,186,162,16,258,1,809,963,1772,9,5,201924
19,10,128,17,185,219,11,283,10,853,779,1632,6,7,201924
19,11,420,41,567,681,28,753,18,2508,2436,4944,13,6,201924
19,12,193,11,503,209,13,220,3,1152,1214,2366,8,5.666666667,201924
20,1,152,4,170,201,40,124,28,719,595,1314,7,5.5,201924
20,2,102,9,106,137,8,103,2,467,639,1106,6,5.333333333,201924
20,3,95,10,133,134,35,66,22,495,542,1037,6,5.333333333,201924
20,4,101,7,78,172,13,117,15,503,720,1223,6,5.333333333,201924
20,5,117,14,171,264,42,109,0,717,692,1409,11,5.25,201924
20,6,193,11,127,293,96,90,2,812,784,1596,8,5.25,201924
20,7,220,13,201,274,11,219,1,939,757,1696,7,5.75,201924
20,8,421,23,528,779,40,419,53,2263,1765,4028,13,6,201924
20,9,338,13,255,235,75,231,16,1163,743,1906,8,5.666666667,201924
20,10,219,10,216,358,13,140,1,957,733,1690,9,5.25,201924
21,1,444,21,279,454,15,356,5,1574,711,2285,9,5.4,201924
21,2,386,27,288,326,123,194,2,1346,97,1443,9,5.2,201924
21,3,434,10,325,314,87,446,20,1636,90,1726,8,5.5,201924
21,4,297,13,163,162,148,180,27,990,80,1070,6,5.25,201924
21,5,425,24,426,435,29,350,23,1712,143,1855,8,5.666666667,201924
21,6,400,18,358,551,43,438,36,1844,41,1885,6,6,201924
21,7,484,26,286,444,81,467,14,1802,189,1991,9,5.333333333,201924
21,8,308,13,261,186,59,274,18,1119,179,1298,9,5.2,201924
21,9,489,23,584,567,83,459,25,2230,99,2329,9,6,201924
21,10,337,24,355,448,31,329,28,1552,99,1651,7,5.5,201924
21,11,190,4,173,179,18,133,5,702,4,706,4,6,201924
21,12,598,32,825,975,43,626,21,3120,175,3295,16,6.5,201924
21,13,472,24,407,312,49,481,69,1814,145,1959,8,5.666666667,201924
21,14,406,16,260,227,80,370,33,1392,192,1584,12,5.333333333,201924
21,15,393,23,521,377,43,366,9,1732,236,1968,7,5.5,201924
22,1,163,34,177,306,32,112,4,828,733,1561,11,5.2,201924
22,2,177,21,276,263,27,142,0,906,875,1781,7,5.5,201924
22,3,309,45,692,615,23,330,0,2014,1866,3880,9,5.666666667,201924
22,4,193,31,527,471,22,231,1,1476,1300,2776,8,6,201924
22,5,160,16,331,220,31,157,13,928,869,1797,10,5.5,201924
23,1,364,4,1193,335,24,219,15,2154,1344,3498,14,5.6,201924
23,2,397,19,632,504,44,209,3,1808,475,2283,9,5.5,201924
23,3,338,6,893,446,23,237,1,1944,764,2708,19,5,201924
23,4,198,4,769,299,28,181,0,1479,1118,2597,6,5.5,201924
24,1,134,23,111,193,22,79,2,564,631,1195,10,5.2,201924
24,2,120,8,176,193,9,149,0,655,754,1409,6,5.5,201924
24,3,248,37,156,233,41,149,2,866,713,1579,9,5.25,201924
24,4,215,23,227,189,27,245,28,954,1054,2008,5,5.5,201924
24,5,273,38,397,589,10,360,0,1667,1516,3183,10,6.333333333,201924
24,6,235,38,335,438,20,297,0,1363,1163,2526,6,6,201924
24,7,211,18,156,315,17,114,0,831,937,1768,9,5.25,201924
25,1,168,13,209,285,16,180,12,883,794,1677,13,5.75,201924
25,2,258,24,299,410,11,272,0,1274,1268,2542,7,5.5,201924
25,3,171,6,252,305,29,215,8,986,778,1764,8,5.6,201924
25,4,176,7,135,244,13,208,0,783,700,1483,8,5.333333333,201924
25,5,177,13,228,360,13,200,0,991,949,1940,8,5.666666667,201924
25,6,194,14,263,280,34,268,1,1054,1069,2123,8,5.75,201924
25,7,248,10,357,460,6,281,0,1362,1319,2681,6,6,201924
26,1,207,9,292,263,8,300,0,1079,1172,2251,9,5.5,201924
26,2,273,16,371,400,8,256,1,1325,1325,2650,12,5.4,201924
26,3,248,12,274,496,7,407,6,1450,1335,2785,14,6.5,201924
26,4,130,15,100,223,18,191,8,685,662,1347,9,5.2,201924
26,5,112,9,185,226,15,208,0,755,611,1366,14,5.5,201924
26,6,179,21,280,320,3,372,0,1175,1083,2258,10,5.333333333,201924
26,7,203,10,180,248,29,162,0,832,676,1508,10,5.5,201924
27,1,155,10,218,297,69,127,0,876,874,1750,8,5.5,201924
27,2,206,21,230,425,21,145,0,1048,867,1915,8,5.666666667,201924
27,3,168,12,177,416,18,140,0,931,795,1726,7,5.666666667,201924
27,4,191,19,332,731,19,260,17,1569,1403,2972,8,6,201924
27,5,89,7,105,228,3,53,0,485,442,927,6,5.333333333,201924
27,6,161,19,214,436,6,178,0,1014,918,1932,7,5.5,201924
28,1,353,41,601,443,10,445,0,1893,726,2619,13,6,201924
28,2,289,35,527,373,12,384,67,1687,690,2377,13,5.666666667,201924
28,3,231,19,218,229,60,291,0,1048,24,1072,7,5.333333333,201924
28,4,462,35,587,387,33,470,50,2024,115,2139,15,6,201924
28,5,222,24,274,365,17,305,22,1229,109,1338,10,6.5,201924
28,6,288,23,287,308,31,171,5,1113,35,1148,13,5.166666667,201924
28,7,237,15,395,335,36,310,3,1331,308,1639,13,6,201924
28,8,143,10,231,256,25,207,1,873,33,906,12,8,201924
28,9,239,20,410,247,17,319,13,1265,151,1416,10,6,201924
29,1,211,22,310,377,38,220,2,1180,1159,2339,7,5.5,201924
29,2,232,21,237,487,23,263,50,1313,1292,2605,11,6,201924
29,3,131,13,123,280,8,131,0,686,687,1373,5,5.666666667,201924
30,1,111,12,134,114,6,131,3,511,397,908,7,5.333333333,201924
30,2,229,8,136,91,170,99,50,783,659,1442,8,5.25,201924
30,3,141,5,222,187,44,177,32,808,753,1561,6,5.666666667,201924
30,4,105,6,215,190,26,160,0,702,562,1264,8,6,201924
30,5,151,5,166,260,58,187,0,827,753,1580,7,5.5,201924
30,6,147,10,163,187,22,131,3,663,696,1359,9,5.333333333,201924
30,7,193,20,184,207,29,225,13,871,751,1622,11,5.25,201924
30,8,210,14,300,350,38,268,10,1190,1020,2210,11,5.4,201924
30,9,208,5,178,176,42,236,19,864,921,1785,8,5,201924
30,10,135,6,272,262,33,205,23,936,776,1712,6,6,201924
30,11,125,11,274,274,12,136,0,832,694,1526,5,5.5,201924
30,12,233,12,446,536,26,350,0,1603,1215,2818,10,6,201924
30,13,183,6,161,281,53,281,44,1009,1028,2037,10,5.4,201924
30,14,141,8,240,171,72,220,7,859,572,1431,8,5.5,201924
30,15,232,9,215,286,33,362,39,1176,1143,2319,11,5.666666667,201924
30,16,179,12,246,292,40,300,40,1109,1058,2167,10,5.333333333,201924
30,17,168,20,217,325,44,233,8,1015,881,1896,8,5.5,201924
30,18,206,8,103,266,15,193,13,804,758,1562,8,5.25,201924
30,19,161,10,346,233,13,252,1,1016,611,1627,13,5.6,201924
30,20,165,13,218,348,116,157,0,1017,841,1858,10,5.4,201924
31,1,146,10,163,54,171,167,1,712,664,1376,8,5.5,201924
31,2,87,9,108,9,123,111,0,447,406,853,6,5.333333333,201924
31,3,433,35,908,581,103,475,0,2535,2171,4706,20,6,201924
31,4,132,7,243,229,58,184,12,865,623,1488,4,6,201924
31,5,160,9,116,198,45,165,0,693,727,1420,6,5.333333333,201924
32,1,192,25,185,195,19,227,10,853,799,1652,12,5.2,201924
32,2,226,18,118,96,53,222,12,745,727,1472,13,5.142857143,201924
32,3,187,37,176,276,7,235,0,918,767,1685,13,5.4,201924
32,4,259,40,204,275,19,265,11,1073,931,2004,12,5.2,201924
1,1,242,42,393,255,48,224,5,1209,1609,2818,13,5.5,201925
1,2,334,42,722,454,52,371,19,1994,2017,4011,10,7.666666667,201925
1,3,273,60,638,372,30,408,10,1791,2445,4236,9,6,201925
2,1,280,16,437,327,10,264,0,1334,3373,4707,11,6,201925
2,2,265,13,328,368,10,309,0,1293,2093,3386,8,6.5,201925
2,3,391,25,479,314,30,292,29,1560,2075,3635,12,6,201925
2,4,244,10,590,191,61,175,3,1274,3221,4495,9,6,201925
2,5,333,36,719,309,88,207,7,1699,2075,3774,12,9,201925
2,6,261,16,458,286,11,189,0,1221,4047,5268,7,6,201925
2,7,303,20,488,273,22,196,49,1351,2224,3575,12,5.75,201925
2,8,268,20,637,391,16,208,16,1556,1841,3397,8,6,201925
3,1,209,16,329,357,21,309,1,1242,844,2086,12,5.666666667,201925
3,2,188,15,448,236,32,139,0,1058,466,1524,9,5.666666667,201925
4,1,198,15,226,412,161,193,34,1239,615,1854,11,5.25,201925
4,2,186,10,394,345,37,178,26,1176,860,2036,14,5.2,201925
5,1,232,14,328,320,22,201,8,1125,865,1990,9,5.666666667,201925
5,2,149,4,229,323,36,136,0,877,504,1381,10,5.2,201925
5,3,231,10,266,376,29,206,12,1130,742,1872,11,5.333333333,201925
5,4,246,20,441,487,12,294,11,1511,842,2353,11,5.75,201925
5,5,191,19,332,445,11,127,21,1146,586,1732,9,9,201925
5,6,197,9,250,340,3,134,22,955,522,1477,10,5.5,201925
5,7,214,11,218,323,3,166,5,940,699,1639,10,5.5,201925
6,1,176,20,288,233,8,266,5,996,532,1528,12,6,201925
6,2,164,13,256,200,34,228,6,901,707,1608,9,5.666666667,201925
7,1,336,8,188,409,40,93,12,1086,599,1685,9,5.25,201925
7,2,203,17,239,573,274,77,0,1383,1260,2643,9,5.25,201925
7,3,365,3,270,170,413,122,22,1365,850,2215,7,5.333333333,201925
7,4,233,16,200,416,21,176,85,1147,627,1774,11,5.4,201925
7,5,344,12,144,590,13,195,2,1300,372,1672,11,5.666666667,201925
7,6,269,9,248,423,33,233,9,1224,822,2046,9,5.666666667,201925
7,7,293,18,272,400,41,197,14,1235,1068,2303,8,5.5,201925
7,8,190,11,161,444,11,180,7,1004,996,2000,12,5.25,201925
7,9,238,13,279,423,15,239,2,1209,935,2144,9,5.666666667,201925
7,10,190,5,175,461,6,94,6,937,611,1548,9,5.5,201925
7,11,161,6,71,176,11,78,17,520,262,782,6,5.333333333,201925
7,12,326,8,236,513,7,116,0,1206,823,2029,9,5.5,201925
7,13,126,12,131,281,37,49,0,636,447,1083,9,5.25,201925
8,1,138,6,309,175,19,104,2,753,691,1444,4,6,201925
8,2,322,28,612,462,21,70,179,1694,1349,3043,17,5.5,201925
8,3,207,14,352,318,15,190,15,1111,962,2073,4,6,201925
8,4,188,24,383,302,16,214,44,1171,1026,2197,11,6,201925
8,5,183,27,218,216,18,180,1,843,762,1605,10,5.25,201925
8,6,236,21,359,381,25,303,1,1326,1100,2426,7,6.5,201925
8,7,206,25,142,198,1,267,0,839,934,1773,7,5.25,201925
8,8,183,31,367,387,5,247,0,1220,1018,2238,10,6,201925
8,9,139,9,114,111,14,256,3,646,738,1384,10,5.2,201925
9,1,112,10,159,168,53,171,2,675,249,924,5,6,201925
9,2,339,74,754,966,75,441,7,2656,1215,3871,12,6,201925
9,3,133,38,389,475,60,271,22,1388,657,2045,7,6,201925
9,4,182,12,350,513,62,249,12,1380,486,1866,11,6,201925
9,5,139,6,269,316,54,207,0,991,501,1492,7,6,201925
9,6,98,12,173,180,115,179,13,770,331,1101,7,6,201925
9,7,115,13,277,428,2,201,0,1036,473,1509,9,6,201925
9,8,82,10,272,386,25,177,15,967,513,1480,5,6,201925
9,9,136,12,227,305,33,128,0,841,356,1197,5,6,201925
9,10,120,26,314,370,33,197,0,1060,581,1641,6,6,201925
9,11,162,14,395,550,43,271,0,1435,644,2079,7,6,201925
9,12,158,26,524,637,32,305,24,1706,847,2553,11,6,201925
9,13,140,16,241,368,65,194,17,1041,519,1560,4,6,201925
9,14,121,7,199,255,33,190,14,819,359,1178,5,6,201925
9,15,211,30,820,992,23,458,6,2540,1156,3696,9,6.5,201925
9,16,279,37,450,655,82,335,0,1838,904,2742,15,6,201925
9,17,140,6,227,330,24,161,0,888,458,1346,6,6,201925
9,18,199,19,348,613,39,276,3,1497,707,2204,12,6,201925
9,19,207,37,302,510,57,219,4,1336,489,1825,5,6,201925
9,20,53,4,77,136,12,57,0,339,190,529,5,6,201925
9,21,107,6,149,278,33,130,6,709,321,1030,3,6,201925
9,22,170,7,212,325,63,158,19,954,380,1334,5,6,201925
9,23,145,15,264,497,31,233,2,1187,509,1696,6,6,201925
9,24,310,22,587,865,84,438,8,2314,1731,4045,12,6,201925
10,1,297,37,275,254,57,341,99,1360,1334,2694,12,5,201925
10,2,296,19,351,313,13,286,8,1286,1659,2945,9,5.25,201925
10,3,317,51,280,318,46,218,98,1328,1475,2803,11,5.4,201925
10,4,316,40,467,470,7,302,0,1602,2748,4350,12,7,201925
11,1,210,16,159,217,5,158,2,767,489,1256,6,5.666666667,201925
11,2,221,22,202,234,15,166,11,871,378,1249,7,6,201925
11,3,173,16,228,267,6,209,9,908,349,1257,3,6,201925
11,4,168,24,137,242,15,218,0,804,407,1211,8,6,201925
11,5,289,38,348,495,28,324,0,1522,536,2058,7,6,201925
11,6,153,5,215,237,9,156,1,776,327,1103,8,6,201925
11,7,205,61,294,504,29,150,5,1248,482,1730,9,5.5,201925
11,8,227,29,233,343,40,194,0,1066,533,1599,9,5.5,201925
11,9,212,48,316,391,13,273,23,1276,573,1849,10,5.666666667,201925
11,10,249,34,226,270,23,269,18,1089,460,1549,10,5.6,201925
11,11,220,38,304,320,16,217,0,1115,394,1509,5,6,201925
11,12,244,36,389,485,9,233,0,1396,560,1956,7,6,201925
11,13,231,37,215,205,17,240,12,957,545,1502,8,5.5,201925
11,14,200,22,190,200,25,213,0,850,446,1296,8,5.5,201925
11,15,144,32,227,222,3,150,0,778,263,1041,9,6,201925
12,1,204,30,231,126,51,140,2,784,418,1202,10,5,201925
12,2,258,28,248,392,16,174,6,1122,661,1783,10,5.5,201925
12,3,184,32,293,432,9,113,1,1064,552,1616,11,5.2,201925
12,4,202,24,281,439,20,133,0,1099,579,1678,9,5.666666667,201925
12,5,290,31,356,269,10,152,13,1121,591,1712,10,5.25,201925
12,6,188,24,142,418,24,55,14,865,602,1467,10,5.25,201925
12,7,268,31,221,406,12,147,42,1127,530,1657,6,5.5,201925
12,8,228,20,193,314,4,106,0,865,703,1568,9,5.25,201925
12,9,258,14,296,500,22,99,16,1205,522,1727,9,5.666666667,201925
13,1,170,18,150,228,23,134,28,751,444,1195,9,5.333333333,201925
13,2,178,16,104,197,37,206,3,741,542,1283,6,5.333333333,201925
13,3,176,18,202,274,75,158,0,903,908,1811,12,5.25,201925
13,4,247,11,290,282,44,180,14,1068,816,1884,9,5.666666667,201925
13,5,262,12,388,326,59,342,6,1395,1041,2436,9,5.75,201925
13,6,318,56,676,620,67,255,6,1998,1561,3559,11,5.666666667,201925
13,7,152,17,284,361,26,136,0,976,859,1835,8,5.5,201925
14,1,204,18,117,86,15,303,0,743,696,1439,6,5.5,201925
14,2,239,11,156,106,15,299,2,828,267,1095,5,5.666666667,201925
14,3,297,11,221,117,1,458,0,1105,697,1802,8,5.4,201925
14,4,198,8,283,323,15,219,1,1047,768,1815,10,6,201925
14,5,171,8,356,239,33,197,0,1004,870,1874,9,5.5,201925
14,6,219,10,369,320,10,222,1,1151,504,1655,11,6,201925
14,7,151,5,168,168,0,159,0,651,205,856,6,6,201925
14,8,368,20,651,782,9,589,2,2421,870,3291,11,6.25,201925
14,9,161,11,183,269,16,188,3,831,319,1150,11,6,201925
14,10,253,13,414,302,8,332,1,1323,536,1859,7,6,201925
14,11,119,14,147,179,15,165,21,660,354,1014,4,6,201925
14,12,238,11,473,220,20,220,1,1183,602,1785,9,5.5,201925
14,13,245,20,344,287,15,269,3,1183,319,1502,6,6,201925
14,14,174,13,210,236,9,204,2,848,860,1708,7,6,201925
14,15,254,11,244,234,23,306,9,1081,642,1723,10,5.6,201925
14,16,206,10,255,190,23,247,8,939,435,1374,5,6,201925
14,17,168,11,158,101,16,191,5,650,714,1364,7,5.25,201925
14,18,205,20,196,153,35,329,19,957,612,1569,9,5.4,201925
14,19,159,20,212,233,9,197,2,832,456,1288,8,5.25,201925
14,20,221,14,277,210,3,257,5,987,473,1460,10,5.666666667,201925
15,1,176,8,215,100,121,321,0,941,655,1596,7,5.333333333,201925
15,2,116,16,241,377,20,176,2,948,390,1338,6,6,201925
15,3,214,20,215,328,121,339,20,1257,710,1967,10,5.666666667,201925
15,4,169,21,246,300,25,248,1,1010,568,1578,4,6,201925
15,5,131,29,242,275,23,242,1,943,720,1663,8,5.666666667,201925
15,6,124,7,325,452,27,209,4,1148,516,1664,7,6,201925
15,7,125,10,259,319,24,203,0,940,361,1301,10,6,201925
15,8,91,8,140,275,21,132,7,674,263,937,4,6,201925
15,9,220,7,157,192,121,234,11,942,721,1663,9,5.75,201925
15,10,107,13,241,254,40,167,4,826,418,1244,6,6,201925
15,11,165,11,291,470,51,197,1,1186,492,1678,8,6,201925
15,12,208,16,461,515,43,222,0,1465,635,2100,8,6,201925
15,13,89,11,196,228,67,209,2,802,349,1151,8,6,201925
15,14,79,18,175,287,7,135,0,701,252,953,4,6,201925
15,15,161,27,282,415,30,223,3,1141,664,1805,6,6,201925
15,16,229,33,406,605,18,279,3,1573,549,2122,8,6,201925
15,17,117,15,222,315,15,205,9,898,355,1253,8,6,201925
15,18,215,11,292,424,22,295,6,1265,963,2228,7,5.666666667,201925
15,19,202,39,467,582,23,321,7,1641,684,2325,10,6,201925
15,20,82,10,208,294,9,151,1,755,724,1479,6,6,201925
15,21,78,13,103,207,10,127,9,547,264,811,6,5.5,201925
15,22,251,36,553,777,26,435,29,2107,969,3076,14,6,201925
15,23,178,13,208,366,15,254,0,1034,905,1939,6,5.333333333,201925
15,24,117,14,240,242,37,135,2,787,880,1667,4,6,201925
15,25,159,15,277,297,41,121,15,925,852,1777,6,6,201925
15,26,117,6,229,281,40,218,1,892,412,1304,9,7,201925
15,27,228,18,363,504,13,304,32,1462,710,2172,9,5.666666667,201925
15,28,203,16,502,403,43,277,4,1448,639,2087,9,5.666666667,201925
15,29,219,21,437,639,14,313,7,1650,563,2213,8,6,201925
15,30,211,23,496,495,38,220,11,1494,630,2124,16,6,201925
15,31,152,40,229,366,13,222,0,1022,376,1398,6,6,201925
15,32,150,4,268,435,30,192,5,1084,447,1531,9,6,201925
15,33,170,13,323,370,12,216,0,1104,407,1511,7,6,201925
15,34,162,13,209,432,15,247,10,1088,441,1529,8,6,201925
15,35,283,19,331,385,12,373,0,1403,559,1962,9,5.666666667,201925
15,36,188,20,229,307,28,184,0,956,650,1606,9,5.5,201925
15,37,196,28,327,560,28,271,13,1423,774,2197,7,6,201925
15,38,158,24,225,355,10,210,4,986,467,1453,6,5.5,201925
15,39,134,32,265,346,20,138,0,935,348,1283,4,6,201925
15,40,244,13,320,453,78,466,0,1574,663,2237,9,6,201925
15,41,209,23,573,593,34,252,11,1695,775,2470,13,6,201925
16,1,134,13,175,148,10,152,0,632,299,931,7,5.333333333,201925
16,2,150,20,112,169,7,175,0,633,334,967,9,5.25,201925
16,3,207,17,158,252,15,138,0,787,503,1290,10,5.25,201925
16,4,187,10,162,136,22,245,0,762,454,1216,8,5.5,201925
16,5,214,23,154,189,24,180,1,785,300,1085,10,5.666666667,201925
16,6,204,19,182,273,26,153,0,857,379,1236,12,5.5,201925
16,7,241,24,146,240,19,225,0,895,552,1447,9,5.5,201925
16,8,295,28,496,466,9,310,4,1608,573,2181,12,6,201925
16,9,211,23,257,251,9,222,0,973,352,1325,9,6,201925
16,10,171,15,257,283,11,172,0,909,389,1298,6,6,201925
16,11,254,17,211,167,73,283,0,1005,729,1734,10,5.4,201925
16,12,196,16,186,177,28,176,4,783,540,1323,10,5.25,201925
17,1,166,18,373,437,14,290,0,1298,714,2012,9,7,201925
17,2,161,12,312,354,10,122,4,975,649,1624,8,5.666666667,201925
17,3,244,16,344,457,16,227,0,1304,797,2101,8,5.5,201925
17,4,245,13,352,352,15,212,9,1198,730,1928,10,5.666666667,201925
17,5,96,7,147,160,9,78,2,499,333,832,5,5.5,201925
18,1,130,17,124,157,29,127,0,584,537,1121,7,5.25,201925
18,2,217,27,357,382,48,242,2,1275,731,2006,9,6.333333333,201925
18,3,129,24,241,191,6,124,0,715,608,1323,8,5.5,201925
19,1,227,15,302,317,15,368,8,1252,552,1804,9,6,201925
19,2,264,19,552,394,14,344,1,1588,402,1990,9,6,201925
19,3,290,13,602,419,25,358,0,1707,785,2492,7,6,201925
19,4,135,9,144,164,36,257,23,768,286,1054,5,6,201925
19,5,332,19,448,636,22,472,5,1934,531,2465,8,6,201925
19,6,91,11,189,233,1,207,1,733,316,1049,5,6,201925
19,7,166,8,407,195,6,198,0,980,724,1704,10,5.5,201925
19,8,94,5,140,154,3,139,0,535,171,706,7,6,201925
19,9,207,15,172,204,10,228,0,836,931,1767,9,5.25,201925
19,10,117,16,228,208,9,274,16,868,272,1140,6,7,201925
19,11,380,33,606,708,15,715,17,2474,814,3288,13,6,201925
19,12,184,12,465,217,13,199,0,1090,822,1912,8,5.666666667,201925
20,1,229,16,189,243,51,143,30,901,750,1651,7,5.5,201925
20,2,146,12,213,170,9,124,0,674,670,1344,6,5.333333333,201925
20,3,113,6,128,116,37,65,24,489,568,1057,6,5.333333333,201925
20,4,249,16,128,216,28,192,35,864,736,1600,6,5.333333333,201925
20,5,154,18,186,343,31,164,0,896,691,1587,11,5.25,201925
20,6,182,17,216,289,132,100,0,936,723,1659,8,5.25,201925
20,7,224,10,239,450,20,211,0,1154,659,1813,7,5.75,201925
20,8,404,27,474,830,40,364,45,2184,1748,3932,14,6.5,201925
20,9,241,21,197,257,50,202,20,988,846,1834,8,5.666666667,201925
20,10,159,6,131,243,10,120,5,674,595,1269,9,5.25,201925
21,1,487,26,324,526,26,271,11,1671,1055,2726,9,5.4,201925
21,2,294,20,281,344,105,206,2,1252,600,1852,9,5.2,201925
21,3,460,17,294,269,76,405,31,1552,1733,3285,8,5.5,201925
21,4,269,11,162,150,85,169,35,881,515,1396,6,5.25,201925
21,5,373,23,362,372,32,328,18,1508,994,2502,8,5.666666667,201925
21,6,355,14,316,450,28,323,30,1516,1056,2572,6,6,201925
21,7,523,28,261,384,64,556,2,1818,1561,3379,9,5.666666667,201925
21,8,332,12,292,213,92,204,25,1170,406,1576,9,5.2,201925
21,9,411,31,520,579,74,356,12,1983,1193,3176,9,6,201925
21,10,366,20,384,423,21,292,49,1555,617,2172,7,5.5,201925
21,11,154,6,194,159,15,111,11,650,504,1154,4,6,201925
21,12,591,36,836,937,46,576,22,3044,1679,4723,16,6.5,201925
21,13,368,27,342,291,34,428,34,1524,1594,3118,8,5.666666667,201925
21,14,422,10,327,290,90,328,36,1503,689,2192,12,5.333333333,201925
21,15,463,26,434,381,55,392,11,1762,1106,2868,7,5.5,201925
22,1,161,26,149,282,23,94,2,737,525,1262,11,5.2,201925
22,2,186,21,266,292,31,178,3,977,589,1566,7,5.5,201925
22,3,245,33,592,620,19,264,0,1773,975,2748,9,5.666666667,201925
22,4,215,21,503,497,18,230,0,1484,855,2339,9,6.5,201925
22,5,142,10,303,219,35,123,5,837,651,1488,10,5.5,201925
23,1,329,11,1239,291,36,205,13,2124,3629,5753,14,5.6,201925
23,2,302,20,340,512,23,139,1,1337,1856,3193,9,5.5,201925
23,3,373,12,1002,551,33,284,2,2257,1582,3839,19,6,201925
23,4,193,9,578,357,14,155,5,1311,1796,3107,5,5.5,201925
24,1,181,34,148,302,26,100,7,798,443,1241,10,5.2,201925
24,2,166,14,209,183,10,181,0,763,691,1454,6,5.5,201925
24,3,168,36,119,196,51,95,1,666,557,1223,9,5.25,201925
24,4,173,11,161,205,34,233,44,861,553,1414,5,5.5,201925
24,5,308,33,461,548,19,308,0,1677,902,2579,10,6.333333333,201925
24,6,221,31,360,398,21,261,0,1292,594,1886,6,6,201925
24,7,243,23,178,291,21,102,0,858,634,1492,9,5.25,201925
25,1,133,7,177,316,11,172,13,829,443,1272,13,5.75,201925
25,2,240,23,331,472,13,265,0,1344,697,2041,7,5.5,201925
25,3,178,9,211,312,32,196,4,942,710,1652,8,5.6,201925
25,4,152,11,153,221,13,180,0,730,644,1374,8,5.333333333,201925
25,5,138,2,224,396,19,189,0,968,495,1463,8,5.666666667,201925
25,6,132,7,246,259,29,228,2,903,610,1513,8,5.75,201925
25,7,244,13,313,465,14,263,0,1312,652,1964,6,6,201925
26,1,168,6,303,308,6,285,0,1076,406,1482,9,5.25,201925
26,2,203,7,351,431,4,221,8,1225,491,1716,12,5.4,201925
26,3,227,13,332,498,11,415,10,1506,461,1967,14,6.5,201925
26,4,152,19,128,187,20,220,0,726,485,1211,9,5.2,201925
26,5,127,6,183,198,11,218,0,743,443,1186,14,5.5,201925
26,6,182,12,268,329,7,359,0,1157,416,1573,10,5.333333333,201925
26,7,163,13,187,262,32,158,0,815,337,1152,10,5.5,201925
27,1,197,13,260,374,67,170,0,1081,699,1780,8,5.5,201925
27,2,252,13,280,539,17,144,2,1247,878,2125,8,5.666666667,201925
27,3,215,9,173,432,9,152,0,990,584,1574,7,5.666666667,201925
27,4,232,12,336,754,20,232,20,1606,939,2545,8,6,201925
27,5,107,8,103,293,5,79,0,595,522,1117,6,5.333333333,201925
27,6,192,14,195,408,6,158,0,973,652,1625,7,5.5,201925
28,1,343,30,628,432,11,337,0,1781,2130,3911,13,6,201925
28,2,292,30,449,314,26,324,63,1498,4020,5518,13,5.666666667,201925
28,3,215,7,267,240,14,301,1,1045,522,1567,7,5.666666667,201925
28,4,359,25,528,342,33,393,59,1739,921,2660,15,6,201925
28,5,227,23,287,377,17,306,23,1260,647,1907,10,5.5,201925
28,6,234,35,258,313,19,114,12,985,261,1246,13,5.166666667,201925
28,7,246,22,412,310,33,305,0,1328,3307,4635,13,6,201925
28,8,157,10,251,255,26,193,2,894,687,1581,12,9,201925
28,9,238,7,389,175,20,254,7,1090,2910,4000,10,6.666666667,201925
29,1,258,22,329,393,38,207,3,1250,791,2041,7,5.5,201925
29,2,234,22,254,504,29,209,45,1297,755,2052,10,5.666666667,201925
29,3,157,15,167,342,15,164,0,860,521,1381,5,5.666666667,201925
30,1,96,6,142,124,5,94,1,468,316,784,7,5,201925
30,2,154,10,86,111,20,124,60,565,399,964,8,5.25,201925
30,3,159,4,163,169,45,167,43,750,297,1047,6,5.666666667,201925
30,4,112,2,204,228,19,139,0,704,192,896,8,6,201925
30,5,151,7,159,236,6,175,0,734,371,1105,7,5.5,201925
30,6,175,9,143,177,18,136,2,660,561,1221,9,5.333333333,201925
30,7,135,8,184,187,44,148,21,727,517,1244,11,5.25,201925
30,8,227,13,282,377,139,255,19,1312,774,2086,11,5.4,201925
30,9,219,4,163,211,33,222,26,878,598,1476,8,5.5,201925
30,10,182,9,263,308,21,214,30,1027,347,1374,6,6,201925
30,11,135,13,226,330,7,152,0,863,312,1175,5,5.5,201925
30,12,239,9,413,544,42,325,0,1572,462,2034,10,6,201925
30,13,209,18,121,309,54,250,34,995,598,1593,10,5.4,201925
30,14,208,6,222,252,46,183,4,921,364,1285,8,5.5,201925
30,15,284,12,212,308,40,353,46,1255,536,1791,11,5.666666667,201925
30,16,196,5,202,314,39,248,42,1046,533,1579,10,5.333333333,201925
30,17,220,27,198,357,32,234,3,1071,762,1833,8,5.5,201925
30,18,167,8,116,170,21,151,12,645,595,1240,8,5.25,201925
30,19,166,7,235,264,6,253,1,932,383,1315,13,5.6,201925
30,20,206,15,211,306,82,159,0,979,546,1525,10,5.4,201925
31,1,211,13,168,49,207,142,0,790,556,1346,8,5.5,201925
31,2,105,7,71,11,156,132,0,482,353,835,6,5.333333333,201925
31,3,474,43,866,598,153,476,0,2610,1198,3808,21,6.333333333,201925
31,4,144,14,252,252,56,183,13,914,487,1401,4,6,201925
31,5,145,10,124,209,26,140,0,654,538,1192,6,5.333333333,201925
32,1,154,19,122,174,19,199,6,693,468,1161,12,5.2,201925
32,2,273,27,171,110,48,238,15,882,632,1514,13,5.142857143,201925
32,3,187,39,180,295,1,216,0,918,739,1657,13,5.4,201925
32,4,227,43,207,259,14,199,10,959,578,1537,13,5.4,201925
1,1,260,40,390,313,34,218,4,1259,2121,3380,13,5.5,201926
1,2,365,47,699,432,63,359,8,1973,3484,5457,10,6.333333333,201926
1,3,265,42,553,367,24,336,7,1594,3378,4972,9,6,201926
2,1,296,10,401,391,12,274,2,1386,3058,4444,11,6,201926
2,2,213,11,271,257,5,233,0,990,5038,6028,7,6,201926
2,3,327,28,462,313,19,282,29,1460,6235,7695,12,6,201926
2,4,248,12,629,159,70,126,5,1249,3540,4789,9,6,201926
2,5,334,21,633,274,51,266,5,1584,6910,8494,16,9,201926
2,6,264,12,404,272,14,208,1,1175,4677,5852,7,6,201926
2,7,250,10,408,253,32,189,13,1155,4910,6065,12,5.75,201926
2,8,218,16,448,279,8,174,23,1166,4569,5735,8,6,201926
3,1,190,10,307,333,11,323,1,1175,1318,2493,12,5.666666667,201926
3,2,149,11,526,212,20,135,0,1053,1304,2357,9,5.666666667,201926
4,1,246,12,266,451,49,191,17,1232,1315,2547,11,5.25,201926
4,2,167,12,326,348,48,141,36,1078,1170,2248,14,5.2,201926
5,1,229,15,378,295,31,208,11,1167,1200,2367,9,5.666666667,201926
5,2,167,15,268,317,19,148,0,934,852,1786,10,5.2,201926
5,3,185,15,245,363,24,179,13,1024,1263,2287,11,5.333333333,201926
5,4,237,12,449,478,9,329,14,1528,1973,3501,11,5.75,201926
5,5,195,17,292,463,21,144,17,1149,1557,2706,8,6.5,201926
5,6,148,16,261,336,8,132,30,931,1098,2029,10,5.5,201926
5,7,188,16,260,366,2,168,3,1003,1217,2220,11,6,201926
6,1,159,17,246,266,11,221,10,930,983,1913,12,6,201926
6,2,147,7,285,188,30,181,4,842,1238,2080,9,5.666666667,201926
7,1,259,10,209,294,167,59,1,999,514,1513,9,5.25,201926
7,2,247,9,136,635,57,62,0,1146,1388,2534,9,5.25,201926
7,3,375,5,212,525,164,202,9,1492,516,2008,7,5.333333333,201926
7,4,225,13,143,370,5,136,52,944,599,1543,11,5.4,201926
7,5,326,7,156,522,10,173,0,1194,789,1983,11,5.666666667,201926
7,6,307,9,306,406,20,284,9,1341,1229,2570,9,5.666666667,201926
7,7,293,23,298,435,41,168,10,1268,1313,2581,8,5.5,201926
7,8,215,8,158,452,9,226,10,1078,1410,2488,12,5.25,201926
7,9,258,14,277,415,16,250,0,1230,1191,2421,9,5.666666667,201926
7,10,179,5,186,439,13,91,0,913,921,1834,9,5.5,201926
7,11,194,2,50,123,15,60,15,459,226,685,6,5.333333333,201926
7,12,263,11,237,559,9,121,0,1200,759,1959,9,5.5,201926
7,13,151,9,136,221,1,79,0,597,473,1070,9,5.25,201926
8,1,127,9,317,189,13,100,2,757,986,1743,4,6,201926
8,2,289,31,603,386,19,78,181,1587,2023,3610,17,5.5,201926
8,3,193,15,337,298,20,197,9,1069,1460,2529,4,6,201926
8,4,164,31,382,305,25,243,26,1176,1367,2543,11,6,201926
8,5,167,18,276,224,22,167,0,874,901,1775,10,5.25,201926
8,6,224,24,357,396,29,310,2,1342,1666,3008,7,6.5,201926
8,7,172,24,180,209,4,244,0,833,1051,1884,7,5.25,201926
8,8,204,17,344,361,11,219,1,1157,1487,2644,10,6,201926
8,9,159,6,97,107,13,208,14,604,810,1414,10,5,201926
9,1,110,7,160,179,45,171,1,673,805,1478,5,6,201926
9,2,310,62,698,927,63,439,7,2506,3158,5664,12,6,201926
9,3,155,27,321,426,36,254,10,1229,1796,3025,7,6,201926
9,4,185,16,358,523,64,233,12,1391,1615,3006,11,6,201926
9,5,141,11,284,347,49,175,1,1008,1021,2029,7,6,201926
9,6,124,20,214,154,131,164,12,819,849,1668,7,6,201926
9,7,115,5,262,415,1,179,0,977,1125,2102,9,6,201926
9,8,110,12,321,402,10,151,11,1017,1033,2050,5,6,201926
9,9,118,10,204,300,27,147,2,808,1033,1841,5,6,201926
9,10,141,17,297,378,20,195,0,1048,1177,2225,6,6,201926
9,11,146,26,436,554,38,264,0,1464,1734,3198,7,6,201926
9,12,140,28,470,651,25,260,23,1597,2194,3791,11,6,201926
9,13,122,11,263,347,85,188,15,1031,1076,2107,4,6,201926
9,14,119,4,205,233,29,193,22,805,1113,1918,5,6,201926
9,15,222,26,781,910,28,475,9,2451,2222,4673,10,6.5,201926
9,16,240,48,416,741,72,340,0,1857,1798,3655,15,6,201926
9,17,119,11,199,319,21,165,0,834,842,1676,6,6,201926
9,18,189,22,332,586,38,262,4,1433,1739,3172,12,6,201926
9,19,181,34,309,441,42,217,3,1227,1912,3139,5,6,201926
9,20,53,2,97,125,13,50,3,343,439,782,5,6,201926
9,21,126,12,173,266,29,118,5,729,751,1480,3,6,201926
9,22,169,7,206,315,59,182,19,957,1178,2135,5,6,201926
9,23,156,14,268,477,30,207,2,1154,1193,2347,6,6,201926
9,24,302,30,546,778,96,421,2,2175,2701,4876,12,6,201926
10,1,248,43,245,240,18,175,74,1043,1600,2643,12,4.666666667,201926
10,2,269,27,293,345,23,292,8,1257,3675,4932,9,5.25,201926
10,3,293,52,298,332,33,253,51,1312,2694,4006,11,5.4,201926
10,4,322,25,428,467,12,290,0,1544,4050,5594,12,7,201926
11,1,201,29,172,201,13,137,2,755,850,1605,6,5.666666667,201926
11,2,225,23,213,229,38,146,17,891,1071,1962,7,6,201926
11,3,162,10,218,285,5,211,9,900,1172,2072,3,6,201926
11,4,174,31,123,215,13,172,1,729,960,1689,8,6,201926
11,5,278,37,343,482,22,298,5,1465,1298,2763,7,6,201926
11,6,125,13,186,224,26,161,4,739,863,1602,8,6,201926
11,7,240,28,275,462,26,156,1,1188,1215,2403,9,5.5,201926
11,8,181,36,246,324,18,164,0,969,1168,2137,9,5.5,201926
11,9,272,39,288,382,9,222,13,1225,1623,2848,10,5.666666667,201926
11,10,223,30,184,180,14,233,7,871,1446,2317,10,5.6,201926
11,11,206,28,314,262,12,196,0,1018,1248,2266,5,6,201926
11,12,227,28,361,469,11,217,0,1313,1567,2880,7,6,201926
11,13,231,26,175,190,21,207,11,861,895,1756,8,5.5,201926
11,14,185,15,208,224,18,199,0,849,1054,1903,8,5.5,201926
11,15,175,31,229,234,4,156,1,830,728,1558,9,6,201926
12,1,160,24,212,197,54,138,4,789,892,1681,10,5.2,201926
12,2,194,21,214,341,21,168,6,965,1221,2186,10,5.5,201926
12,3,165,29,206,423,12,103,0,938,819,1757,11,5.2,201926
12,4,173,17,262,457,11,111,0,1031,1490,2521,9,5.666666667,201926
12,5,220,21,278,316,3,149,10,997,715,1712,10,5.25,201926
12,6,180,15,141,392,31,83,20,862,873,1735,10,5.25,201926
12,7,207,18,204,298,8,151,31,917,1405,2322,6,5.5,201926
12,8,192,17,154,310,3,96,0,772,673,1445,9,5.25,201926
12,9,167,17,239,460,22,71,37,1013,1318,2331,9,5.666666667,201926
13,1,226,20,138,210,21,166,53,834,859,1693,9,5.333333333,201926
13,2,169,11,110,221,34,142,0,687,507,1194,6,5.333333333,201926
13,3,166,11,160,246,64,137,1,785,883,1668,12,5.25,201926
13,4,202,10,276,318,55,165,15,1041,696,1737,9,5.666666667,201926
13,5,278,19,356,325,81,319,9,1387,1712,3099,9,5.75,201926
13,6,289,62,667,514,58,238,7,1835,2087,3922,11,5.666666667,201926
13,7,157,14,279,348,30,116,0,944,1145,2089,8,5.5,201926
14,1,190,18,114,78,10,358,0,768,704,1472,6,5.5,201926
14,2,225,15,169,115,7,318,1,850,909,1759,5,5.666666667,201926
14,3,296,11,243,120,8,338,1,1017,862,1879,8,5.4,201926
14,4,204,10,258,360,14,206,8,1060,1246,2306,10,6,201926
14,5,227,15,400,277,30,269,0,1218,1257,2475,9,5.5,201926
14,6,229,14,411,308,12,229,0,1203,1279,2482,11,6,201926
14,7,130,11,172,159,0,147,0,619,728,1347,6,6,201926
14,8,367,34,640,707,13,580,0,2341,3108,5449,11,6,201926
14,9,155,14,190,275,18,157,1,810,1083,1893,11,6,201926
14,10,243,11,357,344,1,304,0,1260,1348,2608,7,6,201926
14,11,103,10,142,190,19,187,8,659,982,1641,4,6,201926
14,12,264,16,430,227,15,204,1,1157,1335,2492,9,5.5,201926
14,13,245,7,364,305,11,284,6,1222,1434,2656,6,6,201926
14,14,194,14,249,268,13,277,3,1018,1277,2295,7,6,201926
14,15,238,20,208,201,19,261,9,956,1018,1974,10,5.6,201926
14,16,175,11,261,164,24,246,1,882,1228,2110,5,6,201926
14,17,188,19,172,111,21,206,8,725,740,1465,7,5.25,201926
14,18,231,20,201,134,24,270,15,895,1146,2041,9,5.4,201926
14,19,162,12,260,233,9,166,4,846,1036,1882,8,5.25,201926
14,20,189,16,259,195,4,218,1,882,1130,2012,10,5.666666667,201926
15,1,150,5,145,84,165,200,0,749,891,1640,7,5.333333333,201926
15,2,126,9,255,402,36,192,14,1034,1244,2278,6,6,201926
15,3,224,20,241,290,137,317,15,1244,1455,2699,10,5.666666667,201926
15,4,177,16,222,303,11,242,2,973,1477,2450,4,6,201926
15,5,156,29,246,262,27,220,0,940,1067,2007,8,5.666666667,201926
15,6,156,7,322,441,36,190,6,1158,1387,2545,7,6,201926
15,7,152,12,236,322,36,212,0,970,1122,2092,10,6,201926
15,8,96,8,156,269,10,146,5,690,855,1545,4,6,201926
15,9,310,10,161,210,110,205,9,1015,1038,2053,9,5.75,201926
15,10,128,10,227,255,35,185,3,843,948,1791,6,6,201926
15,11,162,15,278,432,43,192,3,1125,1540,2665,8,6,201926
15,12,204,15,458,461,34,207,0,1379,1743,3122,8,6,201926
15,13,101,10,199,204,69,198,1,782,1032,1814,8,6,201926
15,14,105,15,167,224,18,120,5,654,765,1419,4,6,201926
15,15,167,31,285,398,31,234,2,1148,1574,2722,6,6,201926
15,16,206,33,392,564,24,252,7,1478,1180,2658,8,6,201926
15,17,110,10,214,319,16,201,27,897,610,1507,8,6,201926
15,18,233,17,300,447,26,280,0,1303,1444,2747,7,5.666666667,201926
15,19,215,28,419,613,15,343,11,1644,1736,3380,10,6,201926
15,20,85,15,222,268,15,145,0,750,796,1546,6,6,201926
15,21,103,7,89,212,18,154,5,588,664,1252,6,5.5,201926
15,22,288,40,540,721,32,411,20,2052,2648,4700,14,6,201926
15,23,192,23,246,344,17,244,0,1066,1131,2197,6,5.333333333,201926
15,24,144,9,203,278,37,140,5,816,809,1625,4,6,201926
15,25,166,23,263,269,39,150,12,922,940,1862,6,6,201926
15,26,140,4,224,282,37,206,1,894,1176,2070,9,7,201926
15,27,224,19,338,473,15,299,35,1403,1188,2591,9,5.666666667,201926
15,28,251,15,470,381,33,269,4,1423,1700,3123,9,5.666666667,201926
15,29,213,19,415,582,6,284,5,1524,1668,3192,8,6,201926
15,30,228,27,467,514,43,182,9,1470,1846,3316,16,6,201926
15,31,144,39,234,340,16,156,0,929,1272,2201,6,6,201926
15,32,160,9,229,396,28,157,7,986,1032,2018,9,6,201926
15,33,157,13,266,371,23,200,0,1030,1019,2049,7,6,201926
15,34,149,13,244,395,11,214,0,1026,1447,2473,8,6,201926
15,35,267,21,259,355,10,346,0,1258,1468,2726,9,5.666666667,201926
15,36,183,25,256,275,27,172,0,938,865,1803,9,5.5,201926
15,37,212,26,324,530,29,270,21,1412,1660,3072,7,6,201926
15,38,133,20,227,365,16,166,7,934,1113,2047,6,5.5,201926
15,39,138,20,311,333,14,109,0,925,710,1635,4,6,201926
15,40,318,19,329,456,84,451,0,1657,1676,3333,9,6,201926
15,41,254,17,500,584,38,236,8,1637,2285,3922,13,6,201926
16,1,128,9,185,171,5,140,0,638,865,1503,7,5.333333333,201926
16,2,113,11,103,119,1,138,0,485,489,974,9,5.25,201926
16,3,213,22,170,249,15,172,0,841,1020,1861,10,5.25,201926
16,4,182,18,165,127,28,217,0,737,1109,1846,8,5.5,201926
16,5,228,29,166,189,35,195,6,848,1176,2024,10,5.666666667,201926
16,6,208,29,161,267,32,135,0,832,916,1748,12,5.5,201926
16,7,171,26,128,166,29,168,0,688,1058,1746,9,5.5,201926
16,8,270,26,449,510,9,289,7,1560,1967,3527,12,6,201926
16,9,186,17,231,265,10,209,6,924,1225,2149,9,6,201926
16,10,170,17,255,258,16,169,0,885,1107,1992,7,6.5,201926
16,11,218,18,175,131,47,224,0,813,896,1709,10,5.4,201926
16,12,171,14,199,155,11,152,6,708,751,1459,10,5.25,201926
17,1,190,19,381,448,17,248,0,1303,1634,2937,9,7,201926
17,2,149,12,301,355,14,129,5,965,1368,2333,8,5.666666667,201926
17,3,242,12,371,429,15,229,0,1298,1824,3122,8,5.5,201926
17,4,246,15,323,381,17,197,15,1194,1600,2794,10,5.666666667,201926
17,5,99,10,131,154,8,67,0,469,705,1174,5,5.5,201926
18,1,128,19,114,192,11,113,4,581,665,1246,7,5.25,201926
18,2,206,16,338,381,50,213,2,1206,1651,2857,9,6.333333333,201926
18,3,166,12,258,190,8,149,1,784,942,1726,8,5.5,201926
19,1,169,10,314,315,12,372,6,1198,1492,2690,9,6,201926
19,2,254,11,446,312,11,346,0,1380,1701,3081,9,5.5,201926
19,3,274,14,589,400,22,401,0,1700,1786,3486,7,6,201926
19,4,134,8,189,144,32,232,26,765,806,1571,5,6,201926
19,5,384,29,519,669,22,456,13,2092,2820,4912,8,6,201926
19,6,91,9,180,219,6,214,0,719,860,1579,5,6,201926
19,7,156,10,461,192,8,150,0,977,1195,2172,10,5.5,201926
19,8,70,4,148,179,1,123,0,525,718,1243,7,6,201926
19,9,180,15,219,237,9,186,0,846,724,1570,9,5.25,201926
19,10,134,9,179,245,7,285,10,869,1035,1904,6,7,201926
19,11,408,36,596,672,9,643,17,2381,2961,5342,13,6,201926
19,12,193,12,530,227,6,218,2,1188,1120,2308,8,5.666666667,201926
20,1,181,21,159,203,42,150,27,783,847,1630,7,5.5,201926
20,2,174,13,171,197,11,136,0,702,767,1469,6,5.333333333,201926
20,3,125,11,109,104,30,69,32,480,602,1082,6,5.333333333,201926
20,4,104,12,82,142,13,103,29,485,679,1164,6,5.333333333,201926
20,5,167,9,164,319,34,108,1,802,1057,1859,11,5.25,201926
20,6,211,16,204,232,163,88,0,914,982,1896,8,5.25,201926
20,7,250,20,212,380,13,156,1,1032,841,1873,7,5.75,201926
20,8,445,34,504,849,22,352,41,2247,1617,3864,14,6.5,201926
20,9,264,11,225,264,38,236,24,1062,952,2014,8,5.666666667,201926
20,10,170,4,200,228,11,98,1,712,964,1676,9,5.25,201926
21,1,389,19,248,466,21,214,6,1363,1305,2668,9,5.4,201926
21,2,270,32,278,241,141,140,0,1102,2341,3443,9,5.2,201926
21,3,453,12,276,250,61,377,21,1450,2310,3760,8,5.5,201926
21,4,251,7,128,102,60,176,22,746,1470,2216,6,5.25,201926
21,5,322,22,286,281,15,274,13,1213,3152,4365,8,5.666666667,201926
21,6,266,12,262,279,25,251,10,1105,3588,4693,6,6,201926
21,7,379,16,220,276,42,412,1,1346,2775,4121,9,5.666666667,201926
21,8,309,17,225,173,141,208,29,1102,1702,2804,9,5.2,201926
21,9,341,19,472,483,53,320,23,1711,4703,6414,9,6,201926
21,10,304,11,317,367,34,258,34,1325,3067,4392,7,5.5,201926
21,11,129,6,170,142,19,102,5,573,1859,2432,4,6,201926
21,12,560,14,693,810,34,531,18,2660,6337,8997,16,6.5,201926
21,13,346,20,297,292,35,423,15,1428,2593,4021,8,5.666666667,201926
21,14,327,20,303,203,114,230,39,1236,2042,3278,12,5.333333333,201926
21,15,393,11,451,278,42,290,17,1482,3355,4837,7,5.5,201926
22,1,221,41,143,297,14,98,6,820,738,1558,11,5.2,201926
22,2,179,13,287,276,25,150,8,938,893,1831,7,5.5,201926
22,3,232,30,633,598,9,265,0,1767,1688,3455,9,5.666666667,201926
22,4,177,25,458,480,15,247,1,1403,1142,2545,9,6.5,201926
22,5,135,19,418,229,43,139,12,995,1044,2039,10,5.5,201926
23,1,293,8,1122,310,28,160,9,1930,5421,7351,14,5.6,201926
23,2,256,19,524,406,26,150,0,1381,1896,3277,9,5.5,201926
23,3,377,7,913,526,24,227,1,2075,3260,5335,19,6,201926
23,4,138,2,402,201,6,106,0,855,2676,3531,5,5,201926
24,1,140,17,125,208,19,105,2,616,573,1189,10,5.2,201926
24,2,139,20,191,169,9,208,0,736,752,1488,6,5.5,201926
24,3,163,14,112,173,39,125,0,626,634,1260,9,5.25,201926
24,4,132,25,154,190,27,226,37,791,1077,1868,5,5.5,201926
24,5,310,37,451,498,14,285,0,1595,1942,3537,10,6.333333333,201926
24,6,208,21,325,410,26,262,0,1252,913,2165,6,6,201926
24,7,243,16,179,310,28,103,0,879,1004,1883,9,5.25,201926
25,1,154,12,209,257,21,174,39,866,1087,1953,13,5.75,201926
25,2,227,12,280,374,9,240,0,1142,1597,2739,7,5.5,201926
25,3,159,9,236,265,20,166,6,861,1315,2176,8,5.6,201926
25,4,124,16,149,212,16,137,0,654,798,1452,8,5.333333333,201926
25,5,148,8,232,361,10,191,0,950,1249,2199,8,5.666666667,201926
25,6,173,8,250,264,36,212,9,952,1312,2264,8,5.25,201926
25,7,231,19,341,429,10,274,1,1305,1685,2990,6,6,201926
26,1,194,7,271,251,7,268,0,998,788,1786,9,5.5,201926
26,2,187,5,306,359,3,188,6,1054,1226,2280,12,5.4,201926
26,3,228,17,309,471,14,372,6,1417,1516,2933,14,6.5,201926
26,4,145,14,128,209,26,250,6,778,716,1494,9,5.2,201926
26,5,135,15,156,199,17,219,0,741,1002,1743,15,6,201926
26,6,163,15,281,312,9,287,0,1067,1320,2387,10,5.333333333,201926
26,7,118,10,158,221,32,122,0,661,822,1483,10,5.5,201926
27,1,192,7,241,307,62,154,0,963,844,1807,8,5.5,201926
27,2,238,17,247,487,21,156,1,1167,966,2133,8,5.666666667,201926
27,3,246,7,214,392,10,126,0,995,1052,2047,7,5.666666667,201926
27,4,254,13,399,758,16,223,22,1685,2020,3705,8,6,201926
27,5,140,2,185,318,6,108,0,759,603,1362,6,5.333333333,201926
27,6,129,14,232,377,10,156,0,918,942,1860,7,5.5,201926
28,1,319,29,572,465,3,298,0,1686,1795,3481,13,6,201926
28,2,251,23,473,309,33,274,86,1449,2974,4423,15,5.666666667,201926
28,3,173,18,177,212,8,206,1,795,1375,2170,7,5.333333333,201926
28,4,322,16,465,263,40,293,34,1433,5912,7345,15,6,201926
28,5,216,26,254,341,20,274,17,1148,2312,3460,10,5.5,201926
28,6,176,11,248,274,25,101,15,850,2072,2922,13,5.166666667,201926
28,7,218,20,406,318,21,309,1,1293,3657,4950,13,6,201926
28,8,126,14,220,248,27,183,1,819,2424,3243,13,13,201926
28,9,228,8,331,211,18,210,13,1019,2598,3617,10,7.666666667,201926
29,1,269,30,354,412,42,201,4,1312,1449,2761,7,5.5,201926
29,2,301,11,298,523,26,247,53,1459,1493,2952,11,6,201926
29,3,169,21,146,289,15,139,0,779,953,1732,5,5.666666667,201926
30,1,111,10,135,185,14,96,1,552,506,1058,7,5,201926
30,2,143,10,92,79,12,99,43,478,483,961,8,5.25,201926
30,3,189,6,148,204,43,171,31,792,769,1561,6,5.666666667,201926
30,4,101,5,219,181,21,130,0,657,828,1485,8,6,201926
30,5,125,4,123,218,13,150,1,634,952,1586,7,5.5,201926
30,6,148,7,169,160,18,94,7,603,715,1318,9,5.333333333,201926
30,7,211,9,203,264,18,169,18,892,1073,1965,11,5.25,201926
30,8,202,11,271,391,39,248,11,1173,1092,2265,11,5.4,201926
30,9,254,7,163,199,39,211,21,894,1143,2037,8,5.5,201926
30,10,176,6,256,276,15,186,28,943,1266,2209,6,6,201926
30,11,120,7,225,285,5,166,0,808,1168,1976,5,5.5,201926
30,12,233,7,418,544,34,330,5,1571,2143,3714,10,6,201926
30,13,213,18,163,266,29,190,84,963,1192,2155,10,5.4,201926
30,14,174,6,235,230,33,188,4,870,866,1736,8,5.5,201926
30,15,254,8,212,297,40,313,36,1160,1766,2926,11,5.666666667,201926
30,16,210,10,231,339,45,208,40,1083,1471,2554,10,5.333333333,201926
30,17,137,10,180,258,46,136,7,774,814,1588,8,5.5,201926
30,18,109,5,74,126,18,123,6,461,641,1102,8,5.25,201926
30,19,183,11,207,233,7,189,0,830,1142,1972,13,5.6,201926
30,20,185,11,217,376,72,173,0,1034,1032,2066,10,5.4,201926
31,1,215,26,172,54,230,163,1,861,803,1664,8,5.5,201926
31,2,89,8,100,15,143,90,0,445,422,867,6,5.333333333,201926
31,3,400,36,828,604,93,400,0,2361,1966,4327,20,6,201926
31,4,114,14,252,240,52,174,13,859,699,1558,4,6,201926
31,5,112,5,88,156,31,132,0,524,678,1202,5,5.333333333,201926
32,1,198,21,172,171,29,235,11,837,811,1648,12,5.2,201926
32,2,242,18,157,118,46,208,15,804,643,1447,13,5.142857143,201926
32,3,181,39,171,261,8,242,0,902,943,1845,13,5.4,201926
32,4,208,45,171,236,13,198,7,878,724,1602,13,5.4,201926
1,1,300,45,442,345,47,295,2,1476,2021,3497,13,5.5,201927
1,2,303,52,714,468,50,340,3,1930,2621,4551,10,6.333333333,201927
1,3,243,56,571,367,26,382,4,1649,2611,4260,9,6,201927
2,1,256,14,459,398,11,312,0,1450,1991,3441,11,6,201927
2,2,194,9,306,298,11,268,0,1086,3588,4674,7,6,201927
2,3,290,23,473,338,8,312,21,1465,4009,5474,12,6,201927
2,4,231,5,541,217,45,177,8,1224,3155,4379,9,6,201927
2,5,317,27,678,286,79,262,5,1654,5706,7360,16,8.5,201927
2,6,224,10,368,244,12,203,0,1061,3237,4298,8,6.5,201927
2,7,312,10,427,267,19,229,34,1298,3873,5171,12,5.75,201927
2,8,214,12,527,329,9,150,18,1259,3713,4972,8,6,201927
3,1,161,11,235,315,13,201,3,939,1072,2011,12,5.666666667,201927
3,2,136,10,454,205,26,117,0,948,1218,2166,9,5.666666667,201927
4,1,136,11,243,412,27,195,38,1062,1343,2405,11,5.25,201927
4,2,167,13,304,370,28,126,20,1028,1268,2296,14,5.2,201927
5,1,261,19,397,377,33,234,14,1335,1183,2518,9,5.666666667,201927
5,2,187,21,286,457,28,160,0,1139,1254,2393,10,5.2,201927
5,3,201,20,306,484,32,300,16,1359,1350,2709,11,5.333333333,201927
5,4,245,21,508,494,7,340,20,1635,1783,3418,11,5.75,201927
5,5,176,15,338,468,20,148,18,1183,1277,2460,9,6,201927
5,6,155,8,293,325,9,144,27,961,1086,2047,10,5.5,201927
5,7,214,10,327,363,6,193,10,1123,1084,2207,11,6,201927
6,1,166,17,274,249,6,243,6,961,918,1879,12,6,201927
6,2,122,8,291,193,22,184,14,834,1076,1910,9,5.666666667,201927
7,1,234,5,129,314,16,69,8,775,1120,1895,9,5.25,201927
7,2,182,11,94,331,21,31,0,670,1205,1875,9,5.25,201927
7,3,282,4,174,192,117,131,0,900,1413,2313,7,5.333333333,201927
7,4,134,10,87,360,3,71,34,699,1215,1914,11,5.4,201927
7,5,325,5,138,533,12,122,0,1135,1380,2515,11,5.666666667,201927
7,6,263,10,312,406,26,214,19,1250,1456,2706,8,5.333333333,201927
7,7,212,25,234,401,46,186,8,1112,1131,2243,8,5.5,201927
7,8,215,12,169,488,6,195,3,1088,1197,2285,12,5.25,201927
7,9,206,10,246,401,11,182,1,1057,957,2014,9,5.666666667,201927
7,10,190,15,174,483,14,87,0,963,631,1594,9,5.5,201927
7,11,83,1,55,66,11,30,6,252,397,649,6,5.333333333,201927
7,12,199,7,238,498,5,124,0,1071,1348,2419,9,5.5,201927
7,13,86,8,88,224,3,29,0,438,552,990,9,5.25,201927
8,1,141,7,377,186,23,146,5,885,785,1670,4,6,201927
8,2,290,27,646,453,21,302,0,1739,1581,3320,17,5.5,201927
8,3,203,16,398,316,14,178,15,1140,1181,2321,4,6,201927
8,4,196,28,381,312,24,314,37,1292,1009,2301,11,6,201927
8,5,263,22,290,256,12,202,0,1045,913,1958,10,5.25,201927
8,6,229,25,423,394,28,335,5,1439,1499,2938,7,6.5,201927
8,7,190,26,188,182,1,237,0,824,754,1578,7,5.25,201927
8,8,189,21,377,396,9,272,0,1264,1306,2570,10,6,201927
8,9,166,16,162,137,7,232,1,721,980,1701,10,5.2,201927
9,1,102,7,159,149,42,123,5,587,753,1340,5,6,201927
9,2,320,65,687,935,68,430,9,2514,2796,5310,12,6,201927
9,3,133,19,300,402,42,230,22,1148,1535,2683,7,6,201927
9,4,197,20,297,568,65,199,15,1361,1495,2856,11,6,201927
9,5,139,24,287,348,39,189,0,1026,1056,2082,7,6,201927
9,6,121,26,185,199,119,189,20,859,773,1632,7,6,201927
9,7,111,13,247,406,1,182,0,960,1116,2076,9,6,201927
9,8,103,15,293,342,10,140,7,910,1057,1967,5,6,201927
9,9,131,9,213,337,30,114,3,837,927,1764,5,6,201927
9,10,122,21,312,378,25,171,0,1029,1243,2272,6,6,201927
9,11,155,15,416,577,55,225,0,1443,1557,3000,7,6,201927
9,12,131,18,490,630,30,253,37,1589,1915,3504,11,6,201927
9,13,129,18,299,381,71,177,11,1086,1119,2205,4,6,201927
9,14,111,9,203,277,53,182,17,852,924,1776,5,6,201927
9,15,219,31,792,962,25,434,1,2464,2041,4505,10,6.5,201927
9,16,268,48,371,667,88,354,0,1796,1656,3452,15,6,201927
9,17,127,14,204,331,19,160,0,855,450,1305,6,6,201927
9,18,175,21,362,580,41,212,7,1398,1483,2881,12,6,201927
9,19,188,36,257,506,49,207,6,1249,1499,2748,5,6,201927
9,20,45,7,89,137,13,51,2,344,362,706,5,6,201927
9,21,130,14,176,265,27,117,5,734,873,1607,3,6,201927
9,22,130,11,205,316,65,147,13,887,1272,2159,5,6,201927
9,23,140,7,306,529,38,210,5,1235,1112,2347,6,6,201927
9,24,289,21,568,836,81,428,7,2230,2428,4658,14,6,201927
10,1,255,40,234,283,16,243,62,1133,1378,2511,12,4.666666667,201927
10,2,238,26,371,337,20,280,19,1291,2669,3960,9,5.25,201927
10,3,213,26,218,253,17,210,32,969,1852,2821,11,5.4,201927
10,4,314,33,432,508,10,251,1,1549,3080,4629,12,6.5,201927
11,1,195,24,149,234,11,138,1,752,780,1532,6,5.666666667,201927
11,2,192,20,221,212,21,165,17,848,857,1705,7,6,201927
11,3,168,18,208,318,10,176,2,900,1020,1920,3,6,201927
11,4,178,37,152,221,15,191,2,796,911,1707,8,6,201927
11,5,263,33,320,482,24,271,9,1402,942,2344,7,6,201927
11,6,140,12,186,208,11,140,2,699,942,1641,8,6,201927
11,7,210,37,238,401,24,135,0,1045,1439,2484,9,5.5,201927
11,8,208,20,248,343,21,198,0,1038,1082,2120,9,5.5,201927
11,9,292,37,298,411,21,227,19,1305,1467,2772,10,5.666666667,201927
11,10,231,29,218,225,19,247,4,973,1175,2148,10,5.6,201927
11,11,191,30,310,329,15,182,0,1057,699,1756,5,6,201927
11,12,211,29,346,503,9,174,0,1272,1188,2460,7,6,201927
11,13,169,19,134,163,18,155,12,670,963,1633,8,5.5,201927
11,14,212,23,176,213,13,200,0,837,1015,1852,8,5.5,201927
11,15,153,32,202,249,9,147,1,793,1057,1850,9,6,201927
12,1,86,14,135,115,29,76,1,456,735,1191,10,5.2,201927
12,2,203,19,183,304,18,133,3,863,1104,1967,10,5.5,201927
12,3,120,20,186,325,12,68,0,731,1164,1895,11,5.2,201927
12,4,134,25,247,611,18,121,0,1156,1229,2385,9,5.666666667,201927
12,5,150,17,141,244,3,82,2,639,1033,1672,10,5.25,201927
12,6,138,11,76,226,17,43,17,528,952,1480,10,5.25,201927
12,7,214,15,212,288,14,141,54,938,1395,2333,6,5.5,201927
12,8,166,9,150,222,1,67,0,615,847,1462,9,5.25,201927
12,9,130,13,200,431,22,71,22,889,1144,2033,9,5.666666667,201927
13,1,172,13,119,204,26,113,43,690,1040,1730,9,5.333333333,201927
13,2,117,10,76,133,30,93,2,461,488,949,6,5.333333333,201927
13,3,141,12,150,190,58,110,0,661,821,1482,12,5.25,201927
13,4,175,9,209,226,35,115,7,776,840,1616,9,5.666666667,201927
13,5,203,14,289,282,73,217,9,1087,1349,2436,9,5.75,201927
13,6,259,63,522,576,54,202,1,1677,1766,3443,11,5.666666667,201927
13,7,126,14,305,353,14,134,0,946,956,1902,8,5.5,201927
14,1,151,9,107,85,10,242,1,605,713,1318,6,5.5,201927
14,2,210,13,184,116,10,309,0,842,832,1674,5,5.666666667,201927
14,3,260,15,226,120,6,326,0,953,888,1841,8,5.2,201927
14,4,168,13,235,312,21,219,4,972,1083,2055,10,6,201927
14,5,187,10,349,242,26,175,0,989,751,1740,9,5.5,201927
14,6,226,6,435,313,6,213,2,1201,830,2031,11,6,201927
14,7,150,11,187,162,0,140,0,650,505,1155,6,6,201927
14,8,350,29,676,754,14,552,1,2376,2633,5009,11,6.25,201927
14,9,150,19,199,260,20,177,4,829,862,1691,11,6,201927
14,10,219,24,358,337,5,266,0,1209,955,2164,7,6,201927
14,11,135,9,148,184,21,181,22,700,860,1560,4,6,201927
14,12,270,8,449,246,14,239,3,1229,1066,2295,9,5.5,201927
14,13,252,14,332,282,19,296,7,1202,1487,2689,6,6,201927
14,14,167,10,280,262,13,253,0,985,969,1954,7,6,201927
14,15,252,12,202,212,22,320,6,1026,1132,2158,10,5.6,201927
14,16,161,14,240,169,14,248,2,848,634,1482,5,6,201927
14,17,172,14,206,134,36,211,9,782,725,1507,7,5.25,201927
14,18,252,25,271,135,29,350,16,1078,1172,2250,9,5.4,201927
14,19,199,14,271,276,14,217,23,1014,1168,2182,8,5.25,201927
14,20,197,15,230,167,5,202,0,816,873,1689,10,5.666666667,201927
15,1,225,8,156,119,99,224,8,839,811,1650,7,5.333333333,201927
15,2,145,6,266,333,23,157,4,934,1083,2017,6,6,201927
15,3,275,23,220,335,141,342,16,1352,1470,2822,10,5.666666667,201927
15,4,189,7,226,340,19,251,5,1037,1149,2186,4,6,201927
15,5,157,28,228,286,18,228,5,950,976,1926,8,5.666666667,201927
15,6,180,15,300,443,39,200,9,1186,1085,2271,7,6,201927
15,7,151,6,217,333,19,189,1,916,790,1706,10,6,201927
15,8,94,10,167,243,15,111,4,644,824,1468,4,6,201927
15,9,233,8,126,186,102,141,4,800,912,1712,9,5.75,201927
15,10,141,12,232,265,43,168,1,862,699,1561,6,6,201927
15,11,186,18,301,417,55,162,4,1143,1133,2276,8,6,201927
15,12,216,17,453,485,36,197,0,1404,1377,2781,8,6,201927
15,13,92,6,214,230,65,179,0,786,897,1683,8,6,201927
15,14,89,18,142,258,12,134,4,657,605,1262,4,6,201927
15,15,165,44,294,405,29,229,4,1170,1308,2478,6,6,201927
15,16,206,33,351,558,24,236,7,1415,837,2252,8,6,201927
15,17,118,17,198,322,13,189,19,876,614,1490,8,6,201927
15,18,216,15,258,436,27,246,2,1200,1318,2518,7,5.666666667,201927
15,19,235,28,458,639,22,335,9,1726,916,2642,10,6,201927
15,20,92,13,235,273,10,121,0,744,738,1482,6,6,201927
15,21,75,11,131,185,15,123,15,555,587,1142,6,5.5,201927
15,22,283,44,544,665,34,439,30,2039,2392,4431,14,6,201927
15,23,195,8,228,308,10,222,0,971,1012,1983,6,5.333333333,201927
15,24,124,14,230,246,24,128,5,771,800,1571,4,6,201927
15,25,148,16,200,290,56,128,14,852,892,1744,6,6,201927
15,26,139,4,207,245,47,212,2,856,973,1829,9,7,201927
15,27,218,19,333,485,21,308,37,1421,1608,3029,9,5.666666667,201927
15,28,187,13,433,339,55,219,3,1249,1662,2911,9,5.666666667,201927
15,29,259,17,391,597,10,313,5,1592,966,2558,8,6,201927
15,30,211,19,431,465,25,168,7,1326,1515,2841,16,6,201927
15,31,133,44,238,334,18,187,0,954,1143,2097,6,6,201927
15,32,156,13,234,385,19,155,4,966,1256,2222,9,6,201927
15,33,152,10,307,391,12,164,0,1036,774,1810,7,6,201927
15,34,155,16,198,398,7,191,2,967,1118,2085,8,6,201927
15,35,268,20,244,330,2,285,0,1149,1500,2649,9,5.666666667,201927
15,36,189,10,208,229,30,157,0,823,889,1712,9,5.5,201927
15,37,232,16,300,520,34,263,25,1390,1655,3045,7,6,201927
15,38,167,14,237,357,10,192,6,983,1210,2193,6,5.5,201927
15,39,129,21,234,356,18,142,0,900,831,1731,4,6,201927
15,40,304,18,340,405,59,396,0,1522,1564,3086,9,6,201927
15,41,252,29,525,541,31,202,5,1585,1802,3387,13,6,201927
16,1,182,8,208,184,20,172,0,774,742,1516,7,5.333333333,201927
16,2,147,17,73,157,6,153,0,553,727,1280,9,5.25,201927
16,3,175,37,118,217,43,105,13,708,899,1607,10,5.25,201927
16,4,168,15,183,136,13,221,0,736,906,1642,8,5.5,201927
16,5,227,23,187,176,17,213,4,847,1078,1925,10,5.666666667,201927
16,6,176,23,153,203,19,117,0,691,894,1585,12,5.5,201927
16,7,186,16,133,197,28,178,0,738,959,1697,9,5.5,201927
16,8,254,23,475,508,17,285,2,1564,2005,3569,12,6,201927
16,9,205,24,229,261,13,206,5,943,1216,2159,9,6,201927
16,10,146,15,263,305,9,173,0,911,1035,1946,6,6,201927
16,11,182,16,152,135,43,173,0,701,937,1638,10,5.4,201927
16,12,161,14,159,129,9,121,4,597,805,1402,10,5.25,201927
17,1,218,16,360,389,23,270,0,1276,1308,2584,9,7,201927
17,2,137,7,319,313,7,161,10,954,1114,2068,8,5.666666667,201927
17,3,246,17,320,443,14,186,1,1227,1589,2816,8,5.5,201927
17,4,204,19,283,379,35,168,9,1097,1041,2138,10,5.666666667,201927
17,5,106,4,146,179,5,66,0,506,526,1032,5,5.5,201927
18,1,109,18,103,132,6,104,0,472,566,1038,7,5.25,201927
18,2,223,20,342,436,38,191,1,1251,1389,2640,8,6,201927
18,3,129,14,251,164,9,131,2,700,1025,1725,8,5.5,201927
19,1,200,9,326,372,8,337,3,1255,1085,2340,9,6,201927
19,2,295,10,563,371,6,351,0,1596,1797,3393,9,6,201927
19,3,249,17,573,379,17,356,0,1591,1791,3382,7,6,201927
19,4,137,14,168,177,43,238,30,807,1051,1858,5,6,201927
19,5,364,25,526,598,19,491,15,2038,2318,4356,8,6,201927
19,6,102,11,215,250,9,216,1,804,827,1631,5,6,201927
19,7,194,7,480,207,6,175,0,1069,1098,2167,10,5.5,201927
19,8,96,11,172,164,3,134,0,580,618,1198,7,6,201927
19,9,173,14,163,157,28,212,0,747,793,1540,9,5.25,201927
19,10,145,8,219,236,8,299,11,926,1021,1947,6,7,201927
19,11,453,45,573,714,17,670,13,2485,2911,5396,13,6,201927
19,12,168,7,378,223,14,217,2,1009,980,1989,8,5.666666667,201927
20,1,169,5,141,207,43,118,33,716,734,1450,7,5.5,201927
20,2,118,43,124,190,8,48,87,618,613,1231,6,5.333333333,201927
20,3,106,5,158,115,57,62,44,547,344,891,6,5.333333333,201927
20,4,95,7,81,184,19,109,29,524,502,1026,6,5.333333333,201927
20,5,183,13,154,369,33,116,0,868,646,1514,11,5.25,201927
20,6,102,15,128,269,72,67,0,653,694,1347,8,5.25,201927
20,7,190,13,192,277,14,206,0,892,1175,2067,7,5.75,201927
20,8,394,30,464,824,24,334,35,2105,1903,4008,14,6.5,201927
20,9,224,10,154,205,33,178,24,828,1127,1955,8,5.666666667,201927
20,10,133,5,129,182,15,89,4,557,755,1312,9,5.25,201927
21,1,288,13,216,414,11,217,5,1164,1680,2844,9,5.4,201927
21,2,264,14,263,282,62,131,1,1017,2057,3074,9,5.2,201927
21,3,323,11,224,184,54,271,6,1073,2816,3889,8,5.5,201927
21,4,198,10,100,105,64,121,13,611,1521,2132,6,5.25,201927
21,5,276,16,327,290,28,271,18,1226,2533,3759,8,5.666666667,201927
21,6,282,13,227,351,29,260,13,1175,2619,3794,6,6,201927
21,7,350,22,231,304,45,353,0,1305,2459,3764,9,5.666666667,201927
21,8,301,14,292,191,154,205,39,1196,2175,3371,9,5.2,201927
21,9,318,33,459,457,42,259,15,1583,4353,5936,9,6,201927
21,10,277,4,268,330,27,225,34,1165,3015,4180,7,5.5,201927
21,11,131,3,144,127,18,90,3,516,798,1314,4,6,201927
21,12,519,21,755,833,31,494,14,2667,5507,8174,16,6.5,201927
21,13,293,10,279,241,36,324,14,1197,2500,3697,8,5.666666667,201927
21,14,261,17,206,202,66,220,17,989,1814,2803,12,5.333333333,201927
21,15,306,13,370,294,39,254,8,1284,3738,5022,7,5.5,201927
22,1,172,36,157,255,13,80,2,715,736,1451,11,5.2,201927
22,2,197,20,273,264,32,129,2,917,988,1905,7,5.5,201927
22,3,266,40,656,631,14,237,0,1844,1352,3196,9,5.666666667,201927
22,4,195,21,537,497,22,211,1,1484,872,2356,9,6.5,201927
22,5,195,20,351,208,63,135,4,976,964,1940,10,5.5,201927
23,1,303,11,1167,350,33,190,11,2065,4777,6842,14,5.4,201927
23,2,282,24,426,505,45,139,0,1421,2097,3518,9,5.5,201927
23,3,346,15,941,537,20,238,1,2098,2563,4661,19,6,201927
23,4,229,6,613,252,19,147,1,1267,1924,3191,6,5.5,201927
24,1,153,29,112,187,14,78,3,576,611,1187,10,5.2,201927
24,2,110,12,194,156,10,131,0,613,679,1292,6,5.5,201927
24,3,185,24,165,202,36,97,1,710,881,1591,9,5.25,201927
24,4,115,11,162,153,28,169,33,671,951,1622,5,5.5,201927
24,5,252,37,446,460,10,262,0,1467,1996,3463,10,6.333333333,201927
24,6,195,30,294,369,26,282,0,1196,1314,2510,6,6,201927
24,7,177,17,154,349,10,105,0,812,904,1716,9,5.25,201927
25,1,120,9,201,293,21,162,18,824,944,1768,13,5.75,201927
25,2,226,19,288,406,16,254,0,1209,1589,2798,7,5.5,201927
25,3,134,7,276,283,30,177,9,916,958,1874,8,5.6,201927
25,4,132,15,127,227,16,133,0,650,732,1382,8,5.333333333,201927
25,5,149,11,217,425,11,152,0,965,1150,2115,8,5.666666667,201927
25,6,136,16,246,318,36,228,6,986,1118,2104,8,5.75,201927
25,7,210,14,298,487,10,263,0,1282,1531,2813,6,6,201927
26,1,183,8,329,299,4,255,0,1078,1354,2432,9,5.5,201927
26,2,242,15,380,475,3,256,4,1375,1548,2923,12,5.4,201927
26,3,211,18,318,531,9,433,12,1532,1569,3101,14,6.5,201927
26,4,134,13,156,250,11,227,3,794,922,1716,9,5.2,201927
26,5,163,8,214,223,12,252,0,872,942,1814,15,6,201927
26,6,179,11,279,324,9,351,0,1153,1108,2261,10,5.333333333,201927
26,7,171,14,150,234,38,131,0,738,932,1670,10,5.5,201927
27,1,152,10,222,265,59,123,0,831,1098,1929,8,5.5,201927
27,2,192,14,205,414,12,124,1,962,1089,2051,8,5.666666667,201927
27,3,167,9,148,380,10,114,0,828,1178,2006,7,5.666666667,201927
27,4,261,12,355,744,14,228,6,1620,1943,3563,8,6,201927
27,5,113,4,131,297,4,75,0,624,838,1462,6,5.333333333,201927
27,6,146,8,210,438,5,159,0,966,1204,2170,7,5.5,201927
28,1,261,35,632,447,10,307,1,1693,2039,3732,13,6,201927
28,2,313,23,518,356,26,298,92,1626,2477,4103,15,5.666666667,201927
28,3,171,12,184,132,1,166,0,666,1685,2351,7,5.333333333,201927
28,4,410,22,588,339,50,375,48,1832,5267,7099,15,6,201927
28,5,200,14,237,333,11,282,18,1095,2177,3272,10,5.5,201927
28,6,229,22,260,274,24,102,15,926,2187,3113,13,5.166666667,201927
28,7,234,24,429,356,40,254,1,1338,3137,4475,13,6,201927
28,8,139,12,206,209,19,128,6,719,2321,3040,13,9,201927
28,9,214,10,391,244,18,256,14,1147,2192,3339,10,5.75,201927
29,1,252,21,284,386,35,199,3,1180,1164,2344,7,5.5,201927
29,2,227,22,246,459,17,209,40,1220,1110,2330,11,6,201927
29,3,165,16,129,302,11,131,0,754,852,1606,5,5.666666667,201927
30,1,118,4,87,148,6,79,0,442,558,1000,7,5.333333333,201927
30,2,151,7,114,91,46,91,24,524,800,1324,8,5.25,201927
30,3,138,4,149,146,34,145,20,636,921,1557,6,5.666666667,201927
30,4,107,5,193,212,39,116,0,672,918,1590,8,6,201927
30,5,178,8,137,241,17,156,0,737,960,1697,7,5.5,201927
30,6,133,4,122,182,18,97,7,563,648,1211,9,5.333333333,201927
30,7,174,14,124,170,24,166,17,689,914,1603,11,5.25,201927
30,8,181,14,235,306,37,198,14,985,1298,2283,11,5.4,201927
30,9,193,8,148,182,26,180,20,757,1064,1821,8,5.5,201927
30,10,184,11,259,309,30,172,14,979,1235,2214,6,6,201927
30,11,181,14,269,348,9,177,0,998,1275,2273,5,5.5,201927
30,12,202,11,374,547,13,296,7,1450,1767,3217,10,6,201927
30,13,203,10,134,258,21,162,36,824,1100,1924,10,5.4,201927
30,14,128,3,218,170,51,136,11,717,1029,1746,8,5.5,201927
30,15,230,9,199,303,24,270,34,1069,1365,2434,11,5.666666667,201927
30,16,171,9,213,324,40,208,48,1013,1317,2330,10,5.333333333,201927
30,17,151,10,176,291,30,163,2,823,1107,1930,8,5.5,201927
30,18,151,9,77,149,5,133,10,534,792,1326,8,5.25,201927
30,19,150,6,176,183,10,133,3,661,1220,1881,13,5.6,201927
30,20,128,15,185,268,88,102,0,786,1162,1948,10,5.4,201927
31,1,196,14,182,75,203,142,0,812,880,1692,8,5.5,201927
31,2,77,12,97,5,155,87,0,433,352,785,6,5.333333333,201927
31,3,407,47,890,570,90,428,1,2433,2680,5113,21,6.333333333,201927
31,4,96,14,254,254,33,186,13,850,780,1630,4,6,201927
31,5,141,15,142,208,30,146,2,684,918,1602,5,5.333333333,201927
32,1,154,19,142,199,16,175,8,713,994,1707,12,5.2,201927
32,2,266,19,133,91,52,216,14,791,844,1635,13,5.142857143,201927
32,3,160,43,129,253,5,176,0,766,1010,1776,13,5.4,201927
32,4,212,35,180,264,14,242,14,961,1327,2288,13,5.4,201927
1,1,258,26,317,261,46,209,0,1117,1693,2810,13,5.5,201928
1,2,311,45,646,462,49,346,7,1866,2407,4273,10,6.333333333,201928
1,3,248,46,564,395,22,357,11,1643,2156,3799,9,6,201928
2,1,265,13,380,375,10,257,0,1300,1987,3287,11,6,201928
2,2,230,20,322,357,6,285,0,1220,2624,3844,7,6,201928
2,3,333,21,467,334,22,333,21,1531,2564,4095,12,6,201928
2,4,258,13,660,224,48,160,4,1367,2335,3702,9,6,201928
2,5,300,17,681,297,64,242,4,1605,4336,5941,14,8.5,201928
2,6,234,16,435,269,13,221,1,1189,2177,3366,8,6.5,201928
2,7,234,12,431,285,15,265,36,1278,2572,3850,12,5.75,201928
2,8,241,7,608,347,15,199,11,1428,2658,4086,8,6,201928
3,1,181,11,260,294,11,210,3,970,1347,2317,12,5.666666667,201928
3,2,141,12,484,217,19,110,2,985,1134,2119,9,5.666666667,201928
4,1,179,7,203,435,133,147,26,1130,1184,2314,11,5.25,201928
4,2,160,9,371,319,32,125,10,1026,1139,2165,14,5.2,201928
5,1,218,17,404,339,23,193,10,1204,1014,2218,9,5.666666667,201928
5,2,187,15,290,468,33,174,0,1167,989,2156,10,5.2,201928
5,3,197,12,287,467,35,240,20,1258,1220,2478,11,5.333333333,201928
5,4,251,17,550,569,16,338,8,1749,1744,3493,11,5.75,201928
5,5,214,23,383,478,18,161,13,1290,1233,2523,10,6,201928
5,6,158,9,344,335,10,135,35,1026,1056,2082,10,5.5,201928
5,7,226,24,334,458,23,193,2,1260,1124,2384,10,5.5,201928
6,1,157,21,250,213,7,252,3,903,1130,2033,12,6,201928
6,2,146,6,286,189,38,159,10,834,970,1804,9,5.666666667,201928
7,1,262,5,127,223,24,57,3,701,772,1473,9,5.25,201928
7,2,200,5,102,415,14,34,1,771,1170,1941,9,5.25,201928
7,3,362,3,233,253,161,118,1,1131,1022,2153,7,5.333333333,201928
7,4,192,9,134,333,21,91,49,829,1120,1949,11,5.4,201928
7,5,275,7,110,435,12,109,1,949,1800,2749,11,5.666666667,201928
7,6,217,12,291,396,20,226,14,1176,1367,2543,8,5.333333333,201928
7,7,245,26,225,344,37,132,18,1027,1020,2047,8,5.5,201928
7,8,209,11,132,358,8,156,7,881,1102,1983,12,5.25,201928
7,9,230,13,288,409,14,217,4,1175,1003,2178,9,5.666666667,201928
7,10,166,6,155,427,25,70,4,853,647,1500,9,5.5,201928
7,11,89,3,38,62,11,46,3,252,494,746,6,5.333333333,201928
7,12,226,5,197,502,6,97,0,1033,1707,2740,9,5.5,201928
7,13,63,5,92,166,1,31,0,358,758,1116,9,5.25,201928
8,1,133,8,328,181,23,116,2,791,915,1706,4,6,201928
8,2,348,31,573,450,22,261,0,1685,1739,3424,17,5.5,201928
8,3,197,12,357,338,10,164,23,1101,1183,2284,4,6,201928
8,4,184,31,361,320,21,250,25,1192,706,1898,11,6,201928
8,5,230,18,250,233,11,178,0,920,760,1680,10,5.25,201928
8,6,216,35,402,432,34,263,4,1386,1480,2866,7,6.5,201928
8,7,193,24,186,216,7,232,0,858,885,1743,7,5.25,201928
8,8,177,25,358,421,12,213,1,1207,1220,2427,10,6,201928
8,9,190,9,117,134,13,212,0,675,838,1513,10,5.2,201928
9,1,102,2,179,168,50,146,1,648,749,1397,5,6,201928
9,2,313,68,730,967,70,432,11,2591,3057,5648,12,6,201928
9,3,137,16,324,442,63,222,22,1226,1290,2516,7,6,201928
9,4,198,7,369,560,42,190,4,1370,1857,3227,11,6,201928
9,5,139,22,266,379,31,191,0,1028,1384,2412,7,6,201928
9,6,104,20,184,156,138,152,13,767,1048,1815,7,6,201928
9,7,107,5,322,377,5,170,0,986,1259,2245,9,6,201928
9,8,79,27,299,358,16,144,6,929,1251,2180,5,6,201928
9,9,111,5,234,275,43,110,1,779,978,1757,5,6,201928
9,10,121,10,323,351,24,177,0,1006,1079,2085,6,6,201928
9,11,212,17,391,532,28,233,0,1413,1692,3105,7,6,201928
9,12,159,21,484,646,31,211,15,1567,1787,3354,11,6,201928
9,13,138,13,242,343,64,162,17,979,1377,2356,4,6,201928
9,14,127,12,180,246,42,176,4,787,898,1685,5,6,201928
9,15,218,17,807,904,30,448,1,2425,3602,6027,10,6.5,201928
9,16,268,40,368,714,100,295,1,1786,2271,4057,15,6,201928
9,17,132,5,210,306,21,162,0,836,1273,2109,6,6,201928
9,18,165,18,344,570,41,248,20,1406,1743,3149,12,6,201928
9,19,214,46,280,507,54,215,6,1322,1271,2593,5,6,201928
9,20,39,9,99,136,8,51,2,344,422,766,5,6,201928
9,21,151,10,171,286,34,104,7,763,883,1646,3,6,201928
9,22,158,4,228,294,68,180,15,947,1048,1995,5,6,201928
9,23,164,14,301,481,46,195,1,1202,1547,2749,6,6,201928
9,24,297,73,577,745,91,375,10,2168,2389,4557,14,6,201928
10,1,281,30,259,282,30,345,11,1238,1166,2404,12,4.833333333,201928
10,2,226,16,310,289,19,248,11,1119,2393,3512,9,5.25,201928
10,3,229,29,176,233,15,205,29,916,1677,2593,11,5.4,201928
10,4,334,27,487,480,17,325,1,1671,2378,4049,12,6.5,201928
11,1,190,33,170,200,15,127,2,737,1071,1808,6,5.666666667,201928
11,2,239,17,241,230,37,180,12,956,1104,2060,7,6,201928
11,3,166,21,212,254,8,171,3,835,1048,1883,3,6,201928
11,4,202,22,151,248,16,184,0,823,870,1693,8,6,201928
11,5,265,49,360,491,16,281,7,1469,1972,3441,7,6,201928
11,6,153,9,189,250,18,146,1,766,903,1669,8,6,201928
11,7,226,38,280,363,24,145,0,1076,1451,2527,9,5.5,201928
11,8,219,24,237,397,23,192,0,1092,1268,2360,9,5.5,201928
11,9,220,38,355,399,13,210,8,1243,1409,2652,10,5.666666667,201928
11,10,267,38,237,276,19,238,15,1090,1148,2238,10,5.6,201928
11,11,232,45,286,350,13,214,0,1140,1184,2324,5,6,201928
11,12,254,16,438,490,9,188,0,1395,1879,3274,7,6,201928
11,13,248,27,192,215,21,191,20,914,919,1833,8,5.5,201928
11,14,237,28,213,233,15,191,0,917,1003,1920,8,5.5,201928
11,15,188,43,234,266,5,131,0,867,1019,1886,9,6,201928
12,1,131,15,172,132,20,97,0,567,658,1225,10,5,201928
12,2,192,19,238,361,14,164,9,997,1100,2097,10,5.5,201928
12,3,126,22,185,288,20,58,0,699,939,1638,11,5.2,201928
12,4,166,18,271,487,20,107,0,1069,1166,2235,9,5.666666667,201928
12,5,227,27,231,264,3,121,7,880,1153,2033,10,5.25,201928
12,6,138,18,90,370,19,35,8,678,1086,1764,10,5.25,201928
12,7,217,12,219,360,11,163,32,1014,1022,2036,6,5.5,201928
12,8,166,14,170,247,0,58,0,655,867,1522,9,5.25,201928
12,9,219,38,271,793,25,96,0,1442,1214,2656,9,5.666666667,201928
13,1,198,11,166,174,29,122,25,725,873,1598,9,5.333333333,201928
13,2,142,10,106,170,35,116,9,588,588,1176,6,5.333333333,201928
13,3,153,18,144,231,54,131,0,731,923,1654,12,5.25,201928
13,4,181,14,279,269,35,139,13,930,1135,2065,9,5.666666667,201928
13,5,258,15,334,307,67,286,12,1279,1410,2689,9,5.75,201928
13,6,299,59,662,567,70,247,9,1913,2258,4171,11,5.666666667,201928
13,7,155,9,264,331,34,122,0,915,1018,1933,8,5.5,201928
14,1,198,16,113,92,11,270,0,700,779,1479,6,5.5,201928
14,2,204,7,160,96,12,282,1,762,1051,1813,5,5.666666667,201928
14,3,257,12,230,131,13,332,0,975,1076,2051,8,5.4,201928
14,4,195,13,258,306,12,190,2,976,1365,2341,10,6,201928
14,5,155,17,336,184,25,157,0,874,922,1796,9,5.5,201928
14,6,196,9,424,288,34,240,1,1192,1985,3177,11,6,201928
14,7,130,4,151,182,0,129,0,596,853,1449,6,6,201928
14,8,355,30,608,748,8,482,1,2232,2836,5068,11,6.25,201928
14,9,146,16,197,266,18,172,5,820,1037,1857,11,6,201928
14,10,224,23,391,339,7,282,0,1266,1316,2582,7,6,201928
14,11,131,14,167,190,37,175,19,733,736,1469,4,6,201928
14,12,263,15,423,216,10,207,1,1135,1593,2728,9,5.5,201928
14,13,235,12,339,258,16,278,3,1141,1348,2489,6,6,201928
14,14,138,14,239,292,22,224,6,935,998,1933,7,6,201928
14,15,234,29,217,226,23,280,16,1025,1326,2351,10,5.6,201928
14,16,160,17,245,162,15,198,0,797,1111,1908,5,6,201928
14,17,128,9,226,76,18,163,9,629,570,1199,7,5.25,201928
14,18,200,22,268,156,24,269,19,958,1179,2137,9,5.4,201928
14,19,227,16,285,291,20,255,28,1122,1007,2129,8,5.25,201928
14,20,217,8,288,204,4,213,0,934,1021,1955,10,5.666666667,201928
15,1,157,6,131,78,89,193,2,656,808,1464,7,5.333333333,201928
15,2,154,22,263,367,48,179,7,1040,1162,2202,6,6,201928
15,3,287,21,225,336,150,329,21,1369,1589,2958,10,5.666666667,201928
15,4,193,13,233,330,21,259,6,1055,1110,2165,4,6,201928
15,5,168,25,232,293,25,210,4,957,1093,2050,8,5.666666667,201928
15,6,187,4,293,444,27,217,7,1179,1630,2809,7,6,201928
15,7,136,16,223,356,33,185,3,952,1393,2345,10,6,201928
15,8,93,15,178,250,7,121,4,668,686,1354,4,6,201928
15,9,289,8,120,178,106,162,7,870,1009,1879,9,5.75,201928
15,10,146,13,242,273,48,186,2,910,1204,2114,6,6,201928
15,11,189,16,311,405,43,198,1,1163,1460,2623,8,6,201928
15,12,242,10,454,511,42,179,0,1438,1723,3161,8,6,201928
15,13,88,11,195,210,59,150,0,713,843,1556,8,6,201928
15,14,84,9,176,252,10,123,7,661,898,1559,4,6,201928
15,15,190,43,307,446,32,237,4,1259,1250,2509,6,6,201928
15,16,265,45,391,566,20,269,4,1560,1966,3526,8,6,201928
15,17,132,22,234,318,19,197,19,941,1415,2356,8,6,201928
15,18,249,19,272,460,21,248,5,1274,1306,2580,7,5.666666667,201928
15,19,187,35,414,537,18,334,12,1537,2103,3640,10,6,201928
15,20,109,12,212,268,12,114,0,727,723,1450,6,6,201928
15,21,104,8,97,148,18,86,17,478,692,1170,6,5.5,201928
15,22,288,41,526,770,20,409,22,2076,2255,4331,14,6,201928
15,23,165,8,206,300,17,235,1,932,1052,1984,6,5.333333333,201928
15,24,123,18,247,260,27,142,3,820,778,1598,4,6,201928
15,25,186,17,233,279,42,149,18,924,921,1845,6,6,201928
15,26,123,6,240,261,43,200,2,875,994,1869,9,7,201928
15,27,201,14,303,437,25,295,28,1303,1714,3017,9,5.666666667,201928
15,28,216,19,448,350,30,257,6,1326,1549,2875,9,5.666666667,201928
15,29,237,24,468,612,7,266,4,1618,1894,3512,8,6,201928
15,30,240,20,424,470,38,202,9,1403,1657,3060,16,6,201928
15,31,172,40,246,332,21,213,0,1024,971,1995,6,6,201928
15,32,150,5,251,385,26,149,3,969,1163,2132,9,6,201928
15,33,178,10,315,346,19,190,0,1058,1571,2629,7,6,201928
15,34,140,8,217,355,9,186,1,916,1088,2004,8,6,201928
15,35,255,24,246,367,5,267,0,1164,1448,2612,9,5.666666667,201928
15,36,218,13,214,289,22,158,0,914,913,1827,9,5.5,201928
15,37,223,13,327,539,32,308,28,1470,1655,3125,7,6,201928
15,38,181,14,255,396,10,215,4,1075,1170,2245,6,5.5,201928
15,39,138,28,264,329,14,135,0,908,1078,1986,4,6,201928
15,40,266,21,288,407,44,352,0,1378,2140,3518,9,6,201928
15,41,289,26,569,562,49,263,7,1765,1880,3645,13,6,201928
16,1,143,18,233,183,13,169,0,759,715,1474,7,5.333333333,201928
16,2,119,15,70,155,9,138,0,506,580,1086,9,5.25,201928
16,3,221,19,128,252,24,138,0,782,828,1610,10,5.25,201928
16,4,198,14,178,138,27,230,0,785,857,1642,8,5.5,201928
16,5,229,18,187,195,20,185,12,846,868,1714,10,5.666666667,201928
16,6,194,23,162,242,17,149,0,787,761,1548,12,5.5,201928
16,7,270,12,173,204,28,228,0,915,808,1723,9,5.5,201928
16,8,295,18,501,515,5,289,3,1626,1842,3468,12,6,201928
16,9,213,26,252,263,7,225,5,991,1116,2107,9,6,201928
16,10,180,13,307,341,14,194,0,1049,1062,2111,6,6,201928
16,11,237,16,165,160,42,201,0,821,942,1763,10,5.4,201928
16,12,170,8,178,135,13,135,2,641,899,1540,10,5.25,201928
17,1,186,11,367,402,14,242,1,1223,1575,2798,9,7,201928
17,2,163,9,232,333,10,111,6,864,1024,1888,8,5.666666667,201928
17,3,239,7,341,407,9,202,0,1205,1491,2696,8,5.5,201928
17,4,205,10,290,336,25,179,5,1050,1505,2555,10,5.666666667,201928
17,5,76,3,103,156,3,60,0,401,488,889,5,5.5,201928
18,1,130,12,133,159,16,109,0,559,720,1279,7,5.25,201928
18,2,227,21,324,402,36,206,0,1216,1381,2597,9,6.333333333,201928
18,3,120,16,240,174,6,120,1,677,768,1445,8,5.5,201928
19,1,188,18,285,322,12,394,3,1222,1363,2585,9,6,201928
19,2,261,17,604,392,7,360,0,1641,1681,3322,9,6,201928
19,3,279,24,553,351,14,331,4,1556,1957,3513,7,6,201928
19,4,116,13,163,164,28,237,18,739,895,1634,5,6,201928
19,5,362,17,514,596,18,491,14,2012,2436,4448,8,6,201928
19,6,100,9,220,201,8,211,0,749,843,1592,5,6,201928
19,7,247,14,500,252,4,183,0,1200,1279,2479,10,5.5,201928
19,8,85,8,172,147,2,126,1,541,715,1256,7,6,201928
19,9,190,18,219,206,36,280,0,949,766,1715,9,5.25,201928
19,10,137,6,183,229,7,258,13,833,1000,1833,6,7,201928
19,11,397,32,578,711,25,643,16,2402,2781,5183,13,6,201928
19,12,191,16,480,206,17,219,3,1132,1045,2177,13,5.666666667,201928
20,1,224,13,181,225,35,110,27,815,971,1786,7,5.5,201928
20,2,227,3,164,209,7,93,2,705,1042,1747,6,5.333333333,201928
20,3,135,7,146,176,117,91,34,706,598,1304,6,5.333333333,201928
20,4,138,10,106,215,26,90,23,608,581,1189,6,5.333333333,201928
20,5,153,10,219,369,41,87,0,879,910,1789,11,5.25,201928
20,6,160,7,102,232,45,50,2,598,935,1533,8,5.25,201928
20,7,188,13,168,331,10,158,1,869,1232,2101,7,5.75,201928
20,8,489,29,473,794,28,343,51,2207,2464,4671,14,6.5,201928
20,9,176,18,112,180,21,130,13,650,927,1577,8,5.666666667,201928
20,10,277,11,287,266,13,111,4,969,927,1896,9,5.25,201928
21,1,313,13,222,364,15,222,1,1150,1545,2695,9,5.4,201928
21,2,330,27,357,260,70,166,1,1211,1784,2995,9,5.2,201928
21,3,367,6,246,190,39,280,9,1137,2875,4012,8,5.5,201928
21,4,223,5,81,96,28,205,0,638,1135,1773,6,5.25,201928
21,5,314,20,369,243,24,261,18,1249,2347,3596,8,5.666666667,201928
21,6,272,16,226,386,22,225,19,1166,1810,2976,6,6,201928
21,7,440,12,205,350,42,404,0,1453,1733,3186,9,5.666666667,201928
21,8,313,7,217,214,56,310,11,1128,1886,3014,9,5.2,201928
21,9,415,19,438,400,60,300,9,1641,3546,5187,9,6,201928
21,10,303,8,295,344,19,282,38,1289,2307,3596,7,5.5,201928
21,11,139,5,153,149,17,97,3,563,830,1393,4,6,201928
21,12,499,15,699,812,46,466,9,2546,4540,7086,16,6.5,201928
21,13,283,11,255,270,30,308,10,1167,1796,2963,8,5.666666667,201928
21,14,267,5,203,185,38,192,15,905,1796,2701,12,5.333333333,201928
21,15,340,11,352,311,31,239,5,1289,3065,4354,7,5.5,201928
22,1,200,23,141,223,12,65,0,664,737,1401,11,5.2,201928
22,2,211,16,274,301,27,135,6,970,1030,2000,7,5.5,201928
22,3,268,35,631,589,13,226,0,1762,2418,4180,9,5.666666667,201928
22,4,211,24,495,486,16,203,1,1436,1720,3156,9,6.5,201928
22,5,160,14,327,217,49,117,4,888,1153,2041,10,5.5,201928
23,1,306,5,1294,313,32,216,10,2176,2781,4957,14,5.6,201928
23,2,229,13,277,406,19,110,1,1055,1658,2713,8,5.25,201928
23,3,264,6,865,449,38,194,0,1816,2469,4285,19,6,201928
23,4,171,8,471,303,16,124,4,1097,1950,3047,6,5.5,201928
24,1,144,38,136,209,14,68,6,615,865,1480,10,5.2,201928
24,2,162,19,226,173,10,146,0,736,727,1463,6,5.5,201928
24,3,183,28,149,228,60,128,1,777,720,1497,9,5.25,201928
24,4,138,20,168,223,26,173,35,783,802,1585,5,5.5,201928
24,5,298,33,476,549,15,319,0,1690,1758,3448,10,6.333333333,201928
24,6,237,39,307,383,24,249,0,1239,2005,3244,6,6,201928
24,7,221,20,168,366,39,105,0,919,1056,1975,9,5.25,201928
25,1,164,10,225,279,18,189,19,904,873,1777,13,5.75,201928
25,2,209,22,307,377,15,228,0,1158,1255,2413,7,5.5,201928
25,3,151,13,458,293,26,212,7,1160,1138,2298,8,5.6,201928
25,4,141,9,135,229,13,131,0,658,731,1389,8,5.333333333,201928
25,5,162,9,247,426,23,175,0,1042,1052,2094,8,5.666666667,201928
25,6,189,13,264,274,29,212,8,989,1001,1990,8,5.75,201928
25,7,221,12,351,496,3,218,1,1302,1471,2773,6,6,201928
26,1,205,5,302,278,12,254,0,1056,1435,2491,9,5.5,201928
26,2,210,16,369,397,5,168,6,1171,1449,2620,12,5.4,201928
26,3,261,21,296,493,15,399,6,1491,2113,3604,13,6,201928
26,4,111,14,125,177,14,143,0,584,735,1319,9,5.2,201928
26,5,148,10,190,229,14,231,0,822,875,1697,15,6,201928
26,6,169,10,270,294,2,257,0,1002,1384,2386,10,5.333333333,201928
26,7,129,12,177,241,26,125,0,710,798,1508,10,5.5,201928
27,1,126,13,178,205,41,89,0,652,880,1532,8,5.5,201928
27,2,174,9,205,380,20,120,1,909,1309,2218,8,5.666666667,201928
27,3,201,7,160,389,8,96,0,861,1005,1866,7,5.666666667,201928
27,4,213,13,312,672,15,184,11,1420,1831,3251,8,6,201928
27,5,107,3,97,250,4,77,0,538,617,1155,6,5.333333333,201928
27,6,198,14,233,403,12,160,0,1020,1117,2137,7,5.5,201928
28,1,240,32,520,382,6,324,0,1504,1735,3239,13,6,201928
28,2,265,23,465,303,17,262,60,1395,2174,3569,15,5.666666667,201928
28,3,190,4,184,171,3,235,0,787,1661,2448,7,5.333333333,201928
28,4,362,25,513,339,29,384,26,1678,3093,4771,15,6,201928
28,5,237,13,255,319,8,284,8,1124,1935,3059,10,5.5,201928
28,6,170,18,194,219,36,111,15,763,1419,2182,13,5.166666667,201928
28,7,267,20,454,362,19,246,4,1372,2360,3732,13,6,201928
28,8,142,10,279,277,23,205,2,938,2253,3191,12,7,201928
28,9,205,12,410,241,9,219,8,1104,1460,2564,11,5.5,201928
29,1,226,24,281,351,32,176,2,1092,1635,2727,7,5.5,201928
29,2,255,16,194,496,19,177,34,1191,1405,2596,11,6,201928
29,3,166,13,143,311,12,103,0,748,993,1741,6,5.666666667,201928
30,1,100,6,196,119,7,99,3,530,445,975,7,5.333333333,201928
30,2,208,11,130,111,12,96,48,616,641,1257,8,5.25,201928
30,3,157,8,177,158,41,140,35,716,829,1545,6,5.666666667,201928
30,4,99,6,260,239,29,112,0,745,731,1476,8,6,201928
30,5,160,4,168,259,23,140,0,754,881,1635,7,5.5,201928
30,6,145,7,187,185,15,95,4,638,648,1286,9,5.333333333,201928
30,7,169,8,160,182,33,105,18,675,771,1446,11,5.25,201928
30,8,195,8,258,347,66,238,10,1122,1381,2503,11,5.4,201928
30,9,205,3,138,202,43,190,21,802,857,1659,8,5.5,201928
30,10,188,12,257,297,22,177,33,986,1017,2003,6,6,201928
30,11,138,7,230,316,7,143,0,841,902,1743,5,5.5,201928
30,12,220,15,360,510,27,274,0,1406,1860,3266,10,6,201928
30,13,213,9,173,270,60,164,38,927,1014,1941,10,5.4,201928
30,14,154,7,233,181,25,136,14,750,1115,1865,8,5.5,201928
30,15,293,11,201,306,28,299,54,1192,1296,2488,11,5.666666667,201928
30,16,190,12,238,346,36,209,48,1079,1100,2179,10,5.333333333,201928
30,17,190,20,226,329,31,179,4,979,1026,2005,8,5.5,201928
30,18,157,11,112,184,14,111,10,599,644,1243,8,5.25,201928
30,19,181,9,169,207,15,181,2,764,1062,1826,13,5.6,201928
30,20,138,8,186,272,80,142,0,826,1054,1880,10,5.4,201928
31,1,195,8,141,50,206,158,0,758,882,1640,8,5.5,201928
31,2,60,14,80,11,146,70,0,381,449,830,6,5.333333333,201928
31,3,388,89,863,628,124,367,0,2459,3283,5742,20,6,201928
31,4,115,4,284,257,58,133,13,864,906,1770,4,6,201928
31,5,116,5,86,152,55,140,0,554,654,1208,5,5.333333333,201928
32,1,185,20,157,148,22,176,9,717,779,1496,12,5.2,201928
32,2,279,16,175,119,59,247,15,910,951,1861,13,5.142857143,201928
32,3,199,31,207,297,6,192,2,934,992,1926,13,5.4,201928
32,4,215,38,239,292,12,251,14,1061,1131,2192,13,5.4,201928
1,1,252,37,372,248,53,208,1,1171,1654,2825,13,5.5,201929
1,2,324,55,649,439,51,328,6,1852,2154,4006,10,6.333333333,201929
1,3,233,46,602,404,32,372,1,1690,1918,3608,9,6,201929
2,1,216,14,367,354,11,263,0,1225,1718,2943,11,6,201929
2,2,222,12,368,391,4,287,0,1284,1935,3219,7,6,201929
2,3,303,14,526,360,35,300,17,1555,2269,3824,11,5.666666667,201929
2,4,204,5,601,241,45,150,0,1246,1657,2903,9,6,201929
2,5,350,13,763,296,105,271,3,1801,3529,5330,13,8.5,201929
2,6,244,10,458,292,11,194,0,1209,1779,2988,7,6,201929
2,7,228,11,478,297,26,214,24,1278,2153,3431,12,5.75,201929
2,8,254,13,556,404,16,215,18,1476,2584,4060,8,6,201929
3,1,176,8,255,243,12,228,3,925,1236,2161,12,5.666666667,201929
3,2,149,7,543,243,18,109,2,1071,1033,2104,9,5.666666667,201929
4,1,233,13,265,414,26,179,14,1144,1217,2361,11,5.25,201929
4,2,166,12,307,317,43,112,37,994,1043,2037,14,5.2,201929
5,1,224,15,365,367,23,225,6,1225,1449,2674,9,5.666666667,201929
5,2,179,15,237,358,27,114,0,930,1121,2051,10,5.2,201929
5,3,233,13,262,448,25,223,22,1226,1321,2547,11,5.333333333,201929
5,4,235,15,497,542,18,309,13,1629,1650,3279,11,5.75,201929
5,5,201,13,348,483,13,171,15,1244,1327,2571,10,6,201929
5,6,169,8,314,338,16,145,35,1025,1014,2039,10,5.5,201929
5,7,217,12,341,372,13,194,3,1152,1239,2391,11,6,201929
6,1,179,24,341,245,7,220,7,1023,1149,2172,12,6,201929
6,2,168,12,261,208,53,202,5,909,841,1750,9,5.666666667,201929
7,1,191,8,120,416,7,40,8,790,452,1242,9,5.25,201929
7,2,238,7,116,537,76,52,0,1026,782,1808,9,5.25,201929
7,3,223,3,186,339,82,78,0,911,1629,2540,7,5.333333333,201929
7,4,167,9,121,259,1,82,73,712,692,1404,11,5.4,201929
7,5,308,8,132,459,9,126,0,1042,1433,2475,11,5.666666667,201929
7,6,283,10,322,494,19,208,17,1353,1537,2890,9,5.666666667,201929
7,7,275,17,222,399,36,151,17,1117,1414,2531,8,5.5,201929
7,8,297,9,215,391,8,191,10,1121,1120,2241,12,5.25,201929
7,9,227,18,271,359,16,212,1,1104,1601,2705,9,5.666666667,201929
7,10,179,12,140,467,14,48,4,864,1028,1892,9,5.5,201929
7,11,82,0,55,49,10,27,0,223,443,666,6,5.333333333,201929
7,12,240,8,225,546,4,80,0,1103,1411,2514,9,5.5,201929
7,13,150,20,146,236,3,67,0,622,527,1149,9,5.25,201929
8,1,142,10,373,188,13,106,5,837,861,1698,4,6,201929
8,2,282,45,583,436,16,237,0,1599,1886,3485,17,5.5,201929
8,3,187,13,370,352,18,139,32,1111,1135,2246,4,6,201929
8,4,169,24,351,250,18,227,45,1084,819,1903,11,6,201929
8,5,197,26,217,253,12,121,0,826,1140,1966,10,5.25,201929
8,6,222,30,365,390,27,289,0,1323,1392,2715,7,6.5,201929
8,7,132,13,149,179,8,148,0,629,682,1311,7,5.25,201929
8,8,197,31,389,374,11,205,0,1207,1222,2429,10,6,201929
8,9,176,10,129,105,16,178,0,614,582,1196,10,5,201929
9,1,111,8,156,162,40,142,2,621,690,1311,5,6,201929
9,2,336,55,690,920,73,373,11,2458,2722,5180,12,6,201929
9,3,145,24,369,418,69,219,15,1259,1291,2550,7,6,201929
9,4,191,21,416,572,65,201,7,1473,1545,3018,11,6,201929
9,5,159,21,288,372,57,181,0,1078,1132,2210,7,6,201929
9,6,112,10,190,160,113,168,13,766,943,1709,7,6,201929
9,7,115,9,343,395,3,145,0,1010,1050,2060,9,6,201929
9,8,77,21,300,368,20,145,18,949,1045,1994,5,6,201929
9,9,131,5,220,300,45,115,0,816,844,1660,5,6,201929
9,10,125,20,317,381,22,188,0,1053,1059,2112,6,6,201929
9,11,221,13,381,499,40,246,0,1400,1609,3009,7,6,201929
9,12,158,32,523,630,51,257,13,1664,1766,3430,11,6,201929
9,13,146,22,286,382,85,167,22,1110,1146,2256,4,6,201929
9,14,142,10,209,261,32,157,18,829,854,1683,5,6,201929
9,15,216,26,874,965,20,405,11,2517,3211,5728,10,6.5,201929
9,16,278,55,473,724,79,297,0,1906,2566,4472,15,6,201929
9,17,163,7,202,307,21,154,0,854,1278,2132,6,6,201929
9,18,196,17,405,560,41,232,25,1476,1520,2996,12,6,201929
9,19,222,25,320,514,48,232,7,1368,1319,2687,5,6,201929
9,20,63,4,91,120,8,52,4,342,367,709,5,6,201929
9,21,158,7,226,258,32,144,4,829,847,1676,3,6,201929
9,22,159,7,249,347,67,161,25,1015,1008,2023,5,6,201929
9,23,146,12,319,482,50,197,3,1209,1590,2799,6,6,201929
9,24,372,29,572,789,78,377,8,2225,2342,4567,14,6,201929
10,1,261,31,234,226,19,325,17,1113,1044,2157,12,4.5,201929
10,2,231,16,249,284,14,239,8,1041,1998,3039,9,5.25,201929
10,3,246,23,212,204,21,226,33,965,1736,2701,11,5.4,201929
10,4,356,29,441,500,10,283,1,1620,2103,3723,12,6.5,201929
11,1,231,31,170,259,19,145,3,858,810,1668,6,5.666666667,201929
11,2,225,14,223,217,31,139,20,869,1087,1956,7,6,201929
11,3,160,20,211,259,13,155,7,825,916,1741,3,6,201929
11,4,182,35,154,261,13,138,1,784,826,1610,8,6,201929
11,5,270,39,351,443,16,240,8,1367,2217,3584,7,6,201929
11,6,136,9,204,237,12,137,3,738,750,1488,8,6,201929
11,7,197,28,228,297,15,102,1,868,1297,2165,9,5,201929
11,8,192,25,259,352,13,183,0,1024,1265,2289,9,5.5,201929
11,9,266,55,295,377,6,213,14,1226,1367,2593,10,5.666666667,201929
11,10,248,33,239,271,13,200,13,1017,967,1984,10,5.6,201929
11,11,214,40,312,310,25,199,0,1100,1844,2944,5,6,201929
11,12,230,30,343,436,12,214,1,1266,1550,2816,7,6,201929
11,13,192,21,168,163,19,152,25,740,902,1642,8,5.5,201929
11,14,190,31,210,237,11,169,0,848,861,1709,8,5.5,201929
11,15,206,25,230,259,1,138,0,859,829,1688,9,6,201929
12,1,211,23,193,155,32,105,3,722,752,1474,10,5.2,201929
12,2,211,19,237,330,11,165,7,980,1041,2021,10,5.5,201929
12,3,162,13,181,292,12,96,0,756,1103,1859,11,5.2,201929
12,4,173,27,277,497,26,93,0,1093,1045,2138,9,5.666666667,201929
12,5,272,25,210,252,1,112,19,891,1098,1989,10,5.25,201929
12,6,226,18,135,414,19,61,21,894,1033,1927,10,5.25,201929
12,7,227,22,217,353,7,151,13,990,1028,2018,6,5.5,201929
12,8,244,17,175,287,4,74,0,801,827,1628,9,5.25,201929
12,9,192,32,273,543,27,65,0,1132,1107,2239,9,5.666666667,201929
13,1,211,14,167,233,23,116,24,788,797,1585,9,5.333333333,201929
13,2,170,19,97,248,35,136,9,714,746,1460,6,5.333333333,201929
13,3,195,16,193,298,89,137,0,928,735,1663,12,5.25,201929
13,4,267,17,265,314,55,140,13,1071,937,2008,9,5.666666667,201929
13,5,272,18,389,340,73,298,12,1402,1385,2787,9,5.75,201929
13,6,301,60,732,611,70,294,9,2077,1896,3973,11,5.666666667,201929
13,7,171,10,315,304,27,131,0,958,985,1943,8,5.5,201929
14,1,159,11,97,84,7,248,0,606,933,1539,6,5.5,201929
14,2,194,14,144,97,9,249,3,710,1057,1767,5,5.666666667,201929
14,3,305,11,229,92,4,347,2,990,1253,2243,8,5.4,201929
14,4,197,10,221,331,20,183,0,962,1114,2076,10,6,201929
14,5,165,14,366,274,24,186,0,1029,1047,2076,9,5.5,201929
14,6,212,4,409,336,26,183,0,1170,1384,2554,11,6,201929
14,7,131,7,182,144,0,121,0,585,724,1309,6,6,201929
14,8,366,29,659,796,11,495,0,2356,2580,4936,10,6,201929
14,9,148,8,211,230,18,186,1,802,878,1680,11,6,201929
14,10,207,17,369,361,7,226,0,1187,1768,2955,7,6,201929
14,11,133,9,152,176,15,185,14,684,730,1414,4,6,201929
14,12,269,11,562,224,12,229,0,1307,1288,2595,9,5.5,201929
14,13,218,21,366,295,17,272,5,1194,1272,2466,6,6,201929
14,14,161,11,240,281,10,250,5,958,1025,1983,7,6,201929
14,15,265,25,267,223,19,312,6,1117,1143,2260,10,5.6,201929
14,16,135,12,246,162,22,185,8,770,977,1747,5,6,201929
14,17,200,18,227,126,25,258,11,865,673,1538,7,5.25,201929
14,18,217,13,230,144,23,228,14,869,1058,1927,9,5.4,201929
14,19,203,26,228,256,12,175,11,911,952,1863,8,5.25,201929
14,20,229,10,332,213,6,234,1,1025,1145,2170,10,5.666666667,201929
15,1,194,5,207,103,165,202,2,878,946,1824,7,5.333333333,201929
15,2,166,13,266,350,23,205,6,1029,1080,2109,6,6,201929
15,3,342,14,231,297,132,298,22,1336,1560,2896,10,5.666666667,201929
15,4,203,13,277,347,21,264,6,1131,1111,2242,4,6,201929
15,5,160,31,226,319,27,231,5,999,985,1984,8,5.666666667,201929
15,6,180,10,316,501,35,196,10,1248,1320,2568,7,6,201929
15,7,166,12,214,337,21,196,3,949,1025,1974,10,6,201929
15,8,128,7,179,282,9,131,4,740,668,1408,4,6,201929
15,9,297,10,138,143,94,162,6,850,962,1812,9,5.75,201929
15,10,170,7,256,270,55,180,4,942,962,1904,6,6,201929
15,11,186,15,316,455,43,238,0,1253,1248,2501,8,6,201929
15,12,285,13,489,490,41,178,0,1496,1539,3035,8,6,201929
15,13,100,5,172,194,61,180,0,712,814,1526,8,6,201929
15,14,112,10,175,231,8,140,1,677,753,1430,4,6,201929
15,15,163,32,364,403,35,240,2,1239,1223,2462,6,6,201929
15,16,256,34,450,617,25,278,7,1667,2554,4221,8,6,201929
15,17,146,18,252,316,21,209,24,986,1288,2274,8,6,201929
15,18,284,23,267,480,19,282,8,1363,1363,2726,7,5.666666667,201929
15,19,210,44,436,531,8,282,11,1522,2426,3948,10,6,201929
15,20,92,12,233,296,13,133,1,780,781,1561,6,6,201929
15,21,122,11,98,200,18,111,13,573,537,1110,6,5.5,201929
15,22,283,25,555,771,28,420,23,2105,2080,4185,14,6,201929
15,23,192,17,257,346,18,249,0,1079,1107,2186,6,5.333333333,201929
15,24,155,19,254,293,30,150,4,905,796,1701,4,6,201929
15,25,200,33,255,259,45,137,14,943,942,1885,6,6,201929
15,26,143,5,223,241,48,209,4,873,935,1808,9,7,201929
15,27,213,18,308,435,22,283,33,1312,1857,3169,9,5.666666667,201929
15,28,264,19,470,349,41,238,1,1382,1407,2789,9,5.666666667,201929
15,29,242,15,487,623,14,300,12,1693,3770,5463,8,6,201929
15,30,251,27,533,496,53,193,20,1573,1476,3049,16,6,201929
15,31,165,49,228,329,17,178,0,966,992,1958,6,6,201929
15,32,165,7,286,413,29,162,5,1067,1082,2149,9,6,201929
15,33,193,19,307,362,16,184,0,1081,1479,2560,7,6,201929
15,34,138,17,253,413,11,201,6,1039,980,2019,8,6,201929
15,35,286,18,344,444,9,307,0,1408,1336,2744,9,5.666666667,201929
15,36,239,16,246,276,49,185,1,1012,962,1974,9,5.5,201929
15,37,256,18,361,536,33,302,25,1531,1568,3099,7,6,201929
15,38,217,29,265,386,12,196,5,1110,1076,2186,6,5.5,201929
15,39,165,31,296,355,25,151,0,1023,1170,2193,4,6,201929
15,40,319,20,339,390,60,387,0,1515,1975,3490,9,6,201929
15,41,320,24,618,629,38,252,11,1892,1782,3674,13,6,201929
16,1,147,12,167,166,6,103,0,601,568,1169,7,5.333333333,201929
16,2,97,4,70,105,5,86,0,367,539,906,9,5.25,201929
16,3,192,10,165,279,13,131,0,790,915,1705,10,5.25,201929
16,4,184,17,193,121,24,204,0,743,754,1497,8,5.5,201929
16,5,215,23,172,185,25,177,14,811,875,1686,10,5.666666667,201929
16,6,214,28,164,229,27,144,0,806,898,1704,12,5.5,201929
16,7,266,31,160,239,24,184,0,904,936,1840,9,5.5,201929
16,8,277,25,508,498,21,280,8,1617,1640,3257,12,6,201929
16,9,223,18,256,291,7,193,0,988,1043,2031,9,6,201929
16,10,181,9,295,332,6,179,0,1002,1007,2009,6,6,201929
16,11,213,16,190,176,58,182,0,835,807,1642,10,5.4,201929
16,12,194,17,202,189,15,143,0,760,662,1422,10,5.25,201929
17,1,209,21,415,441,18,246,3,1353,1329,2682,9,7,201929
17,2,185,14,358,320,9,159,5,1050,881,1931,8,5.666666667,201929
17,3,285,14,383,421,13,201,2,1319,1211,2530,8,5.5,201929
17,4,223,12,306,375,18,203,3,1140,1199,2339,10,5.666666667,201929
17,5,142,6,146,179,10,110,0,593,383,976,5,5.5,201929
18,1,140,22,148,230,17,134,5,696,728,1424,7,5.25,201929
18,2,255,17,330,429,46,193,0,1270,1245,2515,9,6.333333333,201929
18,3,155,11,290,197,8,123,0,784,780,1564,8,5.5,201929
19,1,186,15,291,299,18,340,1,1150,1445,2595,9,6,201929
19,2,277,18,620,381,17,360,0,1673,1804,3477,9,6,201929
19,3,292,18,552,314,12,318,1,1507,1853,3360,7,6,201929
19,4,142,11,199,166,43,211,25,797,784,1581,5,6,201929
19,5,362,27,480,618,19,430,11,1947,2136,4083,8,6,201929
19,6,98,13,184,225,8,201,1,730,779,1509,5,6,201929
19,7,194,10,503,200,2,146,1,1056,1160,2216,10,5.5,201929
19,8,73,8,163,143,2,112,0,501,587,1088,7,6,201929
19,9,163,12,215,220,23,217,0,850,799,1649,9,5.25,201929
19,10,145,10,191,210,7,243,15,821,959,1780,6,7,201929
19,11,404,47,585,659,19,591,28,2333,2717,5050,13,6,201929
19,12,208,2,500,220,18,149,2,1099,1191,2290,13,5.666666667,201929
20,1,218,11,228,231,35,106,33,862,826,1688,7,5.5,201929
20,2,209,10,171,195,12,103,0,700,877,1577,6,5.333333333,201929
20,3,116,7,139,145,40,81,10,538,569,1107,6,5.333333333,201929
20,4,147,11,71,204,14,109,25,581,425,1006,6,5.333333333,201929
20,5,164,12,200,321,8,121,0,826,983,1809,11,5.25,201929
20,6,221,10,185,166,197,73,36,888,1047,1935,8,5.25,201929
20,7,190,11,172,237,12,141,0,763,1176,1939,7,5.75,201929
20,8,500,20,456,838,35,327,36,2212,3198,5410,13,6,201929
20,9,290,13,168,224,35,143,22,895,1182,2077,8,5.666666667,201929
20,10,193,6,125,236,5,89,0,654,960,1614,9,5.25,201929
21,1,378,9,200,368,18,216,0,1189,1396,2585,9,5.4,201929
21,2,303,21,213,169,62,247,0,1015,1065,2080,9,5.2,201929
21,3,421,11,270,236,46,308,10,1302,2289,3591,8,5.5,201929
21,4,320,5,112,140,36,233,0,846,1012,1858,6,5.25,201929
21,5,312,15,313,279,31,236,27,1213,1780,2993,8,5.666666667,201929
21,6,336,7,282,335,41,261,28,1290,1662,2952,6,6,201929
21,7,581,17,247,305,35,446,3,1634,1493,3127,9,5.666666667,201929
21,8,401,17,301,246,46,369,16,1396,1250,2646,9,5.2,201929
21,9,377,16,472,446,62,331,18,1722,2646,4368,9,6,201929
21,10,369,17,296,362,24,322,22,1412,2020,3432,7,5.5,201929
21,11,151,4,145,162,15,82,3,562,847,1409,4,6,201929
21,12,546,26,711,864,40,445,12,2644,3983,6627,16,6.5,201929
21,13,360,12,224,315,38,342,6,1297,1585,2882,8,5.666666667,201929
21,14,308,12,224,186,60,253,16,1059,1582,2641,12,5.333333333,201929
21,15,383,11,329,295,24,269,11,1322,2134,3456,7,5.5,201929
22,1,222,25,166,330,12,90,5,850,988,1838,11,5.2,201929
22,2,183,12,269,253,24,130,2,873,1004,1877,7,5.5,201929
22,3,382,45,756,648,11,287,0,2129,2490,4619,9,5.666666667,201929
22,4,226,26,578,462,24,235,0,1551,2242,3793,9,6.5,201929
22,5,179,12,363,200,35,155,4,948,1007,1955,10,5.5,201929
23,1,275,11,1113,363,29,185,12,1988,2465,4453,14,5.6,201929
23,2,245,11,346,363,29,115,0,1109,1441,2550,8,5.25,201929
23,3,328,9,982,544,26,246,0,2135,3505,5640,19,6,201929
23,4,180,3,417,197,22,127,4,950,1519,2469,6,5.5,201929
24,1,185,25,145,202,16,84,0,657,609,1266,10,5.2,201929
24,2,204,22,221,183,5,158,0,793,677,1470,6,5.5,201929
24,3,224,33,142,229,47,108,0,783,637,1420,9,5.25,201929
24,4,188,17,204,191,33,198,34,865,810,1675,5,5.5,201929
24,5,334,21,460,545,12,316,0,1688,1641,3329,10,6.333333333,201929
24,6,230,34,330,421,28,228,0,1271,1481,2752,6,6,201929
24,7,219,27,199,320,32,86,0,883,890,1773,9,5.25,201929
25,1,118,13,184,350,19,155,27,866,854,1720,13,5.75,201929
25,2,230,28,318,435,18,223,0,1252,1213,2465,7,5.5,201929
25,3,160,4,254,268,25,152,0,863,1140,2003,8,5.6,201929
25,4,135,20,119,226,8,110,0,618,721,1339,8,5.333333333,201929
25,5,164,10,243,401,8,140,1,967,1018,1985,8,5.666666667,201929
25,6,206,8,309,309,28,237,8,1105,1045,2150,8,5.75,201929
25,7,249,10,324,470,6,237,0,1296,1294,2590,6,6,201929
26,1,162,8,227,263,5,233,0,898,1122,2020,9,5.5,201929
26,2,218,10,353,386,3,159,2,1131,1295,2426,12,5.4,201929
26,3,236,11,332,535,11,364,10,1499,1696,3195,13,6,201929
26,4,111,15,98,204,19,148,1,596,884,1480,9,5.2,201929
26,5,151,9,203,242,16,205,0,826,804,1630,15,6,201929
26,6,166,18,255,303,4,269,0,1015,1328,2343,10,5.333333333,201929
26,7,125,17,154,258,23,137,0,714,851,1565,10,5.5,201929
27,1,211,3,239,298,70,135,0,956,1248,2204,8,5.5,201929
27,2,193,13,198,443,14,143,0,1004,1510,2514,8,5.666666667,201929
27,3,239,8,204,425,3,130,0,1009,1015,2024,7,5.666666667,201929
27,4,223,17,332,741,10,204,16,1543,1583,3126,8,6,201929
27,5,93,9,95,213,8,53,2,473,738,1211,6,5.333333333,201929
27,6,160,9,228,418,11,130,0,956,1046,2002,7,5.5,201929
28,1,200,22,519,355,6,254,0,1356,1861,3217,13,6,201929
28,2,228,19,403,311,15,228,78,1282,1648,2930,15,5.666666667,201929
28,3,165,14,183,177,5,248,0,792,1555,2347,7,5.333333333,201929
28,4,364,23,490,350,23,387,37,1674,2666,4340,15,6,201929
28,5,222,32,244,333,10,255,12,1108,1870,2978,10,5.5,201929
28,6,167,18,181,208,27,98,6,705,907,1612,13,5.166666667,201929
28,7,250,18,419,353,19,240,0,1299,2004,3303,13,6,201929
28,8,167,15,228,225,25,186,0,846,1557,2403,13,7,201929
28,9,199,13,332,254,13,181,5,997,1488,2485,11,5.75,201929
29,1,311,17,333,381,33,200,4,1279,1260,2539,7,5.5,201929
29,2,297,19,253,490,28,229,55,1371,1700,3071,11,6,201929
29,3,170,13,154,327,14,133,0,811,850,1661,6,5.666666667,201929
30,1,125,9,181,134,12,98,0,559,652,1211,7,5.333333333,201929
30,2,194,5,204,128,22,103,18,674,638,1312,8,5.25,201929
30,3,173,7,200,152,34,171,41,778,771,1549,6,5.666666667,201929
30,4,106,4,230,175,20,118,0,653,798,1451,8,6,201929
30,5,171,10,174,252,15,193,0,815,750,1565,7,5.5,201929
30,6,193,9,168,180,22,109,10,691,715,1406,9,5.333333333,201929
30,7,220,5,181,213,27,149,14,809,925,1734,11,5.25,201929
30,8,251,12,265,341,42,177,4,1092,1124,2216,11,5.4,201929
30,9,281,8,162,210,37,182,28,908,855,1763,8,5.5,201929
30,10,222,7,282,307,18,195,23,1054,999,2053,6,6,201929
30,11,139,9,239,328,14,152,0,881,917,1798,5,5.5,201929
30,12,223,10,352,518,26,274,7,1410,1589,2999,10,6,201929
30,13,213,10,133,259,21,170,37,843,1046,1889,10,5.4,201929
30,14,166,5,182,176,29,144,22,724,1040,1764,8,5.5,201929
30,15,336,12,228,293,45,306,55,1275,1170,2445,11,5.666666667,201929
30,16,196,10,237,325,38,209,49,1064,1159,2223,10,5.333333333,201929
30,17,223,17,209,293,40,180,4,966,942,1908,8,5.5,201929
30,18,158,6,87,99,17,85,6,458,510,968,8,5.25,201929
30,19,196,7,181,230,10,171,2,797,784,1581,13,5.6,201929
30,20,181,12,212,333,85,130,0,953,1097,2050,10,5.4,201929
31,1,190,11,176,38,249,101,2,767,902,1669,8,5.5,201929
31,2,76,4,108,9,122,71,0,390,615,1005,6,5.333333333,201929
31,3,414,42,841,640,102,417,0,2456,2913,5369,21,6.333333333,201929
31,4,110,16,293,282,46,137,4,888,1436,2324,4,6,201929
31,5,142,7,100,172,36,133,0,590,605,1195,5,5.333333333,201929
32,1,211,23,195,216,15,165,19,844,798,1642,12,5.2,201929
32,2,296,31,147,128,68,193,19,882,955,1837,13,5.142857143,201929
32,3,175,46,199,250,8,208,0,886,985,1871,13,5.4,201929
32,4,207,35,210,260,13,176,11,912,1057,1969,13,5.4,201929
1,1,254,47,355,298,40,196,1,1191,1520,2711,13,5.5,201930
1,2,290,35,596,337,49,291,6,1604,1983,3587,10,6.333333333,201930
1,3,220,40,524,325,32,300,8,1449,1843,3292,9,6,201930
2,1,231,12,412,366,13,227,0,1261,1406,2667,11,6,201930
2,2,219,16,285,410,8,252,0,1190,1812,3002,7,6,201930
2,3,285,13,491,328,18,262,23,1420,1923,3343,11,5.666666667,201930
2,4,204,2,537,183,46,125,2,1099,1480,2579,9,6,201930
2,5,281,21,733,358,92,294,8,1787,2835,4622,13,8.5,201930
2,6,242,19,432,251,11,193,0,1148,1644,2792,7,6,201930
2,7,303,8,480,322,18,205,19,1355,1981,3336,12,5.75,201930
2,8,252,9,581,419,13,210,7,1491,2486,3977,8,6,201930
3,1,173,6,233,253,13,170,3,851,886,1737,12,5.666666667,201930
3,2,132,13,543,228,33,113,0,1062,1033,2095,9,5.666666667,201930
4,1,164,10,232,395,55,162,17,1035,962,1997,11,5.25,201930
4,2,194,14,332,309,25,138,36,1048,1131,2179,14,5.2,201930
5,1,196,18,392,311,18,226,12,1173,1468,2641,9,5.666666667,201930
5,2,161,12,228,314,17,111,0,843,956,1799,10,5.2,201930
5,3,192,15,239,340,43,189,17,1035,1032,2067,11,5.333333333,201930
5,4,236,16,443,502,8,251,16,1472,1627,3099,11,5.75,201930
5,5,221,15,367,486,9,142,8,1248,1286,2534,10,6,201930
5,6,195,17,251,345,7,140,26,981,1020,2001,10,5.5,201930
5,7,208,18,325,365,2,163,2,1083,1137,2220,10,5.5,201930
6,1,183,17,301,234,7,194,4,940,979,1919,11,5.8,201930
6,2,155,9,241,161,44,161,9,780,916,1696,9,5.666666667,201930
7,1,253,9,164,353,9,65,8,861,1008,1869,9,5.25,201930
7,2,204,12,104,338,152,26,1,837,1031,1868,9,5.25,201930
7,3,239,2,167,109,75,116,1,709,944,1653,7,5.333333333,201930
7,4,164,7,121,400,27,80,15,814,685,1499,11,5.4,201930
7,5,298,10,144,467,1,107,1,1028,1167,2195,11,5.666666667,201930
7,6,265,8,286,434,25,230,15,1263,1318,2581,8,5.333333333,201930
7,7,274,14,250,463,64,109,7,1181,1223,2404,8,5.5,201930
7,8,240,5,163,392,7,139,6,952,995,1947,12,5.25,201930
7,9,255,13,323,384,22,169,2,1168,1406,2574,9,5.666666667,201930
7,10,156,5,175,316,26,57,0,735,1193,1928,9,5.5,201930
7,11,132,5,65,91,17,39,9,358,233,591,6,5.333333333,201930
7,12,189,10,248,477,6,101,0,1031,1009,2040,9,5.5,201930
7,13,136,12,103,230,0,51,0,532,441,973,9,5.25,201930
8,1,134,1,374,203,11,89,4,816,822,1638,4,6,201930
8,2,271,29,572,468,25,242,1,1608,1643,3251,17,5.5,201930
8,3,202,28,339,349,18,164,7,1107,1158,2265,4,6,201930
8,4,167,27,402,332,21,192,25,1166,1315,2481,11,6,201930
8,5,193,20,239,260,12,121,0,845,852,1697,10,5.25,201930
8,6,222,14,366,438,30,292,2,1364,1402,2766,6,6,201930
8,7,192,31,182,197,4,154,0,760,800,1560,7,5.25,201930
8,8,187,21,367,404,5,218,2,1204,1143,2347,10,6,201930
8,9,229,8,170,146,8,229,3,793,814,1607,10,5.2,201930
9,1,127,5,158,161,57,142,5,655,596,1251,5,6,201930
9,2,317,53,762,953,63,427,12,2587,2616,5203,12,6,201930
9,3,188,25,330,407,54,229,27,1260,1284,2544,7,6,201930
9,4,207,18,360,544,44,197,11,1381,1443,2824,11,6,201930
9,5,145,6,270,338,43,172,0,974,1012,1986,7,6,201930
9,6,120,17,191,173,109,133,9,752,752,1504,7,6,201930
9,7,108,6,277,367,1,141,0,900,1019,1919,9,6,201930
9,8,85,8,314,345,19,159,12,942,942,1884,5,6,201930
9,9,134,3,213,255,31,131,1,768,859,1627,5,6,201930
9,10,121,16,305,401,22,169,0,1034,1073,2107,6,6,201930
9,11,177,14,434,494,39,229,0,1387,1482,2869,7,6,201930
9,12,151,28,490,652,26,205,23,1575,1594,3169,11,6,201930
9,13,149,16,279,343,43,173,21,1024,1084,2108,4,6,201930
9,14,136,6,210,237,38,156,11,794,823,1617,5,6,201930
9,15,221,27,842,874,17,386,9,2376,2592,4968,10,6.5,201930
9,16,274,47,435,720,92,289,0,1857,1926,3783,15,6,201930
9,17,123,12,245,330,25,151,0,886,948,1834,6,6,201930
9,18,167,22,344,519,32,234,26,1344,1465,2809,12,6,201930
9,19,204,39,324,525,47,212,4,1355,1331,2686,5,6,201930
9,20,69,4,108,134,8,49,1,373,359,732,5,6,201930
9,21,131,8,167,283,27,120,7,743,845,1588,3,6,201930
9,22,145,8,251,323,60,157,26,970,975,1945,5,6,201930
9,23,145,8,342,508,36,206,5,1250,1298,2548,6,6,201930
9,24,299,29,620,825,90,389,13,2265,2229,4494,14,6,201930
10,1,265,35,260,271,16,265,17,1129,1789,2918,12,5.166666667,201930
10,2,237,19,341,313,10,234,7,1161,1722,2883,9,5.25,201930
10,3,181,19,220,219,12,224,21,896,1428,2324,11,5.4,201930
10,4,318,17,354,417,18,273,0,1397,1827,3224,12,6.5,201930
11,1,228,32,184,227,12,134,1,818,900,1718,6,5.666666667,201930
11,2,236,17,244,237,34,147,17,932,931,1863,7,6,201930
11,3,186,24,220,290,12,159,9,900,837,1737,3,6,201930
11,4,204,27,170,252,16,181,0,850,847,1697,7,5.666666667,201930
11,5,270,40,364,503,7,245,8,1437,1815,3252,7,6,201930
11,6,123,9,224,228,29,119,2,734,720,1454,8,6,201930
11,7,245,26,254,433,31,144,0,1133,1128,2261,9,5.5,201930
11,8,237,20,264,335,14,167,0,1037,1097,2134,9,5.5,201930
11,9,235,38,276,367,13,185,31,1145,1235,2380,10,5.666666667,201930
11,10,243,40,241,245,19,194,10,992,1058,2050,10,5.6,201930
11,11,199,32,310,334,20,167,0,1062,1245,2307,5,6,201930
11,12,257,41,412,506,17,207,0,1440,1410,2850,7,6,201930
11,13,197,25,151,198,15,143,29,758,835,1593,8,5.5,201930
11,14,216,24,222,226,21,209,0,918,921,1839,8,5.5,201930
11,15,218,31,260,302,4,149,1,965,843,1808,9,6,201930
12,1,237,19,280,172,22,116,1,847,718,1565,10,5.2,201930
12,2,230,20,255,351,15,144,0,1015,976,1991,10,5.5,201930
12,3,195,25,212,314,18,100,0,864,862,1726,11,5.2,201930
12,4,152,21,257,439,29,114,0,1012,1032,2044,9,5.666666667,201930
12,5,224,19,185,213,1,75,8,725,839,1564,10,5.25,201930
12,6,179,17,97,287,17,72,4,673,692,1365,10,5.25,201930
12,7,213,23,207,270,11,102,52,878,1064,1942,6,5.5,201930
12,8,199,14,126,233,6,74,0,652,886,1538,9,5.25,201930
12,9,190,29,277,582,17,100,5,1200,945,2145,9,5.666666667,201930
13,1,231,10,147,229,36,134,26,813,792,1605,9,5.333333333,201930
13,2,120,20,115,177,39,102,7,580,510,1090,6,5.333333333,201930
13,3,181,11,206,282,71,127,0,878,691,1569,12,5.25,201930
13,4,227,17,315,303,47,146,24,1079,1129,2208,9,5.666666667,201930
13,5,257,18,363,336,62,279,13,1328,1324,2652,9,5.75,201930
13,6,319,60,651,602,59,253,4,1948,2006,3954,11,5.666666667,201930
13,7,167,10,351,342,24,112,0,1006,962,1968,8,5.5,201930
14,1,232,4,101,85,9,284,0,715,603,1318,6,5.5,201930
14,2,230,14,155,103,18,245,3,768,834,1602,5,5.666666667,201930
14,3,313,17,244,128,8,342,4,1056,1306,2362,8,5.4,201930
14,4,182,14,233,343,11,180,1,964,1105,2069,10,6,201930
14,5,180,17,345,225,29,175,0,971,1205,2176,9,5.5,201930
14,6,246,9,424,278,12,201,1,1171,1225,2396,11,6,201930
14,7,125,3,155,137,0,143,0,563,626,1189,6,6,201930
14,8,364,18,658,710,11,438,0,2199,2319,4518,10,5.75,201930
14,9,134,12,186,243,11,148,1,735,863,1598,11,6,201930
14,10,222,17,404,333,12,248,0,1236,1515,2751,7,6,201930
14,11,143,14,140,213,23,173,25,731,721,1452,4,6,201930
14,12,269,13,468,222,2,175,1,1150,1287,2437,9,5.5,201930
14,13,249,10,382,309,17,281,2,1250,1189,2439,6,6,201930
14,14,170,11,250,300,9,230,2,972,956,1928,7,6,201930
14,15,221,34,181,216,18,256,3,929,1016,1945,10,5.6,201930
14,16,191,14,254,220,18,248,6,951,917,1868,5,6,201930
14,17,175,13,196,99,17,198,10,708,909,1617,7,5.25,201930
14,18,227,15,200,134,37,233,18,864,970,1834,9,5.4,201930
14,19,152,15,242,281,19,197,10,916,904,1820,8,5.25,201930
14,20,240,6,340,204,5,236,0,1031,1059,2090,10,5.666666667,201930
15,1,232,7,190,114,156,241,0,940,979,1919,7,5.333333333,201930
15,2,175,10,303,338,28,161,10,1025,1032,2057,6,6,201930
15,3,335,14,241,300,140,262,26,1318,1229,2547,10,5.666666667,201930
15,4,189,7,219,295,23,241,7,981,1093,2074,4,6,201930
15,5,241,29,251,282,31,193,1,1028,962,1990,8,5.666666667,201930
15,6,181,14,302,456,34,187,6,1180,1218,2398,7,6,201930
15,7,144,18,258,316,28,176,0,940,1024,1964,10,6,201930
15,8,111,14,221,282,19,129,6,782,728,1510,4,6,201930
15,9,291,7,122,204,92,145,7,868,958,1826,9,5.75,201930
15,10,152,10,275,268,56,176,3,940,1000,1940,6,6,201930
15,11,199,15,334,451,62,215,3,1279,1249,2528,8,6,201930
15,12,271,12,542,457,23,196,0,1501,1494,2995,8,6,201930
15,13,118,7,190,172,54,172,1,714,699,1413,8,6,201930
15,14,111,13,168,228,12,139,1,672,690,1362,4,6,201930
15,15,174,25,345,426,19,213,6,1208,1277,2485,6,6,201930
15,16,237,32,384,600,26,241,3,1523,1890,3413,8,6,201930
15,17,121,14,259,291,20,199,21,925,1045,1970,8,6,201930
15,18,282,19,254,439,28,281,4,1307,1227,2534,7,5.666666667,201930
15,19,222,44,435,572,20,283,3,1579,1775,3354,10,6,201930
15,20,110,13,218,258,7,121,0,727,784,1511,6,6,201930
15,21,135,8,127,197,17,117,8,609,591,1200,6,5.5,201930
15,22,326,38,526,719,32,400,42,2083,2101,4184,14,6,201930
15,23,209,16,224,334,18,214,0,1015,950,1965,6,5.333333333,201930
15,24,175,16,244,243,33,133,3,847,804,1651,4,6,201930
15,25,191,18,289,273,49,155,10,985,851,1836,6,6,201930
15,26,153,6,241,261,33,206,2,902,872,1774,9,7,201930
15,27,268,19,336,417,17,287,46,1390,1512,2902,9,5.666666667,201930
15,28,258,19,463,352,58,236,3,1389,1349,2738,9,5.666666667,201930
15,29,229,25,407,598,12,231,9,1511,1823,3334,8,6,201930
15,30,262,25,451,532,32,226,14,1542,1477,3019,16,6,201930
15,31,165,37,268,339,12,192,0,1013,1008,2021,6,6,201930
15,32,207,4,262,396,28,147,5,1049,1197,2246,9,6,201930
15,33,224,11,327,357,19,164,0,1102,1133,2235,7,6,201930
15,34,175,9,221,405,13,205,5,1033,971,2004,8,6,201930
15,35,385,19,321,372,6,317,0,1420,1401,2821,9,5.666666667,201930
15,36,254,16,273,319,18,185,0,1065,1159,2224,9,5.5,201930
15,37,263,17,292,489,37,288,22,1408,1519,2927,7,6,201930
15,38,170,22,202,330,17,199,17,957,1006,1963,6,5.5,201930
15,39,205,23,305,324,22,117,0,996,1119,2115,4,6,201930
15,40,362,13,302,428,78,434,0,1617,1631,3248,9,6,201930
15,41,357,26,601,632,26,252,13,1907,1764,3671,13,6,201930
16,1,142,9,201,170,10,150,0,682,646,1328,7,5.333333333,201930
16,2,125,15,90,115,7,92,0,444,565,1009,9,5.25,201930
16,3,197,11,125,236,13,106,0,688,796,1484,10,5.25,201930
16,4,199,9,157,117,20,180,0,682,814,1496,8,5.5,201930
16,5,202,19,207,210,24,179,3,844,902,1746,10,5.666666667,201930
16,6,204,24,163,207,20,102,0,720,885,1605,12,5.5,201930
16,7,221,23,184,214,30,179,0,851,833,1684,9,5.5,201930
16,8,275,19,468,461,12,262,4,1501,1591,3092,12,6,201930
16,9,216,19,234,265,6,202,1,943,974,1917,9,6,201930
16,10,154,9,281,293,5,126,0,868,997,1865,7,6.5,201930
16,11,235,16,177,148,41,183,0,800,957,1757,10,5.4,201930
16,12,158,9,159,136,18,120,2,602,632,1234,10,5.25,201930
17,1,202,13,401,406,30,259,0,1311,1310,2621,8,6,201930
17,2,169,11,339,352,14,125,4,1014,1034,2048,8,5.666666667,201930
17,3,236,13,308,392,17,188,1,1155,1289,2444,8,5.5,201930
17,4,228,13,333,332,28,173,4,1111,1084,2195,10,5.666666667,201930
17,5,110,9,113,161,6,49,0,448,568,1016,5,5.5,201930
18,1,123,17,156,180,9,91,1,577,467,1044,7,5.25,201930
18,2,224,13,378,394,41,171,0,1221,1251,2472,9,6.333333333,201930
18,3,157,11,313,195,5,119,0,800,640,1440,8,5.5,201930
19,1,194,16,327,309,4,312,0,1162,1257,2419,9,6,201930
19,2,278,16,566,436,10,323,0,1629,1664,3293,9,6,201930
19,3,266,13,533,364,19,312,0,1507,1616,3123,7,6,201930
19,4,138,10,151,154,33,177,24,687,836,1523,5,6,201930
19,5,340,22,473,641,20,399,11,1906,2091,3997,8,6,201930
19,6,97,14,218,225,3,180,1,738,815,1553,5,6,201930
19,7,205,7,440,193,9,163,0,1017,1039,2056,10,5.5,201930
19,8,103,4,136,155,4,108,0,510,534,1044,7,6,201930
19,9,205,14,206,258,30,249,1,963,731,1694,9,5.25,201930
19,10,106,5,227,262,12,230,10,852,869,1721,5,6,201930
19,11,416,44,554,661,22,524,28,2249,2417,4666,13,6,201930
19,12,192,4,497,204,10,182,5,1094,1380,2474,13,5.666666667,201930
20,1,195,9,145,177,32,86,36,680,723,1403,7,5.5,201930
20,2,292,18,176,269,12,121,0,888,1030,1918,6,5.333333333,201930
20,3,91,8,129,162,56,72,25,543,652,1195,6,5.333333333,201930
20,4,138,6,116,123,24,125,31,563,784,1347,6,5.333333333,201930
20,5,186,12,186,691,55,116,0,1246,736,1982,11,5.25,201930
20,6,153,7,126,122,154,67,81,710,694,1404,8,5.25,201930
20,7,154,10,136,269,12,156,0,737,875,1612,7,5.75,201930
20,8,442,26,455,793,28,291,54,2089,2535,4624,13,6,201930
20,9,272,12,155,219,32,164,19,873,1015,1888,8,5.666666667,201930
20,10,225,7,154,204,13,122,5,730,799,1529,9,5.25,201930
21,1,321,17,238,403,18,195,3,1195,1331,2526,9,5.4,201930
21,2,256,17,200,190,82,274,0,1019,2270,3289,9,5.2,201930
21,3,421,12,264,218,67,275,6,1263,1904,3167,8,5.5,201930
21,4,235,3,117,132,47,177,5,716,879,1595,6,5.25,201930
21,5,308,18,373,273,30,238,34,1274,1433,2707,8,5.666666667,201930
21,6,345,17,313,434,25,272,21,1427,1432,2859,6,6,201930
21,7,452,20,244,336,35,400,0,1487,1677,3164,9,5.666666667,201930
21,8,238,8,178,163,44,194,14,839,1495,2334,9,5.2,201930
21,9,334,19,451,464,56,306,7,1637,2222,3859,9,6,201930
21,10,360,27,328,337,30,362,29,1473,1459,2932,7,5.5,201930
21,11,117,5,194,122,7,98,5,548,682,1230,4,6,201930
21,12,524,9,749,836,34,445,13,2610,3276,5886,16,6.5,201930
21,13,322,11,261,284,26,319,3,1226,1319,2545,8,5.666666667,201930
21,14,302,14,227,187,59,297,16,1102,1546,2648,12,5.333333333,201930
21,15,389,15,348,259,57,243,17,1328,1612,2940,7,5.5,201930
22,1,212,32,149,252,16,70,5,736,914,1650,11,5.2,201930
22,2,179,18,259,236,22,126,0,840,1078,1918,7,5.5,201930
22,3,281,26,653,576,9,250,0,1795,1982,3777,9,5.666666667,201930
22,4,187,28,464,476,29,180,2,1366,1858,3224,8,6,201930
22,5,169,17,385,224,44,118,6,963,997,1960,10,5.5,201930
23,1,288,7,1244,367,16,148,14,2084,2685,4769,14,5.6,201930
23,2,278,20,464,476,34,159,0,1431,1551,2982,8,5.25,201930
23,3,306,9,1024,532,32,202,0,2105,3566,5671,19,6,201930
23,4,174,7,555,283,13,120,0,1152,1536,2688,6,5.5,201930
24,1,177,29,144,201,15,75,3,644,581,1225,10,5.2,201930
24,2,150,14,274,168,9,148,1,764,679,1443,6,5.5,201930
24,3,186,32,149,215,36,88,0,706,755,1461,9,5.25,201930
24,4,153,22,172,195,30,168,27,767,808,1575,5,5.5,201930
24,5,296,28,522,493,10,297,0,1646,1646,3292,9,6,201930
24,6,210,30,368,378,35,253,1,1275,1339,2614,6,6,201930
24,7,193,17,161,281,24,91,0,767,834,1601,9,5.25,201930
25,1,121,8,213,250,13,129,36,770,861,1631,13,5.75,201930
25,2,207,15,283,389,7,217,0,1118,1262,2380,7,5.5,201930
25,3,145,6,258,272,24,136,4,845,832,1677,8,5.6,201930
25,4,138,6,159,226,9,118,0,656,667,1323,8,5.333333333,201930
25,5,135,5,201,376,11,156,0,884,953,1837,8,5.666666667,201930
25,6,157,6,264,244,43,207,12,933,990,1923,8,5.75,201930
25,7,224,17,312,434,7,207,0,1201,1306,2507,6,6,201930
26,1,208,6,317,276,5,203,0,1015,1142,2157,9,5.5,201930
26,2,231,9,364,454,5,216,5,1284,1382,2666,12,5.4,201930
26,3,202,17,253,372,10,290,7,1151,1321,2472,13,5,201930
26,4,130,16,112,192,17,166,11,644,822,1466,9,5.2,201930
26,5,158,4,239,269,12,217,0,899,777,1676,14,5.5,201930
26,6,174,10,250,264,3,230,0,931,1107,2038,10,5.333333333,201930
26,7,137,8,174,237,20,110,0,686,677,1363,10,5.5,201930
27,1,170,14,208,287,57,84,0,820,828,1648,8,5.5,201930
27,2,158,16,225,485,15,121,0,1020,1037,2057,8,5.666666667,201930
27,3,178,4,207,429,11,132,0,961,1013,1974,7,5.666666667,201930
27,4,217,10,404,709,21,215,5,1581,1630,3211,8,6,201930
27,5,110,4,91,260,5,55,1,526,409,935,6,5.333333333,201930
27,6,143,6,208,382,12,119,0,870,913,1783,7,5.5,201930
28,1,250,14,538,351,11,274,0,1438,1678,3116,13,6,201930
28,2,227,14,425,270,25,258,68,1287,1612,2899,15,5.666666667,201930
28,3,173,6,175,152,13,248,0,767,1161,1928,7,5.333333333,201930
28,4,334,18,505,365,28,347,36,1633,2078,3711,15,6,201930
28,5,198,10,249,342,12,239,10,1060,1632,2692,9,5.25,201930
28,6,198,17,198,215,23,87,7,745,1128,1873,13,5.166666667,201930
28,7,252,22,398,364,28,253,6,1323,1789,3112,13,6,201930
28,8,151,9,230,249,29,188,3,859,1362,2221,12,6,201930
28,9,203,7,400,245,9,186,7,1057,1324,2381,11,5.75,201930
29,1,297,27,297,389,36,165,1,1212,1196,2408,7,5.5,201930
29,2,328,20,251,481,30,203,64,1377,1522,2899,10,5.666666667,201930
29,3,162,20,188,359,21,121,0,871,767,1638,6,5.666666667,201930
30,1,104,11,182,148,9,110,6,570,462,1032,7,5.333333333,201930
30,2,180,3,192,101,22,94,54,646,597,1243,8,5.25,201930
30,3,162,10,198,171,24,137,36,738,703,1441,6,5.666666667,201930
30,4,100,2,235,163,24,117,0,641,693,1334,8,6,201930
30,5,153,9,140,271,9,170,0,752,766,1518,7,5.5,201930
30,6,205,11,166,192,18,118,7,717,726,1443,9,5.333333333,201930
30,7,193,13,124,157,15,112,16,630,723,1353,11,5.25,201930
30,8,261,19,261,350,41,203,15,1150,1291,2441,11,5.4,201930
30,9,249,4,194,184,37,146,39,853,875,1728,8,5.5,201930
30,10,189,10,290,285,19,174,25,992,958,1950,6,6,201930
30,11,97,6,226,300,9,116,0,754,901,1655,5,5.5,201930
30,12,230,13,420,522,30,255,1,1471,1481,2952,10,6,201930
30,13,183,10,124,233,27,126,37,740,888,1628,10,5.4,201930
30,14,170,5,200,220,42,134,18,789,639,1428,8,5.5,201930
30,15,318,11,249,266,37,259,46,1186,1136,2322,11,5.666666667,201930
30,16,234,11,227,348,42,198,49,1109,1032,2141,10,5.333333333,201930
30,17,188,12,201,307,38,155,8,909,769,1678,8,5.5,201930
30,18,186,6,82,188,14,110,8,594,593,1187,8,5.25,201930
30,19,194,5,221,240,6,169,0,835,744,1579,13,5.6,201930
30,20,159,13,158,345,91,121,0,887,894,1781,10,5.4,201930
31,1,164,9,157,54,215,117,0,716,733,1449,8,5.5,201930
31,2,76,8,100,10,112,62,0,368,496,864,6,5.333333333,201930
31,3,410,29,965,571,69,385,1,2430,2007,4437,20,6,201930
31,4,102,7,288,246,56,152,16,867,678,1545,4,6,201930
31,5,148,13,119,210,14,134,0,638,635,1273,5,5.333333333,201930
32,1,177,24,157,182,25,138,16,719,750,1469,12,5.2,201930
32,2,269,18,130,105,52,204,14,792,954,1746,13,5.142857143,201930
32,3,234,42,175,262,3,180,1,897,841,1738,13,5.4,201930
32,4,199,37,201,252,21,182,13,905,1000,1905,12,5.2,201930
1,1,186,31,258,242,33,153,8,911,1048,1959,13,5.5,201931
1,2,296,42,652,452,52,284,7,1785,1861,3646,10,6.333333333,201931
1,3,239,40,543,417,45,309,3,1596,1727,3323,9,6,201931
2,1,222,12,392,359,8,224,0,1217,1405,2622,11,6,201931
2,2,239,7,345,399,6,272,1,1269,1650,2919,7,6,201931
2,3,297,15,464,368,19,253,21,1437,1772,3209,11,5.666666667,201931
2,4,185,10,597,231,66,152,3,1244,1397,2641,9,6,201931
2,5,307,17,742,370,81,294,4,1815,2537,4352,12,8.5,201931
2,6,233,15,427,252,18,191,0,1136,1527,2663,7,6,201931
2,7,280,9,512,311,15,224,20,1371,1864,3235,12,5.75,201931
2,8,231,15,647,459,12,175,17,1556,1935,3491,8,6,201931
3,1,192,10,281,284,18,195,2,982,1011,1993,12,5.666666667,201931
3,2,154,8,484,233,27,118,0,1024,1110,2134,9,5.666666667,201931
4,1,196,17,251,428,60,136,19,1107,1207,2314,11,5.25,201931
4,2,170,11,377,308,25,107,16,1014,1066,2080,14,5.2,201931
5,1,258,9,360,319,22,166,9,1143,1241,2384,9,5.666666667,201931
5,2,190,9,275,380,19,160,0,1033,885,1918,10,5.2,201931
5,3,202,6,213,421,24,182,16,1064,1191,2255,11,5.333333333,201931
5,4,238,13,471,542,11,269,5,1549,1654,3203,11,5.75,201931
5,5,197,19,350,459,10,152,23,1210,1272,2482,10,6,201931
5,6,146,15,229,294,11,100,53,848,1004,1852,10,5.5,201931
5,7,190,12,316,333,2,140,5,998,1141,2139,10,5.5,201931
6,1,141,8,287,260,6,204,8,914,992,1906,11,5.8,201931
6,2,165,11,301,229,19,181,14,920,811,1731,9,5.666666667,201931
7,1,244,4,143,328,31,63,2,815,813,1628,9,5.25,201931
7,2,218,11,150,280,41,51,1,752,742,1494,9,5.25,201931
7,3,240,1,157,184,144,110,2,838,792,1630,7,5.333333333,201931
7,4,176,6,135,238,6,49,45,655,702,1357,11,5.4,201931
7,5,307,8,130,387,13,109,0,954,988,1942,11,5.666666667,201931
7,6,272,8,324,413,20,209,14,1260,1297,2557,8,5.333333333,201931
7,7,262,14,316,355,62,162,13,1184,1298,2482,8,5.5,201931
7,8,217,5,149,424,12,151,14,972,1014,1986,12,5.25,201931
7,9,216,18,339,395,17,197,3,1185,1200,2385,9,5.666666667,201931
7,10,150,6,189,529,11,62,0,947,1250,2197,9,5.5,201931
7,11,160,1,69,110,12,64,33,449,357,806,6,5.333333333,201931
7,12,270,17,269,462,6,96,0,1120,1113,2233,9,5.5,201931
7,13,118,12,110,286,0,45,0,571,273,844,9,5.25,201931
8,1,121,11,370,193,13,92,3,803,792,1595,4,6,201931
8,2,285,25,630,431,18,221,2,1612,1667,3279,17,5.5,201931
8,3,194,20,426,376,13,158,13,1200,1091,2291,4,6,201931
8,4,189,25,383,300,33,201,14,1145,1003,2148,11,6,201931
8,5,221,30,220,258,24,135,0,888,1096,1984,10,5.25,201931
8,6,238,29,419,468,36,266,4,1460,1386,2846,6,6,201931
8,7,182,28,145,196,4,196,0,751,950,1701,7,5.25,201931
8,8,182,30,375,355,6,194,3,1145,1214,2359,10,6,201931
8,9,174,11,147,135,10,182,5,664,711,1375,10,5.2,201931
9,1,103,5,193,167,54,119,5,646,670,1316,5,6,201931
9,2,402,69,769,979,84,422,15,2740,2668,5408,12,6,201931
9,3,161,21,398,442,44,226,31,1323,1301,2624,7,6,201931
9,4,236,15,423,585,64,197,11,1531,1499,3030,11,6,201931
9,5,152,18,289,366,50,167,0,1042,1082,2124,7,6,201931
9,6,123,21,179,171,107,148,20,769,802,1571,7,6,201931
9,7,119,11,312,337,0,154,0,933,984,1917,9,6,201931
9,8,95,11,306,379,15,124,6,936,972,1908,5,6,201931
9,9,138,5,240,284,49,119,7,842,827,1669,5,6,201931
9,10,107,10,316,360,32,173,1,999,1118,2117,6,6,201931
9,11,180,14,479,601,58,222,3,1557,1407,2964,7,6,201931
9,12,151,29,522,665,25,206,23,1621,1735,3356,11,6,201931
9,13,150,14,254,361,68,158,17,1022,1128,2150,4,6,201931
9,14,140,4,213,286,31,139,7,820,810,1630,5,6,201931
9,15,219,20,845,931,36,407,6,2464,2661,5125,10,6.5,201931
9,16,302,33,501,721,73,348,2,1980,1964,3944,15,6,201931
9,17,152,11,270,353,13,155,0,954,944,1898,6,6,201931
9,18,187,19,378,550,44,225,17,1420,1503,2923,12,6,201931
9,19,234,37,392,512,59,193,2,1429,1392,2821,5,6,201931
9,20,47,3,108,146,12,55,2,373,422,795,5,6,201931
9,21,140,9,190,264,42,125,11,781,798,1579,3,6,201931
9,22,168,15,290,347,62,164,26,1072,1006,2078,5,6,201931
9,23,154,10,331,585,39,178,1,1298,1257,2555,6,6,201931
9,24,318,25,592,874,76,388,3,2276,2210,4486,14,6,201931
10,1,262,18,230,243,31,335,16,1135,1294,2429,12,5,201931
10,2,235,13,270,286,20,263,12,1099,1357,2456,9,5.25,201931
10,3,224,18,162,201,13,173,27,818,1114,1932,11,5.4,201931
10,4,296,27,401,439,6,264,1,1434,1763,3197,11,6,201931
11,1,221,19,173,212,15,113,2,755,833,1588,6,5.666666667,201931
11,2,246,29,281,261,23,153,17,1010,955,1965,7,6,201931
11,3,171,15,224,291,11,195,7,914,911,1825,3,6,201931
11,4,189,21,199,253,21,132,0,815,811,1626,7,5.666666667,201931
11,5,300,36,390,491,18,234,5,1474,1414,2888,7,6,201931
11,6,139,7,200,225,22,137,4,734,766,1500,8,6,201931
11,7,211,41,263,435,19,123,0,1092,952,2044,9,5.5,201931
11,8,205,25,265,344,10,171,0,1020,1032,2052,9,5,201931
11,9,240,59,318,357,13,207,26,1220,1288,2508,10,5.666666667,201931
11,10,253,41,231,256,22,168,9,980,1052,2032,10,5.6,201931
11,11,222,29,332,312,11,178,0,1084,1111,2195,5,6,201931
11,12,256,37,397,478,18,184,1,1371,1388,2759,7,6,201931
11,13,235,30,188,216,21,145,17,852,938,1790,8,5.5,201931
11,14,202,26,230,228,11,161,0,858,870,1728,8,5.5,201931
11,15,198,26,239,315,4,135,0,917,1002,1919,9,6,201931
12,1,159,20,231,116,35,101,2,664,719,1383,10,5.2,201931
12,2,242,30,253,348,11,151,6,1041,1109,2150,10,5.5,201931
12,3,165,15,258,363,27,96,1,925,870,1795,11,5.2,201931
12,4,148,19,260,550,12,130,0,1119,1217,2336,9,5.666666667,201931
12,5,224,8,176,294,2,88,14,806,783,1589,10,5.25,201931
12,6,202,17,170,414,34,56,19,912,657,1569,10,5.25,201931
12,7,287,16,258,311,22,156,34,1084,876,1960,6,5.5,201931
12,8,183,14,145,263,4,44,0,653,773,1426,9,5.25,201931
12,9,226,30,270,589,23,78,5,1221,980,2201,9,5.666666667,201931
13,1,179,13,137,195,32,119,10,685,694,1379,9,5.333333333,201931
13,2,171,11,115,208,35,150,5,695,669,1364,6,5.333333333,201931
13,3,173,16,196,237,80,155,0,857,899,1756,12,5.25,201931
13,4,265,18,315,332,61,182,7,1180,1188,2368,9,5.666666667,201931
13,5,277,17,382,376,68,293,8,1421,1410,2831,9,5.75,201931
13,6,294,41,697,656,54,260,11,2013,2006,4019,11,5.666666667,201931
13,7,176,19,320,393,44,124,0,1076,1015,2091,8,5.5,201931
14,1,198,11,126,129,9,239,0,712,767,1479,6,5.5,201931
14,2,264,8,167,109,14,237,0,799,874,1673,5,5.666666667,201931
14,3,327,15,243,110,5,343,0,1043,1129,2172,8,5.4,201931
14,4,200,15,250,353,13,177,4,1012,1000,2012,10,6,201931
14,5,180,11,320,264,20,144,0,939,1090,2029,9,5.5,201931
14,6,257,16,437,349,11,219,0,1289,1265,2554,11,6,201931
14,7,107,11,151,141,0,121,0,531,626,1157,6,6,201931
14,8,345,22,676,743,18,455,0,2259,2396,4655,10,6,201931
14,9,157,15,168,273,22,130,4,769,738,1507,11,6,201931
14,10,248,23,379,342,5,270,0,1267,1368,2635,7,6,201931
14,11,138,10,160,199,22,163,14,706,689,1395,4,6,201931
14,12,289,12,435,220,6,203,0,1165,1227,2392,9,5.5,201931
14,13,269,12,309,296,11,262,7,1166,1240,2406,6,6,201931
14,14,179,14,281,286,11,233,9,1013,974,1987,7,6,201931
14,15,282,28,216,241,21,253,7,1048,1095,2143,10,5.6,201931
14,16,199,19,277,201,15,221,8,940,934,1874,5,6,201931
14,17,146,14,169,140,12,205,2,688,717,1405,7,5.25,201931
14,18,262,20,252,180,33,242,16,1005,987,1992,9,5.4,201931
14,19,161,20,260,294,17,154,11,917,975,1892,8,5.25,201931
14,20,251,9,269,216,4,231,0,980,953,1933,10,5.666666667,201931
15,1,233,8,187,108,119,215,2,872,762,1634,7,5.333333333,201931
15,2,165,9,330,401,16,174,3,1098,1019,2117,6,6,201931
15,3,359,16,212,325,115,290,20,1337,1398,2735,10,5.666666667,201931
15,4,208,10,245,300,32,225,9,1029,1027,2056,4,6,201931
15,5,223,20,325,288,38,279,0,1173,1149,2322,8,5.666666667,201931
15,6,198,14,363,461,38,181,11,1266,1255,2521,7,6,201931
15,7,166,12,232,330,31,174,0,945,950,1895,10,6,201931
15,8,115,12,177,269,20,108,5,706,721,1427,4,6,201931
15,9,308,5,157,183,141,214,11,1019,934,1953,9,5.75,201931
15,10,133,5,265,287,52,195,3,940,997,1937,6,6,201931
15,11,195,15,344,482,71,223,4,1334,1333,2667,8,6,201931
15,12,277,15,578,505,33,202,0,1610,1526,3136,8,6,201931
15,13,116,16,186,207,77,169,0,771,771,1542,8,6,201931
15,14,105,14,171,264,12,160,2,728,696,1424,4,6,201931
15,15,171,33,314,403,31,223,6,1181,1298,2479,6,6,201931
15,16,251,22,434,641,22,286,4,1660,1840,3500,8,6,201931
15,17,137,6,246,311,13,207,21,941,1013,1954,8,6,201931
15,18,321,21,355,502,35,292,16,1542,1358,2900,7,5.666666667,201931
15,19,227,40,475,667,18,303,16,1746,1707,3453,10,6,201931
15,20,110,12,237,278,5,125,0,767,758,1525,6,6,201931
15,21,154,7,114,209,22,107,27,640,671,1311,6,5.5,201931
15,22,293,53,530,807,25,432,31,2171,2216,4387,14,6,201931
15,23,229,17,210,399,17,235,0,1107,945,2052,6,5.333333333,201931
15,24,120,13,238,279,26,162,6,844,864,1708,4,6,201931
15,25,225,24,255,268,50,171,11,1004,979,1983,6,6,201931
15,26,188,8,236,264,45,196,1,938,935,1873,9,7,201931
15,27,240,24,341,486,19,257,41,1408,1459,2867,9,5.666666667,201931
15,28,267,24,461,381,43,265,4,1445,1397,2842,9,5.666666667,201931
15,29,261,25,432,627,11,289,17,1662,1798,3460,8,6,201931
15,30,272,23,568,526,43,211,13,1656,1627,3283,16,6,201931
15,31,160,29,224,304,18,175,0,910,1019,1929,6,6,201931
15,32,206,12,294,469,34,173,5,1193,1160,2353,9,6,201931
15,33,240,19,367,396,23,207,0,1252,1214,2466,7,6,201931
15,34,193,9,196,382,6,176,0,962,1088,2050,8,6,201931
15,35,334,19,280,437,3,307,0,1380,1371,2751,9,5.666666667,201931
15,36,238,21,260,309,45,177,0,1050,1107,2157,9,5.5,201931
15,37,281,16,378,547,55,282,22,1581,1581,3162,7,6,201931
15,38,233,27,266,441,13,208,4,1192,1073,2265,6,5.5,201931
15,39,186,25,322,397,20,149,1,1100,1210,2310,4,6,201931
15,40,418,22,391,460,79,475,0,1845,1771,3616,9,6,201931
15,41,309,20,662,713,47,264,15,2030,1974,4004,13,6,201931
16,1,166,10,209,193,8,138,0,724,640,1364,7,5.333333333,201931
16,2,103,11,87,105,5,92,0,403,472,875,9,5.25,201931
16,3,204,11,149,292,18,141,0,815,642,1457,10,5.25,201931
16,4,212,15,185,134,16,187,0,749,811,1560,8,5.5,201931
16,5,241,29,223,186,26,205,21,931,854,1785,10,5.666666667,201931
16,6,193,15,189,288,44,124,1,854,827,1681,12,5.5,201931
16,7,184,14,144,201,24,113,0,680,754,1434,9,5.5,201931
16,8,285,23,492,508,12,277,6,1603,1592,3195,12,6,201931
16,9,217,11,301,301,13,212,7,1062,988,2050,9,6,201931
16,10,169,11,299,307,52,103,0,941,967,1908,6,6,201931
16,11,221,15,169,157,62,217,0,841,855,1696,10,5.4,201931
16,12,198,8,189,159,21,143,4,722,770,1492,10,5.25,201931
17,1,208,22,414,448,23,242,1,1358,1365,2723,8,6,201931
17,2,174,9,295,374,12,113,8,985,916,1901,8,5.666666667,201931
17,3,278,12,404,434,9,183,0,1320,1321,2641,8,5.5,201931
17,4,232,10,343,371,30,185,0,1171,1161,2332,10,5.666666667,201931
17,5,114,6,122,165,5,86,0,498,505,1003,5,5.5,201931
18,1,151,10,111,141,8,85,6,512,441,953,7,5.25,201931
18,2,233,18,357,386,34,181,1,1210,1285,2495,9,6.333333333,201931
18,3,140,5,330,192,7,110,0,784,773,1557,8,5.5,201931
19,1,222,12,295,361,6,328,3,1227,1178,2405,9,6,201931
19,2,332,19,580,424,8,310,0,1673,1688,3361,9,6,201931
19,3,322,15,590,348,20,279,0,1574,1540,3114,7,6,201931
19,4,143,10,151,152,40,198,26,720,802,1522,5,6,201931
19,5,358,34,549,671,22,402,11,2047,1912,3959,8,6,201931
19,6,106,12,232,243,5,159,0,757,757,1514,5,6,201931
19,7,234,11,483,223,6,159,0,1116,953,2069,10,5.5,201931
19,8,87,5,163,150,4,71,0,480,507,987,7,6,201931
19,9,250,7,250,228,26,166,0,927,637,1564,9,5.25,201931
19,10,142,9,218,230,8,246,14,867,834,1701,5,6,201931
19,11,462,42,566,693,35,591,16,2405,2347,4752,13,6,201931
19,12,190,10,419,208,10,192,1,1030,1170,2200,13,5.666666667,201931
20,1,214,15,207,213,62,101,43,855,841,1696,7,5.5,201931
20,2,146,15,149,165,13,84,4,576,387,963,6,5.333333333,201931
20,3,120,8,148,162,61,97,37,633,648,1281,6,5.333333333,201931
20,4,160,15,139,207,26,186,36,769,566,1335,6,5.333333333,201931
20,5,149,15,180,319,20,78,0,761,801,1562,11,5.25,201931
20,6,135,8,118,132,122,62,62,639,589,1228,8,5.25,201931
20,7,169,8,184,321,8,144,0,834,824,1658,7,5.75,201931
20,8,493,23,475,842,27,265,51,2176,2160,4336,13,6,201931
20,9,287,13,193,230,37,149,28,937,1115,2052,8,5.666666667,201931
20,10,194,16,167,197,16,102,4,696,665,1361,9,5.25,201931
21,1,343,8,245,434,13,216,0,1259,1138,2397,9,5.4,201931
21,2,307,18,280,184,70,271,0,1130,1269,2399,9,5.2,201931
21,3,459,15,298,267,79,371,2,1491,1719,3210,8,5.5,201931
21,4,236,5,102,139,52,219,12,765,1033,1798,6,5.25,201931
21,5,387,14,417,303,14,338,22,1495,1412,2907,8,5.666666667,201931
21,6,338,13,325,396,31,333,27,1463,1432,2895,6,6,201931
21,7,340,13,227,357,45,377,0,1359,1655,3014,9,5.666666667,201931
21,8,279,7,247,200,52,260,20,1065,1146,2211,9,5.2,201931
21,9,333,14,474,467,47,300,15,1650,1977,3627,9,6,201931
21,10,340,14,368,380,13,277,34,1426,1769,3195,7,5.5,201931
21,11,124,5,160,138,15,93,5,540,605,1145,4,6,201931
21,12,484,22,722,819,48,481,17,2593,3140,5733,15,6,201931
21,13,326,7,297,320,36,331,8,1325,1601,2926,8,5.666666667,201931
21,14,271,14,259,253,40,350,12,1199,1238,2437,12,5.333333333,201931
21,15,372,10,386,316,41,239,9,1373,1724,3097,7,5.5,201931
22,1,201,30,141,272,17,72,5,738,668,1406,11,5.2,201931
22,2,170,23,273,232,36,115,1,850,980,1830,7,5.5,201931
22,3,321,23,630,622,23,205,0,1824,1997,3821,9,5.666666667,201931
22,4,243,24,556,469,24,185,2,1503,1612,3115,8,6,201931
22,5,160,14,419,200,36,107,14,950,1006,1956,10,5.5,201931
23,1,290,8,1231,354,18,168,16,2085,2101,4186,14,5.6,201931
23,2,187,22,323,391,10,107,0,1040,1096,2136,8,5.25,201931
23,3,257,10,924,531,23,202,4,1951,3117,5068,19,6,201931
23,4,192,9,559,329,17,119,6,1231,1311,2542,6,5.5,201931
24,1,158,23,133,254,18,70,2,658,750,1408,10,5.2,201931
24,2,126,20,247,187,12,135,0,727,763,1490,6,5.5,201931
24,3,180,26,159,202,48,100,0,715,563,1278,9,5.25,201931
24,4,107,14,168,174,21,134,22,640,756,1396,5,5.5,201931
24,5,346,23,539,552,9,300,0,1769,1673,3442,9,6,201931
24,6,221,41,361,376,31,252,0,1282,1331,2613,6,6,201931
24,7,157,23,154,291,26,77,0,728,909,1637,9,5.25,201931
25,1,110,3,194,257,24,165,44,797,840,1637,13,5.75,201931
25,2,233,20,300,403,24,240,0,1220,1158,2378,7,5.5,201931
25,3,158,11,304,337,54,186,5,1055,860,1915,8,5.6,201931
25,4,142,15,162,229,6,166,0,720,692,1412,8,5.333333333,201931
25,5,138,10,254,383,19,149,0,953,949,1902,8,5.666666667,201931
25,6,182,10,277,261,41,173,12,956,1060,2016,8,5.75,201931
25,7,224,11,354,491,6,229,0,1315,1259,2574,6,6,201931
26,1,208,3,285,228,5,222,0,951,939,1890,9,5.5,201931
26,2,177,8,369,412,3,130,7,1106,1209,2315,12,5.4,201931
26,3,198,4,213,382,7,265,8,1077,1523,2600,14,6.5,201931
26,4,129,11,105,167,31,177,19,639,627,1266,9,5.2,201931
26,5,191,6,242,310,11,264,3,1027,852,1879,14,5.5,201931
26,6,156,7,237,276,0,191,0,867,979,1846,10,5.333333333,201931
26,7,147,10,156,274,16,117,0,720,870,1590,10,5.5,201931
27,1,160,6,204,235,50,96,0,751,674,1425,8,5.5,201931
27,2,195,12,281,524,10,155,0,1177,1143,2320,8,5.666666667,201931
27,3,180,7,173,380,9,92,0,841,979,1820,7,5.666666667,201931
27,4,261,12,379,721,21,206,11,1611,1646,3257,8,6,201931
27,5,103,3,127,332,8,85,2,660,686,1346,6,5.333333333,201931
27,6,150,10,209,351,5,103,0,828,1137,1965,7,5.5,201931
28,1,240,26,507,338,13,252,0,1376,1512,2888,13,6,201931
28,2,226,20,448,280,11,224,54,1263,1476,2739,15,5.666666667,201931
28,3,153,10,184,178,2,199,0,726,889,1615,7,5.333333333,201931
28,4,354,17,530,373,50,327,22,1673,2010,3683,15,6,201931
28,5,209,23,211,350,10,205,5,1013,1785,2798,9,5.25,201931
28,6,125,10,150,164,18,83,4,554,870,1424,13,5.166666667,201931
28,7,254,14,440,390,31,231,12,1372,1339,2711,13,6,201931
28,8,134,17,289,239,20,183,0,882,1168,2050,12,6,201931
28,9,213,8,362,243,19,178,6,1029,1185,2214,11,5.75,201931
29,1,326,21,315,410,32,178,4,1286,1269,2555,7,5.5,201931
29,2,294,18,279,526,33,236,64,1450,1414,2864,10,5.666666667,201931
29,3,173,21,189,353,11,134,0,881,883,1764,6,5.666666667,201931
30,1,84,9,134,150,12,68,3,460,428,888,7,5.333333333,201931
30,2,218,12,205,135,22,110,67,769,645,1414,8,5.25,201931
30,3,150,2,225,174,26,137,29,743,814,1557,6,5.333333333,201931
30,4,110,6,267,173,23,102,0,681,660,1341,8,6,201931
30,5,172,10,166,232,11,173,0,764,797,1561,7,5.5,201931
30,6,178,10,151,163,27,101,4,634,663,1297,9,5.333333333,201931
30,7,169,11,158,184,27,128,19,696,868,1564,12,5.25,201931
30,8,264,10,293,369,221,251,47,1455,1159,2614,11,5.4,201931
30,9,212,6,179,192,37,158,25,809,897,1706,8,5.5,201931
30,10,189,7,269,300,28,202,32,1027,999,2026,6,6,201931
30,11,157,4,301,314,3,145,0,924,937,1861,5,5.5,201931
30,12,232,8,432,544,16,247,0,1479,1473,2952,10,6,201931
30,13,223,10,153,244,42,190,37,899,856,1755,10,5.4,201931
30,14,185,9,217,264,51,148,8,882,818,1700,8,5.5,201931
30,15,295,10,219,303,42,307,38,1214,1352,2566,11,5.666666667,201931
30,16,196,5,244,384,34,204,43,1110,1058,2168,10,5.333333333,201931
30,17,161,13,175,323,39,152,6,869,985,1854,8,5.5,201931
30,18,165,9,113,183,16,123,8,617,677,1294,8,5.25,201931
30,19,194,6,221,269,30,174,0,894,738,1632,13,5.6,201931
30,20,184,11,182,285,76,124,0,862,920,1782,10,5.4,201931
31,1,174,12,192,44,181,117,0,720,632,1352,8,5.5,201931
31,2,84,9,103,5,170,82,0,453,336,789,6,5.333333333,201931
31,3,397,24,1047,557,73,378,4,2480,1337,3817,20,6,201931
31,4,106,14,280,249,54,129,17,849,573,1422,4,6,201931
31,5,129,10,145,241,29,92,0,646,625,1271,5,5.333333333,201931
32,1,184,12,148,173,16,168,16,717,820,1537,12,5.2,201931
32,2,260,19,129,114,37,189,12,760,873,1633,13,5.142857143,201931
32,3,184,32,187,273,4,214,0,894,814,1708,13,5.4,201931
32,4,205,40,226,292,24,214,8,1009,919,1928,12,5.2,201931
1,1,217,35,354,286,55,174,5,1126,832,1958,13,5.5,201932
1,2,311,45,657,413,53,262,8,1749,1804,3553,10,6.333333333,201932
1,3,220,41,548,415,33,307,2,1566,1688,3254,9,6,201932
2,1,224,6,410,354,22,212,0,1228,1332,2560,11,6,201932
2,2,197,10,328,410,1,195,0,1141,1554,2695,8,6.5,201932
2,3,259,12,455,337,16,281,18,1378,1793,3171,11,5.666666667,201932
2,4,185,15,566,220,66,136,6,1194,1279,2473,9,6,201932
2,5,335,24,759,360,71,248,9,1806,2271,4077,12,7,201932
2,6,270,15,557,341,26,197,0,1406,1383,2789,8,6.5,201932
2,7,234,14,498,305,21,213,19,1304,1519,2823,12,5.75,201932
2,8,211,10,636,419,17,186,25,1504,1759,3263,8,6,201932
3,1,159,7,277,294,24,191,0,952,949,1901,12,5.666666667,201932
3,2,127,7,554,214,12,119,0,1033,1060,2093,9,5.666666667,201932
4,1,197,11,247,407,39,177,45,1123,1259,2382,11,5.25,201932
4,2,148,13,254,334,49,98,21,917,953,1870,14,5.2,201932
5,1,243,12,360,329,18,137,8,1107,1268,2375,9,5.666666667,201932
5,2,165,11,221,364,22,124,0,907,945,1852,10,5.2,201932
5,3,216,22,265,409,34,167,12,1125,1131,2256,11,5.333333333,201932
5,4,227,28,497,558,11,259,22,1602,1577,3179,11,5.75,201932
5,5,215,18,311,473,14,151,18,1200,1265,2465,10,6,201932
5,6,174,11,284,384,17,128,37,1035,992,2027,10,5.5,201932
5,7,197,19,252,376,4,120,6,974,1173,2147,10,5.5,201932
6,1,209,16,277,266,6,192,11,977,1012,1989,12,6,201932
6,2,163,14,328,205,17,146,3,876,846,1722,9,5.666666667,201932
7,1,216,3,95,293,41,51,1,700,642,1342,9,5.25,201932
7,2,161,2,65,404,62,26,0,720,643,1363,9,5.25,201932
7,3,299,7,142,263,87,88,4,890,300,1190,7,5.333333333,201932
7,4,202,16,193,279,1,113,35,839,1013,1852,11,5.4,201932
7,5,267,12,139,471,14,97,0,1000,909,1909,11,5.666666667,201932
7,6,273,18,321,431,24,209,17,1293,1166,2459,9,5.666666667,201932
7,7,215,12,200,377,36,166,10,1016,1162,2178,8,5.5,201932
7,8,207,15,187,413,13,153,6,994,1125,2119,12,5.25,201932
7,9,209,12,288,412,12,199,3,1135,1212,2347,9,5.666666667,201932
7,10,151,11,192,557,31,98,1,1041,1126,2167,9,5.5,201932
7,11,168,4,97,112,21,85,8,495,458,953,6,5.333333333,201932
7,12,241,7,251,567,10,92,0,1168,1116,2284,9,5.5,201932
7,13,116,7,125,223,0,58,0,529,697,1226,9,5.25,201932
8,1,137,5,325,199,6,91,0,763,794,1557,4,6,201932
8,2,262,26,604,421,14,203,0,1530,1539,3069,17,5.5,201932
8,3,201,21,342,359,20,158,17,1118,1114,2232,4,6,201932
8,4,174,24,397,302,23,195,37,1152,1231,2383,11,6,201932
8,5,209,22,216,248,8,173,0,876,821,1697,10,5.25,201932
8,6,240,27,419,422,33,263,4,1408,1378,2786,7,6.5,201932
8,7,186,24,158,179,4,181,0,732,825,1557,7,5.25,201932
8,8,177,50,355,390,13,167,0,1152,1100,2252,10,6,201932
8,9,173,19,143,141,4,161,1,642,656,1298,10,5.2,201932
9,1,103,9,174,139,52,128,10,615,633,1248,5,6,201932
9,2,288,66,728,981,86,347,24,2520,2668,5188,12,6,201932
9,3,156,22,401,476,61,220,17,1353,1282,2635,7,6,201932
9,4,163,16,447,521,96,197,15,1455,1464,2919,11,6,201932
9,5,143,10,261,350,42,185,0,991,996,1987,7,6,201932
9,6,99,19,233,168,118,140,16,793,727,1520,7,6,201932
9,7,106,10,308,417,2,153,1,997,927,1924,9,6,201932
9,8,102,24,311,378,21,123,21,980,953,1933,5,6,201932
9,9,117,12,240,305,32,119,2,827,809,1636,5,6,201932
9,10,116,9,372,428,21,130,0,1076,1003,2079,6,6,201932
9,11,149,17,406,533,43,213,5,1366,1492,2858,7,6,201932
9,12,127,21,533,632,33,198,30,1574,1590,3164,11,6,201932
9,13,128,14,301,385,52,136,23,1039,1047,2086,4,6,201932
9,14,117,7,209,277,41,132,22,805,868,1673,5,6,201932
9,15,212,16,821,902,41,369,11,2372,2518,4890,10,6.5,201932
9,16,248,49,486,793,63,324,2,1965,1971,3936,15,6,201932
9,17,126,11,248,335,18,127,0,865,966,1831,6,6,201932
9,18,131,17,385,627,46,226,25,1457,1341,2798,12,6,201932
9,19,183,35,370,539,57,192,6,1382,1340,2722,5,6,201932
9,20,43,3,102,134,9,46,5,342,363,705,5,6,201932
9,21,131,7,192,271,40,129,6,776,753,1529,3,6,201932
9,22,134,10,275,343,56,154,22,994,989,1983,5,6,201932
9,23,145,6,312,504,41,186,3,1197,1255,2452,6,6,201932
9,24,307,26,658,819,75,346,5,2236,2283,4519,14,6,201932
10,1,244,10,199,234,8,218,10,923,1007,1930,12,4.666666667,201932
10,2,211,16,320,322,15,232,6,1122,1303,2425,9,5.25,201932
10,3,188,19,198,209,16,198,31,859,997,1856,11,5.4,201932
10,4,309,27,437,434,17,267,2,1493,1595,3088,11,6,201932
11,1,214,22,207,275,24,148,3,893,833,1726,6,5.666666667,201932
11,2,217,24,258,272,36,140,22,969,957,1926,7,6,201932
11,3,156,17,228,279,6,151,11,848,912,1760,3,6,201932
11,4,168,22,144,238,17,155,1,745,832,1577,8,6,201932
11,5,276,40,367,484,16,230,5,1418,1504,2922,7,6,201932
11,6,118,15,171,220,15,139,3,681,731,1412,8,6,201932
11,7,197,45,245,448,23,135,3,1096,904,2000,9,5.5,201932
11,8,198,36,264,416,27,223,0,1164,1100,2264,9,5.5,201932
11,9,194,36,337,341,11,175,37,1131,1227,2358,10,5.666666667,201932
11,10,238,29,223,237,13,206,8,954,1008,1962,10,5.6,201932
11,11,188,38,322,360,8,197,0,1113,1103,2216,5,6,201932
11,12,219,36,365,507,13,182,0,1322,1429,2751,7,6,201932
11,13,216,32,133,172,10,133,20,716,785,1501,8,5.5,201932
11,14,222,28,230,222,16,177,3,898,865,1763,8,5.5,201932
11,15,185,42,254,257,5,122,0,865,956,1821,9,6,201932
12,1,133,23,163,134,19,85,0,557,498,1055,10,5.2,201932
12,2,201,26,213,355,8,142,3,948,916,1864,10,5.5,201932
12,3,200,26,287,415,17,113,0,1058,821,1879,11,5.2,201932
12,4,147,24,306,568,18,101,0,1164,1060,2224,9,5.666666667,201932
12,5,245,34,223,279,3,98,7,889,869,1758,10,5.25,201932
12,6,215,18,172,368,34,52,9,868,726,1594,10,5.25,201932
12,7,225,14,243,323,12,117,34,968,972,1940,6,5.5,201932
12,8,233,28,192,295,1,79,0,828,817,1645,9,5.25,201932
12,9,177,18,264,617,27,92,7,1202,1240,2442,9,5.666666667,201932
13,1,190,21,189,246,70,175,47,938,1020,1958,9,5.333333333,201932
13,2,167,22,149,244,46,151,14,793,730,1523,6,5.333333333,201932
13,3,159,26,207,264,78,135,0,869,851,1720,12,5.25,201932
13,4,180,13,301,283,42,133,11,963,1172,2135,9,5.666666667,201932
13,5,259,19,462,357,85,312,13,1507,1474,2981,9,5.75,201932
13,6,273,52,751,660,73,231,6,2046,1924,3970,11,5.666666667,201932
13,7,152,10,341,367,37,119,0,1026,1001,2027,8,5.5,201932
14,1,216,13,127,115,18,227,0,716,545,1261,6,5.5,201932
14,2,195,13,197,135,14,236,1,791,795,1586,5,5.666666667,201932
14,3,235,16,241,107,1,275,1,876,934,1810,8,5.2,201932
14,4,156,17,265,347,15,156,8,964,1120,2084,10,6,201932
14,5,164,17,329,251,25,151,0,937,1071,2008,8,4.25,201932
14,6,225,11,458,350,33,207,4,1288,1221,2509,11,6,201932
14,7,133,9,206,176,0,104,0,628,626,1254,6,6,201932
14,8,384,29,636,800,17,463,0,2329,2315,4644,10,6,201932
14,9,136,13,183,291,12,145,4,784,825,1609,11,6,201932
14,10,219,15,409,334,7,226,0,1210,1311,2521,7,6,201932
14,11,132,12,144,208,32,169,20,717,711,1428,4,6,201932
14,12,272,13,474,245,8,165,0,1177,1160,2337,9,5.5,201932
14,13,250,10,351,293,11,243,4,1162,1228,2390,6,6,201932
14,14,162,11,255,278,13,221,4,944,959,1903,7,6,201932
14,15,231,25,202,222,22,228,2,932,1001,1933,10,5.6,201932
14,16,183,12,262,187,18,205,4,871,977,1848,5,6,201932
14,17,146,15,217,87,15,145,11,636,604,1240,7,5.25,201932
14,18,218,16,249,165,33,221,16,918,1055,1973,9,5.4,201932
14,19,234,26,264,314,23,197,15,1073,1145,2218,8,5.25,201932
14,20,185,7,278,207,2,192,0,871,1022,1893,10,5.666666667,201932
15,1,174,6,140,123,101,184,6,734,813,1547,7,5.333333333,201932
15,2,180,16,308,391,28,177,5,1105,1102,2207,6,6,201932
15,3,304,19,273,350,224,340,19,1529,1478,3007,10,5.666666667,201932
15,4,172,11,342,343,23,204,2,1097,1068,2165,4,6,201932
15,5,173,21,287,319,35,221,5,1061,1096,2157,8,5.666666667,201932
15,6,138,13,346,468,37,168,10,1180,1236,2416,7,6,201932
15,7,147,10,283,355,41,201,6,1043,966,2009,10,6,201932
15,8,95,13,168,251,11,95,6,639,751,1390,4,6,201932
15,9,259,10,171,217,136,185,11,989,821,1810,9,5.75,201932
15,10,126,6,278,342,65,179,6,1002,966,1968,6,6,201932
15,11,185,25,386,469,66,231,5,1367,1255,2622,8,6,201932
15,12,226,9,531,498,46,194,0,1504,1641,3145,8,6,201932
15,13,107,4,163,218,60,153,0,705,767,1472,8,6,201932
15,14,94,6,165,278,17,112,4,676,696,1372,4,6,201932
15,15,149,31,245,377,30,185,2,1019,1151,2170,6,6,201932
15,16,229,38,409,629,26,277,5,1613,1586,3199,8,6,201932
15,17,129,13,248,324,24,196,22,956,960,1916,8,6,201932
15,18,276,18,319,475,15,276,10,1389,1495,2884,7,5.666666667,201932
15,19,189,34,434,576,8,275,8,1524,1743,3267,10,6,201932
15,20,98,9,221,298,13,122,0,761,734,1495,6,6,201932
15,21,124,6,182,235,24,135,20,726,559,1285,6,5.5,201932
15,22,314,34,570,772,34,392,24,2140,2177,4317,14,6,201932
15,23,214,18,270,433,18,274,0,1227,1239,2466,6,5.333333333,201932
15,24,113,16,210,284,29,141,2,795,863,1658,4,6,201932
15,25,171,11,264,315,43,170,19,993,927,1920,6,6,201932
15,26,138,8,231,251,51,198,1,878,907,1785,9,7,201932
15,27,239,9,317,474,22,262,31,1354,1446,2800,9,5.666666667,201932
15,28,272,13,454,384,38,269,5,1435,1539,2974,9,5.666666667,201932
15,29,191,17,411,647,12,288,8,1574,1566,3140,8,6,201932
15,30,262,33,638,582,47,266,12,1840,1591,3431,16,6,201932
15,31,142,39,246,300,26,182,0,935,973,1908,6,6,201932
15,32,189,6,306,415,40,162,5,1123,1202,2325,9,6,201932
15,33,223,9,432,384,23,228,0,1299,1190,2489,7,6,201932
15,34,179,16,266,454,8,188,4,1115,999,2114,8,6,201932
15,35,282,25,300,398,7,332,0,1344,1383,2727,9,5.666666667,201932
15,36,250,15,258,337,81,218,0,1159,902,2061,9,5.5,201932
15,37,211,33,332,508,41,283,31,1439,1461,2900,7,6,201932
15,38,211,26,279,429,9,210,8,1172,1117,2289,6,5.5,201932
15,39,146,28,316,375,20,156,0,1041,1093,2134,4,6,201932
15,40,372,29,407,483,93,542,0,1926,1789,3715,9,6,201932
15,41,257,26,653,651,33,257,19,1896,1957,3853,13,6,201932
16,1,159,10,229,158,14,124,0,694,767,1461,7,5.333333333,201932
16,2,100,12,98,134,2,80,0,426,349,775,9,5.25,201932
16,3,202,24,180,279,35,148,0,868,781,1649,10,5.25,201932
16,4,181,16,183,146,15,172,0,713,674,1387,8,5.5,201932
16,5,253,20,216,206,27,206,8,936,887,1823,10,5.666666667,201932
16,6,198,26,179,256,45,109,1,814,719,1533,12,5.5,201932
16,7,216,17,163,177,24,143,0,740,901,1641,9,5.5,201932
16,8,294,31,528,482,11,230,0,1576,1554,3130,12,6,201932
16,9,229,14,242,257,7,195,0,944,990,1934,9,6,201932
16,10,170,10,301,326,16,158,1,982,926,1908,6,6,201932
16,11,176,10,174,152,63,190,0,765,827,1592,10,5.4,201932
16,12,190,17,192,170,14,135,4,722,694,1416,10,5.25,201932
17,1,213,16,446,460,18,212,2,1367,1396,2763,10,8,201932
17,2,173,15,351,402,10,135,3,1089,1135,2224,8,5.666666667,201932
17,3,271,14,424,474,9,204,0,1396,1406,2802,8,5.5,201932
17,4,283,11,423,384,24,178,1,1304,1228,2532,10,5.666666667,201932
17,5,122,9,133,169,3,81,0,517,504,1021,5,5.5,201932
18,1,131,7,129,192,14,86,2,561,771,1332,7,5.25,201932
18,2,248,20,350,422,34,162,0,1236,1197,2433,8,6,201932
18,3,149,15,307,218,6,137,0,832,729,1561,8,5.5,201932
19,1,190,10,341,344,2,292,3,1182,1245,2427,9,6,201932
19,2,249,10,650,435,13,348,0,1705,1697,3402,9,6,201932
19,3,246,14,563,396,21,304,0,1544,1544,3088,7,6,201932
19,4,114,10,165,189,42,218,33,771,737,1508,5,6,201932
19,5,304,24,473,642,24,382,18,1867,2022,3889,8,6,201932
19,6,81,8,192,240,7,181,1,710,786,1496,5,6,201932
19,7,169,7,468,214,6,118,0,982,1130,2112,10,5.5,201932
19,8,81,4,174,178,3,102,0,542,530,1072,7,6,201932
19,9,138,8,174,146,17,158,0,641,741,1382,9,5.25,201932
19,10,135,11,193,248,11,231,15,844,935,1779,7,8,201932
19,11,341,45,567,731,20,562,18,2284,2382,4666,13,6,201932
19,12,227,5,490,207,15,169,3,1116,1170,2286,13,5.666666667,201932
20,1,195,12,187,206,37,115,37,789,854,1643,7,5.5,201932
20,2,147,7,153,204,5,89,1,606,880,1486,6,5.333333333,201932
20,3,124,3,142,134,35,73,19,530,698,1228,6,5.333333333,201932
20,4,141,10,134,159,32,108,49,633,596,1229,6,5.333333333,201932
20,5,122,6,132,332,42,61,0,695,1012,1707,11,5.25,201932
20,6,186,11,162,134,201,64,85,843,708,1551,8,5.25,201932
20,7,183,14,226,370,10,136,0,939,779,1718,7,5.75,201932
20,8,467,25,484,895,34,327,58,2290,2334,4624,14,6.5,201932
20,9,225,19,164,240,26,163,32,869,1157,2026,8,5.666666667,201932
20,10,183,11,194,220,11,113,2,734,857,1591,9,5.25,201932
21,1,262,13,231,418,12,182,3,1121,888,2009,9,5.4,201932
21,2,256,23,271,197,91,275,1,1114,1227,2341,9,5.2,201932
21,3,410,7,339,231,59,350,18,1414,1214,2628,8,5.5,201932
21,4,201,6,112,133,33,210,31,726,683,1409,6,5.25,201932
21,5,310,18,392,301,29,278,9,1337,1338,2675,8,5.666666667,201932
21,6,297,5,349,395,28,269,35,1378,1281,2659,6,6,201932
21,7,385,9,248,307,32,374,3,1358,1489,2847,9,5.666666667,201932
21,8,204,9,239,153,28,245,13,891,1151,2042,9,5.2,201932
21,9,270,19,499,422,61,280,14,1565,1630,3195,9,6,201932
21,10,256,18,349,395,26,294,31,1369,2503,3872,7,5.5,201932
21,11,109,4,147,145,22,86,10,523,529,1052,4,6,201932
21,12,418,18,689,818,53,394,35,2425,2623,5048,16,6.5,201932
21,13,341,9,321,281,34,364,16,1366,1342,2708,8,5.666666667,201932
21,14,292,16,222,200,48,272,25,1075,1123,2198,12,5.333333333,201932
21,15,294,13,369,280,41,216,22,1235,1289,2524,7,5.5,201932
22,1,223,37,206,316,9,92,3,886,868,1754,11,5.2,201932
22,2,136,21,270,267,27,112,0,833,917,1750,7,5.5,201932
22,3,294,38,754,601,22,233,0,1942,1803,3745,9,5.666666667,201932
22,4,198,21,647,490,24,199,4,1583,1480,3063,9,6.5,201932
22,5,171,20,353,269,43,118,12,986,955,1941,10,5.5,201932
23,1,272,9,1197,350,23,150,13,2014,2213,4227,14,5.6,201932
23,2,228,23,376,436,46,114,0,1223,1268,2491,9,5.5,201932
23,3,296,5,985,561,25,216,3,2091,2691,4782,19,6,201932
23,4,177,3,556,304,13,117,0,1170,1170,2340,6,5.5,201932
24,1,142,31,138,225,11,75,0,622,578,1200,10,5.2,201932
24,2,185,27,256,182,9,166,0,825,830,1655,6,5.5,201932
24,3,161,28,196,233,39,104,0,761,995,1756,9,5.25,201932
24,4,108,17,134,201,22,110,27,619,652,1271,5,5.5,201932
24,5,319,30,489,595,12,273,0,1718,1693,3411,9,6,201932
24,6,196,30,368,440,36,210,0,1280,1286,2566,6,6,201932
24,7,161,25,223,305,23,80,0,817,863,1680,9,5.25,201932
25,1,154,12,208,245,16,154,57,846,894,1740,13,5.75,201932
25,2,233,21,292,500,16,200,0,1262,1192,2454,7,5.5,201932
25,3,192,15,303,313,57,165,12,1057,988,2045,8,5.6,201932
25,4,141,9,169,279,17,133,0,748,718,1466,8,5.333333333,201932
25,5,168,8,247,428,14,183,0,1048,977,2025,8,5.666666667,201932
25,6,236,17,341,329,51,227,17,1218,1050,2268,8,5.75,201932
25,7,241,14,335,495,7,232,0,1324,1345,2669,6,6,201932
26,1,238,4,238,289,5,222,0,996,940,1936,9,5.5,201932
26,2,238,15,403,437,5,174,11,1283,1189,2472,12,5.4,201932
26,3,251,13,320,514,3,291,13,1405,1082,2487,13,6,201932
26,4,124,7,137,214,17,167,8,674,583,1257,9,5.2,201932
26,5,187,11,185,281,16,207,0,887,939,1826,14,5.5,201932
26,6,158,15,244,292,0,198,0,907,945,1852,10,5.333333333,201932
26,7,162,7,157,276,30,112,0,744,648,1392,10,5.5,201932
27,1,134,11,211,276,61,125,0,818,810,1628,8,5.5,201932
27,2,231,16,323,545,20,148,0,1283,952,2235,8,5.666666667,201932
27,3,182,4,162,401,16,110,0,875,907,1782,7,5.666666667,201932
27,4,183,16,359,701,16,175,11,1461,1568,3029,8,6,201932
27,5,108,7,132,274,8,71,0,600,584,1184,6,5.333333333,201932
27,6,163,14,292,448,8,161,0,1086,925,2011,7,5.5,201932
28,1,253,25,545,385,6,266,0,1480,1441,2921,13,6,201932
28,2,206,21,462,306,25,213,63,1296,1328,2624,15,5.666666667,201932
28,3,161,8,211,181,5,180,0,746,882,1628,7,5.333333333,201932
28,4,285,15,502,374,39,266,29,1510,1701,3211,15,4.8,201932
28,5,233,19,256,373,18,249,9,1157,1588,2745,10,5.5,201932
28,6,191,15,208,256,26,100,3,799,890,1689,13,5.166666667,201932
28,7,233,22,421,359,30,232,12,1309,1328,2637,13,6,201932
28,8,155,20,287,278,28,193,1,962,1030,1992,13,7,201932
28,9,180,7,400,262,14,162,12,1037,1118,2155,11,5.75,201932
29,1,221,17,326,361,37,175,0,1137,1048,2185,7,5.5,201932
29,2,295,14,272,504,29,204,71,1389,1225,2614,11,6,201932
29,3,146,19,158,335,7,120,0,785,820,1605,6,5.666666667,201932
30,1,102,9,134,147,19,71,1,483,682,1165,7,5.333333333,201932
30,2,151,11,200,131,19,120,44,676,705,1381,8,5.25,201932
30,3,153,6,207,186,33,135,43,763,801,1564,6,5.666666667,201932
30,4,113,5,233,159,41,104,0,655,668,1323,8,6,201932
30,5,150,6,156,266,19,139,0,736,788,1524,7,5.5,201932
30,6,158,8,200,218,16,89,0,689,673,1362,9,5.333333333,201932
30,7,188,10,218,241,29,154,24,864,937,1801,11,5.25,201932
30,8,190,16,254,317,34,165,4,980,1080,2060,11,5.4,201932
30,9,227,4,200,238,42,185,23,919,932,1851,8,5.5,201932
30,10,188,11,282,297,23,159,41,1001,998,1999,6,6,201932
30,11,164,9,301,317,10,152,0,953,791,1744,5,5.5,201932
30,12,249,9,434,526,21,265,0,1504,1445,2949,10,6,201932
30,13,235,12,167,293,39,192,74,1012,890,1902,10,5.4,201932
30,14,168,7,231,235,73,168,8,890,747,1637,8,5.5,201932
30,15,298,17,244,321,33,305,63,1281,1206,2487,11,5.666666667,201932
30,16,193,2,231,311,32,160,58,987,1121,2108,10,5.333333333,201932
30,17,223,18,240,353,66,205,11,1116,1000,2116,8,5.5,201932
30,18,138,8,97,167,27,97,15,549,487,1036,8,5.25,201932
30,19,196,3,223,242,9,194,0,867,853,1720,13,5.6,201932
30,20,188,14,173,305,62,125,0,867,905,1772,10,5.4,201932
31,1,171,11,180,61,226,140,0,789,839,1628,8,5.5,201932
31,2,94,6,95,12,150,66,0,423,377,800,6,5.333333333,201932
31,3,405,36,957,600,127,367,0,2492,2284,4776,21,6.333333333,201932
31,4,121,10,315,274,49,141,16,926,541,1467,4,6,201932
31,5,131,8,132,234,14,165,0,684,287,971,5,5.333333333,201932
32,1,194,24,137,165,23,145,20,708,697,1405,12,5.2,201932
32,2,262,24,149,125,77,215,20,872,852,1724,13,5.142857143,201932
32,3,217,45,182,279,3,185,0,911,1112,2023,13,5.4,201932
32,4,207,45,228,272,20,250,17,1039,794,1833,13,5.4,201932
1,1,278,43,330,279,29,175,4,1138,1170,2308,13,5.5,201933
1,2,293,28,623,461,51,231,5,1692,1768,3460,10,6.333333333,201933
1,3,198,43,488,366,31,262,5,1393,1672,3065,9,6,201933
2,1,231,11,386,319,13,215,0,1175,1252,2427,11,6,201933
2,2,200,10,321,395,5,225,0,1156,1425,2581,7,6,201933
2,3,327,6,500,354,16,235,21,1459,1621,3080,12,6,201933
2,4,183,11,655,220,64,122,5,1260,1276,2536,9,6,201933
2,5,332,27,689,330,74,239,4,1695,2218,3913,12,7,201933
2,6,289,18,558,360,14,225,0,1464,1367,2831,7,6,201933
2,7,281,16,491,291,15,246,36,1376,1632,3008,12,5.75,201933
2,8,233,17,597,445,20,170,13,1495,1632,3127,8,6,201933
3,1,140,15,252,277,12,159,0,855,944,1799,12,5.666666667,201933
3,2,153,11,534,232,15,98,0,1043,1021,2064,9,5.666666667,201933
4,1,144,12,216,399,39,132,14,956,1081,2037,11,5.25,201933
4,2,185,18,364,361,27,121,10,1086,1019,2105,14,5.2,201933
5,1,239,18,386,348,18,170,5,1184,1277,2461,9,5.666666667,201933
5,2,143,15,255,421,22,105,0,961,1262,2223,10,5.2,201933
5,3,212,11,266,404,27,186,14,1120,1233,2353,11,5.333333333,201933
5,4,239,20,498,491,12,253,17,1530,1521,3051,11,5.75,201933
5,5,198,23,368,412,11,157,29,1198,1173,2371,10,6,201933
5,6,146,6,269,319,7,111,36,894,933,1827,10,5.5,201933
5,7,209,15,299,347,6,134,8,1018,1122,2140,11,6,201933
6,1,155,15,279,259,8,149,13,878,933,1811,12,6,201933
6,2,109,17,242,193,23,186,14,784,855,1639,9,5.666666667,201933
7,1,216,7,132,382,26,54,8,825,1104,1929,9,5.25,201933
7,2,183,12,103,373,16,49,0,736,906,1642,9,5.25,201933
7,3,203,2,149,199,78,88,1,720,879,1599,7,5.333333333,201933
7,4,101,8,92,255,10,41,35,542,954,1496,11,5.4,201933
7,5,286,4,146,565,15,130,0,1146,1161,2307,11,5.666666667,201933
7,6,190,8,269,370,18,198,24,1077,1348,2425,9,5.666666667,201933
7,7,203,20,225,446,35,125,0,1054,1060,2114,8,5.5,201933
7,8,228,2,154,431,8,141,7,971,1102,2073,12,5.25,201933
7,9,208,14,308,436,14,179,1,1160,1132,2292,9,5.666666667,201933
7,10,140,9,186,334,18,62,0,749,1113,1862,9,5.5,201933
7,11,109,3,43,82,10,51,4,302,442,744,6,5.333333333,201933
7,12,217,8,230,508,5,91,0,1059,1111,2170,9,5.5,201933
7,13,103,36,89,226,3,39,1,497,612,1109,9,5.25,201933
8,1,115,9,342,177,17,89,0,749,787,1536,4,6,201933
8,2,263,29,574,391,16,202,0,1475,1518,2993,17,5.5,201933
8,3,228,20,381,357,23,152,14,1175,1136,2311,4,6,201933
8,4,177,23,373,299,19,182,32,1105,1606,2711,11,6,201933
8,5,169,21,231,253,16,119,0,809,817,1626,10,5.25,201933
8,6,242,20,441,442,37,223,5,1410,1370,2780,6,6,201933
8,7,185,31,190,197,3,208,0,814,824,1638,7,5.25,201933
8,8,173,21,316,336,4,174,4,1028,1093,2121,10,6,201933
8,9,223,14,164,141,12,186,11,751,752,1503,10,5.2,201933
9,1,100,3,166,163,54,124,7,617,674,1291,5,6,201933
9,2,337,61,775,992,80,385,19,2649,2705,5354,12,6,201933
9,3,155,20,386,419,35,183,19,1217,1315,2532,7,6,201933
9,4,198,17,389,491,79,165,11,1350,1448,2798,11,6,201933
9,5,139,10,309,359,51,146,0,1014,1031,2045,7,6,201933
9,6,98,18,160,142,107,124,15,664,766,1430,7,6,201933
9,7,108,10,339,387,0,123,0,967,966,1933,9,6,201933
9,8,89,19,323,384,21,137,22,995,968,1963,5,6,201933
9,9,135,5,223,340,44,92,4,843,803,1646,5,6,201933
9,10,111,12,355,400,22,146,2,1048,1050,2098,6,6,201933
9,11,159,20,435,487,44,211,6,1362,1536,2898,7,6,201933
9,12,135,38,570,619,27,219,31,1639,1580,3219,11,6,201933
9,13,123,15,286,372,54,138,22,1010,994,2004,4,6,201933
9,14,109,8,198,285,42,133,13,788,816,1604,5,6,201933
9,15,184,19,856,948,34,366,7,2414,2445,4859,10,6.5,201933
9,16,259,50,460,767,67,254,3,1860,2022,3882,15,6,201933
9,17,152,10,252,349,14,122,0,899,898,1797,6,6,201933
9,18,156,13,359,525,40,205,14,1312,1407,2719,12,6,201933
9,19,190,32,342,521,58,198,3,1344,1419,2763,5,6,201933
9,20,39,6,119,141,11,44,1,361,342,703,5,6,201933
9,21,115,6,199,289,22,114,4,749,761,1510,3,6,201933
9,22,151,8,282,329,42,165,20,997,1034,2031,5,6,201933
9,23,141,12,312,532,41,176,4,1218,1261,2479,6,6,201933
9,24,303,27,649,847,99,343,7,2275,2214,4489,14,6,201933
10,1,192,16,176,232,7,190,13,826,1042,1868,12,4.666666667,201933
10,2,222,16,317,305,14,203,9,1086,1277,2363,9,5.25,201933
10,3,177,14,196,238,15,182,26,848,982,1830,11,5.4,201933
10,4,308,29,414,477,7,224,2,1461,1528,2989,12,6.5,201933
11,1,191,44,209,278,15,120,5,862,825,1687,6,5.666666667,201933
11,2,213,33,252,255,34,154,22,963,967,1930,7,6,201933
11,3,175,18,212,279,8,143,12,847,850,1697,3,6,201933
11,4,185,36,162,270,17,137,0,807,839,1646,8,6,201933
11,5,265,32,350,444,13,224,7,1335,1466,2801,7,6,201933
11,6,124,10,203,224,22,112,2,697,710,1407,8,6,201933
11,7,200,37,216,361,26,123,0,963,1038,2001,9,5.5,201933
11,8,172,33,266,406,19,156,0,1052,1087,2139,9,5.5,201933
11,9,184,49,326,375,9,183,34,1160,1172,2332,10,5.666666667,201933
11,10,208,44,268,282,13,172,10,997,930,1927,10,5.6,201933
11,11,215,38,315,346,12,154,0,1080,1116,2196,5,6,201933
11,12,222,31,367,478,12,178,0,1288,1311,2599,7,6,201933
11,13,183,35,195,202,12,130,26,783,677,1460,8,5.5,201933
11,14,206,19,208,232,10,185,2,862,894,1756,8,5.5,201933
11,15,139,37,227,287,10,141,0,841,850,1691,9,6,201933
12,1,128,19,192,154,17,81,4,595,766,1361,10,5.2,201933
12,2,236,18,267,356,9,146,6,1038,1045,2083,10,5.5,201933
12,3,191,22,270,470,15,96,0,1064,1002,2066,11,5.2,201933
12,4,175,19,311,468,25,112,0,1110,1104,2214,9,5.666666667,201933
12,5,276,34,218,294,4,111,12,949,1243,2192,10,5.25,201933
12,6,185,21,102,228,30,58,12,636,797,1433,10,5.25,201933
12,7,270,19,273,373,27,145,37,1144,1163,2307,6,5.5,201933
12,8,221,14,197,270,9,73,0,784,675,1459,9,5.25,201933
12,9,195,24,412,540,17,76,13,1277,1325,2602,9,5.666666667,201933
13,1,200,10,178,216,77,131,21,833,731,1564,9,5.333333333,201933
13,2,147,21,137,206,37,130,12,690,636,1326,6,5.333333333,201933
13,3,180,21,187,248,94,144,0,874,815,1689,12,5.25,201933
13,4,252,20,284,329,45,123,27,1080,1372,2452,9,5.666666667,201933
13,5,255,22,404,385,87,284,7,1444,1394,2838,9,5.75,201933
13,6,316,64,739,666,78,237,9,2109,2087,4196,11,5.666666667,201933
13,7,165,16,392,393,23,122,0,1111,1062,2173,8,5.5,201933
14,1,175,11,132,90,19,254,0,681,886,1567,6,5.5,201933
14,2,164,17,145,129,10,177,0,642,733,1375,5,5.666666667,201933
14,3,223,15,237,109,7,271,5,867,875,1742,8,5.4,201933
14,4,159,16,219,340,15,150,13,912,1028,1940,10,6,201933
14,5,141,11,325,222,21,121,0,841,887,1728,9,5.25,201933
14,6,205,7,456,351,14,166,0,1199,1365,2564,11,6,201933
14,7,114,5,177,150,0,122,0,568,587,1155,6,6,201933
14,8,289,40,631,779,8,429,2,2178,2207,4385,11,6.25,201933
14,9,126,15,175,249,11,139,3,718,768,1486,11,6,201933
14,10,193,18,366,371,9,228,2,1187,1276,2463,7,6,201933
14,11,104,13,158,197,18,168,26,684,724,1408,4,6,201933
14,12,229,14,516,221,2,205,1,1188,1345,2533,9,5.5,201933
14,13,196,8,324,305,15,227,3,1078,1181,2259,6,6,201933
14,14,133,11,216,294,12,217,9,892,992,1884,7,6,201933
14,15,240,21,210,220,24,247,6,968,1060,2028,10,5.6,201933
14,16,164,19,231,204,21,202,6,847,905,1752,5,6,201933
14,17,172,9,193,121,29,201,11,736,826,1562,7,5.25,201933
14,18,211,17,259,174,31,214,13,919,896,1815,9,5.4,201933
14,19,162,17,191,258,16,125,2,771,961,1732,8,5.25,201933
14,20,216,12,280,182,8,169,0,867,1052,1919,10,5.666666667,201933
15,1,260,9,207,116,154,247,0,993,1000,1993,7,5.333333333,201933
15,2,178,12,303,418,29,191,12,1143,1066,2209,6,6,201933
15,3,283,24,238,354,175,335,27,1436,1396,2832,10,5.666666667,201933
15,4,213,5,280,356,15,210,9,1088,1084,2172,4,6,201933
15,5,182,28,274,329,33,220,1,1067,1038,2105,8,5.666666667,201933
15,6,152,20,358,482,31,160,8,1211,1258,2469,7,6,201933
15,7,152,14,259,338,46,184,3,996,983,1979,10,6,201933
15,8,86,12,163,271,15,110,5,662,704,1366,4,6,201933
15,9,274,6,187,166,128,220,13,994,990,1984,9,5.75,201933
15,10,121,9,264,293,50,183,5,925,987,1912,6,6,201933
15,11,175,14,377,444,60,171,1,1242,1360,2602,8,6,201933
15,12,259,10,540,546,20,182,0,1557,1570,3127,8,6,201933
15,13,103,8,181,238,51,146,0,727,721,1448,8,6,201933
15,14,80,12,198,242,17,125,1,675,745,1420,4,6,201933
15,15,162,39,293,407,45,192,4,1142,1128,2270,6,6,201933
15,16,237,34,420,689,22,247,7,1656,1722,3378,8,6,201933
15,17,120,13,236,304,14,180,26,893,966,1859,8,6,201933
15,18,224,15,345,462,33,253,6,1338,1420,2758,7,5.666666667,201933
15,19,195,32,454,639,18,245,9,1592,1635,3227,10,6,201933
15,20,92,8,222,264,8,93,1,688,761,1449,6,6,201933
15,21,104,7,129,200,16,96,12,564,614,1178,6,5.5,201933
15,22,314,60,561,771,24,392,36,2158,2159,4317,14,6,201933
15,23,197,15,217,358,28,220,0,1035,996,2031,6,5.333333333,201933
15,24,135,11,245,276,32,134,5,838,856,1694,4,6,201933
15,25,171,28,308,288,41,168,14,1018,991,2009,6,6,201933
15,26,141,10,250,275,52,153,1,882,922,1804,9,7,201933
15,27,226,14,355,499,16,259,41,1410,1486,2896,9,5.666666667,201933
15,28,215,18,497,388,56,229,3,1406,1397,2803,9,5.666666667,201933
15,29,214,22,427,652,11,261,12,1599,1644,3243,8,6,201933
15,30,260,25,620,539,39,196,10,1689,1746,3435,16,6,201933
15,31,140,41,244,342,13,176,0,956,932,1888,6,6,201933
15,32,170,6,262,439,37,160,5,1079,1052,2131,9,6,201933
15,33,221,9,376,394,16,215,0,1231,1328,2559,7,6,201933
15,34,153,16,212,321,23,174,0,899,1008,1907,8,6,201933
15,35,318,17,312,441,3,322,1,1414,1385,2799,9,5.666666667,201933
15,36,226,22,338,349,86,221,0,1242,1182,2424,9,5.5,201933
15,37,228,27,338,599,42,303,19,1556,1587,3143,7,6,201933
15,38,213,26,275,480,21,227,7,1249,1320,2569,6,5.5,201933
15,39,170,23,293,416,22,153,0,1077,1127,2204,4,6,201933
15,40,334,31,395,485,116,510,2,1873,1841,3714,9,6,201933
15,41,291,24,693,652,41,281,16,1998,1952,3950,13,6,201933
16,1,157,13,200,177,5,106,0,658,786,1444,7,5.333333333,201933
16,2,133,13,95,143,10,100,0,494,464,958,9,5.25,201933
16,3,168,9,141,263,16,120,0,717,767,1484,10,5.25,201933
16,4,208,14,215,127,24,189,0,777,705,1482,8,5.5,201933
16,5,196,21,169,185,25,159,7,762,767,1529,10,5.666666667,201933
16,6,204,37,242,311,33,137,0,964,837,1801,12,5.5,201933
16,7,187,15,161,235,31,184,0,813,888,1701,9,5.5,201933
16,8,291,33,521,506,12,246,9,1618,1502,3120,12,6,201933
16,9,252,27,215,305,14,238,2,1053,968,2021,9,6,201933
16,10,172,15,271,342,16,140,0,956,962,1918,7,6.5,201933
16,11,208,17,195,185,57,171,0,833,946,1779,10,5.4,201933
16,12,133,14,196,159,18,113,3,636,577,1213,10,5.25,201933
17,1,206,24,459,464,22,213,2,1390,1365,2755,10,8,201933
17,2,174,10,305,345,10,117,8,969,911,1880,8,5.666666667,201933
17,3,259,6,402,465,9,202,1,1344,1248,2592,8,5.5,201933
17,4,238,15,368,364,23,185,9,1202,1165,2367,10,5.666666667,201933
17,5,110,5,154,171,2,78,0,520,598,1118,5,5.5,201933
18,1,100,13,112,129,8,108,1,471,521,992,7,5.25,201933
18,2,245,19,330,413,37,215,0,1259,1184,2443,9,6.333333333,201933
18,3,115,4,282,166,7,98,0,672,826,1498,8,5.5,201933
19,1,180,16,366,346,8,309,7,1232,1204,2436,9,6,201933
19,2,281,18,633,427,10,313,0,1682,1675,3357,9,6,201933
19,3,245,16,602,368,13,282,1,1527,1454,2981,7,5.5,201933
19,4,116,6,183,147,43,183,29,707,734,1441,5,6,201933
19,5,331,26,550,643,19,358,16,1943,1939,3882,8,6,201933
19,6,88,6,207,225,4,169,0,699,772,1471,5,6,201933
19,7,178,10,396,196,8,126,0,914,936,1850,10,5.5,201933
19,8,93,5,155,140,2,92,0,487,513,1000,7,6,201933
19,9,158,16,246,195,30,202,0,847,1027,1874,9,5.25,201933
19,10,106,9,161,230,10,196,13,725,825,1550,6,7,201933
19,11,365,29,598,715,34,516,24,2281,2495,4776,13,6,201933
19,12,173,9,535,185,9,160,1,1072,1133,2205,13,5.666666667,201933
20,1,143,17,167,234,36,92,36,725,825,1550,7,5.5,201933
20,2,194,16,180,187,18,109,5,709,825,1534,6,5.333333333,201933
20,3,106,8,142,143,41,76,59,575,600,1175,6,5.333333333,201933
20,4,97,5,60,123,24,79,17,405,607,1012,6,5.333333333,201933
20,5,152,12,209,367,36,87,0,863,1033,1896,11,5.25,201933
20,6,157,6,159,157,168,65,61,773,903,1676,8,5.25,201933
20,7,183,5,223,304,8,152,0,875,761,1636,7,5.75,201933
20,8,433,31,520,944,31,312,53,2324,2376,4700,14,6.5,201933
20,9,330,9,232,307,51,228,38,1195,1281,2476,8,5.666666667,201933
20,10,270,16,210,231,56,109,3,895,1069,1964,9,5.25,201933
21,1,276,7,199,374,42,188,2,1088,1211,2299,9,5.4,201933
21,2,246,20,236,198,85,220,0,1005,1715,2720,9,5.2,201933
21,3,281,8,272,219,66,249,14,1109,1537,2646,8,5.5,201933
21,4,202,5,114,102,37,166,21,647,878,1525,6,5.25,201933
21,5,260,15,347,297,34,215,8,1176,1431,2607,8,5.666666667,201933
21,6,257,6,321,383,32,265,28,1292,1476,2768,6,6,201933
21,7,365,21,241,276,43,318,4,1268,1567,2835,9,5.666666667,201933
21,8,308,14,331,216,67,264,16,1216,1396,2612,9,5.2,201933
21,9,255,8,434,412,53,244,20,1426,1871,3297,9,6,201933
21,10,219,11,300,361,17,191,25,1124,1931,3055,7,5.5,201933
21,11,90,4,176,151,21,75,5,522,591,1113,5,7,201933
21,12,389,14,672,827,36,361,33,2332,2841,5173,16,6.5,201933
21,13,268,19,261,242,28,263,8,1089,1344,2433,8,5.666666667,201933
21,14,238,20,165,166,43,198,17,847,1165,2012,12,5.333333333,201933
21,15,306,7,336,299,28,175,27,1178,1516,2694,7,5.5,201933
22,1,198,28,183,286,33,79,3,810,825,1635,11,5.2,201933
22,2,165,18,345,279,23,126,3,959,824,1783,7,5.5,201933
22,3,372,47,717,650,22,293,1,2102,2090,4192,9,5.666666667,201933
22,4,226,20,548,485,21,201,3,1504,1532,3036,9,6.5,201933
22,5,177,11,358,266,57,104,9,982,931,1913,10,5.5,201933
23,1,259,9,1254,363,23,170,15,2093,2248,4341,14,5.6,201933
23,2,231,12,348,372,37,87,0,1087,1441,2528,8,5.25,201933
23,3,272,10,911,522,34,211,2,1962,2342,4304,19,6,201933
23,4,179,9,639,303,25,130,4,1289,1274,2563,6,5.5,201933
24,1,146,25,119,245,8,67,0,610,633,1243,10,5.2,201933
24,2,134,15,249,171,12,106,0,687,737,1424,6,5.5,201933
24,3,175,32,180,202,44,88,0,721,719,1440,9,5.25,201933
24,4,175,19,189,201,34,165,31,814,867,1681,5,5.5,201933
24,5,260,29,455,553,8,238,0,1543,1724,3267,9,6,201933
24,6,203,26,358,443,34,233,0,1297,1319,2616,6,6,201933
24,7,147,24,178,363,28,87,1,828,877,1705,9,5.25,201933
25,1,138,9,228,328,23,141,15,882,799,1681,13,5.75,201933
25,2,266,22,345,430,19,239,0,1321,1264,2585,7,5.5,201933
25,3,161,11,302,336,29,155,9,1003,914,1917,8,5.6,201933
25,4,141,4,152,294,10,135,0,736,628,1364,8,5.333333333,201933
25,5,177,15,234,399,20,138,0,983,971,1954,8,5.666666667,201933
25,6,182,17,282,322,37,182,7,1029,995,2024,8,5.75,201933
25,7,290,15,347,538,10,235,0,1435,1326,2761,6,6,201933
26,1,187,8,311,285,9,215,0,1015,1121,2136,9,5.5,201933
26,2,247,7,443,487,4,196,21,1405,1241,2646,12,5.4,201933
26,3,240,10,326,545,8,323,10,1462,1267,2729,14,6.5,201933
26,4,152,10,146,222,10,185,20,745,727,1472,9,5.2,201933
26,5,151,8,167,232,16,162,0,736,988,1724,14,5.5,201933
26,6,172,11,255,329,5,227,0,999,993,1992,10,5.333333333,201933
26,7,166,5,170,281,34,134,1,791,541,1332,10,5.5,201933
27,1,131,9,165,266,57,90,0,718,698,1416,8,5.5,201933
27,2,190,9,172,410,6,87,0,874,1066,1940,8,5.666666667,201933
27,3,151,5,133,375,3,105,2,774,921,1695,7,5.666666667,201933
27,4,210,14,322,601,19,168,9,1343,1506,2849,8,6,201933
27,5,76,1,74,212,14,41,1,419,552,971,6,5.333333333,201933
27,6,144,10,179,373,5,108,0,819,922,1741,7,5.5,201933
28,1,279,20,522,410,8,249,0,1488,1304,2792,13,6,201933
28,2,215,24,425,298,14,181,59,1216,1412,2628,15,5.666666667,201933
28,3,153,12,182,172,5,201,0,725,969,1694,7,5.333333333,201933
28,4,348,19,496,378,32,317,52,1642,1815,3457,13,7.333333333,201933
28,5,179,18,217,328,15,202,16,975,1237,2212,10,5.5,201933
28,6,202,14,169,242,23,103,5,758,854,1612,13,5,201933
28,7,246,20,392,371,33,217,23,1302,1809,3111,13,6,201933
28,8,166,14,258,267,29,166,4,904,983,1887,12,6,201933
28,9,201,11,327,236,9,154,10,948,1103,2051,11,5.75,201933
29,1,229,17,292,380,30,152,1,1101,1218,2319,7,5.5,201933
29,2,274,19,254,520,27,213,66,1373,1388,2761,11,6,201933
29,3,128,21,144,323,17,134,0,767,891,1658,6,5.666666667,201933
30,1,110,13,139,155,8,69,5,499,587,1086,7,5.333333333,201933
30,2,134,5,137,90,34,68,58,526,605,1131,8,5.25,201933
30,3,168,11,192,165,37,145,33,751,814,1565,6,5.666666667,201933
30,4,99,4,243,191,49,117,0,703,663,1366,8,6,201933
30,5,168,2,146,247,24,138,0,725,761,1486,7,5.5,201933
30,6,112,13,169,200,10,85,0,589,652,1241,9,5.333333333,201933
30,7,126,3,125,140,17,97,21,529,573,1102,11,5.25,201933
30,8,195,9,305,386,138,171,7,1211,1262,2473,11,5.4,201933
30,9,215,12,170,230,38,186,39,890,847,1737,8,5.5,201933
30,10,145,6,259,275,24,157,35,901,1036,1937,6,6,201933
30,11,127,4,257,319,5,120,0,832,920,1752,5,5.5,201933
30,12,255,11,419,566,27,223,0,1501,1475,2976,10,6,201933
30,13,189,9,136,266,51,148,55,854,779,1633,10,5.4,201933
30,14,137,9,208,170,43,128,12,707,837,1544,8,5.5,201933
30,15,275,18,233,266,41,260,52,1145,1201,2346,11,5.666666667,201933
30,16,170,8,262,335,47,172,41,1035,1129,2164,10,5.333333333,201933
30,17,154,11,202,313,34,135,16,865,1016,1881,8,5.5,201933
30,18,214,9,141,263,11,118,10,766,610,1376,8,5.25,201933
30,19,190,8,274,242,10,160,0,884,977,1861,13,5.6,201933
30,20,163,11,210,427,81,111,0,1003,813,1816,10,5.4,201933
31,1,166,12,182,60,201,143,0,764,791,1555,8,5.5,201933
31,2,94,7,92,4,180,61,0,438,447,885,6,5.333333333,201933
31,3,373,42,900,593,86,362,0,2356,2848,5204,20,6,201933
31,4,103,12,270,270,42,114,22,833,1409,2242,4,6,201933
31,5,108,3,102,219,19,85,0,536,628,1164,5,5.333333333,201933
32,1,175,22,162,180,42,189,25,795,738,1533,12,5.2,201933
32,2,177,17,132,111,54,148,10,649,708,1357,13,5.142857143,201933
32,3,192,36,197,280,12,174,2,893,900,1793,13,5.4,201933
32,4,203,38,233,295,16,232,19,1036,1267,2303,12,5.2,201933
1,1,207,34,264,242,41,137,3,928,942,1870,13,5.5,201934
1,2,254,39,633,418,42,229,5,1620,1814,3434,10,6.333333333,201934
1,3,188,36,564,375,36,241,6,1446,1523,2969,9,6,201934
2,1,217,21,341,356,8,205,0,1148,1210,2358,11,6,201934
2,2,210,5,349,421,10,210,0,1205,1394,2599,7,6,201934
2,3,247,11,459,290,11,222,14,1254,1499,2753,12,6,201934
2,4,191,8,601,237,70,135,12,1254,1203,2457,9,6,201934
2,5,310,33,701,306,105,229,10,1694,2003,3697,12,7,201934
2,6,293,9,506,327,12,179,0,1326,1551,2877,7,6,201934
2,7,267,18,449,351,16,203,15,1319,1500,2819,12,5.75,201934
2,8,238,9,587,493,17,198,20,1562,1629,3191,8,6,201934
3,1,164,7,294,283,14,200,4,966,963,1929,12,5.666666667,201934
3,2,114,13,480,206,11,70,0,894,877,1771,9,5,201934
4,1,145,14,216,365,92,106,22,960,1047,2007,11,5.25,201934
4,2,171,15,366,341,27,113,14,1047,965,2012,14,5.2,201934
5,1,209,18,380,310,28,179,10,1134,1145,2279,9,5.666666667,201934
5,2,163,26,251,389,22,103,0,954,945,1899,10,5.2,201934
5,3,198,17,239,394,37,182,18,1085,1095,2180,11,5.333333333,201934
5,4,235,23,476,444,13,192,12,1395,1537,2932,11,5.75,201934
5,5,171,13,300,479,17,126,43,1149,1193,2342,10,6,201934
5,6,141,14,250,311,14,100,29,859,882,1741,10,5.5,201934
5,7,167,12,283,321,5,137,8,933,1018,1951,10,5.5,201934
6,1,133,7,225,241,9,149,7,771,867,1638,12,6,201934
6,2,139,10,262,186,27,137,2,763,830,1593,9,5.666666667,201934
7,1,182,6,119,297,4,47,3,658,1062,1720,9,5.25,201934
7,2,177,8,80,410,70,33,0,778,1060,1838,9,5.25,201934
7,3,152,2,134,101,84,80,5,558,1841,2399,7,5.333333333,201934
7,4,123,10,151,231,5,61,58,639,597,1236,11,5.4,201934
7,5,281,11,136,555,17,115,0,1115,1067,2182,11,5.666666667,201934
7,6,233,15,259,405,18,169,12,1111,1301,2412,8,5.333333333,201934
7,7,210,20,298,393,53,163,9,1146,1149,2295,8,5.5,201934
7,8,230,4,157,428,9,164,17,1009,1070,2079,12,5.25,201934
7,9,209,12,327,430,21,173,2,1174,1166,2340,10,6,201934
7,10,199,7,172,431,19,78,0,906,977,1883,9,5.5,201934
7,11,113,4,51,91,15,64,5,343,316,659,6,5.333333333,201934
7,12,215,13,243,546,6,83,0,1106,1137,2243,9,5.5,201934
7,13,83,5,77,205,1,43,0,414,641,1055,9,5.25,201934
8,1,134,8,338,187,19,97,0,783,744,1527,4,6,201934
8,2,291,34,602,448,40,192,1,1608,1380,2988,17,5.5,201934
8,3,193,21,342,348,28,134,24,1090,1137,2227,4,6,201934
8,4,185,25,387,305,30,210,36,1178,1643,2821,11,6,201934
8,5,143,17,214,254,12,129,0,769,806,1575,10,5.25,201934
8,6,195,24,388,442,28,222,3,1302,1420,2722,7,6.5,201934
8,7,175,26,201,227,2,199,0,830,810,1640,7,5.25,201934
8,8,196,35,396,425,6,179,0,1237,1146,2383,10,6,201934
8,9,123,20,128,99,13,160,1,544,569,1113,10,4.6,201934
9,1,85,5,169,148,57,130,9,603,664,1267,5,6,201934
9,2,301,71,781,977,87,398,19,2634,2700,5334,12,6,201934
9,3,145,21,395,497,51,181,28,1318,1354,2672,7,6,201934
9,4,179,18,409,536,50,172,3,1367,1452,2819,11,6,201934
9,5,143,12,279,319,59,136,0,948,992,1940,7,6,201934
9,6,90,10,204,190,120,116,15,745,781,1526,7,6,201934
9,7,92,6,289,408,0,128,0,923,1027,1950,9,6,201934
9,8,90,27,313,385,16,112,26,969,986,1955,5,6,201934
9,9,121,4,225,294,38,115,0,797,844,1641,5,6,201934
9,10,95,13,327,362,13,124,0,934,1075,2009,6,6,201934
9,11,162,17,446,501,36,201,2,1365,1363,2728,7,6,201934
9,12,135,26,567,658,27,177,23,1613,1674,3287,11,6,201934
9,13,107,15,306,374,49,142,18,1011,1094,2105,4,6,201934
9,14,108,7,223,281,21,151,10,801,816,1617,5,6,201934
9,15,193,23,909,950,32,325,6,2438,2470,4908,10,6.5,201934
9,16,249,61,463,732,76,287,5,1873,1942,3815,15,6,201934
9,17,125,15,259,333,19,139,1,891,924,1815,6,6,201934
9,18,162,7,323,552,33,194,20,1291,1476,2767,12,6,201934
9,19,191,40,314,545,67,161,1,1319,1386,2705,5,6,201934
9,20,35,9,111,124,15,42,5,341,365,706,5,6,201934
9,21,121,12,235,319,33,119,0,839,822,1661,3,6,201934
9,22,148,12,282,323,59,162,27,1013,1048,2061,5,6,201934
9,23,142,11,333,481,41,144,2,1154,1258,2412,6,6,201934
9,24,285,30,585,777,93,324,13,2107,2405,4512,14,6,201934
10,1,209,23,182,256,16,192,11,889,1099,1988,12,4.833333333,201934
10,2,227,12,294,310,15,207,4,1069,1060,2129,9,5.25,201934
10,3,170,26,205,218,21,176,55,871,966,1837,11,5.4,201934
10,4,286,25,391,445,21,212,1,1381,1596,2977,12,6.5,201934
11,1,178,35,183,283,21,106,3,809,821,1630,6,5.666666667,201934
11,2,192,15,250,272,47,138,27,941,961,1902,7,6,201934
11,3,163,24,206,269,12,173,14,861,894,1755,3,6,201934
11,4,197,37,177,269,19,130,1,830,792,1622,8,6,201934
11,5,282,31,330,477,15,225,2,1362,1323,2685,7,6,201934
11,6,115,12,191,223,22,115,0,678,714,1392,8,6,201934
11,7,208,35,204,404,14,86,0,951,1115,2066,9,5.5,201934
11,8,194,29,242,378,18,166,0,1027,1136,2163,9,5.5,201934
11,9,226,59,317,368,14,190,20,1194,1157,2351,10,5.666666667,201934
11,10,211,26,225,247,25,173,15,922,987,1909,10,5.6,201934
11,11,206,44,361,350,24,159,0,1144,1070,2214,5,6,201934
11,12,197,36,346,501,15,160,0,1255,1347,2602,7,6,201934
11,13,217,28,209,200,21,142,21,838,810,1648,8,5.5,201934
11,14,195,19,209,231,15,149,3,821,859,1680,8,5.5,201934
11,15,145,37,186,308,3,125,1,805,854,1659,9,6,201934
12,1,92,73,181,141,111,39,59,696,831,1527,10,5.2,201934
12,2,208,17,273,418,26,132,0,1074,1004,2078,10,5.5,201934
12,3,156,14,248,340,14,88,0,860,870,1730,11,5.2,201934
12,4,158,23,309,504,33,90,0,1117,1060,2177,9,5.666666667,201934
12,5,255,31,260,266,3,98,14,927,794,1721,10,5.25,201934
12,6,155,16,101,390,35,43,9,749,912,1661,10,5.25,201934
12,7,229,21,234,344,13,126,32,999,1058,2057,6,5.5,201934
12,8,192,18,177,252,3,89,0,731,648,1379,9,4.25,201934
12,9,184,20,451,442,18,82,15,1212,1262,2474,9,5.666666667,201934
13,1,175,16,148,222,34,112,47,754,798,1552,9,5.333333333,201934
13,2,146,21,157,267,39,151,15,796,686,1482,6,5.333333333,201934
13,3,178,17,224,340,86,130,1,976,1021,1997,12,5.25,201934
13,4,281,19,320,324,68,143,26,1181,1041,2222,9,5.666666667,201934
13,5,242,20,444,316,62,253,13,1350,1408,2758,9,5.75,201934
13,6,301,66,703,637,75,233,11,2026,2012,4038,11,5.666666667,201934
13,7,139,16,283,362,23,90,1,914,989,1903,8,5.5,201934
14,1,160,13,130,115,8,247,2,675,540,1215,6,5.5,201934
14,2,181,15,175,114,6,219,0,710,763,1473,5,5.666666667,201934
14,3,231,7,243,124,9,281,9,904,953,1857,8,5.4,201934
14,4,191,15,231,348,9,151,3,948,759,1707,10,5.5,201934
14,5,178,11,378,271,18,158,0,1014,1059,2073,9,5.5,201934
14,6,215,13,417,297,19,178,0,1139,1348,2487,11,6,201934
14,7,132,4,179,193,0,110,0,618,627,1245,6,6,201934
14,8,313,36,685,806,11,451,1,2303,2266,4569,11,6.25,201934
14,9,123,15,195,253,13,144,0,743,714,1457,11,6,201934
14,10,225,17,346,369,8,200,1,1166,1233,2399,7,6,201934
14,11,141,16,155,208,17,148,15,700,695,1395,4,6,201934
14,12,246,15,400,219,11,172,0,1063,1209,2272,9,5.5,201934
14,13,221,18,322,281,12,232,6,1092,1144,2236,6,6,201934
14,14,138,11,218,293,7,193,6,866,929,1795,7,6,201934
14,15,223,32,190,250,29,228,9,961,884,1845,10,5.6,201934
14,16,161,19,258,227,23,200,11,899,835,1734,5,6,201934
14,17,154,25,182,121,18,167,8,675,711,1386,7,5,201934
14,18,206,28,265,157,27,217,19,919,839,1758,9,5.4,201934
14,19,184,15,214,246,12,161,14,846,897,1743,8,5.25,201934
14,20,193,9,269,226,4,183,1,885,800,1685,10,5.666666667,201934
15,1,195,7,197,95,185,204,2,885,844,1729,7,5.333333333,201934
15,2,163,12,300,392,32,163,12,1074,1196,2270,6,6,201934
15,3,257,27,253,362,189,301,17,1406,1492,2898,10,5.666666667,201934
15,4,207,12,274,357,28,234,7,1119,1135,2254,4,6,201934
15,5,192,25,290,322,27,208,6,1070,1041,2111,8,5.666666667,201934
15,6,150,13,345,499,44,179,10,1240,1236,2476,7,6,201934
15,7,155,15,243,359,44,150,4,970,1039,2009,10,6,201934
15,8,102,6,185,257,5,100,7,662,690,1352,4,6,201934
15,9,241,12,162,182,134,178,14,923,993,1916,9,5.5,201934
15,10,130,11,208,309,33,139,2,832,991,1823,6,6,201934
15,11,161,18,327,410,62,191,9,1178,1383,2561,8,6,201934
15,12,235,16,495,549,25,153,0,1473,1562,3035,8,6,201934
15,13,94,8,200,217,50,154,0,723,770,1493,8,6,201934
15,14,89,10,172,216,28,103,1,619,667,1286,4,6,201934
15,15,150,48,287,421,30,200,6,1142,1183,2325,6,6,201934
15,16,225,36,435,647,23,193,1,1560,1655,3215,8,6,201934
15,17,108,10,237,288,16,163,30,852,971,1823,8,6,201934
15,18,263,14,296,466,21,214,5,1279,1450,2729,7,5.666666667,201934
15,19,200,32,450,613,10,275,13,1593,1643,3236,10,6,201934
15,20,108,14,221,291,12,114,2,762,773,1535,6,6,201934
15,21,120,6,153,202,14,94,20,609,724,1333,6,5.5,201934
15,22,253,52,507,781,27,323,36,1979,2117,4096,14,6,201934
15,23,159,8,235,281,101,133,0,917,1008,1925,6,5.333333333,201934
15,24,104,18,200,250,28,110,7,717,807,1524,4,6,201934
15,25,164,21,266,297,49,120,15,932,1068,2000,6,6,201934
15,26,141,11,197,302,42,176,0,869,943,1812,9,7,201934
15,27,226,17,326,483,29,254,33,1368,1497,2865,9,5.666666667,201934
15,28,252,18,470,362,38,232,2,1374,1417,2791,9,5.666666667,201934
15,29,194,19,478,668,5,266,8,1638,1630,3268,8,6,201934
15,30,259,29,570,551,58,187,16,1670,1862,3532,16,6,201934
15,31,140,33,281,357,6,182,0,999,983,1982,6,6,201934
15,32,182,7,318,445,24,148,3,1127,1189,2316,9,6,201934
15,33,180,18,401,423,18,211,0,1251,1341,2592,7,6,201934
15,34,118,20,208,372,10,159,0,887,1127,2014,8,6,201934
15,35,323,10,307,392,8,281,0,1321,1573,2894,9,5.666666667,201934
15,36,267,25,320,380,96,197,3,1288,1095,2383,9,5.5,201934
15,37,191,24,364,516,46,263,27,1431,1527,2958,7,6,201934
15,38,197,30,280,417,7,167,14,1112,1143,2255,6,5.5,201934
15,39,165,27,275,405,19,101,0,992,1101,2093,4,6,201934
15,40,382,15,390,523,101,428,5,1844,2023,3867,9,6,201934
15,41,300,24,658,689,34,230,15,1950,2063,4013,13,6,201934
16,1,141,10,170,182,9,87,0,599,718,1317,7,5.333333333,201934
16,2,101,9,81,135,7,95,0,428,385,813,9,5.25,201934
16,3,165,21,150,271,22,74,0,703,809,1512,10,5.25,201934
16,4,184,18,195,130,35,229,0,791,717,1508,8,5.5,201934
16,5,213,18,201,206,22,176,7,843,823,1666,10,5.666666667,201934
16,6,192,29,202,354,43,137,0,957,845,1802,12,5.5,201934
16,7,215,22,164,250,27,160,0,838,785,1623,9,5.5,201934
16,8,288,18,575,516,15,244,8,1664,1547,3211,12,6,201934
16,9,233,24,252,355,18,235,6,1123,1027,2150,9,6,201934
16,10,164,14,285,298,9,122,0,892,919,1811,6,6,201934
16,11,229,13,232,179,49,216,0,918,766,1684,10,5.4,201934
16,12,192,16,215,149,42,151,3,768,736,1504,10,5.25,201934
17,1,198,20,449,443,28,196,2,1336,1361,2697,9,7,201934
17,2,175,11,319,334,7,101,6,953,1080,2033,8,5.666666667,201934
17,3,247,15,352,383,15,166,1,1179,1279,2458,8,5.5,201934
17,4,183,14,357,360,23,167,7,1111,1199,2310,10,5.666666667,201934
17,5,130,10,138,153,5,69,0,505,422,927,5,5.5,201934
18,1,113,15,114,152,6,76,3,479,572,1051,7,5.25,201934
18,2,256,21,381,415,24,144,0,1241,1296,2537,9,6.333333333,201934
18,3,138,8,276,217,10,84,0,733,738,1471,8,5.5,201934
19,1,187,7,288,352,11,266,2,1113,1121,2234,9,5.5,201934
19,2,275,17,597,402,17,290,0,1598,1678,3276,9,6,201934
19,3,294,22,549,366,16,252,0,1499,1649,3148,7,6,201934
19,4,107,13,193,173,45,144,21,696,778,1474,5,6,201934
19,5,361,19,499,585,31,315,14,1824,1889,3713,8,6,201934
19,6,81,8,200,213,9,154,3,668,698,1366,5,6,201934
19,7,226,9,496,261,10,173,0,1175,1126,2301,10,5.5,201934
19,8,83,2,165,174,3,89,0,516,493,1009,7,6,201934
19,9,174,10,214,237,18,168,0,821,1164,1985,9,5.25,201934
19,10,125,5,193,205,8,189,12,737,781,1518,6,7,201934
19,11,341,40,575,683,23,476,22,2160,2386,4546,13,6,201934
19,12,162,6,516,205,14,142,3,1048,1083,2131,13,5.666666667,201934
20,1,188,24,187,236,49,98,40,822,824,1646,7,5.5,201934
20,2,132,19,139,151,3,74,4,522,795,1317,6,5.333333333,201934
20,3,96,8,127,109,37,58,47,482,563,1045,6,5,201934
20,4,118,8,105,164,30,121,26,572,772,1344,6,5.333333333,201934
20,5,111,13,171,371,25,96,0,787,1176,1963,11,5.25,201934
20,6,157,5,149,148,117,60,39,675,692,1367,8,5.25,201934
20,7,161,7,192,268,4,108,0,740,867,1607,7,5.75,201934
20,8,442,24,566,940,19,298,84,2373,2275,4648,14,6.5,201934
20,9,184,9,151,245,24,123,15,751,961,1712,8,5.666666667,201934
20,10,187,14,180,276,13,123,11,804,738,1542,9,5.25,201934
21,1,266,19,266,371,10,168,0,1100,1301,2401,9,5.4,201934
21,2,190,14,197,148,61,159,0,769,1474,2243,9,5.2,201934
21,3,236,6,260,225,61,235,6,1029,1533,2562,8,5.5,201934
21,4,205,4,95,101,29,144,18,596,980,1576,6,5.25,201934
21,5,305,8,355,303,14,222,12,1219,1610,2829,8,5.666666667,201934
21,6,289,6,339,380,38,260,31,1343,1585,2928,6,6,201934
21,7,355,9,217,339,39,333,5,1297,1956,3253,9,5.666666667,201934
21,8,261,15,234,185,47,212,32,986,1521,2507,9,5.2,201934
21,9,269,15,442,417,54,206,17,1420,1669,3089,9,6,201934
21,10,229,14,306,400,15,218,23,1205,1656,2861,7,5.5,201934
21,11,92,7,184,136,11,71,1,502,583,1085,4,6,201934
21,12,394,21,685,777,40,322,19,2258,2831,5089,15,6,201934
21,13,306,12,291,300,30,251,4,1194,1497,2691,8,5.666666667,201934
21,14,267,7,221,164,57,206,24,946,1525,2471,12,5.333333333,201934
21,15,322,13,337,304,28,178,15,1197,1473,2670,7,5.5,201934
22,1,168,25,176,284,9,72,3,737,771,1508,11,5.2,201934
22,2,181,22,305,284,31,111,1,935,884,1819,7,5.5,201934
22,3,268,51,686,649,11,249,0,1914,1895,3809,9,5.666666667,201934
22,4,189,28,598,482,28,212,0,1537,1558,3095,9,6.5,201934
22,5,184,14,373,243,46,102,8,970,1024,1994,10,5.5,201934
23,1,234,3,1241,317,15,141,21,1972,1956,3928,14,5.6,201934
23,2,154,21,290,392,34,99,0,990,1471,2461,9,5.5,201934
23,3,260,4,925,525,34,197,4,1949,2063,4012,19,0,201934
23,4,136,12,551,358,16,120,2,1195,1199,2394,6,5.5,201934
24,1,118,34,162,233,8,73,5,633,714,1347,10,5.2,201934
24,2,144,15,216,163,7,146,0,691,762,1453,6,5.5,201934
24,3,178,23,156,175,57,79,0,668,664,1332,9,5.25,201934
24,4,162,17,178,200,49,124,43,773,863,1636,5,5.5,201934
24,5,233,37,458,532,12,254,0,1526,1634,3160,10,6.333333333,201934
24,6,186,27,413,422,25,205,0,1278,1274,2552,6,6,201934
24,7,173,21,203,314,20,93,0,824,781,1605,9,5.25,201934
25,1,132,11,201,285,17,135,15,796,891,1687,13,5.75,201934
25,2,174,19,271,334,9,174,0,981,1120,2101,7,5.5,201934
25,3,121,13,276,314,24,131,4,883,971,1854,8,5.6,201934
25,4,138,10,133,230,9,147,0,667,659,1326,8,5.333333333,201934
25,5,153,10,199,342,14,119,0,837,971,1808,8,5.666666667,201934
25,6,163,14,296,290,43,161,4,971,1000,1971,8,5.75,201934
25,7,234,14,295,513,3,206,0,1265,1311,2576,6,6,201934
26,1,182,6,270,292,4,218,0,972,993,1965,9,5.5,201934
26,2,202,8,363,469,4,157,14,1217,1283,2500,12,5.4,201934
26,3,222,19,319,491,9,311,11,1382,1360,2742,13,6,201934
26,4,116,14,113,185,19,141,6,594,750,1344,9,5.2,201934
26,5,146,6,148,193,2,143,0,638,742,1380,15,6,201934
26,6,185,11,246,305,5,190,0,942,871,1813,10,5.333333333,201934
26,7,147,6,166,252,14,100,0,685,867,1552,10,5.25,201934
27,1,116,11,180,274,67,70,0,718,856,1574,8,5.5,201934
27,2,157,12,195,459,18,83,7,931,1245,2176,8,5.666666667,201934
27,3,146,7,137,388,6,78,1,763,830,1593,7,5.666666667,201934
27,4,192,11,351,653,11,182,10,1410,1433,2843,8,6,201934
27,5,62,3,76,215,3,44,3,406,548,954,6,5.333333333,201934
27,6,118,5,188,339,5,80,0,735,869,1604,7,5.5,201934
28,1,224,21,513,377,9,236,0,1380,1384,2764,13,6,201934
28,2,205,17,431,296,16,189,89,1243,1206,2449,15,5.666666667,201934
28,3,152,13,207,155,7,176,0,710,1096,1806,7,5.333333333,201934
28,4,306,28,506,377,33,280,30,1560,1653,3213,17,6.666666667,201934
28,5,174,9,231,308,19,174,8,923,1088,2011,10,5.5,201934
28,6,143,18,171,211,46,133,3,725,678,1403,13,5.166666667,201934
28,7,203,23,349,339,27,174,30,1145,1369,2514,13,6,201934
28,8,127,8,276,234,33,165,4,847,980,1827,13,7,201934
28,9,163,8,329,178,9,152,16,855,1065,1920,11,5.75,201934
29,1,218,20,323,388,40,134,6,1129,1273,2402,7,5.5,201934
29,2,277,20,271,502,26,198,61,1355,1582,2937,11,6,201934
29,3,115,16,136,268,9,102,0,646,906,1552,6,5.666666667,201934
30,1,89,6,138,163,20,71,4,491,416,907,7,5.333333333,201934
30,2,160,6,95,147,20,90,67,585,697,1282,8,5.25,201934
30,3,183,6,262,175,49,143,41,859,680,1539,6,5.666666667,201934
30,4,122,3,221,186,35,94,0,661,702,1363,8,6,201934
30,5,133,7,152,239,10,129,0,670,740,1410,7,5.5,201934
30,6,172,5,161,207,37,103,8,693,634,1327,9,5.333333333,201934
30,7,147,9,124,194,33,117,27,651,582,1233,11,5.25,201934
30,8,179,14,216,343,74,181,17,1024,1348,2372,11,5.4,201934
30,9,196,6,211,189,33,153,36,824,800,1624,8,5.5,201934
30,10,166,6,268,289,32,144,35,940,993,1933,6,6,201934
30,11,119,7,228,336,9,111,0,810,892,1702,5,5.5,201934
30,12,199,14,411,573,24,213,0,1434,1514,2948,10,5.75,201934
30,13,162,8,167,271,56,165,44,873,842,1715,10,5.2,201934
30,14,137,12,231,193,57,143,9,782,842,1624,8,5.5,201934
30,15,306,19,223,278,47,302,67,1242,1263,2505,11,5.666666667,201934
30,16,141,7,199,299,38,153,65,902,1028,1930,10,5.333333333,201934
30,17,206,21,235,347,39,141,22,1011,1004,2015,8,5.5,201934
30,18,140,2,103,187,16,94,12,554,552,1106,8,5.25,201934
30,19,153,5,178,208,12,159,0,715,940,1655,13,5.6,201934
30,20,174,11,209,316,82,103,3,898,967,1865,10,5.4,201934
31,1,205,5,185,62,191,119,0,767,1038,1805,8,5.5,201934
31,2,66,9,113,9,183,48,0,428,485,913,6,5.333333333,201934
31,3,413,41,919,634,83,368,0,2458,3802,6260,21,6.333333333,201934
31,4,117,14,287,248,43,131,16,856,1276,2132,4,6,201934
31,5,131,5,125,241,15,122,0,639,719,1358,5,5.333333333,201934
32,1,157,31,191,187,29,191,13,799,762,1561,12,5.2,201934
32,2,208,23,156,159,52,164,29,791,641,1432,13,5.142857143,201934
32,3,185,27,174,280,12,147,0,825,877,1702,13,5.4,201934
32,4,219,34,223,256,14,151,1,898,972,1870,13,5.4,201934
1,1,180,39,281,257,38,114,5,914,1143,2057,13,5.5,201935
1,2,237,44,599,412,50,191,9,1542,1648,3190,10,6.666666667,201935
1,3,203,34,492,368,23,213,7,1340,1475,2815,9,6.333333333,201935
2,1,222,11,359,343,9,181,0,1125,1280,2405,11,6,201935
2,2,181,5,307,380,7,177,0,1057,1344,2401,8,6.5,201935
2,3,259,19,491,384,6,237,27,1423,1468,2891,11,5.666666667,201935
2,4,197,8,518,251,47,102,5,1128,1320,2448,9,6.5,201935
2,5,339,19,735,352,80,209,7,1741,1887,3628,12,6.5,201935
2,6,224,5,550,321,32,164,0,1296,1465,2761,7,6,201935
2,7,219,12,452,302,16,178,13,1192,1389,2581,12,5.75,201935
2,8,224,8,559,408,21,167,12,1399,1547,2946,8,6,201935
3,1,145,8,210,286,17,147,1,814,888,1702,12,5.333333333,201935
3,2,127,11,509,240,17,92,0,996,1130,2126,9,6,201935
4,1,170,10,208,367,39,109,26,929,929,1858,11,5.5,201935
4,2,121,13,308,240,86,81,11,860,886,1746,14,5.4,201935
5,1,216,10,346,325,24,123,10,1054,1120,2174,9,5.666666667,201935
5,2,139,11,177,266,14,83,0,690,697,1387,10,5.2,201935
5,3,156,16,187,358,17,120,8,862,1049,1911,11,5.333333333,201935
5,4,228,19,487,474,11,200,20,1439,1551,2990,11,6,201935
5,5,165,14,335,418,5,105,6,1048,1144,2192,10,6,201935
5,6,152,8,256,294,7,81,25,823,914,1737,10,5.5,201935
5,7,169,33,252,297,4,103,0,858,956,1814,11,6,201935
6,1,113,22,281,252,6,129,21,824,814,1638,12,6.2,201935
6,2,123,13,279,175,26,127,14,757,924,1681,9,5.666666667,201935
7,1,196,10,88,286,2,65,0,647,923,1570,9,5.25,201935
7,2,152,4,162,217,9,30,0,574,808,1382,9,5.25,201935
7,3,198,4,113,126,80,80,2,603,1237,1840,7,5.333333333,201935
7,4,166,10,139,257,6,86,6,670,906,1576,11,5.4,201935
7,5,249,9,139,493,23,102,1,1016,1159,2175,11,5.666666667,201935
7,6,214,12,275,358,19,151,11,1040,1097,2137,8,5.666666667,201935
7,7,209,21,271,365,44,126,10,1046,1226,2272,8,5.25,201935
7,8,257,7,187,379,5,155,12,1002,1177,2179,12,5.25,201935
7,9,190,7,258,431,8,162,4,1060,1123,2183,9,5.666666667,201935
7,10,152,5,140,407,16,54,0,774,892,1666,9,5.5,201935
7,11,112,2,35,68,8,42,13,280,504,784,6,5.333333333,201935
7,12,228,7,231,477,6,82,0,1031,1181,2212,9,5.5,201935
7,13,100,11,111,210,0,50,0,482,513,995,9,5.25,201935
8,1,147,9,355,181,23,66,7,788,768,1556,4,6,201935
8,2,262,33,537,369,24,154,0,1379,1706,3085,17,5.75,201935
8,3,190,16,375,345,16,140,14,1096,1145,2241,4,6,201935
8,4,174,27,385,274,25,156,51,1092,1243,2335,11,6,201935
8,5,184,19,279,268,19,135,0,904,1048,1952,10,5.25,201935
8,6,208,15,382,421,29,219,4,1278,1308,2586,7,6.5,201935
8,7,156,24,170,206,2,124,0,682,538,1220,7,5.25,201935
8,8,167,33,418,383,9,146,2,1158,1194,2352,10,7,201935
8,9,166,26,130,103,14,143,0,582,540,1122,10,5.2,201935
9,1,114,1,148,168,42,110,7,590,607,1197,5,6,201935
9,2,262,91,763,920,93,288,19,2436,2583,5019,12,6,201935
9,3,137,21,338,464,53,167,27,1207,1234,2441,7,6,201935
9,4,198,15,394,565,89,193,14,1468,1362,2830,11,6,201935
9,5,110,25,274,291,71,108,1,880,1004,1884,7,6,201935
9,6,117,24,212,175,125,125,22,800,710,1510,7,6,201935
9,7,90,5,318,333,3,98,1,848,955,1803,9,6,201935
9,8,95,16,280,371,11,107,13,893,984,1877,5,6,201935
9,9,118,3,193,308,31,86,1,740,810,1550,5,6,201935
9,10,100,13,321,351,23,116,3,927,1026,1953,6,6,201935
9,11,164,24,398,547,41,176,9,1359,1416,2775,7,7,201935
9,12,141,23,550,642,34,210,37,1637,1586,3223,11,6,201935
9,13,124,14,307,373,68,115,29,1030,990,2020,4,6,201935
9,14,111,12,196,252,38,124,15,748,799,1547,5,6,201935
9,15,181,24,841,917,37,269,12,2281,2456,4737,10,6.5,201935
9,16,252,45,481,709,76,246,3,1812,1823,3635,15,6,201935
9,17,128,11,243,326,24,101,0,833,906,1739,6,6,201935
9,18,137,15,340,532,52,152,61,1289,1284,2573,12,6,201935
9,19,196,64,383,497,52,152,17,1361,1301,2662,5,6,201935
9,20,40,13,108,114,26,22,0,323,353,676,5,6,201935
9,21,143,20,187,269,28,78,1,726,769,1495,3,6,201935
9,22,135,6,257,302,42,120,26,888,980,1868,5,6,201935
9,23,159,27,369,465,57,125,5,1207,1192,2399,6,7,201935
9,24,285,27,568,821,89,307,12,2109,2461,4570,14,6,201935
10,1,182,14,180,235,17,172,12,812,1003,1815,12,4.833333333,201935
10,2,232,13,280,284,24,163,4,1000,1071,2071,9,5.25,201935
10,3,172,11,182,194,24,178,33,794,861,1655,11,5.4,201935
10,4,270,24,373,448,14,199,5,1333,1396,2729,12,7,201935
11,1,162,45,206,258,31,116,2,820,784,1604,6,5.666666667,201935
11,2,183,29,230,220,31,88,21,802,913,1715,7,6,201935
11,3,144,25,244,252,11,128,7,811,841,1652,3,6,201935
11,4,159,37,144,237,24,113,2,716,808,1524,8,6,201935
11,5,246,45,335,450,7,190,0,1273,1431,2704,7,6.5,201935
11,6,109,16,184,250,17,97,2,675,645,1320,8,6,201935
11,7,156,26,201,323,7,84,0,797,1078,1875,9,5.25,201935
11,8,201,29,281,364,26,127,1,1029,1005,2034,9,5.5,201935
11,9,188,35,280,347,4,159,5,1018,1156,2174,10,5.666666667,201935
11,10,174,31,215,232,20,148,8,828,847,1675,10,5.6,201935
11,11,168,29,251,320,6,127,0,901,1048,1949,5,5,201935
11,12,216,31,357,424,11,135,0,1174,1252,2426,7,6.5,201935
11,13,155,37,129,170,21,109,14,635,716,1351,8,5.5,201935
11,14,184,34,210,236,22,134,2,822,869,1691,8,5.5,201935
11,15,130,35,203,294,2,90,0,754,890,1644,9,6,201935
12,1,123,21,170,148,29,94,6,591,578,1169,10,5.2,201935
12,2,146,14,191,307,19,81,4,762,894,1656,10,5.5,201935
12,3,121,21,215,283,13,80,0,733,793,1526,11,5,201935
12,4,176,27,298,451,30,102,0,1084,1137,2221,9,6,201935
12,5,215,36,233,292,5,108,25,914,940,1854,10,5,201935
12,6,161,18,103,384,33,37,4,740,841,1581,10,5,201935
12,7,194,9,259,292,8,97,14,873,981,1854,6,5.5,201935
12,8,195,19,193,289,4,70,0,770,680,1450,9,5,201935
12,9,197,16,420,453,85,69,3,1243,1150,2393,9,5.666666667,201935
13,1,215,24,189,219,28,111,31,817,913,1730,9,5.333333333,201935
13,2,160,23,144,275,53,147,15,817,749,1566,6,5.333333333,201935
13,3,165,23,169,258,77,110,0,802,852,1654,12,5.25,201935
13,4,238,15,252,314,27,132,14,992,1102,2094,9,5.666666667,201935
13,5,254,18,393,309,81,251,18,1324,1443,2767,9,5.75,201935
13,6,282,50,664,613,104,159,6,1878,2028,3906,11,6,201935
13,7,154,29,313,310,46,71,0,923,1041,1964,8,5.5,201935
14,1,167,9,108,80,11,195,2,572,703,1275,6,5.5,201935
14,2,188,8,168,113,15,214,1,707,729,1436,5,5.666666667,201935
14,3,232,13,216,131,5,243,1,841,949,1790,8,5.4,201935
14,4,165,12,230,321,19,136,6,889,1002,1891,10,6,201935
14,5,167,10,345,252,23,114,0,911,919,1830,9,5.5,201935
14,6,236,14,459,296,18,134,0,1157,1057,2214,11,6,201935
14,7,135,6,204,178,0,103,0,626,561,1187,6,6,201935
14,8,316,37,659,730,26,342,1,2111,2152,4263,11,6,201935
14,9,119,15,169,256,10,127,1,697,754,1451,11,6,201935
14,10,221,19,401,326,9,186,0,1162,1199,2361,7,6.5,201935
14,11,126,12,175,197,26,128,27,691,679,1370,4,6,201935
14,12,232,16,445,206,14,155,0,1068,982,2050,9,5.5,201935
14,13,177,22,321,285,10,147,3,965,1128,2093,6,6,201935
14,14,135,17,287,255,28,149,12,883,883,1766,7,6,201935
14,15,193,16,188,203,28,194,5,827,924,1751,10,5.6,201935
14,16,186,22,275,193,27,152,3,858,877,1735,5,6,201935
14,17,158,31,201,135,18,159,6,708,697,1405,7,5.25,201935
14,18,204,21,240,148,23,168,17,821,817,1638,9,5.4,201935
14,19,165,19,242,281,9,144,12,872,897,1769,8,5.25,201935
14,20,198,13,265,193,3,177,0,849,903,1752,10,5.666666667,201935
15,1,153,12,169,77,135,117,2,665,658,1323,7,5.333333333,201935
15,2,170,21,289,406,42,113,6,1047,1085,2132,6,6,201935
15,3,238,19,256,356,160,237,18,1284,1250,2534,10,5.666666667,201935
15,4,205,6,230,374,31,185,8,1039,1022,2061,4,6,201935
15,5,191,35,255,313,22,170,3,989,1159,2148,8,5.666666667,201935
15,6,152,11,346,467,40,165,13,1194,1170,2364,7,6.5,201935
15,7,155,10,264,349,50,133,6,967,964,1931,10,6,201935
15,8,77,10,164,289,10,79,13,642,616,1258,4,6,201935
15,9,242,14,171,193,126,149,10,905,967,1872,9,5.75,201935
15,10,133,9,231,316,19,115,7,830,848,1678,6,6,201935
15,11,153,23,297,408,52,110,3,1046,1168,2214,8,6,201935
15,12,243,18,502,472,26,136,2,1399,1511,2910,8,6,201935
15,13,103,7,172,220,67,117,0,686,679,1365,8,6,201935
15,14,72,6,157,223,24,84,5,571,654,1225,4,6,201935
15,15,162,44,264,366,25,133,6,1000,1098,2098,6,6,201935
15,16,178,26,385,584,16,171,7,1367,1589,2956,8,6,201935
15,17,114,15,177,299,12,156,14,787,835,1622,8,6,201935
15,18,255,34,365,464,39,195,9,1361,1277,2638,7,5.666666667,201935
15,19,215,37,487,671,12,243,18,1683,1559,3242,10,6,201935
15,20,87,15,212,288,9,102,2,715,715,1430,6,6,201935
15,21,114,11,160,191,24,106,14,620,565,1185,6,5.5,201935
15,22,273,73,536,692,24,220,32,1850,2066,3916,14,6,201935
15,23,267,20,223,368,24,212,0,1114,1226,2340,6,5.333333333,201935
15,24,130,8,223,269,38,89,2,759,804,1563,4,6,201935
15,25,159,23,235,284,44,123,12,880,941,1821,6,6,201935
15,26,131,4,199,275,24,140,3,776,824,1600,9,7,201935
15,27,212,10,346,455,17,214,29,1283,1348,2631,9,5.666666667,201935
15,28,261,25,455,341,47,181,4,1314,1551,2865,9,5.666666667,201935
15,29,213,23,435,613,7,204,8,1503,1606,3109,8,6,201935
15,30,260,27,440,464,50,151,11,1403,1556,2959,16,6,201935
15,31,143,55,245,342,14,169,0,968,952,1920,6,6,201935
15,32,174,4,246,391,21,120,4,960,1018,1978,9,6,201935
15,33,199,21,345,403,16,150,0,1134,1218,2352,7,6,201935
15,34,115,20,192,354,13,115,12,821,882,1703,8,6,201935
15,35,291,19,274,385,7,242,0,1218,1292,2510,9,5.666666667,201935
15,36,226,23,263,288,54,131,2,987,829,1816,9,5.5,201935
15,37,217,17,334,530,56,189,31,1374,1431,2805,7,6,201935
15,38,174,33,246,369,23,114,11,970,1038,2008,6,5.5,201935
15,39,134,28,273,375,13,102,0,925,1013,1938,4,6,201935
15,40,289,26,357,452,104,341,2,1571,1737,3308,9,6,201935
15,41,263,20,591,587,32,148,21,1662,1793,3455,13,6,201935
16,1,139,7,174,157,15,110,0,602,696,1298,7,5.333333333,201935
16,2,80,16,82,113,9,71,0,371,394,765,9,5.25,201935
16,3,199,16,188,239,17,121,4,784,814,1598,10,5.25,201935
16,4,182,19,200,154,36,202,0,793,695,1488,8,5.5,201935
16,5,205,24,201,192,20,144,20,806,852,1658,10,5.666666667,201935
16,6,171,14,167,173,31,101,0,657,850,1507,12,5.5,201935
16,7,152,18,133,184,27,114,0,628,714,1342,9,5.5,201935
16,8,236,21,475,437,11,202,2,1384,1672,3056,12,6,201935
16,9,210,14,234,260,6,175,3,902,1042,1944,9,6.5,201935
16,10,125,13,264,269,10,115,0,796,905,1701,6,6,201935
16,11,191,22,190,154,56,191,0,804,782,1586,10,5.4,201935
16,12,157,13,186,145,16,125,5,647,716,1363,10,5.25,201935
17,1,223,16,408,417,22,168,1,1255,1322,2577,9,8,201935
17,2,176,9,319,361,14,95,5,979,863,1842,8,5.666666667,201935
17,3,210,12,370,414,26,131,4,1167,1171,2338,8,5.5,201935
17,4,210,13,325,354,16,120,5,1043,1143,2186,10,5.666666667,201935
17,5,92,2,145,149,10,55,0,453,431,884,5,5.5,201935
18,1,131,15,110,183,6,85,5,535,526,1061,7,5.25,201935
18,2,219,24,329,410,33,141,0,1156,1267,2423,9,7.333333333,201935
18,3,127,8,260,205,10,117,0,727,813,1540,8,5.75,201935
19,1,173,10,316,301,18,231,5,1054,1189,2243,9,6,201935
19,2,263,18,573,354,18,237,0,1463,1575,3038,9,6,201935
19,3,240,18,511,367,28,209,0,1373,1455,2828,7,6,201935
19,4,121,9,172,165,16,141,20,644,664,1308,5,6,201935
19,5,312,28,479,604,12,300,9,1744,1860,3604,8,6,201935
19,6,76,11,209,214,9,130,0,649,681,1330,5,6,201935
19,7,165,8,442,208,3,99,0,925,979,1904,10,5.5,201935
19,8,69,5,154,137,1,52,0,418,501,919,7,6,201935
19,9,186,27,267,276,44,146,0,946,973,1919,9,5.25,201935
19,10,105,4,164,199,7,134,6,619,623,1242,7,7,201935
19,11,311,37,495,614,22,405,18,1902,2029,3931,13,6.333333333,201935
19,12,172,7,475,183,8,138,2,985,1008,1993,13,5.666666667,201935
20,1,167,19,203,191,31,93,21,725,640,1365,7,5.5,201935
20,2,117,14,103,174,6,57,2,473,659,1132,6,5.333333333,201935
20,3,88,9,176,135,61,75,35,579,769,1348,6,5.333333333,201935
20,4,120,6,115,130,45,101,51,568,993,1561,6,5.333333333,201935
20,5,92,8,144,268,19,56,1,588,926,1514,11,4.75,201935
20,6,125,6,151,99,166,55,90,692,726,1418,8,5.25,201935
20,7,147,12,162,260,5,94,0,680,1059,1739,7,5.75,201935
20,8,401,32,454,781,32,255,52,2007,2310,4317,14,7,201935
20,9,218,21,194,240,64,145,20,902,1089,1991,8,5.666666667,201935
20,10,160,13,161,204,19,80,6,643,703,1346,9,5.25,201935
21,1,216,7,190,343,7,137,0,900,1046,1946,9,5.4,201935
21,2,197,18,187,161,45,163,0,771,972,1743,9,5.2,201935
21,3,242,12,282,200,52,262,11,1061,1416,2477,8,5.5,201935
21,4,200,6,88,105,33,127,23,582,796,1378,6,5.25,201935
21,5,295,17,322,253,16,181,16,1100,1399,2499,8,5.666666667,201935
21,6,263,9,320,405,32,195,28,1252,1393,2645,6,6,201935
21,7,349,16,230,334,42,256,2,1229,1543,2772,9,5.666666667,201935
21,8,251,5,258,186,57,216,30,1003,1036,2039,9,5.2,201935
21,9,241,18,387,363,50,198,26,1283,1504,2787,9,6,201935
21,10,221,12,282,344,26,186,21,1092,1431,2523,7,5.5,201935
21,11,86,5,184,130,21,72,3,501,531,1032,4,6,201935
21,12,374,28,668,811,36,341,9,2267,2408,4675,15,6,201935
21,13,266,12,266,265,24,234,6,1073,1396,2469,8,5.666666667,201935
21,14,234,12,252,167,33,202,12,912,1093,2005,12,5.333333333,201935
21,15,290,11,303,291,20,185,7,1107,1252,2359,7,5.5,201935
22,1,186,28,177,301,14,83,1,790,852,1642,11,5.2,201935
22,2,155,19,265,230,28,103,1,801,847,1648,7,5.5,201935
22,3,256,36,575,613,16,207,0,1703,1892,3595,9,6,201935
22,4,252,26,595,463,21,208,5,1570,1495,3065,9,6.5,201935
22,5,154,9,426,184,22,109,12,916,955,1871,10,5.5,201935
23,1,263,9,1107,410,30,134,8,1961,2156,4117,14,5.6,201935
23,2,151,15,267,306,39,63,0,841,1174,2015,9,5.5,201935
23,3,281,8,1015,577,33,180,2,2096,2055,4151,19,7,201935
23,4,143,2,545,286,13,99,2,1090,1157,2247,6,5.5,201935
24,1,116,34,141,233,9,82,7,622,710,1332,10,5.2,201935
24,2,160,24,229,173,24,116,1,727,714,1441,6,5.5,201935
24,3,140,15,170,176,20,77,0,598,564,1162,9,5.25,201935
24,4,131,19,182,201,27,116,21,697,676,1373,5,5.5,201935
24,5,265,28,468,504,12,192,0,1469,1566,3035,10,6.666666667,201935
24,6,164,30,358,403,14,171,0,1140,1284,2424,7,7,201935
24,7,213,20,201,278,13,87,0,812,796,1608,9,5.25,201935
25,1,139,5,223,261,28,124,24,804,757,1561,13,5.75,201935
25,2,245,17,275,404,8,143,0,1092,1320,2412,7,5.5,201935
25,3,167,15,315,315,30,130,6,978,1037,2015,8,5.6,201935
25,4,126,14,151,247,25,107,0,670,705,1375,8,5.333333333,201935
25,5,132,10,204,401,13,107,0,867,976,1843,8,5.666666667,201935
25,6,198,10,300,331,35,174,3,1051,1170,2221,8,5.75,201935
25,7,225,11,331,399,7,169,0,1142,1369,2511,6,6,201935
26,1,212,9,221,270,6,192,0,910,951,1861,9,5.5,201935
26,2,228,8,339,391,4,125,9,1104,1103,2207,12,5.4,201935
26,3,232,9,309,498,14,296,9,1367,1371,2738,13,6.5,201935
26,4,109,21,125,200,14,109,8,586,642,1228,9,5.2,201935
26,5,154,12,243,297,11,169,0,886,855,1741,15,6,201935
26,6,157,11,296,340,0,186,1,991,1020,2011,10,5.333333333,201935
26,7,120,9,117,204,25,87,0,562,633,1195,10,5.5,201935
27,1,116,7,210,249,49,78,0,709,925,1634,8,5.5,201935
27,2,153,11,194,341,16,57,0,772,1019,1791,8,5.666666667,201935
27,3,145,7,117,354,9,71,4,707,814,1521,7,5.666666667,201935
27,4,196,16,279,653,15,132,14,1305,1465,2770,8,6.5,201935
27,5,76,5,89,228,11,56,0,465,738,1203,6,5.333333333,201935
27,6,124,11,165,322,4,80,0,706,741,1447,7,5.5,201935
28,1,204,16,500,386,5,175,0,1286,1413,2699,13,6,201935
28,2,217,12,393,275,19,156,59,1131,1227,2358,15,6,201935
28,3,126,12,156,121,2,105,0,522,737,1259,7,4.666666667,201935
28,4,301,14,494,350,20,216,31,1426,1655,3081,18,6.666666667,201935
28,5,194,14,241,318,5,156,8,936,1160,2096,10,5.5,201935
28,6,96,8,99,136,15,56,2,412,564,976,13,4.166666667,201935
28,7,234,28,382,376,28,171,19,1238,1285,2523,13,6,201935
28,8,120,12,161,199,18,101,2,613,786,1399,12,5,201935
28,9,175,7,399,218,11,122,10,942,965,1907,11,5.75,201935
29,1,240,21,325,418,31,135,3,1173,1256,2429,7,5.5,201935
29,2,231,18,237,440,29,163,53,1171,1465,2636,10,6,201935
29,3,134,14,136,289,15,91,0,679,722,1401,6,5.666666667,201935
30,1,86,13,119,186,16,82,4,506,485,991,7,5.333333333,201935
30,2,149,8,159,127,24,105,65,637,699,1336,8,5.25,201935
30,3,151,12,174,156,43,108,32,676,783,1459,6,5.666666667,201935
30,4,96,5,196,161,23,94,0,575,647,1222,8,6,201935
30,5,152,10,174,251,9,122,2,720,683,1403,7,5.5,201935
30,6,149,12,215,246,26,90,7,745,712,1457,9,5.333333333,201935
30,7,208,12,244,243,22,151,27,907,838,1745,11,5.25,201935
30,8,174,17,250,304,50,134,14,943,963,1906,11,5.4,201935
30,9,156,2,205,178,29,116,26,712,819,1531,8,5.5,201935
30,10,134,12,243,222,33,118,26,788,853,1641,6,6.5,201935
30,11,130,8,204,329,9,107,0,787,852,1639,5,5.5,201935
30,12,196,9,369,519,17,201,0,1311,1424,2735,10,6.25,201935
30,13,214,10,158,290,43,154,65,934,993,1927,10,5.4,201935
30,14,132,6,170,192,38,109,21,668,841,1509,8,5.5,201935
30,15,199,13,220,281,36,226,54,1029,1044,2073,11,5.666666667,201935
30,16,149,7,216,332,29,162,65,960,994,1954,10,5.333333333,201935
30,17,134,10,141,234,26,91,9,645,808,1453,8,5.5,201935
30,18,139,7,85,202,20,105,16,574,558,1132,8,5.25,201935
30,19,165,5,212,196,6,130,0,714,779,1493,13,5.6,201935
30,20,123,8,168,237,55,73,0,664,944,1608,10,5.4,201935
31,1,164,13,182,55,173,109,0,696,863,1559,8,5.5,201935
31,2,72,11,112,3,157,78,0,433,293,726,6,5.333333333,201935
31,3,375,60,847,574,102,254,4,2216,2653,4869,21,6.666666667,201935
31,4,103,14,295,286,40,95,25,858,930,1788,4,6,201935
31,5,105,4,102,192,18,96,0,517,700,1217,5,5.333333333,201935
32,1,165,13,138,163,27,157,16,679,787,1466,12,5.2,201935
32,2,213,21,193,126,58,150,26,787,817,1604,13,5.142857143,201935
32,3,190,59,196,263,3,142,1,854,868,1722,13,5.6,201935
32,4,169,24,203,205,20,141,12,774,899,1673,13,5.4,201935
1,1,233,50,328,297,44,126,4,1082,1262,2344,13,5.5,201937
1,2,234,49,579,438,48,162,9,1519,1651,3170,10,6.666666667,201937
1,3,199,48,498,394,41,230,2,1412,1461,2873,9,6.333333333,201937
2,1,180,13,327,340,9,201,0,1070,1121,2191,11,6,201937
2,2,157,7,342,238,6,132,0,882,1216,2098,7,6,201937
2,3,262,11,419,341,13,210,31,1287,1404,2691,11,5.666666667,201937
2,4,200,10,645,214,47,73,1,1190,1293,2483,9,6.5,201937
2,5,285,24,613,237,159,188,1,1507,1876,3383,11,6,201937
2,6,244,17,579,267,9,123,1,1240,1373,2613,8,6.5,201937
2,7,269,15,449,339,19,158,10,1259,1387,2646,12,5.75,201937
2,8,220,23,559,367,29,111,6,1315,1500,2815,7,9,201937
3,1,126,11,240,264,19,139,7,806,774,1580,13,5.666666667,201937
3,2,141,18,496,232,32,75,0,994,908,1902,9,6,201937
4,1,162,13,211,338,70,129,33,956,964,1920,11,5.5,201937
4,2,172,16,376,433,56,102,19,1174,1353,2527,14,5.4,201937
5,1,525,17,435,331,30,134,9,1481,1196,2677,9,5.666666667,201937
5,2,445,25,254,267,39,86,0,1116,1121,2237,10,5.2,201937
5,3,475,29,232,294,40,162,7,1239,1140,2379,11,5.333333333,201937
5,4,734,20,465,444,18,201,10,1892,1378,3270,11,6,201937
5,5,472,17,380,389,20,90,10,1378,1068,2446,10,6,201937
5,6,360,17,294,250,12,57,21,1011,867,1878,10,5.5,201937
5,7,434,10,278,287,36,95,5,1145,913,2058,10,5.5,201937
6,1,139,16,272,170,11,122,26,756,792,1548,13,6.2,201937
6,2,132,14,336,199,26,142,9,858,745,1603,9,5.666666667,201937
7,1,330,10,129,216,18,61,0,764,610,1374,9,5.25,201937
7,2,234,10,133,353,10,34,0,774,598,1372,9,5.25,201937
7,3,218,0,215,107,212,38,2,792,526,1318,7,5.333333333,201937
7,4,227,14,153,213,7,65,21,700,446,1146,11,5.4,201937
7,5,283,13,153,660,15,80,0,1204,1003,2207,11,5.666666667,201937
7,6,305,23,347,274,43,140,7,1139,1265,2404,9,6,201937
7,7,274,25,302,271,82,106,4,1064,991,2055,8,5.5,201937
7,8,231,12,164,562,18,112,0,1099,810,1909,12,5.25,201937
7,9,224,6,334,430,15,155,1,1165,1181,2346,9,5.666666667,201937
7,10,217,9,319,335,22,48,0,950,692,1642,9,5.5,201937
7,11,181,6,133,71,3,31,9,434,218,652,6,5.333333333,201937
7,12,240,9,302,379,6,60,0,996,974,1970,9,5.5,201937
7,13,158,6,108,342,1,59,0,674,240,914,9,5.25,201937
8,1,148,11,478,157,21,58,2,875,818,1693,4,6,201937
8,2,291,61,631,332,24,90,0,1429,1496,2925,17,5.75,201937
8,3,243,43,438,336,32,119,23,1234,1092,2326,4,6,201937
8,4,193,36,406,274,42,185,35,1171,1208,2379,11,6,201937
8,5,180,92,294,222,19,55,1,863,664,1527,10,5.25,201937
8,6,248,20,368,423,51,209,7,1326,1323,2649,7,6.5,201937
8,7,176,110,228,200,14,123,1,852,772,1624,8,5.25,201937
8,8,187,32,359,375,9,178,3,1143,1170,2313,10,7,201937
8,9,185,19,189,139,28,175,2,737,681,1418,10,5.2,201937
9,1,112,18,141,125,53,91,3,543,537,1080,5,6,201937
9,2,518,58,716,787,129,187,18,2413,2499,4912,12,6,201937
9,3,167,15,371,316,87,147,15,1118,1273,2391,7,6,201937
9,4,197,19,429,453,130,135,6,1369,1416,2785,11,6,201937
9,5,132,29,292,266,54,92,1,866,924,1790,7,6,201937
9,6,132,85,205,165,125,99,5,816,731,1547,7,6,201937
9,7,91,8,427,244,1,53,1,825,941,1766,9,6,201937
9,8,90,25,359,255,26,113,18,886,924,1810,5,6,201937
9,9,113,13,289,258,58,81,2,814,762,1576,5,6,201937
9,10,119,24,380,288,35,85,14,945,904,1849,6,6,201937
9,11,157,15,466,324,134,162,10,1268,1325,2593,7,7,201937
9,12,248,27,489,533,49,96,13,1455,1537,2992,11,6,201937
9,13,113,20,340,319,85,89,12,978,1005,1983,4,6,201937
9,14,113,15,301,281,72,124,7,913,788,1701,5,6,201937
9,15,271,30,821,650,38,183,21,2014,2346,4360,10,6.5,201937
9,16,236,94,528,763,58,232,2,1913,1786,3699,15,6,201937
9,17,115,11,278,267,28,83,7,789,863,1652,6,6,201937
9,18,173,26,370,399,111,146,37,1262,1284,2546,12,6,201937
9,19,180,74,399,377,143,106,41,1320,1332,2652,5,6,201937
9,20,46,29,104,92,28,14,1,314,326,640,5,6,201937
9,21,116,8,192,219,100,54,1,690,783,1473,3,6,201937
9,22,139,18,281,259,88,112,18,915,934,1849,5,6,201937
9,23,180,38,466,380,75,95,4,1238,1207,2445,6,7,201937
9,24,299,55,572,688,169,230,4,2017,2671,4688,14,6,201937
10,1,217,52,234,218,36,223,28,1008,1091,2099,12,4.833333333,201937
10,2,186,25,344,269,13,144,6,987,1180,2167,10,5.25,201937
10,3,155,27,221,224,13,158,44,842,1002,1844,11,5.4,201937
10,4,266,35,380,427,18,190,7,1323,1413,2736,12,7,201937
11,1,155,76,228,207,33,100,1,800,835,1635,6,5.666666667,201937
11,2,211,30,256,213,39,98,8,855,896,1751,7,6,201937
11,3,159,26,228,257,20,120,8,818,831,1649,3,6,201937
11,4,152,51,200,240,37,114,1,795,788,1583,8,6,201937
11,5,248,89,389,460,15,152,3,1356,1325,2681,7,6.5,201937
11,6,108,20,207,194,31,86,4,650,659,1309,8,6,201937
11,7,243,65,362,517,19,99,2,1307,1026,2333,9,5.5,201937
11,8,217,38,302,358,67,134,1,1117,1134,2251,9,5.5,201937
11,9,194,61,349,462,16,184,10,1276,1112,2388,10,5.666666667,201937
11,10,210,46,273,196,48,85,7,865,924,1789,10,5.6,201937
11,11,182,33,288,331,17,117,0,968,1091,2059,5,6,201937
11,12,195,45,352,452,11,149,0,1204,1226,2430,7,6.5,201937
11,13,157,41,212,205,34,75,7,731,777,1508,8,5.5,201937
11,14,173,32,244,179,14,106,6,754,788,1542,8,5.5,201937
11,15,151,47,275,211,9,80,7,780,734,1514,9,6,201937
12,1,170,34,250,140,68,65,5,732,665,1397,10,5.2,201937
12,2,213,29,242,454,21,111,10,1080,1048,2128,10,5.5,201937
12,3,230,28,297,530,16,99,0,1200,1229,2429,11,5.2,201937
12,4,205,26,296,428,37,58,1,1051,1268,2319,9,6,201937
12,5,231,34,335,405,10,72,5,1092,710,1802,10,5.25,201937
12,6,204,35,276,499,72,20,2,1108,681,1789,10,5.25,201937
12,7,222,14,248,370,28,123,37,1042,1071,2113,6,5.5,201937
12,8,252,22,267,415,4,80,0,1040,872,1912,9,5.25,201937
12,9,201,23,492,373,43,61,2,1195,1149,2344,9,5.666666667,201937
13,1,341,13,136,162,36,54,10,752,957,1709,9,5.333333333,201937
13,2,177,9,103,170,36,47,10,552,749,1301,6,5.333333333,201937
13,3,150,19,181,190,94,94,0,728,813,1541,12,5.25,201937
13,4,237,15,299,344,62,109,23,1089,1203,2292,9,5.666666667,201937
13,5,240,18,334,282,89,176,7,1146,1172,2318,9,5.75,201937
13,6,335,39,621,586,82,167,8,1838,1958,3796,11,6,201937
13,7,182,30,329,321,49,59,0,970,1027,1997,8,5.5,201937
14,1,155,15,113,79,13,132,6,513,752,1265,6,5.5,201937
14,2,177,22,169,95,61,139,1,664,785,1449,5,5.666666667,201937
14,3,225,23,289,92,9,217,1,856,917,1773,8,5.4,201937
14,4,185,19,262,273,16,115,6,876,918,1794,10,6,201937
14,5,179,26,456,181,37,90,1,970,858,1828,9,5.25,201937
14,6,218,22,521,232,14,54,0,1061,1186,2247,11,6,201937
14,7,127,24,226,134,0,41,0,552,626,1178,6,6,201937
14,8,370,41,707,566,33,230,6,1953,2071,4024,11,6,201937
14,9,134,23,220,230,20,100,1,728,760,1488,11,6,201937
14,10,194,41,416,287,10,152,3,1103,1136,2239,7,6.5,201937
14,11,136,14,210,145,41,136,17,699,721,1420,4,6,201937
14,12,255,15,615,185,44,83,1,1198,1233,2431,9,5.5,201937
14,13,175,20,420,210,9,131,3,968,991,1959,6,6,201937
14,14,161,20,273,256,25,133,15,883,824,1707,7,6,201937
14,15,237,42,220,166,49,155,13,882,807,1689,10,5.6,201937
14,16,185,33,309,154,47,121,4,853,870,1723,5,6,201937
14,17,176,34,244,84,43,81,4,666,979,1645,7,5.25,201937
14,18,215,47,365,101,43,97,2,870,1234,2104,9,5.4,201937
14,19,222,35,275,220,19,118,10,899,1012,1911,8,5.25,201937
14,20,188,16,329,217,7,108,0,865,954,1819,10,5.666666667,201937
15,1,217,26,220,144,237,153,11,1008,1220,2228,7,5.333333333,201937
15,2,159,13,299,213,63,80,4,831,1031,1862,6,6,201937
15,3,282,28,314,282,251,166,19,1342,1512,2854,10,5.666666667,201937
15,4,189,32,247,307,28,164,9,976,1036,2012,4,6,201937
15,5,193,72,347,220,16,89,1,938,1299,2237,8,5.666666667,201937
15,6,122,4,314,479,14,144,5,1082,1232,2314,7,6.5,201937
15,7,148,10,315,270,52,99,4,898,967,1865,10,6,201937
15,8,90,16,179,232,13,57,6,593,618,1211,4,6,201937
15,9,229,19,168,97,129,162,1,805,1009,1814,9,5.75,201937
15,10,132,8,219,309,17,133,4,822,796,1618,6,6,201937
15,11,183,28,330,353,65,116,6,1081,1097,2178,8,6,201937
15,12,237,24,584,470,59,129,0,1503,1390,2893,8,6,201937
15,13,87,14,174,182,90,110,0,657,687,1344,8,6,201937
15,14,94,8,151,200,26,82,2,563,563,1126,4,6,201937
15,15,138,56,277,405,29,116,5,1026,1050,2076,6,6,201937
15,16,210,37,385,589,28,153,8,1410,1432,2842,8,6,201937
15,17,151,11,237,232,16,144,20,811,805,1616,8,6,201937
15,18,208,38,357,433,43,125,12,1216,1323,2539,7,5.666666667,201937
15,19,193,48,465,591,17,230,11,1555,1606,3161,10,6,201937
15,20,72,29,265,215,20,67,2,670,681,1351,6,6,201937
15,21,95,9,119,153,26,64,13,479,588,1067,6,5.5,201937
15,22,279,154,702,647,30,122,13,1947,1965,3912,14,6,201937
15,23,149,18,202,315,18,130,0,832,1146,1978,6,5.333333333,201937
15,24,164,18,243,274,31,78,6,814,802,1616,4,6,201937
15,25,139,13,222,274,31,88,11,778,926,1704,6,6,201937
15,26,150,13,163,214,106,59,7,712,806,1518,9,7,201937
15,27,184,18,312,444,26,194,38,1216,1242,2458,9,5.666666667,201937
15,28,198,63,538,284,52,123,5,1263,1294,2557,9,5.666666667,201937
15,29,212,35,458,518,6,177,13,1419,1577,2996,8,6,201937
15,30,239,31,466,500,45,118,3,1402,1534,2936,16,6,201937
15,31,115,183,212,272,18,70,0,870,965,1835,6,6,201937
15,32,132,18,239,330,60,70,2,851,1043,1894,9,6,201937
15,33,163,30,395,317,17,134,0,1056,1103,2159,7,6,201937
15,34,157,22,306,431,34,130,10,1090,865,1955,8,6,201937
15,35,246,10,283,420,3,239,0,1201,1355,2556,9,5.666666667,201937
15,36,202,16,278,309,87,136,5,1033,1415,2448,9,5.5,201937
15,37,229,30,367,393,83,169,14,1285,1384,2669,7,6,201937
15,38,208,52,486,328,54,97,8,1233,1096,2329,6,5.5,201937
15,39,180,19,255,253,41,81,6,835,943,1778,4,6,201937
15,40,326,23,356,428,75,282,0,1490,1649,3139,9,6,201937
15,41,245,24,619,617,50,188,27,1770,1718,3488,13,6,201937
16,1,125,15,230,93,17,46,0,526,607,1133,7,5.333333333,201937
16,2,135,54,141,128,9,92,0,559,509,1068,9,5.25,201937
16,3,159,25,102,189,12,66,0,553,553,1106,10,5.25,201937
16,4,188,32,205,117,40,123,0,705,868,1573,8,5.5,201937
16,5,193,24,212,169,34,154,6,792,970,1762,10,5.666666667,201937
16,6,169,38,226,156,30,82,2,703,686,1389,12,5.5,201937
16,7,183,32,193,191,39,105,1,744,700,1444,9,5.5,201937
16,8,293,38,644,464,13,115,1,1568,1593,3161,12,6,201937
16,9,188,27,282,252,6,134,1,890,1053,1943,9,6.5,201937
16,10,148,24,308,281,15,99,0,875,880,1755,6,6,201937
16,11,206,13,178,149,57,170,0,773,792,1565,10,5.4,201937
16,12,143,25,219,110,18,102,1,618,499,1117,10,5,201937
17,1,172,74,471,393,26,132,6,1274,1278,2552,9,8,201937
17,2,172,7,340,370,9,103,9,1010,1174,2184,8,5.666666667,201937
17,3,261,35,518,416,35,103,1,1369,1392,2761,8,5.5,201937
17,4,196,13,300,331,27,144,13,1024,1252,2276,10,5.666666667,201937
17,5,101,5,138,120,10,41,0,415,664,1079,5,5.5,201937
18,1,144,8,114,120,11,77,21,495,566,1061,7,5.25,201937
18,2,250,33,363,335,30,120,0,1131,1204,2335,9,7,201937
18,3,161,21,401,221,19,98,0,921,702,1623,8,5.75,201937
19,1,209,7,197,208,7,141,5,774,976,1750,9,5,201937
19,2,192,19,452,296,6,108,0,1073,1310,2383,9,5,201937
19,3,200,16,507,251,27,138,2,1141,1322,2463,7,5,201937
19,4,132,9,147,118,44,106,15,571,612,1183,5,5,201937
19,5,234,25,371,402,20,172,14,1238,1521,2759,8,5,201937
19,6,57,8,235,140,7,69,0,516,575,1091,5,5,201937
19,7,137,4,323,143,10,66,0,683,855,1538,10,4.5,201937
19,8,69,6,114,93,2,47,0,331,372,703,7,5,201937
19,9,85,11,115,93,20,53,0,377,493,870,9,4.25,201937
19,10,125,10,155,205,10,150,19,674,705,1379,6,6,201937
19,11,280,29,473,595,15,374,22,1788,2004,3792,13,5.333333333,201937
19,12,133,11,363,139,7,63,0,716,871,1587,13,4.333333333,201937
20,1,197,21,225,194,62,66,23,788,1002,1790,8,5.5,201937
20,2,199,27,225,103,32,32,10,628,353,981,6,5.333333333,201937
20,3,123,9,143,120,251,38,14,698,331,1029,6,5.333333333,201937
20,4,229,11,104,111,43,113,42,653,367,1020,6,5.333333333,201937
20,5,139,30,302,319,70,50,3,913,493,1406,11,5.25,201937
20,6,146,10,184,179,91,65,76,751,583,1334,8,5.25,201937
20,7,211,14,267,261,72,73,1,899,662,1561,8,5.75,201937
20,8,362,40,696,571,51,170,15,1905,2175,4080,14,7,201937
20,9,263,22,277,175,98,116,8,959,981,1940,8,5.666666667,201937
20,10,211,13,305,145,27,47,10,758,485,1243,9,5.25,201937
21,1,307,25,326,182,32,78,1,951,945,1896,9,5.4,201937
21,2,192,38,350,137,86,104,0,907,1118,2025,9,5.2,201937
21,3,253,8,244,213,58,187,8,971,909,1880,8,5.5,201937
21,4,214,12,218,61,141,62,5,713,562,1275,7,5.25,201937
21,5,246,19,497,230,14,75,11,1092,1209,2301,8,5.666666667,201937
21,6,250,17,338,281,63,147,28,1124,1649,2773,6,6,201937
21,7,303,16,193,263,43,242,5,1065,1142,2207,9,5.666666667,201937
21,8,214,15,199,101,54,103,17,703,1006,1709,9,5.2,201937
21,9,190,31,438,279,69,96,6,1109,1282,2391,9,5,201937
21,10,213,18,454,294,24,132,16,1151,1241,2392,7,5.5,201937
21,11,73,1,142,99,24,27,3,369,422,791,4,5,201937
21,12,363,32,715,454,149,219,39,1971,2195,4166,16,6,201937
21,13,242,12,359,202,30,178,3,1026,1021,2047,8,5.666666667,201937
21,14,277,13,251,163,92,192,9,997,883,1880,12,5.333333333,201937
21,15,302,11,356,266,56,182,18,1191,1129,2320,7,5.5,201937
22,1,161,43,179,261,19,61,1,725,899,1624,11,5.2,201937
22,2,157,28,285,197,74,68,2,811,946,1757,7,5.5,201937
22,3,292,70,717,553,23,191,0,1846,2031,3877,9,6,201937
22,4,242,38,594,403,14,117,3,1411,1539,2950,9,6.5,201937
22,5,186,25,368,235,65,112,8,999,1149,2148,10,5.5,201937
23,1,215,10,1188,303,45,97,3,1861,2005,3866,14,5.6,201937
23,2,224,26,519,306,46,49,1,1171,1152,2323,9,5.5,201937
23,3,288,21,1217,480,72,135,0,2213,2136,4349,19,0,201937
23,4,155,8,627,255,22,85,6,1158,1323,2481,6,5.5,201937
24,1,126,52,127,124,10,52,3,494,475,969,10,5.2,201937
24,2,115,21,246,141,14,70,2,609,760,1369,6,5.5,201937
24,3,209,66,169,204,49,59,0,756,975,1731,9,5.25,201937
24,4,138,17,158,183,36,106,21,659,863,1522,5,5.5,201937
24,5,257,45,678,472,16,156,1,1625,1527,3152,10,6.666666667,201937
24,6,168,103,459,302,24,98,0,1154,1176,2330,6,6,201937
24,7,152,17,214,264,78,47,2,774,980,1754,9,5.25,201937
25,1,114,15,267,245,22,80,5,748,919,1667,13,5.75,201937
25,2,195,37,338,382,31,148,0,1131,955,2086,7,6,201937
25,3,194,14,351,298,46,190,11,1104,973,2077,8,5.6,201937
25,4,89,21,160,185,44,40,1,540,599,1139,8,5.333333333,201937
25,5,154,21,236,364,8,86,0,869,906,1775,8,5.666666667,201937
25,6,155,11,304,328,39,205,11,1053,941,1994,8,5.75,201937
25,7,213,24,386,437,6,97,0,1163,1228,2391,6,6,201937
26,1,210,10,337,317,4,194,0,1072,1075,2147,9,5.5,201937
26,2,247,8,379,432,9,154,9,1238,1383,2621,12,5.4,201937
26,3,314,31,399,486,10,237,3,1480,1676,3156,13,6.5,201937
26,4,113,87,225,185,29,68,2,709,554,1263,9,5.2,201937
26,5,153,22,230,253,12,139,0,809,710,1519,15,6,201937
26,6,211,10,264,306,32,182,0,1005,1009,2014,10,5.333333333,201937
26,7,143,12,191,145,24,58,0,573,789,1362,10,5.5,201937
27,1,100,15,175,164,99,38,1,592,653,1245,8,5.5,201937
27,2,226,13,248,430,16,89,0,1022,838,1860,8,5.666666667,201937
27,3,176,5,187,407,17,82,7,881,647,1528,7,5.666666667,201937
27,4,169,23,381,640,33,103,6,1355,1221,2576,8,6.5,201937
27,5,105,4,82,178,12,39,1,421,321,742,6,5.333333333,201937
27,6,147,39,254,472,6,126,3,1047,1051,2098,8,5.5,201937
28,1,214,18,529,355,15,123,0,1254,1416,2670,13,6,201937
28,2,203,25,400,262,24,112,30,1056,1302,2358,15,6,201937
28,3,125,12,208,143,12,96,0,596,824,1420,7,5.333333333,201937
28,4,261,29,457,260,38,160,31,1236,1298,2534,18,6.666666667,201937
28,5,119,18,208,315,7,135,18,820,892,1712,10,4.5,201937
28,6,158,18,196,217,33,82,6,710,932,1642,13,5.166666667,201937
28,7,172,19,397,344,43,143,16,1134,1242,2376,13,6,201937
28,8,100,13,219,274,21,130,4,761,1053,1814,13,7,201937
28,9,162,14,297,191,11,88,7,770,924,1694,11,5.75,201937
29,1,236,21,280,378,39,127,2,1083,1188,2271,7,5.5,201937
29,2,232,14,222,459,29,161,40,1157,1252,2409,10,6,201937
29,3,125,23,157,326,8,118,1,758,761,1519,6,5.666666667,201937
30,1,90,18,139,93,47,25,4,416,698,1114,7,5.333333333,201937
30,2,212,8,195,73,61,29,28,606,627,1233,9,5.25,201937
30,3,148,3,167,150,59,96,27,650,882,1532,6,5.666666667,201937
30,4,103,14,273,134,28,47,0,599,661,1260,8,6,201937
30,5,180,10,215,260,15,121,14,815,790,1605,7,5.5,201937
30,6,118,19,294,161,22,98,5,717,590,1307,9,5.333333333,201937
30,7,163,24,186,174,120,86,21,774,694,1468,11,5.25,201937
30,8,233,20,395,349,63,186,18,1264,995,2259,11,5.4,201937
30,9,235,13,185,147,89,109,12,790,969,1759,8,5.5,201937
30,10,191,23,299,244,24,118,15,914,958,1872,6,6.5,201937
30,11,170,11,343,284,13,70,0,891,983,1874,5,5.5,201937
30,12,203,29,529,350,31,136,2,1280,1458,2738,10,6.25,201937
30,13,258,23,198,205,72,108,26,890,911,1801,10,5.4,201937
30,14,184,18,303,121,140,90,4,860,674,1534,8,5.5,201937
30,15,239,14,266,266,84,202,26,1097,1106,2203,11,5.666666667,201937
30,16,203,15,297,288,46,140,28,1017,1049,2066,10,5.333333333,201937
30,17,197,18,327,309,46,109,17,1023,822,1845,8,5.5,201937
30,18,256,21,161,239,22,131,31,861,940,1801,8,5.25,201937
30,19,170,8,322,237,23,97,1,858,717,1575,13,5.6,201937
30,20,194,24,255,218,154,65,2,912,1010,1922,10,5.4,201937
31,1,169,14,364,29,304,69,0,949,857,1806,8,5.5,201937
31,2,63,10,124,4,160,54,0,415,665,1080,6,5.333333333,201937
31,3,426,115,1154,465,223,173,6,2562,2620,5182,20,6.333333333,201937
31,4,84,27,315,225,76,100,20,847,900,1747,4,6,201937
31,5,118,11,180,150,60,77,1,597,833,1430,7,5.333333333,201937
32,1,195,47,185,184,57,91,11,770,781,1551,12,5.2,201937
32,2,152,29,153,80,79,91,11,595,697,1292,13,5.142857143,201937
32,3,200,35,207,266,16,151,0,875,845,1720,13,5.6,201937
32,4,213,43,214,283,34,141,29,957,1047,2004,13,5.4,201937
1,1,182,40,286,206,29,83,2,828,821,1649,13,5,201938
1,2,219,64,501,352,47,132,2,1317,1466,2783,10,5.333333333,201938
1,3,171,42,482,302,29,179,1,1206,1330,2536,9,5,201938
2,1,152,18,320,247,31,134,7,909,1110,2019,11,5,201938
2,2,182,14,288,265,5,162,0,916,1050,1966,7,5,201938
2,3,216,11,404,338,13,193,10,1185,1216,2401,12,5.333333333,201938
2,4,139,14,524,205,43,62,6,993,930,1923,9,5,201938
2,5,223,20,615,260,120,136,2,1376,1405,2781,11,5,201938
2,6,227,15,518,275,16,90,0,1141,1083,2224,8,5.5,201938
2,7,234,13,430,265,25,115,9,1091,1166,2257,12,5,201938
2,8,197,28,524,333,22,123,6,1233,1232,2465,7,7,201938
3,1,133,13,225,228,25,93,3,720,776,1496,13,5,201938
3,2,114,17,478,238,26,64,0,937,911,1848,9,5,201938
4,1,133,15,187,289,76,98,21,819,1040,1859,11,5,201938
4,2,122,17,345,306,67,84,28,969,894,1863,14,5,201938
5,1,624,16,366,278,25,181,6,1496,1014,2510,9,5,201938
5,2,324,22,213,241,26,56,0,882,655,1537,10,5,201938
5,3,673,40,258,329,38,127,21,1486,923,2409,11,5,201938
5,4,628,28,531,410,16,140,12,1765,1197,2962,11,5,201938
5,5,438,18,312,362,12,65,9,1216,992,2208,10,5,201938
5,6,325,8,294,230,12,64,24,957,743,1700,10,5,201938
5,7,400,13,249,227,5,72,9,975,822,1797,10,5,201938
6,1,117,20,245,191,9,107,12,701,729,1430,13,5.2,201938
6,2,110,7,278,202,24,124,13,758,667,1425,9,5,201938
7,1,310,11,131,197,12,28,0,689,657,1346,9,5,201938
7,2,144,15,219,1034,19,16,0,1447,530,1977,9,5,201938
7,3,183,6,199,106,185,47,1,727,742,1469,7,5,201938
7,4,199,8,147,182,4,43,4,587,589,1176,11,5,201938
7,5,265,14,233,344,51,98,1,1006,864,1870,11,5,201938
7,6,216,14,348,250,49,82,9,968,1078,2046,9,5.333333333,201938
7,7,197,11,253,210,66,95,4,836,1064,1900,8,5,201938
7,8,199,12,187,443,63,94,0,998,765,1763,12,5,201938
7,9,155,10,257,352,19,118,2,913,1188,2101,9,5,201938
7,10,126,8,250,222,18,31,0,655,548,1203,9,5,201938
7,11,101,3,77,75,14,40,1,311,201,512,6,5,201938
7,12,185,3,310,343,10,47,0,898,881,1779,9,5,201938
7,13,87,26,158,286,1,41,0,599,482,1081,9,5,201938
8,1,115,9,338,153,23,55,1,694,653,1347,4,5,201938
8,2,198,36,532,276,17,70,0,1129,1196,2325,17,5,201938
8,3,198,33,359,310,40,109,15,1064,990,2054,4,5,201938
8,4,159,21,353,232,30,117,36,948,980,1928,11,5,201938
8,5,119,58,253,178,14,32,0,654,744,1398,10,5,201938
8,6,201,47,358,396,46,159,9,1216,1203,2419,7,5.5,201938
8,7,175,76,185,174,4,151,0,765,739,1504,8,5,201938
8,8,141,19,277,318,10,120,1,886,975,1861,11,6,201938
8,9,154,30,137,80,23,145,5,574,566,1140,10,5,201938
9,1,76,7,119,117,42,72,2,435,497,932,5,5,201938
9,2,484,41,519,627,94,144,18,1927,2155,4082,12,5,201938
9,3,168,18,321,305,114,103,16,1045,1034,2079,7,5,201938
9,4,126,17,346,342,102,95,4,1032,1259,2291,11,5,201938
9,5,88,33,242,242,59,76,0,740,729,1469,7,5,201938
9,6,78,74,157,129,93,69,8,608,731,1339,7,5,201938
9,7,77,5,393,196,0,21,0,692,742,1434,9,5,201938
9,8,73,9,256,222,45,90,10,705,814,1519,5,5,201938
9,9,93,16,267,229,43,52,1,701,710,1411,5,5,201938
9,10,95,16,308,250,38,85,10,802,811,1613,6,5,201938
9,11,138,20,392,286,130,118,6,1090,1045,2135,7,5,201938
9,12,222,17,412,476,40,105,23,1295,1374,2669,11,5,201938
9,13,94,19,316,312,69,78,9,897,825,1722,4,5,201938
9,14,113,25,222,268,65,120,8,821,703,1524,5,5,201938
9,15,310,21,835,631,32,197,25,2051,1924,3975,10,5.5,201938
9,16,158,95,364,545,46,110,8,1326,1536,2862,15,5,201938
9,17,114,12,277,226,36,66,5,736,730,1466,6,5,201938
9,18,136,19,310,347,83,112,35,1042,1097,2139,12,5,201938
9,19,163,70,300,319,119,96,27,1094,1187,2281,5,5,201938
9,20,38,25,65,79,24,13,0,244,293,537,5,5,201938
9,21,90,14,132,138,92,35,0,501,620,1121,3,5,201938
9,22,119,16,252,201,93,76,12,769,805,1574,5,5,201938
9,23,104,29,358,276,80,54,0,901,1031,1932,6,5,201938
9,24,249,60,508,553,172,195,2,1739,1923,3662,14,5,201938
10,1,189,18,191,225,21,173,10,827,786,1613,12,4.5,201938
10,2,156,21,279,261,28,137,6,888,884,1772,10,5,201938
10,3,165,23,250,195,21,156,60,870,843,1713,11,5,201938
10,4,214,40,323,429,19,163,2,1190,1289,2479,12,5.5,201938
11,1,121,81,189,167,21,70,2,651,645,1296,6,5,201938
11,2,136,36,226,175,37,84,7,701,721,1422,7,5,201938
11,3,125,35,201,266,19,101,3,750,721,1471,3,5,201938
11,4,165,45,189,173,34,87,1,694,586,1280,8,5.333333333,201938
11,5,184,67,303,358,8,124,3,1047,1113,2160,7,5,201938
11,6,95,26,160,163,23,83,1,551,602,1153,8,5,201938
11,7,181,55,444,463,23,71,1,1238,932,2170,9,5,201938
11,8,153,39,250,340,65,103,2,952,1022,1974,9,5,201938
11,9,179,49,282,365,13,149,11,1048,1039,2087,10,5,201938
11,10,162,47,273,174,40,84,18,798,776,1574,10,5,201938
11,11,154,40,238,300,12,114,0,858,867,1725,5,5,201938
11,12,166,53,314,398,7,86,4,1028,1045,2073,7,5,201938
11,13,165,30,256,152,27,63,5,698,722,1420,8,5,201938
11,14,138,29,190,164,23,103,5,652,782,1434,8,5,201938
11,15,116,63,223,198,8,52,1,661,699,1360,9,5,201938
12,1,101,23,179,119,52,46,1,521,488,1009,10,5,201938
12,2,145,23,227,333,8,103,7,846,1023,1869,10,5,201938
12,3,162,25,257,414,10,65,0,933,1090,2023,11,5,201938
12,4,186,19,289,483,21,46,0,1044,944,1988,9,5,201938
12,5,234,37,293,281,1,53,8,907,962,1869,10,5,201938
12,6,139,15,231,323,57,31,5,801,833,1634,10,5,201938
12,7,189,27,222,331,12,87,49,917,868,1785,6,5,201938
12,8,224,13,221,336,4,56,0,854,965,1819,9,5,201938
12,9,174,26,417,362,34,52,1,1066,1185,2251,9,5,201938
13,1,229,18,126,135,42,38,13,601,844,1445,9,5,201938
13,2,138,22,89,158,123,61,15,606,866,1472,6,5,201938
13,3,177,29,196,230,90,75,0,797,1052,1849,12,5,201938
13,4,170,19,271,242,53,70,20,845,958,1803,9,5,201938
13,5,180,13,333,244,73,157,10,1010,1490,2500,9,5,201938
13,6,264,51,575,472,72,144,5,1583,1677,3260,11,5,201938
13,7,156,16,272,303,32,49,0,828,868,1696,8,5,201938
14,1,178,9,123,109,13,193,2,627,597,1224,6,5,201938
14,2,132,22,188,91,59,101,2,595,592,1187,5,5,201938
14,3,243,18,295,79,19,221,1,876,857,1733,8,5,201938
14,4,195,15,227,259,26,99,5,826,880,1706,10,5,201938
14,5,162,28,441,189,53,99,0,972,1120,2092,9,5,201938
14,6,185,21,474,239,10,73,0,1002,989,1991,11,5,201938
14,7,113,11,205,133,0,36,0,498,543,1041,6,5,201938
14,8,382,29,671,502,25,219,3,1831,1976,3807,11,5.25,201938
14,9,109,17,178,196,22,68,0,590,700,1290,11,5,201938
14,10,162,40,403,198,8,118,0,929,958,1887,7,5,201938
14,11,155,22,240,190,52,136,16,811,630,1441,4,5,201938
14,12,242,22,560,173,28,83,0,1108,1134,2242,9,5,201938
14,13,167,18,365,174,8,95,6,833,845,1678,6,5,201938
14,14,146,12,269,209,22,137,7,802,859,1661,7,5,201938
14,15,216,20,252,160,52,125,6,831,946,1777,10,5,201938
14,16,148,21,291,167,46,95,9,777,786,1563,5,5,201938
14,17,135,18,194,53,45,70,6,521,893,1414,7,5,201938
14,18,181,33,338,117,56,98,7,830,1006,1836,9,5,201938
14,19,156,30,237,146,48,90,7,714,890,1604,8,5,201938
14,20,176,8,295,152,6,107,0,744,951,1695,10,5,201938
15,1,113,12,132,57,175,103,3,595,1028,1623,7,5,201938
15,2,99,12,229,181,94,70,5,690,813,1503,6,5,201938
15,3,190,20,193,197,242,124,15,981,1243,2224,10,5,201938
15,4,171,13,258,249,54,149,5,899,893,1792,4,5,201938
15,5,169,54,281,189,30,72,0,795,873,1668,8,5,201938
15,6,111,3,237,371,23,109,7,861,976,1837,7,5,201938
15,7,100,10,270,229,42,57,1,709,757,1466,10,5,201938
15,8,68,17,159,194,7,60,2,507,575,1082,4,5,201938
15,9,193,14,105,81,114,126,3,636,845,1481,9,5,201938
15,10,120,5,162,280,15,111,1,694,713,1407,6,5,201938
15,11,134,37,230,318,51,81,4,855,965,1820,8,5,201938
15,12,197,13,496,337,47,81,0,1171,1278,2449,8,5,201938
15,13,70,21,132,151,96,95,2,567,560,1127,8,5,201938
15,14,57,9,147,201,30,66,2,512,525,1037,4,5,201938
15,15,128,108,271,298,58,47,4,914,896,1810,6,5,201938
15,16,169,24,298,454,24,101,9,1079,1271,2350,8,5,201938
15,17,135,13,210,207,22,123,12,722,753,1475,8,5,201938
15,18,194,29,300,341,30,120,9,1023,1227,2250,7,5,201938
15,19,166,26,401,512,21,165,6,1297,1419,2716,10,5,201938
15,20,77,27,199,190,23,52,3,571,645,1216,6,5,201938
15,21,94,10,124,127,32,48,21,456,686,1142,6,5,201938
15,22,226,139,537,552,24,135,14,1627,1607,3234,14,5,201938
15,23,153,19,187,261,18,130,1,769,1029,1798,6,5,201938
15,24,94,22,188,217,17,55,2,595,632,1227,4,5,201938
15,25,140,17,188,243,34,87,12,721,806,1527,6,5,201938
15,26,111,9,170,192,123,39,2,646,653,1299,9,6,201938
15,27,160,18,306,370,19,146,23,1042,1116,2158,9,5,201938
15,28,194,38,463,301,52,113,10,1171,1125,2296,9,5,201938
15,29,173,23,417,413,7,152,18,1203,1262,2465,8,5,201938
15,30,181,26,341,329,37,97,7,1018,1299,2317,16,5,201938
15,31,93,133,169,234,13,54,0,696,741,1437,6,5,201938
15,32,156,9,246,269,47,79,2,808,818,1626,9,5,201938
15,33,147,13,290,300,28,83,0,861,925,1786,7,5,201938
15,34,145,21,224,347,25,99,4,865,832,1697,8,5,201938
15,35,273,15,242,385,7,238,0,1160,1249,2409,9,5,201938
15,36,222,25,247,282,82,128,0,986,1277,2263,9,5,201938
15,37,181,18,293,361,72,119,4,1048,1146,2194,7,5,201938
15,38,173,47,337,306,53,89,4,1009,1138,2147,6,5,201938
15,39,124,14,224,184,28,66,0,640,793,1433,4,5,201938
15,40,239,43,269,333,85,223,4,1196,1345,2541,9,5,201938
15,41,198,26,444,426,55,113,12,1274,1510,2784,13,5,201938
16,1,131,10,229,138,10,24,0,542,619,1161,7,5,201938
16,2,98,33,105,83,12,67,0,398,416,814,9,5,201938
16,3,153,24,133,200,26,75,0,611,555,1166,10,5,201938
16,4,138,17,201,92,36,91,0,575,776,1351,8,5,201938
16,5,153,38,197,149,25,107,14,683,682,1365,10,5,201938
16,6,151,32,205,127,65,55,0,635,800,1435,12,5,201938
16,7,184,46,200,155,39,91,0,715,775,1490,9,5,201938
16,8,249,31,552,421,11,94,3,1361,1334,2695,12,5,201938
16,9,182,25,246,231,8,87,1,780,793,1573,9,5,201938
16,10,114,18,275,230,24,73,0,734,784,1518,7,5.5,201938
16,11,147,41,185,125,65,120,1,684,822,1506,10,5,201938
16,12,169,25,198,140,18,84,2,636,804,1440,10,5,201938
17,1,135,51,376,322,25,78,5,992,1012,2004,9,6,201938
17,2,129,10,270,326,2,82,8,827,853,1680,8,5,201938
17,3,164,21,363,292,12,91,0,943,1052,1995,8,5,201938
17,4,125,14,266,281,28,91,2,807,915,1722,10,5,201938
17,5,89,5,143,112,9,66,0,424,561,985,5,5,201938
18,1,174,11,131,123,35,78,34,586,667,1253,7,5,201938
18,2,203,21,339,336,31,106,0,1036,964,2000,9,5.333333333,201938
18,3,130,16,288,173,5,75,0,687,759,1446,8,5,201938
19,1,249,11,300,250,10,140,5,965,1057,2022,9,5,201938
19,2,242,24,589,350,15,153,0,1373,1355,2728,9,5,201938
19,3,250,23,678,335,54,154,1,1495,1355,2850,7,5,201938
19,4,143,19,216,119,57,138,15,707,624,1331,5,5,201938
19,5,328,30,552,472,27,189,19,1617,1642,3259,8,5,201938
19,6,89,12,232,212,4,90,0,639,700,1339,5,5,201938
19,7,161,10,511,192,6,74,0,954,972,1926,10,5,201938
19,8,56,7,127,111,1,27,0,329,409,738,7,5,201938
19,9,114,16,228,159,15,89,0,621,764,1385,9,5,201938
19,10,150,14,282,253,13,169,8,889,709,1598,7,7,201938
19,11,357,33,544,712,27,390,10,2073,1918,3991,13,5,201938
19,12,169,8,461,147,5,59,2,851,1167,2018,13,5,201938
20,1,183,14,200,168,37,62,15,679,673,1352,8,5,201938
20,2,148,15,202,111,26,25,9,536,618,1154,6,5,201938
20,3,108,14,106,68,324,39,14,673,481,1154,6,5,201938
20,4,170,12,163,117,53,109,28,652,422,1074,6,5,201938
20,5,129,40,268,275,64,51,1,828,735,1563,11,5,201938
20,6,115,8,269,95,160,96,43,786,603,1389,8,5,201938
20,7,151,7,248,164,31,63,0,664,744,1408,8,5,201938
20,8,316,25,576,515,47,134,14,1627,1701,3328,14,5.5,201938
20,9,253,22,204,171,78,63,10,801,728,1529,8,5,201938
20,10,173,13,251,104,39,21,4,605,513,1118,9,5,201938
21,1,220,18,266,204,26,71,0,805,968,1773,9,5,201938
21,2,135,22,221,111,69,48,1,607,994,1601,9,4.8,201938
21,3,224,8,235,201,68,151,16,903,840,1743,8,5,201938
21,4,215,16,233,68,104,100,3,739,609,1348,7,5,201938
21,5,200,19,340,191,23,67,9,849,940,1789,8,5,201938
21,6,208,16,283,246,54,125,25,957,1145,2102,6,5,201938
21,7,299,22,211,216,60,156,3,967,951,1918,9,5,201938
21,8,160,15,254,99,62,90,12,692,861,1553,9,5,201938
21,9,163,25,350,312,35,104,7,996,1244,2240,9,5,201938
21,10,199,31,434,288,16,100,10,1078,1063,2141,7,5,201938
21,11,81,5,145,88,30,36,5,390,454,844,4,5,201938
21,12,286,38,692,434,151,202,27,1830,2095,3925,16,5.5,201938
21,13,193,19,282,205,28,132,3,862,924,1786,8,5,201938
21,14,241,15,211,179,80,197,14,937,736,1673,12,5,201938
21,15,234,12,389,270,29,142,20,1096,1038,2134,7,5,201938
22,1,146,59,166,316,25,63,0,775,685,1460,11,5,201938
22,2,186,30,249,160,106,60,9,800,748,1548,7,5,201938
22,3,231,53,665,505,15,151,1,1621,1531,3152,9,5,201938
22,4,167,41,526,368,26,97,4,1229,1293,2522,9,5.5,201938
22,5,114,22,381,232,54,83,8,894,870,1764,10,5,201938
23,1,196,5,1051,264,58,81,7,1662,1628,3290,14,5,201938
23,2,161,30,425,283,35,43,0,977,859,1836,8,5,201938
23,3,200,15,879,365,33,88,2,1582,1882,3464,19,5,201938
23,4,124,13,497,244,21,60,8,967,1110,2077,6,5,201938
24,1,112,46,167,186,13,52,2,578,407,985,10,5,201938
24,2,122,22,196,143,18,77,0,578,607,1185,6,5,201938
24,3,136,70,147,240,89,35,0,717,816,1533,9,5,201938
24,4,149,22,167,174,33,77,18,640,730,1370,5,5,201938
24,5,199,36,582,438,14,126,0,1395,1396,2791,9,5,201938
24,6,134,53,339,246,45,98,0,915,1073,1988,7,6,201938
24,7,168,15,203,200,69,36,0,691,1134,1825,9,5,201938
25,1,111,9,243,209,26,58,5,661,740,1401,13,5,201938
25,2,199,49,311,370,20,89,0,1038,1127,2165,7,5,201938
25,3,185,18,266,314,20,119,9,931,975,1906,8,5,201938
25,4,103,28,212,190,45,49,1,628,947,1575,8,5,201938
25,5,151,24,321,368,22,112,0,998,816,1814,8,5,201938
25,6,151,10,290,290,41,188,8,978,893,1871,8,5,201938
25,7,186,19,397,423,5,70,0,1100,1171,2271,6,5,201938
26,1,141,13,274,218,5,159,0,810,904,1714,9,5,201938
26,2,184,13,294,333,5,108,4,941,1111,2052,12,5,201938
26,3,234,28,304,447,8,221,10,1252,1159,2411,13,5,201938
26,4,105,60,211,182,24,78,3,663,615,1278,9,5,201938
26,5,96,22,136,176,29,104,0,563,743,1306,14,5,201938
26,6,192,12,232,271,15,151,0,873,862,1735,10,5,201938
26,7,108,8,149,144,29,41,0,479,597,1076,10,5,201938
27,1,122,10,215,186,130,43,0,706,600,1306,8,5,201938
27,2,146,12,240,434,36,79,1,948,743,1691,8,5,201938
27,3,146,5,127,331,9,56,3,677,777,1454,7,5,201938
27,4,155,19,282,507,17,77,8,1065,1058,2123,8,5.5,201938
27,5,68,5,98,175,16,31,1,394,426,820,6,5,201938
27,6,127,12,171,351,5,88,1,755,796,1551,8,5,201938
28,1,146,22,432,295,9,96,0,1000,1098,2098,13,5,201938
28,2,154,16,413,253,32,103,31,1002,1196,2198,15,5,201938
28,3,116,13,223,142,8,68,0,570,467,1037,7,5,201938
28,4,252,28,460,288,43,132,25,1228,1329,2557,18,5.666666667,201938
28,5,140,12,256,371,23,165,19,986,869,1855,10,5.25,201938
28,6,138,21,181,183,51,55,1,630,578,1208,13,5,201938
28,7,169,32,389,267,50,134,16,1057,1183,2240,13,5,201938
28,8,71,14,183,187,18,92,5,570,848,1418,12,5,201938
28,9,144,16,290,197,16,83,8,754,764,1518,11,5,201938
29,1,154,21,306,305,22,122,1,931,1077,2008,7,5,201938
29,2,140,11,179,409,18,134,53,944,1152,2096,11,4.666666667,201938
29,3,108,30,147,313,11,106,0,715,604,1319,6,5,201938
30,1,90,28,104,67,62,22,6,379,581,960,7,5,201938
30,2,128,10,202,69,51,23,35,518,660,1178,9,4.75,201938
30,3,155,8,202,111,53,82,57,668,636,1304,6,4.666666667,201938
30,4,84,5,242,122,35,54,0,542,513,1055,8,5,201938
30,5,148,15,256,180,16,103,6,724,674,1398,7,5,201938
30,6,132,5,171,146,40,75,3,572,541,1113,9,5,201938
30,7,168,13,213,140,85,61,16,696,931,1627,11,5,201938
30,8,161,27,440,187,62,89,10,976,1258,2234,11,5,201938
30,9,164,13,211,141,93,131,22,775,762,1537,8,5,201938
30,10,120,12,244,202,21,96,18,713,912,1625,7,5.5,201938
30,11,93,8,325,229,4,58,0,717,729,1446,5,5,201938
30,12,164,11,462,281,20,109,0,1047,1108,2155,10,5,201938
30,13,206,20,176,203,81,136,29,851,1160,2011,10,5,201938
30,14,108,10,187,110,110,60,0,585,732,1317,8,5,201938
30,15,198,13,217,209,97,143,27,904,1028,1932,11,5,201938
30,16,138,17,251,251,37,114,44,852,908,1760,10,5,201938
30,17,162,28,249,209,26,75,14,763,1078,1841,8,5,201938
30,18,197,28,144,112,26,102,25,634,839,1473,8,5,201938
30,19,160,14,213,155,37,62,0,641,775,1416,13,5,201938
30,20,131,8,161,344,86,81,0,811,850,1661,10,5,201938
31,1,151,13,270,50,188,46,0,718,916,1634,8,5,201938
31,2,69,10,112,9,162,43,0,405,358,763,6,5,201938
31,3,313,108,928,395,179,125,11,2059,2070,4129,20,5,201938
31,4,84,26,283,179,35,85,17,709,787,1496,4,5,201938
31,5,160,14,108,126,42,74,1,525,483,1008,7,5,201938
32,1,133,33,157,144,60,100,16,643,784,1427,12,5,201938
32,2,163,36,167,93,77,121,20,677,978,1655,13,5,201938
32,3,153,35,185,263,9,133,1,779,684,1463,13,5,201938
32,4,158,65,207,241,22,122,23,838,750,1588,13,5.2,201938
1,1,157,33,298,175,40,85,2,790,902,1692,13,4.5,201939
1,2,228,39,517,398,41,158,0,1381,1470,2851,10,5.666666667,201939
1,3,178,51,477,332,27,152,1,1218,1382,2600,9,5.333333333,201939
2,1,164,22,311,252,19,148,15,931,1068,1999,11,5,201939
2,2,168,2,279,257,6,141,0,853,1100,1953,7,5,201939
2,3,196,9,363,340,11,152,25,1096,1296,2392,11,4.666666667,201939
2,4,184,12,538,190,49,66,1,1040,1387,2427,9,5.5,201939
2,5,249,20,622,266,131,169,0,1457,1819,3276,11,5,201939
2,6,187,25,501,229,8,94,0,1044,1348,2392,7,5,201939
2,7,232,14,478,286,25,135,9,1179,1299,2478,12,4.75,201939
2,8,195,8,441,280,20,84,5,1033,1552,2585,7,6,201939
3,1,92,10,200,202,11,78,2,595,713,1308,13,4.333333333,201939
3,2,77,6,276,110,21,30,0,520,786,1306,9,3.333333333,201939
4,1,157,16,197,281,55,71,9,786,907,1693,11,4.5,201939
4,2,131,15,325,310,45,79,21,926,986,1912,14,4.4,201939
5,1,523,11,302,260,20,116,8,1240,1350,2590,9,4.666666667,201939
5,2,314,22,220,272,28,53,1,910,930,1840,10,5,201939
5,3,541,48,258,251,51,95,9,1253,1298,2551,11,4.333333333,201939
5,4,499,21,519,445,9,127,11,1631,1922,3553,11,5,201939
5,5,333,11,325,396,21,81,3,1170,1422,2592,10,5,201939
5,6,277,14,260,234,20,48,39,892,879,1771,10,4.5,201939
5,7,318,12,226,262,4,60,3,885,818,1703,10,4.5,201939
6,1,111,12,212,155,8,78,21,597,772,1369,13,5.2,201939
6,2,112,5,182,157,22,58,6,542,744,1286,9,4.333333333,201939
7,1,284,5,212,143,51,30,1,726,556,1282,9,4.25,201939
7,2,116,9,86,880,18,19,0,1128,456,1584,9,4.25,201939
7,3,235,6,175,94,191,35,0,736,532,1268,7,4.333333333,201939
7,4,152,8,117,139,5,28,13,462,910,1372,11,4.4,201939
7,5,201,14,190,342,45,73,0,865,1248,2113,11,4.666666667,201939
7,6,211,9,363,251,47,100,5,986,854,1840,9,5,201939
7,7,205,10,241,239,66,62,2,825,869,1694,8,4.5,201939
7,8,157,4,112,236,78,57,2,646,752,1398,12,4.25,201939
7,9,165,9,242,364,27,101,0,908,985,1893,10,5,201939
7,10,128,6,218,318,27,38,0,735,687,1422,9,4.5,201939
7,11,108,1,58,58,8,33,11,277,433,710,6,4.333333333,201939
7,12,186,14,250,344,6,51,0,851,941,1792,9,4.5,201939
7,13,97,17,123,246,1,19,0,503,578,1081,9,4.25,201939
8,1,147,7,378,144,29,44,6,755,953,1708,4,5,201939
8,2,239,67,539,267,12,77,0,1201,1403,2604,17,4.75,201939
8,3,168,37,358,244,32,81,18,938,1270,2208,4,5,201939
8,4,134,19,364,235,23,112,39,926,1137,2063,11,5,201939
8,5,181,71,255,221,25,47,0,800,802,1602,10,4.25,201939
8,6,196,46,343,337,32,141,6,1101,1361,2462,7,5.5,201939
8,7,136,38,158,180,1,95,0,608,797,1405,8,4.25,201939
8,8,188,16,267,302,11,120,2,906,1006,1912,10,6,201939
8,9,125,20,101,104,19,78,3,450,467,917,10,4,201939
9,1,89,8,119,121,43,56,9,445,568,1013,5,5,201939
9,2,452,53,579,617,104,145,14,1964,2414,4378,12,5,201939
9,3,140,13,343,340,99,118,18,1071,1209,2280,7,5,201939
9,4,148,26,373,373,109,65,3,1097,1291,2388,11,5,201939
9,5,109,31,228,204,67,68,0,707,902,1609,7,5,201939
9,6,79,33,158,122,91,58,14,555,870,1425,7,5,201939
9,7,73,9,340,198,1,29,1,651,778,1429,9,5,201939
9,8,80,11,258,232,48,71,12,712,845,1557,5,5,201939
9,9,87,2,196,214,61,56,0,616,871,1487,5,5,201939
9,10,105,20,306,235,32,76,15,789,924,1713,6,5,201939
9,11,143,14,373,329,131,102,7,1099,1333,2432,7,5,201939
9,12,188,13,383,463,43,84,33,1207,1415,2622,11,5,201939
9,13,123,14,271,207,84,57,10,766,1066,1832,4,5,201939
9,14,121,12,237,233,51,101,14,769,960,1729,5,5,201939
9,15,256,21,793,570,37,173,32,1882,2232,4114,10,5.5,201939
9,16,213,126,377,532,40,93,4,1385,1880,3265,15,5,201939
9,17,97,9,246,224,34,65,1,676,847,1523,6,5,201939
9,18,143,20,294,339,84,136,37,1053,1195,2248,12,5,201939
9,19,134,63,257,279,87,86,17,923,1349,2272,5,5,201939
9,20,37,17,85,80,29,14,0,262,344,606,5,5,201939
9,21,95,9,134,150,63,30,3,484,695,1179,3,5,201939
9,22,132,11,213,236,66,77,8,743,923,1666,5,5,201939
9,23,96,31,421,323,48,46,0,965,1209,2174,6,5,201939
9,24,226,54,484,545,199,135,3,1646,2138,3784,14,5,201939
10,1,161,27,143,188,12,123,11,665,810,1475,12,3.833333333,201939
10,2,184,22,302,250,23,119,10,910,1113,2023,10,4.25,201939
10,3,114,22,143,172,14,116,32,613,868,1481,11,4.4,201939
10,4,252,17,363,399,15,145,1,1192,1420,2612,12,6,201939
11,1,125,71,150,182,18,44,0,590,843,1433,6,4.666666667,201939
11,2,147,16,217,172,37,88,4,681,803,1484,7,5,201939
11,3,116,29,174,225,22,91,5,662,822,1484,3,5,201939
11,4,151,39,158,164,32,80,1,625,837,1462,8,5,201939
11,5,228,61,341,390,20,137,6,1183,1252,2435,7,5.5,201939
11,6,85,26,179,189,32,80,3,594,635,1229,8,5,201939
11,7,164,39,235,306,13,82,1,840,1081,1921,9,4.5,201939
11,8,150,41,224,365,77,79,1,937,1005,1942,9,4.5,201939
11,9,166,45,270,383,6,148,10,1028,1149,2177,10,4.666666667,201939
11,10,141,22,183,153,32,80,12,623,887,1510,10,4.6,201939
11,11,143,32,275,273,7,113,0,843,990,1833,5,5,201939
11,12,150,50,363,376,10,82,9,1040,1126,2166,7,5.5,201939
11,13,126,34,202,122,19,56,8,567,738,1305,8,4.5,201939
11,14,134,23,189,156,10,79,0,591,702,1293,8,4.5,201939
11,15,109,48,193,188,10,77,3,628,812,1440,9,5,201939
12,1,94,25,113,101,36,50,3,422,634,1056,10,4.2,201939
12,2,159,18,150,313,5,82,2,729,900,1629,10,4.5,201939
12,3,98,16,159,258,11,30,0,572,955,1527,11,4.2,201939
12,4,171,16,219,414,26,41,0,887,995,1882,9,5,201939
12,5,140,16,169,216,1,10,3,555,892,1447,10,4.25,201939
12,6,119,11,158,244,24,15,7,578,967,1545,10,4.25,201939
12,7,158,9,133,304,10,59,21,694,946,1640,6,4.5,201939
12,8,133,19,240,241,4,64,0,701,1035,1736,9,4.25,201939
12,9,141,11,360,380,30,37,1,960,1149,2109,9,4.666666667,201939
13,1,161,12,97,118,25,25,12,450,735,1185,9,4.333333333,201939
13,2,131,18,81,158,44,63,8,503,502,1005,6,4.333333333,201939
13,3,158,11,131,151,69,46,0,566,767,1333,12,4.25,201939
13,4,202,21,266,242,78,48,19,876,1056,1932,9,4.666666667,201939
13,5,220,18,304,279,74,128,19,1042,1170,2212,9,4.75,201939
13,6,266,36,580,543,81,96,7,1609,1840,3449,11,5,201939
13,7,126,21,244,280,29,52,2,754,910,1664,8,4.5,201939
14,1,109,10,87,63,22,61,0,352,472,824,6,4.5,201939
14,2,132,11,131,63,37,99,0,473,713,1186,5,4.666666667,201939
14,3,181,15,159,66,17,111,5,554,744,1298,8,4.4,201939
14,4,140,16,237,258,19,74,5,749,979,1728,10,5,201939
14,5,98,9,248,138,28,47,0,568,839,1407,9,3.75,201939
14,6,185,18,435,214,11,54,1,918,1061,1979,11,5,201939
14,7,122,15,206,114,0,25,0,482,572,1054,6,5,201939
14,8,373,27,652,530,42,181,0,1805,2017,3822,11,5.25,201939
14,9,121,23,167,202,13,75,0,601,679,1280,11,5,201939
14,10,168,43,362,256,18,108,2,957,1207,2164,7,5.5,201939
14,11,140,18,216,164,49,120,13,720,801,1521,4,5,201939
14,12,193,26,427,137,11,50,0,844,1299,2143,9,4.5,201939
14,13,178,20,352,192,11,99,2,854,1018,1872,6,5,201939
14,14,127,13,219,202,18,103,6,688,854,1542,7,5,201939
14,15,202,24,207,131,49,114,8,735,879,1614,10,4.6,201939
14,16,132,25,256,156,33,84,0,686,884,1570,5,5,201939
14,17,126,28,152,57,29,71,3,466,722,1188,7,4.25,201939
14,18,153,21,208,86,26,74,6,574,837,1411,9,4.4,201939
14,19,122,27,214,166,25,81,21,656,789,1445,8,4.25,201939
14,20,145,10,251,164,7,67,0,644,849,1493,10,4.666666667,201939
15,1,132,10,129,66,168,91,2,598,814,1412,7,4.333333333,201939
15,2,115,14,204,195,97,62,4,691,902,1593,6,5,201939
15,3,208,18,191,218,238,100,15,988,1297,2285,10,4.666666667,201939
15,4,128,25,240,246,33,111,15,798,1040,1838,4,5,201939
15,5,157,33,233,203,27,48,3,704,956,1660,8,4.666666667,201939
15,6,112,12,255,438,34,104,19,974,1135,2109,7,5.5,201939
15,7,91,10,275,197,62,61,6,702,943,1645,10,5,201939
15,8,89,10,123,193,12,52,6,485,629,1114,4,5,201939
15,9,136,15,87,74,126,101,0,539,931,1470,9,4.75,201939
15,10,102,3,180,296,25,67,2,675,895,1570,6,5,201939
15,11,127,19,261,292,35,84,7,825,1057,1882,8,5,201939
15,12,170,18,483,380,45,85,1,1182,1506,2688,8,5,201939
15,13,93,14,147,164,102,92,0,612,695,1307,8,5,201939
15,14,65,9,118,184,24,62,0,462,555,1017,4,5,201939
15,15,128,115,253,268,52,55,7,878,1076,1954,6,5,201939
15,16,187,30,272,470,33,107,9,1108,1413,2521,8,5,201939
15,17,107,13,172,241,26,94,18,671,820,1491,8,5,201939
15,18,155,17,255,342,28,100,2,899,1271,2170,7,4.666666667,201939
15,19,137,23,371,530,29,146,15,1251,1589,2840,10,5,201939
15,20,54,18,192,200,21,41,2,528,696,1224,6,5,201939
15,21,72,3,102,125,21,62,17,402,544,946,6,4.5,201939
15,22,232,126,450,516,28,139,13,1504,1936,3440,14,5,201939
15,23,119,10,146,251,31,103,4,664,913,1577,6,4.333333333,201939
15,24,95,30,191,199,28,61,4,608,802,1410,4,5,201939
15,25,119,18,192,235,28,74,11,677,833,1510,6,5,201939
15,26,100,8,142,181,81,68,0,580,749,1329,9,6,201939
15,27,158,18,281,388,14,134,22,1015,1250,2265,9,4.666666667,201939
15,28,182,39,442,303,65,84,6,1121,1361,2482,9,4.666666667,201939
15,29,161,14,403,445,14,123,10,1170,1453,2623,8,5,201939
15,30,194,18,363,402,45,81,7,1110,1348,2458,16,5,201939
15,31,111,137,172,224,16,40,0,700,889,1589,6,5,201939
15,32,113,16,229,274,51,77,1,761,899,1660,9,5,201939
15,33,137,15,304,248,30,70,0,804,1093,1897,7,5,201939
15,34,178,22,231,353,13,88,4,889,1011,1900,8,5,201939
15,35,238,17,206,329,9,151,0,950,1283,2233,9,4.666666667,201939
15,36,168,17,167,245,30,85,1,713,1061,1774,9,4.5,201939
15,37,179,23,280,373,70,99,13,1037,1366,2403,7,5,201939
15,38,133,30,287,282,36,84,3,855,968,1823,6,4.5,201939
15,39,122,23,218,188,33,69,1,654,875,1529,4,5,201939
15,40,235,26,260,345,74,174,2,1116,1525,2641,9,5,201939
15,41,210,18,458,477,75,110,10,1358,1768,3126,13,5,201939
16,1,73,21,183,97,7,21,1,403,575,978,7,4.333333333,201939
16,2,111,31,93,84,22,37,0,378,432,810,9,4.25,201939
16,3,155,14,135,195,33,73,2,607,654,1261,10,4.25,201939
16,4,165,22,189,104,41,68,0,589,825,1414,8,4.5,201939
16,5,156,26,185,166,29,107,4,673,854,1527,10,4.666666667,201939
16,6,125,31,179,153,28,57,1,574,765,1339,12,4.5,201939
16,7,144,20,198,171,26,64,0,623,683,1306,9,4.5,201939
16,8,223,31,583,410,11,62,2,1322,1601,2923,12,5,201939
16,9,134,21,238,238,5,84,0,720,962,1682,9,5.5,201939
16,10,103,8,225,249,11,72,0,668,869,1537,6,5,201939
16,11,134,30,128,101,26,84,0,503,683,1186,10,4.4,201939
16,12,107,20,159,124,9,56,1,476,608,1084,10,4.25,201939
17,1,150,48,384,362,49,69,2,1064,1286,2350,9,7,201939
17,2,122,6,241,350,9,65,4,797,973,1770,8,4.666666667,201939
17,3,163,18,347,288,21,77,0,914,1157,2071,8,4.5,201939
17,4,140,14,271,330,23,78,1,857,1090,1947,10,4.666666667,201939
17,5,71,6,124,103,9,41,0,354,427,781,5,4.5,201939
18,1,89,14,99,75,25,43,21,366,455,821,7,4.25,201939
18,2,200,20,255,333,37,102,0,947,1221,2168,9,6,201939
18,3,96,9,225,126,2,41,0,499,715,1214,8,4.75,201939
19,1,217,7,270,260,9,133,2,898,897,1795,9,5,201939
19,2,221,17,557,342,18,154,0,1309,1407,2716,9,5,201939
19,3,278,14,662,303,36,129,0,1422,1395,2817,7,5,201939
19,4,148,14,219,145,49,134,25,734,693,1427,5,5,201939
19,5,284,37,482,469,27,204,19,1522,1612,3134,8,5,201939
19,6,69,8,279,189,8,81,1,635,619,1254,5,5,201939
19,7,177,14,447,217,7,82,0,944,1008,1952,10,4.5,201939
19,8,62,10,148,120,2,35,0,377,425,802,7,5,201939
19,9,128,12,189,181,10,69,7,596,880,1476,9,4.25,201939
19,10,146,6,251,237,9,129,13,791,856,1647,7,7,201939
19,11,345,39,568,663,10,353,11,1989,2233,4222,13,5.333333333,201939
19,12,158,15,408,158,5,63,4,811,814,1625,13,4.666666667,201939
20,1,160,8,195,188,44,48,18,661,682,1343,8,4.5,201939
20,2,105,17,143,67,15,29,2,378,518,896,6,4.333333333,201939
20,3,116,9,129,86,96,44,13,493,465,958,6,4.333333333,201939
20,4,111,8,83,71,26,65,9,373,491,864,6,4.333333333,201939
20,5,85,22,205,195,18,36,0,561,937,1498,11,4.25,201939
20,6,102,6,79,88,39,46,31,391,570,961,8,4.25,201939
20,7,115,7,192,172,14,55,0,555,770,1325,8,4.75,201939
20,8,321,34,645,544,25,107,10,1686,1885,3571,14,6,201939
20,9,179,5,136,121,43,67,3,554,908,1462,8,4.333333333,201939
20,10,114,6,147,87,17,18,12,401,611,1012,9,4.25,201939
21,1,153,15,222,170,44,53,0,657,618,1275,9,4.4,201939
21,2,140,49,226,101,75,43,0,634,852,1486,9,4.2,201939
21,3,188,9,207,191,56,147,5,803,983,1786,8,4.5,201939
21,4,143,6,119,51,69,57,2,447,538,985,7,4.25,201939
21,5,181,16,395,197,15,61,10,875,973,1848,8,4.666666667,201939
21,6,220,18,322,270,58,112,12,1012,1556,2568,6,6,201939
21,7,282,8,157,159,59,77,0,742,943,1685,9,4,201939
21,8,147,10,209,100,51,54,12,583,836,1419,9,4,201939
21,9,168,35,375,347,51,98,8,1082,1232,2314,9,5,201939
21,10,193,26,476,264,17,93,13,1082,987,2069,7,5,201939
21,11,56,4,137,76,16,32,2,323,481,804,4,5,201939
21,12,276,21,662,458,177,184,81,1859,2254,4113,15,5.5,201939
21,13,173,20,298,184,29,126,0,830,1113,1943,8,4.666666667,201939
21,14,163,10,171,140,53,121,13,671,891,1562,12,4.333333333,201939
21,15,172,12,261,229,19,106,12,811,975,1786,7,4.5,201939
22,1,124,34,146,267,20,51,1,643,720,1363,11,4.2,201939
22,2,132,24,194,157,86,45,1,639,809,1448,7,4.5,201939
22,3,227,38,589,508,12,141,0,1515,1986,3501,9,4.666666667,201939
22,4,176,30,507,365,8,84,3,1173,1531,2704,9,5.5,201939
22,5,140,26,345,219,62,66,10,868,954,1822,10,4.5,201939
23,1,183,4,923,225,48,82,4,1469,1891,3360,14,4.6,201939
23,2,146,17,330,240,37,32,0,802,950,1752,8,4.25,201939
23,3,223,16,853,380,34,70,0,1576,2287,3863,19,0,201939
23,4,117,4,479,219,28,56,4,907,1194,2101,6,4.5,201939
24,1,106,42,103,153,22,52,0,478,676,1154,10,4.2,201939
24,2,102,15,194,134,11,71,0,527,674,1201,6,4.5,201939
24,3,106,31,110,109,59,31,0,446,673,1119,9,4.25,201939
24,4,127,17,168,136,21,75,15,559,725,1284,5,4.5,201939
24,5,205,37,547,451,13,113,0,1366,1657,3023,10,5.666666667,201939
24,6,160,78,335,264,44,84,1,966,1145,2111,6,5,201939
24,7,124,32,153,186,71,19,0,585,736,1321,9,4.25,201939
25,1,115,14,225,224,36,53,3,670,837,1507,13,4.75,201939
25,2,169,39,260,305,18,75,0,866,1073,1939,7,5,201939
25,3,120,7,224,287,23,80,12,753,819,1572,8,4.6,201939
25,4,117,19,146,162,34,35,0,513,528,1041,8,4.333333333,201939
25,5,104,14,205,302,16,83,0,724,801,1525,8,4.666666667,201939
25,6,152,7,246,255,28,117,9,814,1002,1816,8,4.75,201939
25,7,186,18,337,334,6,76,0,957,1038,1995,6,5,201939
26,1,155,10,269,230,2,111,0,777,993,1770,9,4.5,201939
26,2,181,13,313,366,6,111,14,1004,1227,2231,12,4.4,201939
26,3,255,21,325,414,12,202,7,1236,1567,2803,13,5.5,201939
26,4,145,52,142,149,33,62,2,585,663,1248,9,4.2,201939
26,5,121,5,144,144,13,94,0,521,772,1293,15,5,201939
26,6,186,9,189,237,22,162,0,805,957,1762,10,4.333333333,201939
26,7,106,14,143,140,22,48,1,474,553,1027,10,4.25,201939
27,1,129,8,140,155,73,41,0,546,725,1271,8,4.5,201939
27,2,138,13,173,315,20,60,2,721,925,1646,8,4.666666667,201939
27,3,150,3,107,307,11,54,3,635,663,1298,7,4.666666667,201939
27,4,165,22,298,510,12,75,2,1084,1242,2326,8,5.5,201939
27,5,76,3,100,167,17,28,3,394,428,822,6,4.333333333,201939
27,6,134,12,157,310,2,77,0,692,978,1670,8,4.5,201939
28,1,140,24,429,320,6,113,0,1032,1126,2158,13,5,201939
28,2,182,15,405,240,16,116,43,1017,1208,2225,15,5,201939
28,3,126,12,213,91,6,72,1,521,613,1134,7,4,201939
28,4,284,26,425,284,39,131,37,1226,1447,2673,18,5.666666667,201939
28,5,128,13,209,274,12,122,25,783,885,1668,10,4.5,201939
28,6,95,14,114,120,25,36,4,408,401,809,13,4.166666667,201939
28,7,213,22,379,286,54,127,10,1091,1172,2263,13,5,201939
28,8,81,12,130,223,15,86,2,549,1196,1745,13,5,201939
28,9,142,10,261,175,9,62,2,661,790,1451,11,4.5,201939
29,1,186,19,233,325,25,91,4,883,1156,2039,7,4.5,201939
29,2,177,12,224,414,23,129,57,1036,1139,2175,10,5,201939
29,3,100,17,152,262,13,74,5,623,702,1325,6,4.666666667,201939
30,1,84,9,100,70,37,30,4,334,344,678,7,4.333333333,201939
30,2,100,8,204,56,47,16,18,449,703,1152,9,4.25,201939
30,3,148,10,147,111,72,73,19,580,626,1206,6,4.666666667,201939
30,4,75,6,240,128,22,57,0,528,609,1137,8,5,201939
30,5,137,13,242,230,10,78,6,716,912,1628,7,4.5,201939
30,6,118,7,223,154,18,70,0,590,688,1278,9,4.333333333,201939
30,7,132,9,223,122,41,48,11,586,692,1278,11,4.25,201939
30,8,169,15,348,185,71,71,7,866,1170,2036,11,4.4,201939
30,9,150,11,161,120,77,75,16,610,754,1364,8,4.5,201939
30,10,141,9,277,240,18,82,13,780,871,1651,7,6,201939
30,11,101,5,236,232,12,59,0,645,842,1487,5,4.5,201939
30,12,196,18,507,351,19,88,1,1180,1311,2491,10,5.25,201939
30,13,146,11,122,157,49,63,24,572,810,1382,10,4.4,201939
30,14,114,10,193,114,93,57,4,585,803,1388,8,4.5,201939
30,15,184,10,220,220,58,120,32,844,1044,1888,11,4.666666667,201939
30,16,155,10,231,270,24,93,35,818,916,1734,10,4.333333333,201939
30,17,137,18,252,223,44,64,22,760,1162,1922,8,4.5,201939
30,18,147,16,128,81,9,56,22,459,651,1110,8,4.25,201939
30,19,133,15,231,117,39,53,1,589,782,1371,13,4.6,201939
30,20,128,9,194,227,78,89,0,725,866,1591,10,4.4,201939
31,1,160,18,254,33,172,25,0,662,710,1372,8,4.5,201939
31,2,81,16,104,9,136,38,0,384,460,844,6,4.333333333,201939
31,3,359,73,930,420,152,107,5,2046,2247,4293,20,5.333333333,201939
31,4,95,12,273,212,55,63,14,724,828,1552,4,5,201939
31,5,125,4,125,127,36,64,2,483,518,1001,7,4.333333333,201939
32,1,133,18,168,147,31,84,16,597,712,1309,12,4.2,201939
32,2,131,12,96,83,65,58,9,454,594,1048,13,4.142857143,201939
32,3,159,27,155,233,2,117,0,693,904,1597,13,4.6,201939
32,4,127,28,175,216,17,121,18,702,1092,1794,13,4.4,201939
1,1,219,44,318,252,46,98,6,983,884,1867,13,5.5,201940
1,2,283,64,651,437,42,176,6,1659,1397,3056,10,6.666666667,201940
1,3,220,63,581,365,25,171,3,1428,1204,2632,9,6.333333333,201940
2,1,183,21,398,282,27,145,16,1072,1099,2171,11,6,201940
2,2,207,7,348,312,16,156,0,1046,856,1902,7,6,201940
2,3,273,13,426,367,20,217,18,1334,1202,2536,12,6,201940
2,4,219,12,577,221,50,70,7,1156,1062,2218,9,6.5,201940
2,5,302,26,709,244,186,191,3,1661,1438,3099,11,6,201940
2,6,248,21,561,304,11,116,0,1261,1107,2368,8,6.5,201940
2,7,231,20,530,322,42,133,13,1291,1202,2493,12,5.75,201940
2,8,247,11,544,375,34,115,6,1332,1186,2518,7,7,201940
3,1,185,19,251,245,17,111,3,831,821,1652,13,5.666666667,201940
3,2,143,22,517,260,33,67,0,1042,1058,2100,9,6,201940
4,1,175,13,239,322,77,112,15,953,885,1838,11,5.5,201940
4,2,167,10,331,398,43,88,14,1051,1134,2185,14,5.4,201940
5,1,593,17,370,319,35,91,12,1437,1133,2570,9,5.666666667,201940
5,2,406,24,270,323,38,75,0,1136,949,2085,10,6,201940
5,3,534,36,270,317,31,129,18,1335,1120,2455,11,5.333333333,201940
5,4,510,31,565,554,17,136,18,1831,1717,3548,11,6,201940
5,5,359,26,428,427,16,68,13,1337,1139,2476,10,6,201940
5,6,299,12,279,273,24,73,49,1009,1068,2077,10,5.5,201940
5,7,399,19,278,300,14,102,1,1113,1233,2346,10,5.5,201940
6,1,216,19,216,208,8,106,19,792,711,1503,12,6,201940
6,2,135,11,262,202,23,96,12,741,778,1519,9,5.666666667,201940
7,1,362,5,179,205,38,44,0,833,673,1506,9,5.25,201940
7,2,252,5,143,925,38,36,0,1399,659,2058,9,5.25,201940
7,3,191,9,164,168,108,44,0,684,1058,1742,7,5.333333333,201940
7,4,197,12,239,189,12,48,5,702,519,1221,11,5.4,201940
7,5,222,6,191,364,52,72,1,908,1076,1984,11,5.666666667,201940
7,6,211,13,327,303,27,79,4,964,918,1882,8,5.666666667,201940
7,7,196,22,303,283,90,93,11,998,797,1795,8,5.5,201940
7,8,218,19,195,445,59,96,5,1037,884,1921,12,5.25,201940
7,9,220,9,288,391,33,129,6,1076,931,2007,9,5.666666667,201940
7,10,169,12,226,289,17,45,0,758,691,1449,9,5.5,201940
7,11,86,4,74,57,10,24,3,258,270,528,6,5.333333333,201940
7,12,188,11,287,364,8,41,0,899,920,1819,9,5.5,201940
7,13,102,5,150,217,0,36,0,510,666,1176,9,5.25,201940
8,1,164,10,450,179,18,65,7,893,730,1623,4,6,201940
8,2,321,75,678,379,30,99,0,1582,1224,2806,17,5.75,201940
8,3,207,43,445,411,40,90,28,1264,962,2226,4,6,201940
8,4,184,31,425,279,33,141,19,1112,966,2078,11,6,201940
8,5,200,69,269,216,17,49,0,820,916,1736,10,5.25,201940
8,6,167,13,276,217,32,96,6,807,1318,2125,7,6.5,201940
8,7,187,47,180,219,6,124,0,763,927,1690,8,5.25,201940
8,8,250,21,491,489,18,212,2,1483,878,2361,11,8,201940
8,9,184,31,157,125,21,98,0,616,515,1131,10,4.8,201940
9,1,120,13,147,142,65,66,6,559,463,1022,5,6,201940
9,2,533,94,717,762,143,148,21,2418,1965,4383,12,6,201940
9,3,187,24,428,380,113,136,22,1290,1059,2349,7,6,201940
9,4,197,28,499,497,134,109,5,1469,1102,2571,11,6,201940
9,5,116,41,280,290,75,91,0,893,767,1660,7,6,201940
9,6,108,44,221,176,131,90,12,782,613,1395,7,6,201940
9,7,85,8,458,274,1,19,0,845,684,1529,9,6,201940
9,8,97,18,314,286,52,80,15,862,738,1600,5,6,201940
9,9,128,13,255,233,81,68,0,778,597,1375,5,6,201940
9,10,98,22,395,245,40,90,30,920,817,1737,6,6,201940
9,11,191,20,432,385,176,125,6,1335,1085,2420,7,7,201940
9,12,264,21,540,522,40,111,45,1543,1363,2906,11,6,201940
9,13,121,26,303,295,87,102,16,950,834,1784,4,6,201940
9,14,132,13,285,310,73,152,9,974,731,1705,5,6,201940
9,15,282,24,940,751,69,195,25,2286,1950,4236,10,6.5,201940
9,16,246,157,471,619,68,127,12,1700,1467,3167,15,6,201940
9,17,121,12,296,282,42,57,9,819,709,1528,6,6,201940
9,18,172,12,322,438,97,145,50,1236,1129,2365,12,6,201940
9,19,172,97,344,373,119,82,31,1218,987,2205,5,6,201940
9,20,51,23,91,92,43,16,1,317,242,559,5,6,201940
9,21,134,10,179,230,86,42,2,683,523,1206,3,6,201940
9,22,160,16,259,295,99,92,14,935,782,1717,5,6,201940
9,23,154,27,453,343,69,51,0,1097,906,2003,6,7,201940
9,24,265,52,594,617,246,177,7,1958,1818,3776,14,6,201940
10,1,204,23,184,218,35,121,12,797,632,1429,12,4.666666667,201940
10,2,183,16,310,284,22,122,8,945,891,1836,10,5.25,201940
10,3,151,32,205,213,16,115,39,771,803,1574,11,5.4,201940
10,4,290,20,450,475,18,162,0,1415,1219,2634,12,7,201940
11,1,125,58,185,187,21,56,3,635,654,1289,6,4.666666667,201940
11,2,160,18,230,137,47,97,6,695,595,1290,7,5,201940
11,3,122,20,233,216,12,121,5,729,626,1355,3,5,201940
11,4,96,38,176,185,38,88,0,621,569,1190,8,5,201940
11,5,188,53,356,451,20,129,9,1206,937,2143,7,5.5,201940
11,6,104,34,231,217,19,61,4,670,569,1239,8,6,201940
11,7,152,39,297,327,16,63,0,894,1054,1948,9,4.5,201940
11,8,157,61,233,312,63,80,0,906,886,1792,9,4.5,201940
11,9,163,41,252,341,9,122,13,941,861,1802,10,4.666666667,201940
11,10,169,33,208,182,34,104,6,736,706,1442,10,4.6,201940
11,11,138,27,238,308,14,102,0,827,604,1431,5,5,201940
11,12,160,40,349,382,16,84,7,1038,986,2024,7,5.5,201940
11,13,115,32,164,131,27,54,2,525,592,1117,8,4.5,201940
11,14,146,32,221,184,10,63,0,656,564,1220,8,4.5,201940
11,15,108,55,226,217,3,72,4,685,535,1220,9,5,201940
12,1,121,32,185,156,37,67,6,604,614,1218,10,5.2,201940
12,2,218,24,229,347,10,95,7,930,863,1793,10,5.5,201940
12,3,155,15,235,338,18,56,0,817,941,1758,11,5.2,201940
12,4,205,33,306,470,30,53,0,1097,885,1982,9,6,201940
12,5,170,28,251,257,2,27,8,743,1191,1934,10,5.25,201940
12,6,116,24,237,411,57,19,14,878,682,1560,10,5.25,201940
12,7,210,17,187,343,5,94,24,880,876,1756,6,5.5,201940
12,8,201,19,215,347,6,55,0,843,823,1666,9,5.25,201940
12,9,188,33,363,485,100,61,0,1230,1219,2449,9,5.666666667,201940
13,1,224,13,124,169,52,56,15,653,646,1299,9,5.333333333,201940
13,2,187,19,134,186,65,58,10,659,753,1412,6,5.333333333,201940
13,3,213,30,179,234,74,80,0,810,776,1586,12,5.25,201940
13,4,243,22,285,246,50,71,20,937,845,1782,9,5.666666667,201940
13,5,247,20,369,316,68,182,18,1220,1048,2268,9,5.75,201940
13,6,321,55,679,608,87,165,11,1926,1650,3576,11,6,201940
13,7,189,37,344,354,35,60,0,1019,916,1935,8,5.5,201940
14,1,181,45,132,91,59,129,6,643,671,1314,6,5.5,201940
14,2,153,17,170,95,51,103,2,591,569,1160,5,5.666666667,201940
14,3,253,21,287,94,28,183,5,871,812,1683,8,5.4,201940
14,4,179,16,274,317,17,106,2,911,769,1680,10,6,201940
14,5,143,20,429,195,59,93,0,939,988,1927,9,5.5,201940
14,6,222,26,494,294,27,60,0,1123,965,2088,11,6,201940
14,7,117,24,268,139,0,40,0,588,496,1084,6,6,201940
14,8,372,43,721,645,31,212,4,2028,1734,3762,11,6.25,201940
14,9,139,12,199,243,22,83,1,699,626,1325,11,6,201940
14,10,214,42,453,260,4,123,1,1097,946,2043,7,6.5,201940
14,11,182,23,255,186,46,169,26,887,734,1621,4,6,201940
14,12,237,32,531,186,39,76,0,1101,1011,2112,9,5.5,201940
14,13,210,19,402,239,9,104,4,987,832,1819,6,6,201940
14,14,157,30,290,257,22,121,11,888,891,1779,7,6,201940
14,15,216,40,227,188,42,114,8,835,853,1688,10,5.6,201940
14,16,194,26,281,196,30,114,6,847,707,1554,5,6,201940
14,17,139,21,202,66,45,66,4,543,682,1225,7,5.25,201940
14,18,220,33,317,106,55,95,16,842,912,1754,9,5.4,201940
14,19,200,28,258,174,29,87,13,789,881,1670,8,5.25,201940
14,20,184,23,357,187,7,90,0,848,732,1580,10,5.666666667,201940
15,1,169,25,159,101,198,124,0,776,670,1446,7,5.333333333,201940
15,2,145,14,252,242,112,79,5,849,679,1528,6,6,201940
15,3,257,21,245,246,294,112,11,1186,1047,2233,10,5.666666667,201940
15,4,226,25,243,326,43,169,15,1047,892,1939,4,6,201940
15,5,192,62,320,274,18,67,3,936,909,1845,8,5.666666667,201940
15,6,161,7,317,441,37,145,10,1118,874,1992,7,6.5,201940
15,7,142,25,346,283,69,67,12,944,713,1657,10,6,201940
15,8,102,10,170,228,14,59,5,588,510,1098,4,6,201940
15,9,226,15,130,126,125,125,5,752,815,1567,9,5.75,201940
15,10,118,11,201,295,20,100,5,750,686,1436,6,6,201940
15,11,188,37,279,368,47,99,8,1026,854,1880,8,6,201940
15,12,234,17,553,422,43,80,0,1349,1215,2564,8,6,201940
15,13,109,15,187,183,112,110,0,716,593,1309,8,6,201940
15,14,70,21,180,221,37,76,1,606,494,1100,4,6,201940
15,15,161,115,284,344,44,84,7,1039,879,1918,6,6,201940
15,16,241,42,353,507,37,119,16,1315,1061,2376,8,6,201940
15,17,126,22,199,301,25,99,18,790,707,1497,8,6,201940
15,18,221,41,348,410,26,120,10,1176,1213,2389,7,5.666666667,201940
15,19,207,50,464,661,30,168,20,1600,1264,2864,10,6,201940
15,20,86,38,238,224,6,39,5,636,770,1406,6,6,201940
15,21,113,11,114,170,30,62,16,516,411,927,6,5.5,201940
15,22,276,149,589,619,42,166,30,1871,1527,3398,14,6,201940
15,23,186,25,255,277,39,105,21,908,984,1892,6,5.333333333,201940
15,24,153,20,233,228,41,57,6,738,779,1517,4,6,201940
15,25,174,25,278,274,17,89,6,863,853,1716,6,6,201940
15,26,135,15,184,244,93,76,1,748,623,1371,9,7,201940
15,27,197,17,434,388,29,133,26,1224,1114,2338,9,5.666666667,201940
15,28,244,31,604,365,54,116,8,1422,1094,2516,9,5.666666667,201940
15,29,224,26,512,550,8,115,17,1452,1186,2638,8,6,201940
15,30,239,17,417,474,60,80,12,1299,1103,2402,16,6,201940
15,31,143,188,200,255,17,48,0,851,742,1593,6,6,201940
15,32,171,11,257,375,76,84,0,974,775,1749,9,6,201940
15,33,178,19,409,322,34,88,0,1050,799,1849,7,6,201940
15,34,217,30,281,398,30,117,10,1083,894,1977,8,6,201940
15,35,258,16,270,427,11,170,0,1152,1070,2222,9,5.666666667,201940
15,36,208,24,229,360,132,95,5,1053,1140,2193,9,5.5,201940
15,37,212,27,345,389,84,132,12,1201,1076,2277,7,6,201940
15,38,148,45,367,318,42,88,3,1011,1120,2131,6,5.5,201940
15,39,161,19,274,283,45,70,2,854,642,1496,4,6,201940
15,40,245,67,319,443,104,213,1,1392,1197,2589,9,6,201940
15,41,277,25,544,511,75,104,20,1556,1338,2894,13,6,201940
16,1,145,24,265,139,8,32,0,613,519,1132,7,5.333333333,201940
16,2,117,37,118,108,15,50,0,445,536,981,9,5.25,201940
16,3,181,28,163,207,38,86,0,703,554,1257,10,5.25,201940
16,4,178,20,234,86,56,89,0,663,584,1247,8,5.5,201940
16,5,159,16,190,205,38,99,6,713,727,1440,10,5.666666667,201940
16,6,156,41,229,162,33,68,0,689,737,1426,12,5.5,201940
16,7,179,30,194,185,30,75,4,697,701,1398,9,5.5,201940
16,8,307,37,665,508,10,84,1,1612,1335,2947,12,6,201940
16,9,241,20,264,248,17,113,0,903,718,1621,9,6.5,201940
16,10,143,18,316,261,30,74,0,842,716,1558,6,6,201940
16,11,200,35,197,161,58,136,1,788,835,1623,10,5.4,201940
16,12,150,15,228,150,15,87,3,648,733,1381,10,5.25,201940
17,1,165,66,411,438,37,117,3,1237,1046,2283,9,8,201940
17,2,135,10,352,348,10,106,10,971,954,1925,8,5.666666667,201940
17,3,217,20,468,395,23,86,0,1209,1160,2369,8,5.5,201940
17,4,185,12,334,311,29,89,4,964,856,1820,10,5.666666667,201940
17,5,103,12,133,127,14,59,0,448,406,854,5,5.5,201940
18,1,120,21,151,96,36,60,18,502,580,1082,7,5.25,201940
18,2,249,22,376,381,33,130,0,1191,1059,2250,9,7,201940
18,3,159,12,346,186,13,63,1,780,843,1623,8,5.75,201940
19,1,275,22,381,310,15,140,6,1149,1015,2164,9,6,201940
19,2,269,19,670,373,18,156,0,1505,1310,2815,9,6,201940
19,3,317,34,754,384,47,175,2,1713,1481,3194,7,6,201940
19,4,154,11,230,173,71,163,38,840,636,1476,5,6,201940
19,5,351,22,535,606,37,255,25,1831,1444,3275,8,6,201940
19,6,90,13,299,264,9,130,7,812,611,1423,5,6,201940
19,7,154,9,498,207,11,76,0,955,976,1931,10,5.25,201940
19,8,66,5,164,128,2,51,0,416,340,756,7,6,201940
19,9,212,14,255,242,27,113,3,866,816,1682,9,5.25,201940
19,10,187,16,359,272,17,178,6,1035,809,1844,6,7,201940
19,11,424,43,660,793,16,412,14,2362,1920,4282,13,6.333333333,201940
19,12,200,11,684,190,14,81,2,1182,1015,2197,13,5.666666667,201940
20,1,202,10,227,170,44,76,26,755,731,1486,8,5.5,201940
20,2,91,12,134,90,19,26,6,378,568,946,6,5.333333333,201940
20,3,109,12,108,107,117,34,15,502,704,1206,6,5.333333333,201940
20,4,106,17,86,56,38,48,14,365,685,1050,6,5.333333333,201940
20,5,104,15,173,131,22,24,0,469,845,1314,11,5.25,201940
20,6,172,7,107,126,120,111,32,675,862,1537,8,5.25,201940
20,7,156,9,240,223,41,58,0,727,676,1403,8,5.75,201940
20,8,361,22,784,570,54,148,9,1948,1781,3729,14,7,201940
20,9,242,13,157,156,81,79,18,746,795,1541,8,5.666666667,201940
20,10,166,7,310,159,11,17,7,677,817,1494,9,5.25,201940
21,1,220,23,366,232,29,44,0,914,948,1862,9,5.4,201940
21,2,135,54,241,127,84,46,0,687,936,1623,9,5.2,201940
21,3,233,6,208,200,63,163,5,878,946,1824,8,5.5,201940
21,4,110,12,115,67,55,57,8,424,689,1113,7,5.25,201940
21,5,169,20,413,236,19,85,12,954,1029,1983,8,5.666666667,201940
21,6,207,15,380,288,69,151,27,1137,1036,2173,6,7,201940
21,7,388,9,181,231,58,125,4,996,1067,2063,9,5.666666667,201940
21,8,219,24,342,98,129,105,17,934,1325,2259,9,5.2,201940
21,9,196,34,488,353,64,126,7,1268,1109,2377,9,6,201940
21,10,201,13,395,299,25,110,8,1051,1248,2299,7,6,201940
21,11,86,5,128,132,23,50,3,427,334,761,4,6,201940
21,12,367,28,780,538,213,180,65,2171,1905,4076,16,7,201940
21,13,222,21,363,205,33,180,2,1026,932,1958,8,5.666666667,201940
21,14,186,18,185,172,60,123,11,755,1008,1763,12,5.333333333,201940
21,15,239,9,335,307,22,156,21,1089,1129,2218,7,5.5,201940
22,1,176,44,160,310,15,58,1,764,779,1543,11,5.2,201940
22,2,176,27,310,195,96,61,1,866,752,1618,7,5.5,201940
22,3,281,54,760,648,11,184,0,1938,1620,3558,9,6,201940
22,4,217,41,651,460,11,123,1,1504,1153,2657,10,7,201940
22,5,170,27,419,217,70,89,8,1000,864,1864,10,5.5,201940
23,1,213,9,1173,267,39,98,3,1802,1653,3455,14,5.6,201940
23,2,180,20,372,229,36,28,0,865,1032,1897,9,5.5,201940
23,3,233,13,858,492,32,87,1,1716,1448,3164,19,0,201940
23,4,154,13,579,287,31,72,11,1147,959,2106,6,5.5,201940
24,1,118,38,146,175,11,41,1,530,601,1131,10,5.2,201940
24,2,128,29,237,198,11,72,1,676,699,1375,6,5.5,201940
24,3,162,58,172,199,84,45,1,721,698,1419,9,5.25,201940
24,4,119,25,186,198,34,95,35,692,649,1341,5,5.5,201940
24,5,267,44,664,509,16,142,0,1642,1387,3029,10,6.666666667,201940
24,6,160,114,406,311,64,97,0,1152,963,2115,6,6,201940
24,7,175,20,182,152,72,30,0,631,728,1359,9,5.25,201940
25,1,127,10,262,254,45,60,11,769,720,1489,13,5.75,201940
25,2,235,54,358,429,27,117,0,1220,1022,2242,7,6,201940
25,3,191,10,260,302,21,109,6,899,1102,2001,8,5.6,201940
25,4,161,19,189,211,56,31,0,667,632,1299,8,5.333333333,201940
25,5,208,16,328,403,23,90,1,1069,986,2055,8,5.666666667,201940
25,6,161,13,263,325,53,128,3,946,1031,1977,8,5.75,201940
25,7,238,16,367,474,6,79,0,1180,1074,2254,6,6,201940
26,1,160,13,308,217,7,115,0,820,762,1582,9,5.5,201940
26,2,182,15,290,381,4,95,6,973,942,1915,12,5.4,201940
26,3,244,28,351,459,9,205,11,1307,1158,2465,13,6.5,201940
26,4,150,17,234,182,32,80,5,700,669,1369,9,5.2,201940
26,5,122,12,144,164,19,100,0,561,601,1162,15,6,201940
26,6,216,15,244,318,17,188,1,999,899,1898,10,5.333333333,201940
26,7,122,14,164,179,39,74,0,592,594,1186,10,5.5,201940
27,1,105,17,169,164,74,50,3,582,642,1224,8,5.5,201940
27,2,194,8,229,422,23,54,1,931,963,1894,8,5.666666667,201940
27,3,181,12,161,396,6,73,2,831,723,1554,7,5.666666667,201940
27,4,190,13,355,597,18,92,3,1268,1097,2365,8,6.5,201940
27,5,92,3,83,222,19,28,5,452,489,941,6,5.333333333,201940
27,6,141,11,198,378,4,80,0,812,835,1647,8,5.5,201940
28,1,196,24,502,336,7,129,2,1196,1154,2350,13,6,201940
28,2,165,28,435,251,28,117,40,1064,1197,2261,15,6,201940
28,3,122,17,266,136,3,77,0,621,857,1478,7,5.333333333,201940
28,4,288,30,514,341,43,157,41,1414,1265,2679,16,6,201940
28,5,198,16,304,424,24,180,28,1174,915,2089,10,5.5,201940
28,6,153,22,183,185,51,55,5,654,381,1035,13,5.166666667,201940
28,7,208,27,489,318,61,163,24,1290,1032,2322,13,6,201940
28,8,144,18,253,274,18,125,3,835,792,1627,13,7,201940
28,9,164,25,390,215,21,108,12,935,800,1735,11,5.75,201940
29,1,215,18,318,401,27,132,6,1117,911,2028,7,5.5,201940
29,2,198,14,209,480,21,129,52,1103,997,2100,11,6.333333333,201940
29,3,128,9,177,302,15,110,7,748,745,1493,6,5.666666667,201940
30,1,107,14,153,147,69,42,6,538,430,968,7,5.333333333,201940
30,2,200,13,204,94,38,49,39,637,582,1219,9,5.25,201940
30,3,152,9,179,113,85,81,22,641,736,1377,6,5.666666667,201940
30,4,95,9,274,133,33,44,0,588,553,1141,8,6,201940
30,5,173,15,281,211,22,70,1,773,701,1474,7,5.5,201940
30,6,126,9,261,241,77,108,5,827,441,1268,9,5.333333333,201940
30,7,181,27,298,170,60,69,23,828,751,1579,11,5.25,201940
30,8,217,25,432,217,70,101,5,1067,1139,2206,11,5.4,201940
30,9,213,15,248,179,89,102,30,876,793,1669,8,5.5,201940
30,10,137,15,291,226,16,98,24,807,887,1694,6,6.5,201940
30,11,145,19,396,285,11,80,0,936,745,1681,5,5.5,201940
30,12,185,19,608,405,17,104,3,1341,1111,2452,10,6.25,201940
30,13,197,16,186,219,91,132,19,860,859,1719,10,5.4,201940
30,14,181,20,246,154,124,65,3,793,638,1431,8,5.5,201940
30,15,215,20,259,220,81,161,33,989,880,1869,11,5.666666667,201940
30,16,159,13,251,270,53,134,22,902,946,1848,10,5.333333333,201940
30,17,174,29,261,218,22,99,31,834,892,1726,8,5.5,201940
30,18,209,22,113,110,25,78,36,593,688,1281,8,5.25,201940
30,19,174,19,268,155,86,96,0,798,696,1494,13,5.6,201940
30,20,159,8,214,347,74,114,0,916,802,1718,10,5.4,201940
31,1,156,12,321,49,170,54,0,762,677,1439,8,5.5,201940
31,2,79,9,120,2,167,49,0,426,662,1088,6,5.333333333,201940
31,3,379,102,1072,477,161,136,7,2334,2250,4584,21,6.666666667,201940
31,4,129,10,283,215,76,88,20,821,703,1524,4,6,201940
31,5,173,8,187,157,61,59,0,645,550,1195,7,5.333333333,201940
32,1,169,31,165,164,46,106,17,698,668,1366,12,5.2,201940
32,2,216,30,180,105,73,111,21,736,706,1442,13,5.142857143,201940
32,3,134,24,149,240,7,118,0,672,774,1446,13,5.6,201940
32,4,140,38,178,249,14,111,11,741,803,1544,13,5.4,201940
1,1,213,40,306,253,61,90,4,967,1060,2027,13,5.5,201941
1,2,283,50,603,378,44,168,9,1535,1795,3330,10,6.666666667,201941
1,3,199,55,515,393,47,162,5,1376,1435,2811,9,6.333333333,201941
2,1,198,13,365,283,30,129,21,1039,945,1984,11,6,201941
2,2,190,16,331,335,8,185,0,1065,1055,2120,7,6,201941
2,3,276,12,418,386,15,215,20,1342,1358,2700,12,6,201941
2,4,186,16,599,235,40,52,5,1133,1188,2321,9,6.5,201941
2,5,263,31,698,302,170,197,4,1665,1824,3489,11,6,201941
2,6,241,11,545,306,28,114,0,1245,1253,2498,8,6.5,201941
2,7,236,15,525,258,29,127,5,1195,1320,2515,12,5.75,201941
2,8,209,13,514,375,34,119,4,1268,1313,2581,7,7,201941
3,1,171,7,234,263,30,96,3,804,747,1551,13,5.666666667,201941
3,2,114,22,440,217,41,53,1,888,812,1700,9,6,201941
4,1,203,20,227,323,102,78,10,963,980,1943,11,5.5,201941
4,2,107,9,250,366,34,67,24,857,937,1794,14,5.4,201941
5,1,418,20,392,350,17,120,10,1327,1499,2826,9,5.666666667,201941
5,2,304,23,265,206,25,68,0,891,944,1835,10,6,201941
5,3,464,24,259,340,38,135,7,1267,1393,2660,11,5.333333333,201941
5,4,491,31,511,505,14,153,15,1720,1879,3599,11,6,201941
5,5,346,12,360,508,20,76,17,1339,1463,2802,10,6,201941
5,6,287,13,301,314,13,79,56,1063,988,2051,10,5.5,201941
5,7,340,8,292,313,4,89,3,1049,1067,2116,10,5.5,201941
6,1,239,13,245,202,9,96,17,821,757,1578,12,6,201941
6,2,110,12,227,175,22,100,8,654,746,1400,9,5.666666667,201941
7,1,248,4,112,152,27,27,2,572,787,1359,9,5.25,201941
7,2,243,10,104,911,124,32,0,1424,711,2135,9,5.25,201941
7,3,244,2,188,139,117,38,0,728,923,1651,7,5.333333333,201941
7,4,255,14,195,246,4,63,24,801,531,1332,11,5.4,201941
7,5,237,7,308,390,42,67,0,1051,903,1954,11,5.666666667,201941
7,6,197,16,364,278,37,89,4,985,1081,2066,8,5.666666667,201941
7,7,238,12,254,242,73,88,12,919,1106,2025,8,5.5,201941
7,8,187,11,161,432,56,91,1,939,719,1658,12,5.25,201941
7,9,168,12,262,406,35,114,6,1003,1043,2046,9,5.666666667,201941
7,10,156,7,198,281,10,39,0,691,575,1266,9,5.5,201941
7,11,68,2,78,49,8,20,0,225,338,563,6,5.333333333,201941
7,12,177,7,264,424,6,61,1,940,989,1929,9,5.5,201941
7,13,121,30,309,602,0,30,0,1092,277,1369,9,5.25,201941
8,1,144,9,437,156,15,45,0,806,878,1684,4,6,201941
8,2,277,60,688,313,19,71,0,1428,1399,2827,17,5.75,201941
8,3,194,41,405,354,41,106,18,1159,1165,2324,4,6,201941
8,4,157,32,390,250,47,128,35,1039,1060,2099,11,6,201941
8,5,181,56,247,203,15,29,1,732,739,1471,10,5.25,201941
8,6,154,44,239,241,25,86,6,795,785,1580,10,6.5,201941
8,7,196,65,176,206,8,92,0,743,621,1364,8,5.25,201941
8,8,261,44,462,522,14,171,0,1474,1315,2789,10,7,201941
8,9,188,25,159,124,27,121,2,646,754,1400,10,5.2,201941
9,1,89,10,142,110,53,63,7,474,522,996,5,6,201941
9,2,474,78,618,671,129,124,20,2114,2304,4418,12,6,201941
9,3,171,23,365,388,93,128,27,1195,1236,2431,7,6,201941
9,4,153,23,368,426,141,71,2,1184,1306,2490,11,6,201941
9,5,100,50,261,242,55,58,0,766,815,1581,7,6,201941
9,6,79,9,182,157,94,95,16,632,644,1276,7,6,201941
9,7,79,8,347,203,5,46,2,690,809,1499,9,6,201941
9,8,74,6,247,288,49,73,10,747,941,1688,5,6,201941
9,9,92,13,240,242,76,68,1,732,760,1492,5,6,201941
9,10,99,36,314,244,37,61,21,812,878,1690,6,6,201941
9,11,159,14,372,397,157,120,7,1226,1319,2545,7,7,201941
9,12,216,18,397,480,35,110,27,1283,1467,2750,11,6,201941
9,13,116,23,254,277,64,74,7,815,928,1743,4,6,201941
9,14,96,11,257,246,56,72,6,744,938,1682,5,6,201941
9,15,200,20,710,578,42,158,23,1731,2259,3990,11,7,201941
9,16,243,164,428,533,83,133,6,1590,1712,3302,15,6,201941
9,17,92,14,240,233,35,57,2,673,810,1483,6,6,201941
9,18,139,18,270,358,86,102,46,1019,1282,2301,12,6,201941
9,19,137,60,327,302,126,87,23,1062,1126,2188,5,6,201941
9,20,52,22,80,85,40,14,1,294,347,641,5,6,201941
9,21,124,4,138,204,68,38,2,578,618,1196,3,6,201941
9,22,106,10,253,235,96,66,17,783,907,1690,5,6,201941
9,23,135,37,418,366,53,48,3,1060,1142,2202,6,7,201941
9,24,237,53,478,520,204,142,1,1635,1882,3517,14,6,201941
10,1,218,40,252,286,25,150,35,1006,780,1786,12,4.333333333,201941
10,2,235,23,317,305,18,161,10,1069,1077,2146,10,5.25,201941
10,3,173,25,161,211,23,117,22,732,817,1549,11,5.4,201941
10,4,281,44,379,460,20,161,2,1347,1483,2830,12,7,201941
11,1,175,75,216,207,36,73,3,785,816,1601,6,5.666666667,201941
11,2,173,28,274,223,70,103,10,881,877,1758,7,6,201941
11,3,118,26,228,237,30,99,6,744,917,1661,3,6,201941
11,4,146,39,167,243,32,106,2,735,882,1617,8,6,201941
11,5,220,97,383,448,14,162,4,1328,1541,2869,7,6.5,201941
11,6,103,29,174,171,16,67,3,563,745,1308,8,6,201941
11,7,186,55,369,511,11,72,0,1204,997,2201,9,5.5,201941
11,8,197,64,282,443,72,89,0,1147,1103,2250,9,5.5,201941
11,9,196,39,323,475,13,152,14,1212,1375,2587,10,5.666666667,201941
11,10,219,39,261,241,50,126,18,954,903,1857,10,5.6,201941
11,11,176,44,323,367,14,131,0,1055,1127,2182,5,6,201941
11,12,202,64,462,485,23,91,2,1329,1313,2642,7,6.5,201941
11,13,164,47,209,167,29,75,10,701,766,1467,8,5.5,201941
11,14,165,28,255,215,31,86,2,782,730,1512,8,5.5,201941
11,15,151,53,211,274,17,84,15,805,809,1614,9,6,201941
12,1,104,23,211,155,45,66,3,607,535,1142,10,5.2,201941
12,2,191,18,233,386,7,104,9,948,902,1850,10,5.5,201941
12,3,145,18,213,366,21,57,0,820,607,1427,11,5.2,201941
12,4,195,23,289,446,28,45,2,1028,1265,2293,9,6,201941
12,5,168,22,154,189,0,20,4,557,482,1039,10,5,201941
12,6,166,24,261,431,38,24,10,954,820,1774,10,5,201941
12,7,154,16,221,359,13,81,28,872,748,1620,6,4.5,201941
12,8,149,22,158,232,2,45,0,608,597,1205,9,4.75,201941
12,9,187,22,307,490,47,68,1,1122,1428,2550,9,5.666666667,201941
13,1,255,14,135,181,40,40,15,680,577,1257,9,5.333333333,201941
13,2,145,20,117,155,85,53,11,586,720,1306,6,5.333333333,201941
13,3,150,12,146,145,75,62,3,593,697,1290,12,5.25,201941
13,4,232,23,266,291,60,71,18,961,968,1929,9,5.666666667,201941
13,5,247,19,353,317,68,145,18,1167,1155,2322,9,5.75,201941
13,6,307,56,637,599,75,132,9,1815,1947,3762,11,6,201941
13,7,165,26,274,322,52,51,0,890,865,1755,8,5.5,201941
14,1,145,32,120,88,41,130,1,557,531,1088,6,5.5,201941
14,2,99,14,138,67,69,84,1,472,611,1083,5,5.666666667,201941
14,3,250,23,283,92,11,166,8,833,745,1578,8,5.4,201941
14,4,159,15,280,310,25,102,5,896,925,1821,10,6,201941
14,5,154,23,405,182,30,79,0,873,767,1640,9,5.25,201941
14,6,200,23,520,229,29,56,0,1057,1083,2140,11,6,201941
14,7,92,14,252,109,0,27,0,494,588,1082,6,6,201941
14,8,328,45,716,595,30,178,0,1892,2107,3999,11,6.25,201941
14,9,138,15,176,277,11,88,0,705,660,1365,11,6,201941
14,10,173,49,393,268,3,124,0,1010,1119,2129,7,6.5,201941
14,11,148,22,235,230,44,108,16,803,881,1684,4,6,201941
14,12,189,26,496,159,29,58,0,957,1025,1982,9,5.5,201941
14,13,185,14,376,231,7,95,5,913,1130,2043,6,6,201941
14,14,180,18,268,219,17,111,11,824,773,1597,7,6,201941
14,15,200,29,229,184,61,110,9,822,866,1688,10,5.6,201941
14,16,117,30,284,161,37,86,3,718,830,1548,5,6,201941
14,17,130,27,174,95,48,70,3,547,509,1056,7,5.25,201941
14,18,177,26,269,96,40,97,14,719,889,1608,9,5.4,201941
14,19,168,12,228,160,15,71,7,661,640,1301,8,5.25,201941
14,20,177,27,331,175,9,89,0,808,815,1623,10,5.666666667,201941
15,1,128,19,127,95,197,81,0,647,694,1341,7,5.333333333,201941
15,2,139,12,219,253,121,57,6,807,826,1633,6,6,201941
15,3,225,29,222,230,247,88,19,1060,1108,2168,10,5.666666667,201941
15,4,187,20,265,313,41,149,19,994,978,1972,4,6,201941
15,5,190,71,348,247,19,65,6,946,921,1867,8,5.666666667,201941
15,6,137,11,300,412,34,90,12,996,1098,2094,7,6.5,201941
15,7,142,10,309,199,81,80,7,828,871,1699,10,6,201941
15,8,101,17,157,213,22,46,5,561,612,1173,4,6,201941
15,9,212,19,128,117,139,139,0,754,693,1447,9,5.75,201941
15,10,93,9,206,297,16,95,5,721,787,1508,6,6,201941
15,11,163,35,269,340,40,74,5,926,1022,1948,8,6,201941
15,12,191,16,453,438,56,63,0,1217,1321,2538,8,6,201941
15,13,83,11,178,170,131,84,0,657,707,1364,8,6,201941
15,14,77,23,176,206,27,80,0,589,555,1144,4,6,201941
15,15,127,102,370,301,61,69,0,1030,1046,2076,6,6,201941
15,16,225,25,357,546,27,150,8,1338,1344,2682,8,6,201941
15,17,101,25,176,249,15,93,18,677,777,1454,8,6,201941
15,18,203,26,304,338,24,150,5,1050,1008,2058,7,5.666666667,201941
15,19,181,34,412,545,20,158,1,1351,1534,2885,10,6,201941
15,20,80,25,215,189,14,37,3,563,556,1119,6,6,201941
15,21,90,12,116,151,38,70,25,502,537,1039,6,5.5,201941
15,22,243,115,537,587,35,147,25,1689,1821,3510,14,6,201941
15,23,147,10,176,313,39,107,12,804,725,1529,6,5.333333333,201941
15,24,126,18,226,261,24,71,4,730,592,1322,4,6,201941
15,25,163,26,229,287,37,83,6,831,659,1490,6,6,201941
15,26,112,10,158,225,73,74,0,652,700,1352,9,7,201941
15,27,170,18,349,391,20,111,41,1100,1196,2296,9,5.666666667,201941
15,28,218,33,531,359,68,100,6,1315,1304,2619,9,5.666666667,201941
15,29,184,18,400,495,13,121,12,1243,1359,2602,8,6,201941
15,30,241,32,382,443,50,94,14,1256,1267,2523,16,6,201941
15,31,127,189,172,261,13,54,0,816,847,1663,6,6,201941
15,32,145,17,207,313,60,60,4,806,954,1760,9,6,201941
15,33,183,12,352,320,29,83,0,979,1014,1993,7,6,201941
15,34,171,15,205,384,13,68,1,857,1016,1873,8,6,201941
15,35,265,10,247,379,5,161,0,1067,1145,2212,9,5.666666667,201941
15,36,197,15,221,293,56,89,3,874,948,1822,9,5.5,201941
15,37,216,16,303,415,91,119,13,1173,1185,2358,7,6,201941
15,38,154,50,295,284,30,54,3,870,985,1855,6,5.5,201941
15,39,144,20,235,221,26,64,0,710,829,1539,4,6,201941
15,40,258,60,263,365,121,155,5,1227,1327,2554,9,6,201941
15,41,242,30,486,492,83,105,11,1449,1560,3009,13,6,201941
16,1,142,12,267,126,23,30,0,600,512,1112,7,5.333333333,201941
16,2,95,29,90,99,8,51,0,372,364,736,9,5.25,201941
16,3,161,17,123,168,21,54,0,544,487,1031,10,5.25,201941
16,4,174,27,245,146,62,106,0,760,723,1483,8,5.5,201941
16,5,154,30,150,196,33,82,11,656,745,1401,10,5.666666667,201941
16,6,146,37,189,137,36,44,0,589,677,1266,12,5.5,201941
16,7,168,42,206,164,33,60,3,676,733,1409,9,5.5,201941
16,8,228,32,538,410,10,87,5,1310,1479,2789,12,6,201941
16,9,187,21,262,280,18,98,0,866,898,1764,9,6.5,201941
16,10,115,13,229,216,15,59,1,648,809,1457,6,6,201941
16,11,139,30,156,134,37,88,2,586,691,1277,10,5.4,201941
16,12,158,18,211,146,7,95,0,635,578,1213,10,5.25,201941
17,1,132,52,328,315,32,86,2,947,1229,2176,9,8,201941
17,2,117,8,253,301,9,65,8,761,942,1703,8,5.666666667,201941
17,3,161,14,315,298,21,69,3,881,960,1841,8,5.5,201941
17,4,160,8,280,300,25,65,4,842,925,1767,10,5.666666667,201941
17,5,113,11,141,124,16,61,0,466,416,882,5,5.5,201941
18,1,122,17,107,111,35,49,21,462,463,925,7,4.5,201941
18,2,235,27,309,379,29,118,0,1097,1109,2206,8,6.666666667,201941
18,3,153,17,370,190,11,65,0,806,665,1471,8,5.75,201941
19,1,269,10,352,273,19,151,10,1084,963,2047,9,6,201941
19,2,294,32,720,409,11,158,0,1624,1436,3060,9,6,201941
19,3,320,17,816,373,37,164,1,1728,1505,3233,7,6,201941
19,4,123,12,168,164,51,118,27,663,863,1526,5,6,201941
19,5,346,28,570,630,35,270,23,1902,1812,3714,8,6,201941
19,6,77,8,223,236,7,108,3,662,823,1485,5,6,201941
19,7,197,16,575,213,11,102,0,1114,1020,2134,10,5.5,201941
19,8,72,8,152,117,0,39,0,388,442,830,7,6,201941
19,9,129,16,203,116,30,84,7,585,491,1076,9,5.25,201941
19,10,122,11,270,258,8,152,17,838,961,1799,6,7,201941
19,11,370,61,626,767,19,421,18,2282,2365,4647,13,6,201941
19,12,225,15,599,174,14,68,3,1098,903,2001,13,5.666666667,201941
20,1,165,14,200,185,30,63,28,685,851,1536,8,5.5,201941
20,2,123,23,240,123,43,25,11,588,654,1242,6,5.333333333,201941
20,3,96,8,115,73,64,26,18,400,839,1239,6,5.333333333,201941
20,4,107,8,93,90,44,44,15,401,597,998,6,5.333333333,201941
20,5,128,21,283,248,41,19,0,740,705,1445,11,5.25,201941
20,6,151,2,136,92,106,109,37,633,773,1406,8,5.25,201941
20,7,192,14,233,252,34,38,0,763,636,1399,8,5.75,201941
20,8,304,36,677,609,39,143,9,1817,2020,3837,14,7,201941
20,9,180,8,132,128,60,49,10,567,787,1354,8,5.333333333,201941
20,10,129,4,311,142,33,29,10,658,576,1234,9,5.25,201941
21,1,216,22,301,206,55,39,0,839,840,1679,9,5.4,201941
21,2,130,33,183,100,41,32,0,519,739,1258,9,5.2,201941
21,3,219,10,192,228,45,144,2,840,1009,1849,8,5.5,201941
21,4,144,7,114,60,71,46,1,443,834,1277,7,5.25,201941
21,5,175,22,373,225,11,51,5,862,1102,1964,8,5.666666667,201941
21,6,219,18,341,320,64,120,22,1104,1232,2336,6,7,201941
21,7,356,9,181,190,38,87,1,862,981,1843,9,5.666666667,201941
21,8,214,13,357,134,35,98,16,867,1226,2093,9,5.2,201941
21,9,161,34,486,342,78,115,13,1229,1286,2515,9,6,201941
21,10,220,27,487,345,15,102,23,1219,1383,2602,7,6,201941
21,11,78,1,163,101,18,27,5,393,402,795,4,6,201941
21,12,275,26,680,525,150,172,96,1924,2279,4203,16,7,201941
21,13,205,17,329,181,21,152,0,905,1004,1909,8,5.666666667,201941
21,14,202,10,181,210,63,143,11,820,1017,1837,12,5.333333333,201941
21,15,181,5,279,238,40,139,20,902,1181,2083,7,5.5,201941
22,1,196,43,199,295,24,77,0,834,744,1578,11,5.2,201941
22,2,177,38,231,177,100,53,3,779,873,1652,7,5.5,201941
22,3,287,48,706,589,11,127,0,1768,1702,3470,9,6,201941
22,4,200,32,577,472,24,91,4,1400,1370,2770,9,6.5,201941
22,5,148,21,401,231,61,80,14,956,1006,1962,10,5.5,201941
23,1,208,8,981,301,51,74,7,1630,1695,3325,14,5.6,201941
23,2,166,21,375,253,83,27,0,925,956,1881,9,5.5,201941
23,3,219,12,819,478,29,83,1,1641,1889,3530,19,0,201941
23,4,129,16,522,263,33,73,17,1053,1128,2181,6,5.5,201941
24,1,108,55,138,213,18,36,5,573,545,1118,10,5.2,201941
24,2,128,32,266,188,12,86,0,712,535,1247,6,5.5,201941
24,3,170,43,165,139,81,50,2,650,666,1316,9,5.25,201941
24,4,104,17,199,178,31,87,41,657,670,1327,5,5.5,201941
24,5,268,52,708,498,9,110,0,1645,1556,3201,10,6.666666667,201941
24,6,145,121,426,304,39,96,0,1131,1054,2185,6,6,201941
24,7,150,10,145,194,63,26,0,588,709,1297,9,5.25,201941
25,1,82,6,181,246,30,42,2,589,695,1284,13,5,201941
25,2,210,51,387,396,57,105,0,1206,1153,2359,7,6,201941
25,3,159,7,250,331,14,115,3,879,873,1752,8,5.6,201941
25,4,135,25,181,209,67,43,0,660,488,1148,8,5.333333333,201941
25,5,167,12,261,382,11,86,1,920,894,1814,8,5.666666667,201941
25,6,144,10,223,270,42,114,2,805,1008,1813,8,5.75,201941
25,7,225,17,405,397,11,59,0,1114,1115,2229,6,6,201941
26,1,217,14,255,258,6,111,0,861,897,1758,9,5.5,201941
26,2,206,18,385,408,5,119,7,1148,1071,2219,12,5.4,201941
26,3,283,22,405,499,13,246,8,1476,1457,2933,13,6.5,201941
26,4,124,11,151,141,30,55,7,519,600,1119,9,5.2,201941
26,5,155,19,201,186,30,150,0,741,622,1363,15,6,201941
26,6,202,9,204,289,8,154,2,868,907,1775,10,5.333333333,201941
26,7,111,16,139,184,41,56,1,548,592,1140,10,5,201941
27,1,173,14,214,200,115,51,1,768,788,1556,8,5.5,201941
27,2,217,23,229,548,20,58,3,1098,758,1856,8,5.666666667,201941
27,3,185,7,143,386,15,68,2,806,830,1636,7,5.666666667,201941
27,4,198,18,357,606,27,81,8,1295,1329,2624,8,6.5,201941
27,5,108,1,127,191,37,38,1,503,433,936,6,5.333333333,201941
27,6,152,6,202,336,15,78,0,789,731,1520,8,5.5,201941
28,1,220,30,530,400,16,93,0,1289,1118,2407,13,6,201941
28,2,202,18,411,263,16,107,47,1064,1183,2247,15,6,201941
28,3,105,15,180,95,4,41,0,440,461,901,7,4.333333333,201941
28,4,292,29,515,327,32,120,46,1361,1649,3010,17,6,201941
28,5,156,13,229,319,9,121,19,866,1021,1887,10,5.5,201941
28,6,115,7,151,160,23,46,4,506,427,933,13,5,201941
28,7,226,31,413,307,44,139,27,1187,1382,2569,13,6,201941
28,8,99,16,178,221,13,99,4,630,882,1512,13,7,201941
28,9,186,14,360,203,27,101,15,906,873,1779,11,5.75,201941
29,1,208,24,269,447,37,111,1,1097,1159,2256,7,5.5,201941
29,2,186,18,222,538,27,156,56,1203,1232,2435,11,6.333333333,201941
29,3,129,18,150,292,25,75,4,693,794,1487,6,5.666666667,201941
30,1,72,14,120,121,65,29,9,430,476,906,7,5,201941
30,2,122,18,185,68,50,27,33,503,561,1064,9,5.25,201941
30,3,143,11,159,133,77,96,24,643,660,1303,6,5.666666667,201941
30,4,96,6,276,125,36,47,0,586,598,1184,8,6,201941
30,5,129,19,239,175,21,58,8,649,866,1515,7,5.5,201941
30,6,144,10,236,205,36,93,5,729,651,1380,9,5,201941
30,7,155,11,260,182,80,70,29,787,755,1542,11,5.25,201941
30,8,173,24,490,252,94,80,5,1118,783,1901,11,5.4,201941
30,9,191,12,197,186,84,87,16,773,802,1575,8,5.5,201941
30,10,161,6,318,286,13,101,26,911,786,1697,6,6.5,201941
30,11,113,13,354,292,8,47,0,827,857,1684,5,5.5,201941
30,12,200,12,552,362,23,102,1,1252,1344,2596,10,6.25,201941
30,13,217,20,169,201,98,98,24,827,721,1548,10,5.4,201941
30,14,139,17,215,150,111,75,1,708,736,1444,8,5.5,201941
30,15,209,12,274,280,96,176,48,1095,918,2013,11,5.666666667,201941
30,16,155,12,247,282,48,122,48,914,1023,1937,10,5.333333333,201941
30,17,170,18,334,244,30,93,38,927,812,1739,8,5.5,201941
30,18,189,13,114,121,20,54,28,539,551,1090,8,5.25,201941
30,19,159,9,265,203,21,71,1,729,646,1375,13,5.6,201941
30,20,145,8,162,276,82,77,1,751,863,1614,10,5.4,201941
31,1,160,19,349,52,244,40,0,864,700,1564,8,5.5,201941
31,2,101,9,107,11,206,51,0,485,455,940,6,5.333333333,201941
31,3,443,116,1111,527,210,143,7,2557,2510,5067,21,6.666666667,201941
31,4,109,18,278,231,65,85,21,807,806,1613,4,6,201941
31,5,151,4,119,129,54,72,1,530,444,974,7,5.333333333,201941
32,1,159,36,177,174,48,81,20,695,692,1387,12,5.2,201941
32,2,180,33,180,88,104,102,18,705,603,1308,13,5.142857143,201941
32,3,157,52,182,307,10,113,0,821,647,1468,13,5.6,201941
32,4,176,58,202,274,27,135,19,891,816,1707,12,5.2,201941
1,1,180,46,328,221,53,89,2,919,930,1849,13,5.5,201942
1,2,232,54,653,434,48,140,7,1568,1611,3179,10,6.666666667,201942
1,3,176,51,567,400,34,180,5,1413,1438,2851,9,6.333333333,201942
2,1,179,15,382,289,22,147,26,1060,1124,2184,11,6,201942
2,2,199,15,345,375,7,160,0,1101,1086,2187,7,6,201942
2,3,257,21,406,390,21,205,30,1330,1328,2658,12,6,201942
2,4,186,15,687,225,49,57,4,1223,1119,2342,9,6.5,201942
2,5,253,19,700,287,163,155,5,1582,1724,3306,11,6,201942
2,6,251,25,566,294,23,145,0,1304,1307,2611,8,6.5,201942
2,7,302,18,523,324,32,98,9,1306,1310,2616,12,5.75,201942
2,8,200,22,561,390,17,114,14,1318,1332,2650,7,7,201942
3,1,168,23,253,277,27,109,3,860,856,1716,13,5.666666667,201942
3,2,125,25,460,255,40,49,0,954,920,1874,9,6,201942
4,1,188,25,234,381,71,107,25,1031,887,1918,11,5.5,201942
4,2,172,14,300,347,21,101,29,984,1124,2108,14,5.4,201942
5,1,348,23,380,353,28,151,16,1299,1699,2998,9,5.666666667,201942
5,2,372,30,279,274,40,72,0,1067,1129,2196,10,6,201942
5,3,416,41,301,499,34,123,9,1423,1473,2896,11,5.333333333,201942
5,4,419,36,515,515,16,172,14,1687,1808,3495,11,6,201942
5,5,328,19,401,505,17,90,23,1383,1315,2698,10,6,201942
5,6,308,20,305,317,23,71,50,1094,1011,2105,10,5.5,201942
5,7,346,14,294,374,39,78,6,1151,1069,2220,11,6,201942
6,1,219,9,248,210,10,97,13,806,838,1644,12,6,201942
6,2,131,13,309,237,33,99,11,833,696,1529,9,5.666666667,201942
7,1,225,8,231,212,29,30,1,736,763,1499,9,5.25,201942
7,2,225,10,97,804,92,31,1,1260,672,1932,9,5.25,201942
7,3,315,7,275,243,172,40,2,1054,519,1573,7,5.333333333,201942
7,4,276,10,119,215,17,37,19,693,696,1389,11,5.4,201942
7,5,335,10,182,406,32,83,0,1048,958,2006,11,5.666666667,201942
7,6,221,14,377,307,37,84,6,1046,946,1992,9,6,201942
7,7,232,14,241,245,95,89,7,923,958,1881,8,5.5,201942
7,8,182,11,173,699,52,83,0,1200,672,1872,12,5.25,201942
7,9,179,8,294,412,32,86,4,1015,1060,2075,9,5.666666667,201942
7,10,209,16,226,310,19,50,0,830,947,1777,9,5.5,201942
7,11,125,4,101,75,10,35,6,356,322,678,6,5.333333333,201942
7,12,234,14,322,463,13,56,0,1102,905,2007,9,5.5,201942
7,13,95,13,322,189,0,29,0,648,444,1092,9,5.25,201942
8,1,135,15,433,154,24,41,2,804,872,1676,4,6,201942
8,2,251,53,619,322,26,73,0,1344,1412,2756,17,5.75,201942
8,3,188,48,403,368,53,103,21,1184,1211,2395,4,6,201942
8,4,155,46,422,248,35,92,33,1031,1130,2161,11,6,201942
8,5,138,44,278,221,14,41,0,736,706,1442,10,5.25,201942
8,6,172,42,252,234,34,108,9,851,725,1576,10,12,201942
8,7,209,107,189,201,6,136,0,848,803,1651,8,5.25,201942
8,8,264,23,522,570,14,189,2,1584,1443,3027,10,7,201942
8,9,176,22,166,130,28,118,0,640,571,1211,10,5.2,201942
9,1,99,9,152,151,58,50,3,522,495,1017,5,6,201942
9,2,328,66,651,695,142,149,36,2067,2284,4351,12,6,201942
9,3,150,18,387,345,73,103,30,1106,1241,2347,7,6,201942
9,4,138,27,414,406,127,94,6,1212,1319,2531,11,6,201942
9,5,96,51,218,271,60,69,0,765,889,1654,7,6,201942
9,6,93,18,199,172,112,91,21,706,712,1418,7,6,201942
9,7,81,10,359,218,5,40,5,718,762,1480,9,6,201942
9,8,78,12,227,279,36,72,12,716,818,1534,5,6,201942
9,9,100,10,218,254,84,59,0,725,743,1468,5,6,201942
9,10,81,21,307,246,39,71,37,802,901,1703,6,6,201942
9,11,133,17,390,394,163,120,9,1226,1323,2549,7,7,201942
9,12,184,16,448,487,20,103,34,1292,1370,2662,11,6,201942
9,13,107,19,277,255,77,83,13,831,882,1713,4,6,201942
9,14,100,12,202,227,56,103,16,716,865,1581,5,6,201942
9,15,173,20,714,600,36,144,18,1705,2078,3783,10,6.5,201942
9,16,194,118,362,591,88,85,2,1440,1581,3021,15,6,201942
9,17,95,13,257,241,39,51,1,697,766,1463,6,6,201942
9,18,136,15,295,404,86,102,59,1097,1119,2216,12,6,201942
9,19,132,84,310,345,108,77,21,1077,1175,2252,5,6,201942
9,20,32,13,103,104,34,22,1,309,322,631,5,6,201942
9,21,112,5,160,235,66,40,1,619,622,1241,3,6,201942
9,22,121,12,231,286,73,79,12,814,840,1654,5,6,201942
9,23,140,33,382,402,65,66,2,1090,1086,2176,6,7,201942
9,24,245,50,494,561,180,139,6,1675,1847,3522,14,6,201942
10,1,255,31,220,223,18,152,46,945,879,1824,12,4.833333333,201942
10,2,200,31,319,321,23,132,15,1041,988,2029,10,5.25,201942
10,3,210,35,213,279,26,149,40,952,768,1720,11,5.4,201942
10,4,274,20,1312,510,23,160,0,2299,1343,3642,12,7,201942
11,1,173,105,230,282,43,64,3,900,671,1571,6,5.666666667,201942
11,2,154,36,253,201,81,97,9,831,776,1607,7,6,201942
11,3,131,35,185,258,25,89,6,729,691,1420,3,6,201942
11,4,154,51,168,249,33,112,1,768,674,1442,8,6,201942
11,5,237,68,402,455,30,151,12,1355,1285,2640,7,6.5,201942
11,6,107,30,222,190,28,65,4,646,623,1269,8,6,201942
11,7,206,49,301,462,16,72,1,1107,999,2106,9,5.5,201942
11,8,164,65,249,578,93,101,1,1251,1037,2288,9,5.5,201942
11,9,193,53,321,457,12,153,3,1192,1047,2239,10,5.666666667,201942
11,10,181,31,242,203,37,108,22,824,806,1630,10,5.6,201942
11,11,168,38,311,348,14,123,0,1002,922,1924,5,6,201942
11,12,190,55,403,452,22,108,10,1240,1170,2410,7,6.5,201942
11,13,182,35,246,164,32,90,7,756,647,1403,8,5.5,201942
11,14,166,41,240,208,50,79,0,784,742,1526,8,5.5,201942
11,15,138,47,258,229,10,102,13,797,736,1533,9,6,201942
12,1,108,21,202,166,57,54,3,611,567,1178,10,5.2,201942
12,2,174,36,257,390,15,109,0,981,869,1850,10,5.5,201942
12,3,213,27,266,389,11,63,0,969,1001,1970,11,5.2,201942
12,4,185,16,279,415,24,33,1,953,1067,2020,9,6,201942
12,5,202,30,207,251,7,55,4,756,638,1394,10,5.25,201942
12,6,144,22,187,346,17,14,8,738,667,1405,10,5,201942
12,7,187,21,258,379,12,102,21,980,870,1850,6,5.5,201942
12,8,205,24,181,291,6,56,0,763,879,1642,9,5.25,201942
12,9,193,20,303,459,81,36,0,1092,1043,2135,9,5.666666667,201942
13,1,317,18,168,196,68,59,19,845,635,1480,9,5.333333333,201942
13,2,192,14,121,174,63,64,16,644,589,1233,6,5.333333333,201942
13,3,173,21,172,161,87,91,4,709,801,1510,12,5.25,201942
13,4,231,17,270,244,52,74,16,904,955,1859,9,5.666666667,201942
13,5,206,18,418,349,66,169,29,1255,1244,2499,9,5.75,201942
13,6,317,58,582,593,71,134,7,1762,1833,3595,11,6,201942
13,7,194,27,305,339,60,60,0,985,954,1939,8,5.5,201942
14,1,150,34,121,81,53,108,3,550,608,1158,6,5.5,201942
14,2,209,21,172,117,64,114,0,697,494,1191,5,5.666666667,201942
14,3,259,20,341,114,9,196,9,948,825,1773,8,5.4,201942
14,4,149,18,276,315,19,85,9,871,847,1718,10,6,201942
14,5,174,21,398,216,26,84,0,919,901,1820,9,5.5,201942
14,6,183,21,519,247,23,63,0,1056,1168,2224,11,6,201942
14,7,122,12,247,118,0,25,0,524,514,1038,6,6,201942
14,8,378,55,813,636,37,195,4,2118,1965,4083,11,6.25,201942
14,9,129,14,223,222,20,90,0,698,790,1488,11,6,201942
14,10,165,68,429,288,2,107,1,1060,1025,2085,7,6.5,201942
14,11,159,17,258,230,45,115,15,839,814,1653,4,6,201942
14,12,214,18,529,145,36,67,0,1009,1035,2044,9,5.5,201942
14,13,201,21,426,243,10,117,2,1020,981,2001,6,6,201942
14,14,146,30,249,242,17,112,18,814,809,1623,7,6,201942
14,15,218,52,306,196,66,114,13,965,895,1860,10,5.6,201942
14,16,134,33,286,200,45,65,7,770,851,1621,5,6,201942
14,17,142,30,203,66,45,95,6,587,595,1182,7,5.25,201942
14,18,215,35,330,128,52,90,14,864,827,1691,9,5.4,201942
14,19,236,31,234,245,40,93,15,894,913,1807,8,5.25,201942
14,20,205,19,386,225,6,111,0,952,780,1732,10,5.666666667,201942
15,1,159,15,135,98,171,92,1,671,810,1481,7,5.333333333,201942
15,2,159,11,230,252,121,87,11,871,799,1670,6,6,201942
15,3,274,27,223,273,241,72,26,1136,1168,2304,10,5.666666667,201942
15,4,167,25,237,291,34,112,15,881,1016,1897,4,6,201942
15,5,179,41,304,274,30,57,4,889,879,1768,8,5.666666667,201942
15,6,149,14,262,472,24,127,4,1052,1060,2112,7,6.5,201942
15,7,130,21,313,246,82,94,2,888,876,1764,10,6,201942
15,8,74,9,140,211,16,37,4,491,486,977,4,6,201942
15,9,208,10,123,116,157,107,1,722,697,1419,9,5.75,201942
15,10,115,8,164,296,23,104,5,715,733,1448,6,6,201942
15,11,165,27,247,326,44,77,4,890,961,1851,8,6,201942
15,12,227,13,471,472,55,88,0,1326,1334,2660,8,6,201942
15,13,88,18,167,202,104,79,1,659,645,1304,8,6,201942
15,14,86,26,151,198,31,62,2,556,584,1140,4,6,201942
15,15,119,106,263,269,58,65,6,886,963,1849,6,6,201942
15,16,211,24,336,561,51,113,13,1309,1332,2641,8,6,201942
15,17,115,25,177,236,26,92,24,695,733,1428,8,6,201942
15,18,237,23,270,429,29,153,5,1146,1106,2252,7,5.666666667,201942
15,19,166,38,397,495,30,148,24,1298,1425,2723,10,6,201942
15,20,80,30,199,175,20,41,3,548,596,1144,6,6,201942
15,21,102,7,129,176,36,58,18,526,528,1054,6,5.5,201942
15,22,232,113,544,594,21,134,26,1664,1729,3393,14,6,201942
15,23,170,18,257,302,31,130,6,914,891,1805,6,5.333333333,201942
15,24,119,12,195,238,61,57,11,693,691,1384,4,6,201942
15,25,172,16,251,278,34,98,12,861,785,1646,6,6,201942
15,26,127,13,171,228,72,60,2,673,737,1410,9,7,201942
15,27,198,30,339,406,34,98,48,1153,1216,2369,9,5.666666667,201942
15,28,226,32,502,323,75,105,4,1267,1294,2561,9,5.666666667,201942
15,29,189,26,385,580,12,135,18,1345,1370,2715,8,6,201942
15,30,227,29,385,429,64,106,20,1260,1233,2493,16,6,201942
15,31,130,174,196,260,19,56,0,835,816,1651,6,6,201942
15,32,162,14,217,342,70,68,0,873,959,1832,9,6,201942
15,33,168,16,389,308,31,71,0,983,1024,2007,7,6,201942
15,34,167,14,181,386,11,65,8,832,986,1818,8,6,201942
15,35,278,26,270,435,8,188,0,1205,1144,2349,9,5.666666667,201942
15,36,197,16,197,299,71,81,1,862,966,1828,9,5.5,201942
15,37,206,37,309,423,70,133,17,1195,1157,2352,7,6,201942
15,38,162,59,335,318,52,66,5,997,943,1940,6,5.5,201942
15,39,159,12,245,247,38,61,0,762,807,1569,4,6,201942
15,40,289,52,275,376,104,154,5,1255,1337,2592,9,6,201942
15,41,246,34,558,549,85,85,14,1571,1544,3115,13,6,201942
16,1,157,10,276,152,15,30,0,640,566,1206,7,5.333333333,201942
16,2,113,34,110,143,10,53,0,463,511,974,9,5.25,201942
16,3,181,18,137,187,29,68,0,620,736,1356,10,5.25,201942
16,4,199,22,234,133,56,81,0,725,659,1384,8,5.5,201942
16,5,200,23,187,189,34,98,33,764,681,1445,10,5.666666667,201942
16,6,152,41,197,160,39,53,0,642,766,1408,12,5.5,201942
16,7,197,34,262,206,37,95,1,832,783,1615,9,5.5,201942
16,8,268,37,557,504,11,97,5,1479,1427,2906,12,6,201942
16,9,214,28,324,340,13,120,1,1040,920,1960,9,6.5,201942
16,10,163,28,297,269,15,66,0,838,690,1528,6,6,201942
16,11,186,32,204,141,50,129,0,742,688,1430,10,5.4,201942
16,12,126,16,212,140,17,69,0,580,561,1141,10,5,201942
17,1,143,57,355,360,39,104,2,1060,1107,2167,9,8,201942
17,2,162,13,289,366,14,90,8,942,900,1842,8,5.666666667,201942
17,3,236,25,412,422,36,97,0,1228,1170,2398,8,5.5,201942
17,4,194,16,310,346,27,92,11,996,928,1924,10,5.666666667,201942
17,5,128,10,145,158,20,59,0,520,482,1002,5,5.5,201942
18,1,114,18,146,127,51,64,17,537,385,922,7,5.25,201942
18,2,273,29,366,416,39,120,3,1246,1162,2408,9,7,201942
18,3,156,16,318,194,4,81,0,769,766,1535,8,5.75,201942
19,1,251,13,353,335,17,143,9,1121,1113,2234,9,6,201942
19,2,328,24,706,370,21,160,0,1609,1583,3192,9,6,201942
19,3,301,29,757,364,47,153,0,1651,1674,3325,7,6,201942
19,4,109,7,180,133,41,93,46,609,786,1395,5,6,201942
19,5,362,41,625,625,29,258,30,1970,1823,3793,8,6,201942
19,6,88,10,217,257,8,129,0,709,707,1416,5,6,201942
19,7,214,15,630,223,13,90,1,1186,923,2109,10,5.5,201942
19,8,64,12,138,108,3,33,0,358,388,746,7,6,201942
19,9,202,20,280,205,18,124,7,856,674,1530,9,5.25,201942
19,10,132,15,279,202,8,152,11,799,934,1733,6,7,201942
19,11,406,50,635,822,20,367,22,2322,2323,4645,13,6.333333333,201942
19,12,184,15,506,190,19,83,4,1001,1092,2093,13,5.666666667,201942
20,1,178,12,238,194,70,64,24,780,718,1498,8,5.5,201942
20,2,66,11,139,94,19,18,6,353,430,783,6,5.333333333,201942
20,3,122,11,151,98,156,37,21,596,534,1130,6,5.333333333,201942
20,4,126,12,93,114,52,53,27,477,691,1168,6,5.333333333,201942
20,5,163,21,265,277,21,39,0,786,539,1325,11,5.25,201942
20,6,176,8,145,134,105,115,50,733,616,1349,8,5.25,201942
20,7,284,16,243,249,25,75,0,892,727,1619,8,5.75,201942
20,8,393,31,681,611,41,123,13,1893,1911,3804,14,7,201942
20,9,238,16,172,166,90,51,14,747,890,1637,8,5.666666667,201942
20,10,180,14,291,159,35,44,6,729,904,1633,9,5.25,201942
21,1,203,18,294,212,48,48,1,824,766,1590,9,5.4,201942
21,2,206,67,262,108,83,37,0,763,707,1470,9,5.2,201942
21,3,201,4,245,201,51,136,21,859,801,1660,8,5.5,201942
21,4,239,15,209,81,132,76,2,754,444,1198,7,5.25,201942
21,5,202,25,419,253,23,89,4,1015,875,1890,8,5.666666667,201942
21,6,193,13,365,332,81,132,36,1152,1069,2221,6,7,201942
21,7,436,17,242,210,81,152,1,1139,965,2104,9,5.666666667,201942
21,8,152,8,220,105,54,81,21,641,834,1475,9,5.2,201942
21,9,191,22,509,388,68,136,13,1327,1261,2588,9,6,201942
21,10,213,21,443,317,32,135,31,1192,1121,2313,7,6,201942
21,11,73,4,162,124,23,27,2,415,415,830,4,6,201942
21,12,315,26,689,511,159,144,103,1947,1988,3935,16,7,201942
21,13,203,19,357,208,25,134,8,954,961,1915,8,5.666666667,201942
21,14,224,13,244,170,98,186,14,949,791,1740,12,5.333333333,201942
21,15,225,15,261,280,43,123,22,969,1023,1992,7,5.5,201942
22,1,189,35,242,318,24,84,2,894,767,1661,11,5.2,201942
22,2,135,21,270,172,110,50,3,761,849,1610,7,5.5,201942
22,3,300,39,813,649,15,153,0,1969,1903,3872,9,6,201942
22,4,231,40,629,441,22,118,1,1482,1517,2999,9,6.5,201942
22,5,171,31,386,254,62,65,15,984,966,1950,10,5.5,201942
23,1,188,13,975,271,29,74,8,1558,1688,3246,14,5.6,201942
23,2,240,12,398,270,24,25,0,969,1051,2020,8,5.25,201942
23,3,196,12,769,422,38,70,0,1507,1713,3220,19,0,201942
23,4,128,9,531,289,35,68,7,1067,1216,2283,6,5.5,201942
24,1,153,75,184,238,38,59,0,747,606,1353,10,5.2,201942
24,2,124,23,239,156,13,73,0,628,633,1261,6,5.5,201942
24,3,159,48,162,180,94,40,0,683,693,1376,9,5.25,201942
24,4,148,23,192,170,33,92,36,694,672,1366,5,5.5,201942
24,5,239,43,677,598,7,139,0,1703,1635,3338,10,6.666666667,201942
24,6,171,83,460,332,53,88,0,1187,1147,2334,6,6,201942
24,7,185,26,181,218,94,38,0,742,648,1390,9,5.25,201942
25,1,139,15,205,287,41,79,10,776,686,1462,13,4.25,201942
25,2,266,54,336,356,44,78,0,1134,1107,2241,7,6,201942
25,3,180,6,236,316,18,94,5,855,903,1758,8,5.6,201942
25,4,162,12,183,210,59,31,0,657,596,1253,8,5.333333333,201942
25,5,174,14,316,382,25,65,0,976,957,1933,8,5.666666667,201942
25,6,195,8,296,309,45,136,8,997,802,1799,8,5.75,201942
25,7,271,22,426,433,8,82,0,1242,1165,2407,6,6,201942
26,1,182,14,297,268,10,119,0,890,888,1778,9,5.5,201942
26,2,197,22,371,390,6,128,9,1123,1116,2239,12,5.4,201942
26,3,279,23,372,528,20,218,11,1451,1493,2944,13,6.5,201942
26,4,151,33,217,157,41,81,9,689,748,1437,9,5.2,201942
26,5,162,11,197,209,18,128,0,725,656,1381,15,6,201942
26,6,224,19,254,270,23,163,0,953,1043,1996,10,5.333333333,201942
26,7,150,14,155,185,49,57,0,610,611,1221,10,5.5,201942
27,1,130,19,185,231,90,30,0,685,485,1170,8,5.5,201942
27,2,208,14,238,444,23,82,1,1010,1224,2234,8,5.666666667,201942
27,3,206,10,158,419,8,58,2,861,827,1688,7,5.666666667,201942
27,4,205,21,302,590,15,86,4,1223,1342,2565,8,6.5,201942
27,5,102,4,123,211,35,34,3,512,486,998,6,5.333333333,201942
27,6,174,11,208,447,8,96,0,944,859,1803,8,5.5,201942
28,1,205,22,529,394,13,106,0,1269,1243,2512,13,6,201942
28,2,201,19,437,267,34,115,50,1123,901,2024,15,6,201942
28,3,148,18,256,128,10,60,0,620,613,1233,7,5,201942
28,4,303,20,480,326,23,148,36,1336,1375,2711,17,6,201942
28,5,161,10,201,345,7,146,19,889,978,1867,10,5.5,201942
28,6,178,22,164,245,39,65,8,721,697,1418,13,5.166666667,201942
28,7,238,24,459,343,55,131,30,1280,1224,2504,13,6,201942
28,8,130,12,175,263,22,106,1,709,780,1489,13,7,201942
28,9,161,10,340,203,25,84,20,843,873,1716,11,5.75,201942
29,1,244,22,322,403,27,110,0,1128,1097,2225,7,5.5,201942
29,2,263,15,205,510,19,132,79,1223,1117,2340,10,6,201942
29,3,134,20,182,321,18,72,4,751,670,1421,6,5.666666667,201942
30,1,128,17,162,157,83,40,12,599,462,1061,7,5.333333333,201942
30,2,127,7,168,77,50,38,22,489,578,1067,9,5.25,201942
30,3,168,7,157,129,74,67,35,637,733,1370,6,5.666666667,201942
30,4,94,9,278,124,45,45,0,595,587,1182,8,6,201942
30,5,125,16,246,169,16,44,7,623,695,1318,7,5.5,201942
30,6,123,9,217,215,32,77,6,679,705,1384,9,5.333333333,201942
30,7,222,22,287,177,94,84,45,931,878,1809,11,5.25,201942
30,8,170,21,350,250,90,63,9,953,1017,1970,11,5.4,201942
30,9,184,7,178,134,78,108,21,710,848,1558,8,5.5,201942
30,10,176,14,247,281,23,94,41,876,985,1861,6,6.5,201942
30,11,131,13,292,294,8,72,0,810,855,1665,5,5.5,201942
30,12,195,21,532,394,23,101,3,1269,1285,2554,10,6.25,201942
30,13,229,20,212,216,106,120,30,933,849,1782,10,5.4,201942
30,14,133,17,253,168,108,51,3,733,711,1444,8,5.5,201942
30,15,204,10,267,280,77,156,57,1051,992,2043,11,5.666666667,201942
30,16,149,22,240,263,33,120,71,898,841,1739,10,5.333333333,201942
30,17,148,17,255,222,22,70,31,765,840,1605,8,5.5,201942
30,18,181,13,97,108,18,51,24,492,589,1081,8,5.25,201942
30,19,157,16,234,167,51,68,0,693,848,1541,13,5.6,201942
30,20,139,10,198,348,101,82,0,878,832,1710,10,5.4,201942
31,1,163,18,282,40,203,71,0,777,775,1552,8,5.5,201942
31,2,68,13,111,15,179,49,0,435,503,938,6,5.333333333,201942
31,3,418,92,1095,462,196,158,4,2425,2492,4917,21,6.666666667,201942
31,4,123,11,271,215,76,101,22,819,841,1660,4,6,201942
31,5,141,15,199,165,67,81,7,675,733,1408,7,5.333333333,201942
32,1,192,48,217,206,44,123,23,853,691,1544,12,5.2,201942
32,2,211,25,181,135,84,130,14,780,705,1485,13,5.142857143,201942
32,3,175,37,187,337,8,125,0,869,748,1617,13,5.6,201942
32,4,220,86,264,303,20,124,14,1031,614,1645,12,5.2,201942
1,1,187,48,285,258,76,75,2,931,999,1930,13,5.5,201943
1,2,265,42,562,403,68,169,11,1520,1510,3030,10,6.666666667,201943
1,3,191,52,535,384,48,174,7,1391,1466,2857,9,6.333333333,201943
2,1,214,16,353,306,27,139,24,1079,1194,2273,11,6,201943
2,2,182,6,270,371,16,158,0,1003,1179,2182,7,6,201943
2,3,266,17,444,434,24,183,26,1394,1472,2866,12,6,201943
2,4,170,18,597,218,59,69,8,1139,1292,2431,9,6.5,201943
2,5,283,19,687,288,188,185,6,1656,1705,3361,11,6,201943
2,6,223,27,537,351,25,109,0,1272,1297,2569,8,6.5,201943
2,7,246,13,481,298,31,95,15,1179,1241,2420,12,5.75,201943
2,8,217,10,523,379,30,134,16,1309,1322,2631,7,7,201943
3,1,180,10,245,224,15,89,5,768,784,1552,13,5.5,201943
3,2,151,21,490,247,31,53,0,993,908,1901,9,5.666666667,201943
4,1,224,18,247,349,94,81,26,1039,1020,2059,12,5.75,201943
4,2,176,9,295,351,37,70,28,966,881,1847,14,5.4,201943
5,1,366,22,358,326,37,107,17,1233,1265,2498,9,5.666666667,201943
5,2,220,19,233,291,24,48,0,835,1000,1835,10,6,201943
5,3,288,32,308,475,62,94,21,1280,1247,2527,11,5.333333333,201943
5,4,359,34,553,526,15,154,19,1660,1748,3408,11,6,201943
5,5,309,18,392,525,21,75,10,1350,1367,2717,10,6,201943
5,6,205,15,273,279,19,79,47,917,1065,1982,10,5.5,201943
5,7,293,14,279,356,3,84,7,1036,1110,2146,11,6,201943
6,1,206,19,246,229,13,85,19,817,827,1644,13,6.2,201943
6,2,169,18,286,267,30,115,12,897,718,1615,9,5.666666667,201943
7,1,313,9,204,236,34,46,0,842,711,1553,9,5.25,201943
7,2,220,6,127,407,46,24,0,830,707,1537,9,5.25,201943
7,3,238,3,312,185,220,47,1,1006,468,1474,7,5.333333333,201943
7,4,231,10,131,212,7,39,16,646,1089,1735,11,5.4,201943
7,5,247,9,218,421,40,80,0,1015,1161,2176,11,5.666666667,201943
7,6,280,11,464,327,62,115,5,1264,1054,2318,9,6,201943
7,7,220,17,277,251,102,72,5,944,1046,1990,8,5.5,201943
7,8,231,11,245,580,75,119,3,1264,914,2178,12,5.25,201943
7,9,181,6,262,407,24,125,11,1016,1033,2049,9,5.666666667,201943
7,10,221,8,268,349,12,56,0,914,750,1664,9,5.5,201943
7,11,110,4,119,78,26,26,1,364,201,565,6,5.333333333,201943
7,12,223,5,328,425,16,52,0,1049,1022,2071,9,5.5,201943
7,13,47,21,314,527,1,10,0,920,807,1727,9,5.25,201943
8,1,167,11,459,168,25,50,2,882,789,1671,4,6,201943
8,2,266,69,734,328,21,51,0,1469,1458,2927,17,5.75,201943
8,3,193,40,397,359,30,110,39,1168,1189,2357,4,6,201943
8,4,195,29,388,299,33,146,54,1144,1098,2242,11,6,201943
8,5,213,67,269,255,43,59,1,907,849,1756,10,5.25,201943
8,6,172,40,241,241,28,81,12,815,640,1455,10,9,201943
8,7,161,51,179,213,9,111,0,724,805,1529,8,5.25,201943
8,8,248,28,441,546,14,178,1,1456,1465,2921,10,7,201943
8,9,254,33,177,137,38,108,10,757,558,1315,10,4.8,201943
9,1,90,5,121,113,53,49,3,434,512,946,5,6,201943
9,2,332,83,682,743,138,163,39,2180,2084,4264,12,6,201943
9,3,138,19,324,377,88,99,20,1065,1138,2203,7,6,201943
9,4,166,20,392,413,126,76,3,1196,1240,2436,11,6,201943
9,5,111,34,231,271,63,72,0,782,750,1532,7,6,201943
9,6,93,10,152,163,95,91,15,619,626,1245,7,6,201943
9,7,110,9,359,246,2,38,21,785,706,1491,9,6,201943
9,8,77,18,283,285,48,84,24,819,779,1598,5,6,201943
9,9,100,12,215,247,65,62,1,702,739,1441,5,6,201943
9,10,97,26,361,276,38,70,39,907,799,1706,6,6,201943
9,11,167,21,430,397,154,108,9,1286,1346,2632,7,7,201943
9,12,191,21,476,570,39,134,33,1464,1339,2803,11,6,201943
9,13,111,13,229,298,76,73,26,826,824,1650,4,6,201943
9,14,85,11,225,238,58,71,14,702,737,1439,5,6,201943
9,15,287,21,893,738,55,169,34,2197,1798,3995,11,7,201943
9,16,218,134,357,678,95,89,10,1581,1637,3218,15,6,201943
9,17,123,12,248,285,41,48,1,758,745,1503,6,6,201943
9,18,150,11,317,391,100,125,35,1129,1105,2234,12,6,201943
9,19,170,61,286,293,128,89,22,1049,1076,2125,5,6,201943
9,20,52,27,109,108,46,15,2,359,315,674,5,6,201943
9,21,129,14,151,241,54,48,2,639,617,1256,3,6,201943
9,22,127,17,229,284,87,70,17,831,815,1646,5,6,201943
9,23,139,38,412,336,35,49,1,1010,1040,2050,6,7,201943
9,24,265,52,567,693,247,184,14,2022,1752,3774,14,6,201943
10,1,169,16,213,234,31,150,25,838,794,1632,12,4.833333333,201943
10,2,202,29,336,328,19,123,21,1058,1154,2212,10,5.25,201943
10,3,185,33,233,275,49,145,46,966,810,1776,11,5.4,201943
10,4,262,39,410,495,17,164,1,1388,1407,2795,12,7,201943
11,1,162,115,214,353,61,94,0,999,827,1826,6,5.666666667,201943
11,2,160,38,262,230,72,97,15,874,823,1697,7,6,201943
11,3,141,35,220,250,30,104,5,785,735,1520,3,6,201943
11,4,172,60,221,233,48,89,0,823,732,1555,8,6,201943
11,5,269,79,377,443,23,152,18,1361,1297,2658,7,6.5,201943
11,6,134,25,234,217,25,88,4,727,570,1297,8,6,201943
11,7,190,50,280,437,22,54,0,1033,1269,2302,9,5.5,201943
11,8,196,61,301,442,80,83,3,1166,1127,2293,9,5.5,201943
11,9,194,61,306,442,20,145,1,1169,1171,2340,10,5.666666667,201943
11,10,178,41,230,221,40,123,41,874,843,1717,10,5.6,201943
11,11,183,39,289,365,8,131,0,1015,1016,2031,5,6,201943
11,12,163,67,406,449,23,99,8,1215,1231,2446,7,6.5,201943
11,13,163,37,199,169,43,95,9,715,708,1423,8,5.5,201943
11,14,146,41,239,175,62,70,0,733,675,1408,8,5.5,201943
11,15,130,58,222,232,18,70,23,753,776,1529,9,6,201943
12,1,127,29,176,147,38,54,2,573,587,1160,10,5.2,201943
12,2,179,15,204,375,10,116,5,904,980,1884,10,5.5,201943
12,3,137,20,176,290,14,52,0,689,841,1530,11,5.2,201943
12,4,211,24,269,470,19,39,0,1032,986,2018,9,6,201943
12,5,142,17,150,201,0,26,11,547,712,1259,10,5.25,201943
12,6,145,16,231,561,21,17,3,994,985,1979,10,5.25,201943
12,7,170,10,194,317,8,64,2,765,943,1708,6,5.5,201943
12,8,131,16,166,267,5,38,0,623,700,1323,9,5.25,201943
12,9,181,20,289,422,26,42,0,980,1093,2073,9,5.666666667,201943
13,1,207,20,125,164,47,59,11,633,645,1278,9,5.333333333,201943
13,2,145,27,135,178,75,70,20,650,670,1320,6,5.333333333,201943
13,3,187,25,191,225,133,107,0,868,632,1500,12,5.25,201943
13,4,218,16,265,286,45,79,25,934,967,1901,9,5.666666667,201943
13,5,280,17,410,372,69,154,29,1331,1205,2536,9,5.75,201943
13,6,334,61,676,664,80,157,20,1992,1786,3778,11,6,201943
13,7,189,21,290,366,47,46,2,961,913,1874,8,5.5,201943
14,1,149,34,157,88,57,99,6,590,570,1160,6,5.5,201943
14,2,196,18,163,102,73,141,2,695,573,1268,5,5.666666667,201943
14,3,294,29,347,98,18,157,3,946,929,1875,8,5.4,201943
14,4,202,16,314,273,23,104,4,936,999,1935,10,6,201943
14,5,199,26,435,196,50,84,1,991,997,1988,9,5.5,201943
14,6,208,25,532,257,9,81,2,1114,1128,2242,11,6,201943
14,7,115,20,266,132,0,28,0,561,512,1073,6,6,201943
14,8,317,42,756,612,47,228,2,2004,1950,3954,11,6,201943
14,9,110,22,186,234,9,79,2,642,752,1394,11,6,201943
14,10,191,73,414,283,5,109,3,1078,1003,2081,7,6.5,201943
14,11,179,17,273,268,66,139,25,967,856,1823,4,6,201943
14,12,250,27,541,206,32,57,0,1113,1025,2138,9,5.5,201943
14,13,199,12,437,222,9,113,4,996,896,1892,6,6,201943
14,14,148,17,297,268,25,137,13,905,859,1764,7,6,201943
14,15,252,42,260,191,78,117,6,946,845,1791,10,5.6,201943
14,16,129,26,246,157,32,92,2,684,720,1404,5,6,201943
14,17,133,35,221,79,61,69,12,610,567,1177,7,5.25,201943
14,18,221,31,305,134,69,83,19,862,790,1652,9,5.4,201943
14,19,165,23,254,198,22,95,8,765,754,1519,8,5.25,201943
14,20,204,22,333,215,7,85,1,867,892,1759,10,5.666666667,201943
15,1,137,11,126,93,200,72,1,640,623,1263,7,5.333333333,201943
15,2,139,11,188,254,99,48,5,744,813,1557,6,6,201943
15,3,235,19,207,211,242,76,19,1009,1142,2151,10,5.666666667,201943
15,4,158,25,226,298,45,122,15,889,918,1807,4,6,201943
15,5,151,58,252,254,24,62,9,810,907,1717,8,5.666666667,201943
15,6,139,7,230,439,20,76,10,921,1012,1933,7,6.5,201943
15,7,130,15,278,230,77,78,8,816,839,1655,10,6,201943
15,8,99,13,144,222,25,43,8,554,586,1140,4,6,201943
15,9,198,12,135,104,171,96,3,719,741,1460,9,5.75,201943
15,10,117,4,159,287,28,101,9,705,696,1401,6,6,201943
15,11,159,31,287,357,64,86,7,991,916,1907,8,6,201943
15,12,193,17,513,453,55,69,0,1300,1272,2572,8,6,201943
15,13,91,17,149,188,101,78,1,625,651,1276,8,6,201943
15,14,66,15,119,201,23,52,3,479,572,1051,4,6,201943
15,15,144,99,232,315,65,54,8,917,915,1832,6,6,201943
15,16,212,30,339,569,30,107,16,1303,1318,2621,8,6,201943
15,17,111,18,205,285,33,101,22,775,695,1470,8,6,201943
15,18,211,30,269,363,33,113,3,1022,1152,2174,7,5.666666667,201943
15,19,166,45,397,539,19,122,22,1310,1347,2657,10,6,201943
15,20,86,9,265,266,18,45,8,697,611,1308,6,6,201943
15,21,127,7,108,170,46,53,22,533,472,1005,6,5.5,201943
15,22,255,92,575,625,28,153,28,1756,1681,3437,14,6,201943
15,23,147,14,235,307,28,99,1,831,798,1629,6,5.333333333,201943
15,24,125,32,199,233,31,54,3,677,717,1394,4,6,201943
15,25,153,20,252,287,33,73,9,827,809,1636,6,6,201943
15,26,112,4,179,247,80,51,0,673,667,1340,9,7,201943
15,27,191,13,330,440,29,123,38,1164,1128,2292,9,5.666666667,201943
15,28,231,21,472,297,59,105,9,1194,1293,2487,9,5.666666667,201943
15,29,201,20,458,620,11,114,12,1436,1340,2776,8,6,201943
15,30,224,32,368,377,63,84,18,1166,1218,2384,16,6,201943
15,31,131,175,156,256,18,44,0,780,820,1600,6,6,201943
15,32,124,20,240,356,48,89,0,877,780,1657,9,6,201943
15,33,144,15,329,305,26,60,0,879,934,1813,7,6,201943
15,34,154,10,200,359,26,77,5,831,837,1668,8,6,201943
15,35,250,18,300,480,9,160,4,1221,1187,2408,9,5.666666667,201943
15,36,176,19,220,311,108,83,7,924,1031,1955,9,5.5,201943
15,37,205,24,289,420,77,128,12,1155,1214,2369,7,6,201943
15,38,153,42,285,324,40,58,5,907,937,1844,6,5.5,201943
15,39,149,9,238,246,37,53,2,734,736,1470,4,6,201943
15,40,236,62,211,413,108,133,2,1165,1280,2445,9,6,201943
15,41,230,25,501,521,67,77,13,1434,1490,2924,13,6,201943
16,1,123,17,216,126,13,18,2,515,584,1099,7,5.333333333,201943
16,2,91,31,88,111,16,48,0,385,356,741,9,5.25,201943
16,3,172,19,137,262,37,59,1,687,766,1453,10,5.25,201943
16,4,227,35,221,127,62,86,0,758,681,1439,8,5.5,201943
16,5,179,36,187,201,49,86,14,752,651,1403,10,5.666666667,201943
16,6,205,29,215,167,27,67,0,710,708,1418,12,5.5,201943
16,7,198,18,232,200,33,70,0,751,699,1450,9,5.5,201943
16,8,320,33,577,497,11,104,1,1543,1497,3040,12,6,201943
16,9,213,26,323,314,13,99,0,988,954,1942,9,6.5,201943
16,10,150,17,308,265,26,66,0,832,775,1607,6,6,201943
16,11,210,47,201,176,66,103,0,803,694,1497,10,5.4,201943
16,12,177,27,201,155,29,72,3,664,661,1325,10,5.25,201943
17,1,170,41,374,391,39,75,2,1092,1055,2147,9,8,201943
17,2,125,7,266,383,12,85,5,883,851,1734,8,5.666666667,201943
17,3,207,16,363,402,31,88,1,1108,1104,2212,8,5.5,201943
17,4,171,14,316,318,31,70,7,927,945,1872,10,5.666666667,201943
17,5,88,8,148,122,17,37,0,420,481,901,5,5.5,201943
18,1,181,17,167,156,38,106,45,710,645,1355,7,5.25,201943
18,2,301,35,352,427,42,111,0,1268,1113,2381,8,6.666666667,201943
18,3,130,11,294,215,3,74,0,727,729,1456,8,5.75,201943
19,1,245,21,303,301,18,145,8,1041,1129,2170,9,6,201943
19,2,251,19,705,421,15,161,2,1574,1656,3230,9,6,201943
19,3,301,23,773,374,45,137,0,1653,1767,3420,7,6,201943
19,4,125,12,206,135,57,119,46,700,664,1364,5,6,201943
19,5,314,34,624,589,44,272,28,1905,2051,3956,8,6,201943
19,6,86,14,254,291,5,112,1,763,779,1542,5,6,201943
19,7,209,17,641,210,11,73,0,1161,1154,2315,10,5.5,201943
19,8,59,6,162,128,2,30,0,387,368,755,7,6,201943
19,9,210,17,313,248,30,108,5,931,901,1832,9,5.25,201943
19,10,156,10,322,242,14,154,17,915,841,1756,6,7,201943
19,11,441,56,634,848,17,397,15,2408,2293,4701,13,6.333333333,201943
19,12,189,11,632,183,16,81,3,1115,1257,2372,13,5.666666667,201943
20,1,180,21,188,178,43,56,27,693,633,1326,8,5.5,201943
20,2,148,27,209,140,31,27,8,590,670,1260,6,5.333333333,201943
20,3,129,30,164,118,182,37,24,684,495,1179,6,5.333333333,201943
20,4,124,12,105,94,48,68,20,471,362,833,6,5.333333333,201943
20,5,141,23,214,246,34,40,0,698,674,1372,11,5.25,201943
20,6,200,7,101,123,139,118,44,732,747,1479,8,5.25,201943
20,7,154,13,191,246,11,52,0,667,916,1583,8,5.75,201943
20,8,441,30,705,721,44,159,10,2110,1901,4011,14,7,201943
20,9,257,19,249,178,59,71,7,840,584,1424,8,5.666666667,201943
20,10,186,8,286,189,25,36,7,737,896,1633,9,5.25,201943
21,1,187,20,268,195,50,43,3,766,894,1660,9,5.4,201943
21,2,151,59,228,119,60,56,0,673,591,1264,9,5.2,201943
21,3,237,9,240,227,84,148,9,954,861,1815,8,5.5,201943
21,4,219,9,221,81,118,60,1,709,498,1207,7,5.25,201943
21,5,207,16,437,222,25,70,11,988,1114,2102,8,5.666666667,201943
21,6,246,16,336,313,83,132,42,1168,1172,2340,6,7,201943
21,7,434,6,229,208,60,177,0,1114,1144,2258,9,5.666666667,201943
21,8,147,15,243,98,48,75,25,651,634,1285,9,5.2,201943
21,9,201,34,485,388,75,99,9,1291,1264,2555,9,6,201943
21,10,226,23,541,364,33,152,36,1375,1152,2527,7,6,201943
21,11,81,0,154,86,28,38,5,392,430,822,4,6,201943
21,12,394,29,833,533,157,184,151,2281,2024,4305,15,6.5,201943
21,13,214,21,363,195,36,133,3,965,985,1950,8,5.666666667,201943
21,14,208,13,202,174,85,128,26,836,1015,1851,12,5.333333333,201943
21,15,233,9,270,243,33,109,21,918,949,1867,7,5.5,201943
22,1,192,35,174,314,22,50,2,789,892,1681,11,5.2,201943
22,2,182,27,274,192,127,56,6,864,750,1614,7,5.5,201943
22,3,276,48,757,632,22,136,0,1871,1892,3763,9,6,201943
22,4,203,46,649,442,23,101,1,1465,1377,2842,9,6.5,201943
22,5,163,21,373,240,71,72,16,956,1039,1995,10,5.5,201943
23,1,245,8,1127,286,38,78,15,1797,1721,3518,14,5.6,201943
23,2,199,15,391,271,17,42,0,935,1174,2109,8,5.25,201943
23,3,223,14,922,477,52,90,0,1778,1575,3353,19,0,201943
23,4,138,8,534,275,31,64,13,1063,1026,2089,6,5.5,201943
24,1,115,66,147,184,18,60,4,594,505,1099,10,5.2,201943
24,2,115,27,222,164,20,77,1,626,628,1254,6,5,201943
24,3,162,69,179,187,91,67,0,755,693,1448,9,5.25,201943
24,4,170,26,196,163,67,108,34,764,644,1408,5,5.5,201943
24,5,294,47,715,531,21,117,0,1725,1682,3407,9,6.333333333,201943
24,6,177,122,396,328,65,68,0,1156,1187,2343,6,6,201943
24,7,147,18,161,198,60,35,0,619,575,1194,9,5.25,201943
25,1,121,13,249,252,22,55,12,724,719,1443,13,5.75,201943
25,2,233,49,347,382,30,86,0,1127,1176,2303,7,5.5,201943
25,3,153,6,224,324,22,83,14,826,785,1611,8,5.6,201943
25,4,117,22,187,221,53,34,0,634,632,1266,8,5,201943
25,5,145,8,220,327,8,57,3,768,634,1402,8,4,201943
25,6,184,9,283,306,47,105,13,947,893,1840,8,5,201943
25,7,163,9,305,302,10,46,0,835,834,1669,6,4,201943
26,1,178,13,273,254,7,110,0,835,884,1719,9,5.5,201943
26,2,226,12,324,393,5,121,20,1101,1096,2197,12,5.4,201943
26,3,316,27,427,522,18,239,12,1561,1442,3003,13,6.5,201943
26,4,114,16,191,150,40,80,6,597,668,1265,9,5.2,201943
26,5,143,17,159,199,24,139,0,681,619,1300,15,6,201943
26,6,223,19,220,313,18,149,0,942,890,1832,10,5.333333333,201943
26,7,160,15,138,204,42,58,1,618,604,1222,10,5.5,201943
27,1,188,31,282,274,147,35,0,957,704,1661,8,5.5,201943
27,2,211,12,154,375,28,79,1,860,1142,2002,8,5.666666667,201943
27,3,218,9,170,447,17,72,4,937,957,1894,7,5.666666667,201943
27,4,257,18,353,619,29,85,9,1370,1188,2558,8,6.5,201943
27,5,100,1,125,259,14,39,1,539,398,937,6,5.333333333,201943
27,6,187,15,235,459,6,78,0,980,808,1788,8,5.5,201943
28,1,170,28,496,346,10,99,0,1149,1296,2445,13,6,201943
28,2,195,18,503,303,21,109,68,1217,1205,2422,15,6,201943
28,3,111,9,246,128,10,75,2,581,582,1163,7,5.333333333,201943
28,4,323,38,406,366,52,147,47,1379,1471,2850,17,6,201943
28,5,226,26,252,367,16,119,44,1050,923,1973,10,5.5,201943
28,6,153,17,161,202,47,64,4,648,669,1317,13,5.166666667,201943
28,7,230,29,426,343,50,164,27,1269,1214,2483,13,6,201943
28,8,120,9,207,258,43,103,2,742,758,1500,13,7,201943
28,9,155,9,309,193,20,77,20,783,931,1714,11,5.5,201943
29,1,245,21,312,449,18,128,0,1173,1165,2338,7,5.5,201943
29,2,252,19,259,479,21,137,79,1246,1169,2415,11,6.333333333,201943
29,3,115,18,159,302,21,71,4,690,695,1385,6,5.666666667,201943
30,1,114,8,163,148,57,23,13,526,399,925,7,5.333333333,201943
30,2,132,20,161,76,42,27,53,511,486,997,9,5.25,201943
30,3,150,10,183,134,87,73,33,670,698,1368,6,5.666666667,201943
30,4,95,7,270,145,35,50,0,602,611,1213,8,6,201943
30,5,150,14,229,204,18,54,1,670,638,1308,7,5.5,201943
30,6,179,11,265,251,42,63,10,821,728,1549,9,5.333333333,201943
30,7,192,2,260,182,61,72,36,805,866,1671,11,5.25,201943
30,8,179,18,388,216,81,64,2,948,1097,2045,11,5.4,201943
30,9,193,15,193,194,78,87,26,786,730,1516,8,5.5,201943
30,10,179,9,303,248,28,104,34,905,1068,1973,6,6.5,201943
30,11,147,6,313,330,10,54,0,860,721,1581,5,5.5,201943
30,12,244,20,558,400,30,118,2,1372,1152,2524,10,6.25,201943
30,13,234,17,243,223,108,120,45,990,875,1865,10,5.4,201943
30,14,125,13,245,145,123,63,1,715,777,1492,8,5.5,201943
30,15,262,13,246,271,131,148,63,1134,1139,2273,11,5.666666667,201943
30,16,187,14,242,355,43,110,70,1021,849,1870,10,5.333333333,201943
30,17,160,23,300,207,29,77,41,837,857,1694,8,5.5,201943
30,18,191,9,172,160,34,48,22,636,506,1142,8,5.25,201943
30,19,165,14,249,163,35,64,1,691,696,1387,13,5.6,201943
30,20,141,11,203,375,92,61,0,883,778,1661,10,5.4,201943
31,1,178,16,302,43,228,42,0,809,773,1582,8,5.5,201943
31,2,75,12,101,19,197,53,0,457,471,928,6,5.333333333,201943
31,3,424,110,1164,506,177,130,4,2515,2427,4942,21,6.666666667,201943
31,4,125,21,331,194,58,74,32,835,820,1655,4,6,201943
31,5,140,12,162,189,59,124,4,690,615,1305,7,5.333333333,201943
32,1,189,37,172,169,37,108,44,756,797,1553,12,5.2,201943
32,2,185,37,209,111,104,119,10,775,846,1621,13,5.142857143,201943
32,3,184,32,173,276,5,106,1,777,829,1606,13,5.6,201943
32,4,219,76,276,279,19,116,13,998,1051,2049,12,5.2,201943
1,1,212,30,269,268,58,78,3,918,928,1846,13,5.5,201944
1,2,235,36,525,395,60,148,16,1415,1561,2976,10,6.666666667,201944
1,3,193,45,492,388,29,127,4,1278,1358,2636,9,6.333333333,201944
2,1,198,17,329,293,28,157,33,1055,804,1859,11,6,201944
2,2,166,9,313,365,16,152,0,1021,1045,2066,7,6,201944
2,3,257,15,468,420,22,192,28,1402,1327,2729,12,6,201944
2,4,158,11,548,191,67,54,9,1038,1162,2200,9,6.5,201944
2,5,246,28,632,271,158,173,6,1514,1621,3135,11,6,201944
2,6,221,14,506,329,21,116,0,1207,1238,2445,7,6,201944
2,7,268,29,482,283,35,89,9,1195,1239,2434,12,5.75,201944
2,8,202,14,497,338,33,112,30,1226,1306,2532,7,7,201944
3,1,166,11,269,257,23,102,7,835,810,1645,13,5.666666667,201944
3,2,147,12,530,232,22,69,0,1012,906,1918,9,6,201944
4,1,153,14,192,362,61,74,29,885,1033,1918,11,5.5,201944
4,2,179,13,314,376,37,93,34,1046,1086,2132,14,5.4,201944
5,1,325,16,358,360,30,98,11,1198,1188,2386,9,5.666666667,201944
5,2,225,13,189,272,16,50,0,765,1060,1825,10,6,201944
5,3,270,29,331,422,55,125,25,1257,1304,2561,11,5.333333333,201944
5,4,363,37,575,563,12,129,30,1709,1653,3362,11,6,201944
5,5,240,14,351,557,21,93,34,1310,1291,2601,10,6,201944
5,6,203,17,282,318,12,71,56,959,950,1909,10,5.5,201944
5,7,271,12,299,351,4,94,8,1039,927,1966,10,6,201944
6,1,182,5,234,215,11,90,22,759,846,1605,13,6.2,201944
6,2,148,15,292,223,24,123,17,842,826,1668,9,5.666666667,201944
7,1,299,9,118,184,19,20,0,649,730,1379,9,5.25,201944
7,2,210,6,167,473,24,45,0,925,621,1546,9,5.25,201944
7,3,258,8,248,147,145,45,3,854,575,1429,7,5.333333333,201944
7,4,192,9,91,185,0,44,19,540,574,1114,11,5.4,201944
7,5,251,12,194,436,53,66,0,1012,1065,2077,11,5.666666667,201944
7,6,202,16,390,274,56,94,5,1037,913,1950,9,6,201944
7,7,232,27,254,288,103,77,5,986,847,1833,8,5.5,201944
7,8,240,12,190,495,63,83,4,1087,1026,2113,12,5.25,201944
7,9,167,16,299,414,29,105,0,1030,989,2019,9,5.666666667,201944
7,10,142,8,232,416,15,47,0,860,1000,1860,9,5.5,201944
7,11,156,5,180,76,14,29,3,463,385,848,6,5.333333333,201944
7,12,166,10,309,438,12,38,0,973,966,1939,9,5.5,201944
7,13,133,22,205,304,1,42,0,707,1225,1932,9,5.25,201944
8,1,148,11,455,156,17,52,4,843,807,1650,4,6,201944
8,2,252,60,717,348,34,60,2,1473,1020,2493,17,5.75,201944
8,3,203,49,418,329,28,95,28,1150,1095,2245,4,6,201944
8,4,183,28,385,270,46,146,48,1106,1009,2115,11,6,201944
8,5,193,54,252,242,20,49,0,810,785,1595,10,5.25,201944
8,6,173,40,310,237,41,106,19,926,1094,2020,10,8,201944
8,7,171,84,190,223,14,84,0,766,801,1567,8,5.25,201944
8,8,230,33,436,536,9,189,1,1434,1416,2850,10,7,201944
8,9,242,35,227,138,53,119,1,815,626,1441,10,5,201944
9,1,111,14,142,160,83,64,9,583,471,1054,5,6,201944
9,2,331,64,713,785,166,194,69,2322,2152,4474,12,6,201944
9,3,139,15,368,410,90,111,48,1181,1042,2223,7,6,201944
9,4,152,20,386,437,136,107,4,1242,1181,2423,11,6,201944
9,5,113,49,286,304,83,81,1,917,757,1674,7,6,201944
9,6,106,11,192,184,98,81,20,692,758,1450,7,6,201944
9,7,92,13,401,278,3,30,13,830,741,1571,9,6,201944
9,8,106,10,305,300,42,59,27,849,748,1597,5,6,201944
9,9,96,11,198,242,86,65,2,700,695,1395,5,6,201944
9,10,102,16,374,292,30,66,40,920,866,1786,6,6,201944
9,11,147,22,433,405,146,106,5,1264,1183,2447,7,7,201944
9,12,195,26,464,582,49,133,45,1494,1292,2786,11,6,201944
9,13,99,8,279,267,81,68,16,818,788,1606,4,6,201944
9,14,102,17,206,250,74,78,15,742,692,1434,5,6,201944
9,15,230,22,1036,835,44,171,27,2365,1856,4221,10,6.5,201944
9,16,230,98,412,654,90,110,14,1608,1505,3113,15,6,201944
9,17,124,15,275,286,48,67,2,817,740,1557,6,6,201944
9,18,153,18,315,411,104,112,59,1172,1065,2237,12,6,201944
9,19,179,65,276,361,135,80,24,1120,1050,2170,5,6,201944
9,20,45,15,98,103,45,12,1,319,295,614,5,6,201944
9,21,99,10,157,227,81,35,0,609,607,1216,3,6,201944
9,22,119,11,205,246,107,71,17,776,783,1559,5,6,201944
9,23,118,35,367,365,54,57,6,1002,1039,2041,6,7,201944
9,24,269,38,572,653,232,181,13,1958,1725,3683,14,6,201944
10,1,158,25,179,224,20,119,25,750,752,1502,12,4.666666667,201944
10,2,166,23,307,297,16,150,17,976,1065,2041,10,5.25,201944
10,3,164,18,211,254,24,100,32,803,885,1688,11,5.4,201944
10,4,274,28,411,471,12,128,0,1324,1351,2675,12,7,201944
11,1,136,56,165,260,35,75,4,731,903,1634,6,5.666666667,201944
11,2,171,36,260,218,66,90,13,854,763,1617,7,6,201944
11,3,168,29,233,242,28,99,7,806,678,1484,3,6,201944
11,4,183,45,194,227,48,99,1,797,763,1560,8,6,201944
11,5,255,90,364,496,13,142,17,1377,1302,2679,7,6.5,201944
11,6,127,26,219,198,28,57,5,660,666,1326,8,6,201944
11,7,192,84,369,690,14,61,0,1410,905,2315,9,5.5,201944
11,8,144,41,270,419,95,85,3,1057,1188,2245,9,5.5,201944
11,9,180,38,301,476,6,109,6,1116,1119,2235,10,5.666666667,201944
11,10,192,44,220,209,37,118,48,868,819,1687,10,5.6,201944
11,11,175,45,293,382,17,98,0,1010,965,1975,5,6,201944
11,12,188,51,383,400,23,94,9,1148,1215,2363,7,6.5,201944
11,13,159,40,223,187,55,75,10,749,719,1468,8,5.5,201944
11,14,151,44,253,206,61,58,0,773,773,1546,8,5.5,201944
11,15,132,57,201,220,9,82,8,709,755,1464,9,6,201944
12,1,119,21,226,134,44,64,3,611,730,1341,10,5.2,201944
12,2,184,23,262,361,9,93,9,941,974,1915,10,5.5,201944
12,3,197,23,254,399,12,48,1,934,885,1819,11,5.2,201944
12,4,173,21,298,549,26,55,0,1122,1006,2128,9,6,201944
12,5,148,28,129,267,1,33,6,612,625,1237,10,5.25,201944
12,6,143,21,319,779,30,16,6,1314,777,2091,10,5.25,201944
12,7,184,17,182,338,7,94,41,863,821,1684,6,5.5,201944
12,8,159,35,168,269,3,50,0,684,700,1384,9,5.25,201944
12,9,178,22,250,387,33,40,0,910,1037,1947,9,5.666666667,201944
13,1,186,18,105,253,59,52,22,695,514,1209,9,5.333333333,201944
13,2,175,25,99,164,95,66,24,648,674,1322,6,5.333333333,201944
13,3,193,20,195,232,114,129,4,887,725,1612,12,5.25,201944
13,4,200,17,249,298,72,100,49,985,974,1959,9,5.666666667,201944
13,5,236,20,389,337,84,157,30,1253,1273,2526,9,5.75,201944
13,6,299,50,656,595,70,125,18,1813,1868,3681,11,6,201944
13,7,167,17,287,339,51,61,2,924,1039,1963,8,5.5,201944
14,1,143,33,137,85,62,88,7,555,624,1179,6,5.5,201944
14,2,174,23,199,79,69,127,4,675,703,1378,5,5.666666667,201944
14,3,193,17,289,99,15,139,5,757,754,1511,8,5.4,201944
14,4,171,17,261,312,18,90,4,873,912,1785,10,6,201944
14,5,164,20,364,205,45,58,0,856,941,1797,9,5.5,201944
14,6,194,29,491,281,23,69,1,1088,1018,2106,11,6,201944
14,7,134,17,284,116,0,33,0,584,543,1127,6,6,201944
14,8,353,47,730,636,34,210,0,2010,1999,4009,11,6.25,201944
14,9,89,17,176,240,12,68,1,603,584,1187,11,6,201944
14,10,178,59,411,299,12,119,4,1082,1029,2111,7,6.5,201944
14,11,178,23,292,223,53,132,34,935,853,1788,4,6,201944
14,12,207,24,545,198,34,58,3,1069,1001,2070,9,5.5,201944
14,13,182,17,415,278,13,103,6,1014,898,1912,6,6,201944
14,14,142,21,271,221,18,108,16,797,842,1639,7,6,201944
14,15,218,28,271,152,62,80,24,835,898,1733,10,5.6,201944
14,16,181,33,316,196,40,77,6,849,749,1598,5,6,201944
14,17,149,28,264,85,56,111,6,699,522,1221,7,5.25,201944
14,18,193,45,347,124,71,72,13,865,877,1742,9,5.4,201944
14,19,172,15,230,170,28,61,17,693,742,1435,8,5.25,201944
14,20,198,20,310,195,5,95,0,823,966,1789,10,5.666666667,201944
15,1,139,9,117,72,203,74,0,614,670,1284,7,5.333333333,201944
15,2,124,13,222,248,116,46,13,782,821,1603,6,6,201944
15,3,238,20,191,268,281,74,19,1091,1016,2107,10,5.666666667,201944
15,4,175,17,226,340,55,111,7,931,873,1804,4,6,201944
15,5,170,51,297,232,26,56,6,838,955,1793,8,5.666666667,201944
15,6,187,12,304,429,37,67,18,1054,991,2045,7,6.5,201944
15,7,128,17,284,283,79,60,5,856,873,1729,10,6,201944
15,8,92,8,198,234,10,44,12,598,480,1078,4,6,201944
15,9,206,12,132,113,150,81,6,700,703,1403,9,5.75,201944
15,10,105,6,182,293,24,73,10,693,711,1404,6,6,201944
15,11,157,31,280,344,50,60,11,933,927,1860,8,6,201944
15,12,206,18,468,484,67,67,0,1310,1224,2534,8,6,201944
15,13,88,19,160,186,141,70,0,664,611,1275,8,6,201944
15,14,71,22,145,203,29,51,3,524,532,1056,4,6,201944
15,15,161,95,259,345,64,61,8,993,882,1875,6,6,201944
15,16,209,33,350,539,39,110,15,1295,1316,2611,8,6,201944
15,17,122,15,195,269,29,76,20,726,711,1437,8,6,201944
15,18,243,35,324,409,30,100,11,1152,1130,2282,7,5.666666667,201944
15,19,186,54,413,606,40,149,29,1477,1287,2764,10,6,201944
15,20,83,28,249,205,17,43,2,627,521,1148,6,6,201944
15,21,101,9,114,152,28,63,27,494,579,1073,6,5.5,201944
15,22,237,133,610,609,35,125,41,1790,1660,3450,14,6,201944
15,23,157,16,192,279,22,95,2,763,875,1638,6,5.333333333,201944
15,24,99,7,233,249,59,65,9,721,695,1416,4,6,201944
15,25,163,15,214,242,41,81,12,768,869,1637,6,6,201944
15,26,136,7,185,246,84,67,1,726,702,1428,9,7,201944
15,27,175,25,361,410,31,125,34,1161,1118,2279,9,5.666666667,201944
15,28,200,33,433,341,48,87,1,1143,1210,2353,9,5.666666667,201944
15,29,204,18,379,557,9,109,15,1291,1357,2648,8,6,201944
15,30,208,15,351,356,64,63,12,1069,1253,2322,16,6,201944
15,31,132,188,191,281,18,51,0,861,761,1622,6,6,201944
15,32,150,22,213,307,82,81,2,857,875,1732,9,6,201944
15,33,161,16,342,305,40,85,0,949,911,1860,7,6,201944
15,34,159,16,205,379,20,62,8,849,880,1729,8,6,201944
15,35,250,19,259,447,10,166,8,1159,1128,2287,9,5.666666667,201944
15,36,169,18,191,311,52,75,6,822,883,1705,9,5.5,201944
15,37,204,25,297,411,107,104,19,1167,1125,2292,7,6,201944
15,38,138,57,276,324,56,55,11,917,1021,1938,6,5.5,201944
15,39,148,17,225,259,40,52,1,742,713,1455,4,6,201944
15,40,226,55,237,393,114,140,3,1168,1202,2370,9,6,201944
15,41,218,19,535,521,65,103,9,1470,1461,2931,13,6,201944
16,1,166,21,271,148,12,19,1,638,604,1242,7,5.333333333,201944
16,2,103,37,92,105,15,42,0,394,444,838,9,5.25,201944
16,3,174,19,149,204,47,62,0,655,588,1243,10,5.25,201944
16,4,217,26,268,167,64,99,0,841,755,1596,8,5.5,201944
16,5,178,23,185,185,44,104,32,751,774,1525,10,5.666666667,201944
16,6,141,39,177,146,40,48,0,591,658,1249,12,5.5,201944
16,7,145,32,159,199,27,63,6,631,647,1278,9,5.5,201944
16,8,248,29,646,509,14,90,4,1540,1483,3023,12,6,201944
16,9,206,24,289,292,15,79,0,905,953,1858,9,6.5,201944
16,10,128,20,263,255,13,58,0,737,814,1551,6,6,201944
16,11,172,24,206,158,70,104,0,734,694,1428,10,5.4,201944
16,12,163,18,170,145,30,74,2,602,561,1163,10,5.25,201944
17,1,171,45,421,413,58,75,5,1188,1039,2227,9,8,201944
17,2,125,7,338,382,17,68,12,949,924,1873,8,5.666666667,201944
17,3,195,14,399,378,32,83,0,1101,1083,2184,8,5.5,201944
17,4,169,11,339,335,34,86,9,983,1076,2059,10,5.666666667,201944
17,5,81,12,152,156,24,37,0,462,572,1034,5,5.5,201944
18,1,114,17,108,102,27,58,26,452,474,926,7,5.25,201944
18,2,238,28,349,364,36,106,0,1121,1257,2378,9,7,201944
18,3,167,12,312,197,17,82,0,787,785,1572,8,5.75,201944
19,1,227,13,285,280,22,112,13,952,933,1885,9,5,201944
19,2,250,23,592,385,8,125,0,1383,1343,2726,9,5,201944
19,3,257,29,717,350,33,110,3,1499,1405,2904,7,5,201944
19,4,135,11,179,121,43,115,53,657,569,1226,5,5,201944
19,5,309,30,590,565,31,207,36,1768,1570,3338,8,5,201944
19,6,78,8,206,251,5,113,2,663,647,1310,5,5,201944
19,7,150,16,462,185,8,65,0,886,857,1743,10,5,201944
19,8,55,9,144,115,4,30,0,357,302,659,7,5,201944
19,9,184,28,281,216,32,91,6,838,736,1574,9,5,201944
19,10,141,21,329,247,10,148,21,917,735,1652,6,6,201944
19,11,342,42,543,764,21,334,31,2077,2008,4085,13,5.333333333,201944
19,12,165,16,430,171,12,72,1,867,862,1729,13,5,201944
20,1,182,17,167,220,34,49,47,716,754,1470,8,5.5,201944
20,2,141,19,188,110,33,24,7,522,412,934,6,5.333333333,201944
20,3,104,11,162,100,124,60,23,584,476,1060,6,5.333333333,201944
20,4,158,16,79,105,51,76,22,507,556,1063,6,5.333333333,201944
20,5,97,10,251,299,29,42,0,728,753,1481,11,5.25,201944
20,6,112,4,99,158,127,98,47,645,547,1192,8,5.25,201944
20,7,156,19,267,342,32,60,0,876,756,1632,8,5.75,201944
20,8,366,49,742,697,60,147,21,2082,1939,4021,14,7,201944
20,9,208,27,199,166,87,89,18,794,635,1429,8,5.666666667,201944
20,10,176,10,266,131,39,53,19,694,750,1444,9,5.25,201944
21,1,159,14,267,191,29,37,0,697,842,1539,9,5.4,201944
21,2,149,39,259,125,56,52,0,680,633,1313,9,5.2,201944
21,3,200,4,198,215,65,123,10,815,785,1600,8,5.5,201944
21,4,135,17,165,56,88,47,5,513,606,1119,7,5.25,201944
21,5,181,20,392,221,32,63,13,922,978,1900,8,5.666666667,201944
21,6,217,15,421,340,83,125,44,1245,1087,2332,6,7,201944
21,7,356,9,196,233,62,94,4,954,911,1865,9,5.666666667,201944
21,8,125,7,238,107,60,62,16,615,727,1342,9,5.2,201944
21,9,171,18,433,377,55,84,16,1154,1341,2495,9,6,201944
21,10,228,27,436,353,27,122,59,1252,1197,2449,7,6,201944
21,11,67,3,134,91,25,30,5,355,418,773,4,6,201944
21,12,353,34,760,510,138,163,160,2118,2091,4209,15,6.5,201944
21,13,196,17,346,234,50,115,6,964,1034,1998,8,5.666666667,201944
21,14,183,26,188,182,103,111,25,818,920,1738,12,5.333333333,201944
21,15,182,8,301,300,25,120,33,969,990,1959,7,5.5,201944
22,1,173,41,180,290,24,58,3,769,782,1551,11,5.2,201944
22,2,161,32,292,209,67,37,5,803,719,1522,7,5.5,201944
22,3,243,48,734,573,10,123,0,1731,1826,3557,9,6,201944
22,4,210,48,534,469,16,92,4,1373,1416,2789,9,6.5,201944
22,5,138,27,334,211,51,66,13,840,952,1792,10,5.5,201944
23,1,235,14,1188,319,34,84,8,1882,1772,3654,14,5.6,201944
23,2,184,23,422,257,36,35,0,957,930,1887,8,5.25,201944
23,3,224,6,820,460,31,69,0,1610,1625,3235,19,0,201944
23,4,116,8,533,249,35,78,8,1027,1004,2031,6,5.5,201944
24,1,110,46,145,242,14,43,1,601,710,1311,10,5.2,201944
24,2,131,23,231,206,12,74,0,677,747,1424,6,5.5,201944
24,3,131,51,132,191,74,39,1,619,700,1319,9,5.25,201944
24,4,143,20,203,203,47,103,39,758,689,1447,5,5.5,201944
24,5,225,43,616,525,14,99,0,1522,1623,3145,10,6.666666667,201944
24,6,133,107,396,277,42,79,0,1034,1184,2218,6,6,201944
24,7,106,21,145,211,61,27,0,571,717,1288,9,5.25,201944
25,1,133,5,227,303,43,65,12,788,779,1567,13,5.75,201944
25,2,219,47,339,368,29,86,0,1088,1195,2283,7,6,201944
25,3,173,11,243,318,37,116,10,908,891,1799,8,5.6,201944
25,4,158,27,167,223,64,31,0,670,640,1310,8,5.333333333,201944
25,5,203,18,296,422,27,65,7,1038,1283,2321,8,5.666666667,201944
25,6,188,6,286,317,48,100,8,953,1095,2048,8,5.75,201944
25,7,287,19,414,489,9,66,0,1284,1437,2721,6,6,201944
26,1,217,14,335,266,9,143,0,984,884,1868,9,5.5,201944
26,2,212,11,311,380,7,118,10,1049,1124,2173,12,5.4,201944
26,3,304,25,420,523,14,273,9,1568,1449,3017,13,6.5,201944
26,4,121,16,225,152,38,75,11,638,586,1224,9,5.2,201944
26,5,141,8,192,185,15,130,0,671,751,1422,15,6,201944
26,6,235,16,235,293,14,185,0,978,909,1887,10,5.333333333,201944
26,7,140,19,180,219,61,58,0,677,575,1252,10,5.5,201944
27,1,103,7,189,168,66,28,0,561,629,1190,8,5.5,201944
27,2,176,11,181,375,23,50,0,816,746,1562,8,5.333333333,201944
27,3,165,8,160,424,7,78,3,845,790,1635,7,5.333333333,201944
27,4,194,15,292,597,28,74,3,1203,1249,2452,8,6.5,201944
27,5,117,5,106,286,28,31,4,577,638,1215,6,5,201944
27,6,162,10,202,427,2,78,0,881,900,1781,8,5.5,201944
28,1,187,14,494,334,6,93,0,1128,1129,2257,13,6,201944
28,2,188,24,412,256,28,105,57,1070,1087,2157,15,6,201944
28,3,141,15,252,139,3,54,5,609,464,1073,7,5.333333333,201944
28,4,276,22,421,298,36,136,56,1245,1255,2500,17,6,201944
28,5,199,27,229,358,9,124,20,966,963,1929,10,5.25,201944
28,6,109,13,85,148,31,37,5,428,592,1020,13,4.166666667,201944
28,7,191,24,392,284,49,83,37,1060,1204,2264,13,6,201944
28,8,99,8,195,242,50,72,3,669,714,1383,13,7,201944
28,9,149,8,353,202,34,99,16,861,786,1647,11,5.75,201944
29,1,223,20,323,395,36,104,1,1102,1136,2238,7,5.5,201944
29,2,226,18,222,491,25,142,95,1219,1218,2437,11,6.333333333,201944
29,3,127,19,150,315,23,66,5,705,727,1432,6,5.666666667,201944
30,1,114,12,137,147,102,38,4,554,614,1168,7,5.333333333,201944
30,2,90,7,127,73,33,35,71,436,473,909,9,5.25,201944
30,3,153,9,212,131,97,79,39,720,567,1287,6,5.666666667,201944
30,4,107,18,277,160,49,55,0,666,559,1225,8,6,201944
30,5,141,9,261,251,8,58,5,733,657,1390,7,5.5,201944
30,6,140,16,228,194,33,60,3,674,814,1488,9,5.333333333,201944
30,7,149,7,208,161,58,58,29,670,815,1485,11,5.25,201944
30,8,175,22,482,241,134,55,1,1110,1061,2171,11,5.4,201944
30,9,163,17,200,169,74,79,31,733,792,1525,8,5.5,201944
30,10,169,16,303,231,35,77,43,874,837,1711,6,6.5,201944
30,11,120,11,268,294,17,67,0,777,867,1644,5,5.5,201944
30,12,175,11,616,403,24,119,1,1349,1342,2691,10,6.25,201944
30,13,214,12,194,212,94,109,52,887,910,1797,10,5.4,201944
30,14,118,12,247,154,121,43,1,696,688,1384,8,5.5,201944
30,15,171,12,195,257,70,119,62,886,989,1875,11,5.666666667,201944
30,16,148,11,268,259,52,107,72,917,943,1860,10,5.333333333,201944
30,17,139,19,294,208,27,80,41,808,755,1563,8,5.5,201944
30,18,149,9,123,151,23,34,27,516,563,1079,8,5.25,201944
30,19,153,15,322,204,61,63,0,818,677,1495,13,5.6,201944
30,20,148,11,194,297,86,82,0,818,798,1616,10,5.2,201944
31,1,161,13,256,56,211,28,0,725,740,1465,8,5.5,201944
31,2,71,15,121,11,179,53,0,450,486,936,6,5.333333333,201944
31,3,406,70,1071,517,167,148,4,2383,2408,4791,21,6.666666667,201944
31,4,115,18,285,215,81,90,34,838,850,1688,4,6,201944
31,5,148,11,198,170,61,76,4,668,606,1274,7,5.333333333,201944
32,1,170,31,180,177,64,95,32,749,726,1475,12,5.2,201944
32,2,196,48,174,117,99,94,15,743,609,1352,13,5.142857143,201944
32,3,218,48,222,382,15,127,0,1012,916,1928,13,5.6,201944
32,4,197,36,231,280,18,134,20,916,1053,1969,13,5.4,201944
1,1,157,39,280,210,50,70,3,809,685,1494,13,4,201945
1,2,174,36,391,316,22,108,4,1051,1121,2172,10,4.333333333,201945
1,3,121,30,324,285,30,79,3,872,978,1850,9,4,201945
2,1,116,16,208,191,13,101,26,671,558,1229,11,4,201945
2,2,121,11,184,252,8,135,0,711,740,1451,7,4,201945
2,3,165,18,314,272,16,116,23,924,937,1861,12,4.333333333,201945
2,4,105,5,361,150,33,32,1,687,769,1456,9,4,201945
2,5,142,6,407,190,106,82,2,935,1064,1999,11,4,201945
2,6,135,10,334,273,15,89,0,856,842,1698,7,3.5,201945
2,7,158,15,311,234,22,67,6,813,801,1614,12,4,201945
2,8,132,6,367,303,14,73,9,904,791,1695,7,5,201945
3,1,207,10,253,243,16,116,3,848,718,1566,13,4,201945
3,2,91,11,379,175,21,39,1,717,719,1436,9,4,201945
4,1,108,15,150,253,57,50,11,644,634,1278,11,4,201945
4,2,90,4,168,211,29,34,15,551,654,1205,14,4,201945
5,1,184,8,279,267,16,61,4,819,914,1733,9,4,201945
5,2,128,8,142,202,18,31,0,529,553,1082,10,4,201945
5,3,170,24,207,379,49,100,41,970,1060,2030,11,4,201945
5,4,173,21,369,394,11,76,13,1057,1082,2139,11,4,201945
5,5,161,9,240,382,11,83,13,899,924,1823,10,4,201945
5,6,116,14,191,183,7,42,29,582,685,1267,10,4,201945
5,7,155,7,200,228,2,58,12,662,747,1409,10,4,201945
6,1,133,12,172,180,10,46,23,576,582,1158,13,4.2,201945
6,2,112,6,232,151,24,68,15,608,689,1297,9,4,201945
7,1,140,2,103,130,3,18,0,396,364,760,9,4,201945
7,2,170,7,167,306,26,39,0,715,649,1364,9,4,201945
7,3,121,4,88,116,63,20,1,413,1297,1710,7,4,201945
7,4,147,9,102,172,7,27,25,489,411,900,11,4,201945
7,5,173,9,123,316,39,40,1,701,603,1304,11,4,201945
7,6,134,8,233,206,16,58,8,663,870,1533,9,4.333333333,201945
7,7,194,12,190,203,70,64,7,740,1010,1750,8,4,201945
7,8,151,13,112,632,53,40,0,1001,760,1761,12,4,201945
7,9,91,11,194,302,27,71,8,704,803,1507,9,4,201945
7,10,93,7,160,220,9,23,0,512,692,1204,9,4,201945
7,11,71,0,46,34,11,17,0,179,329,508,6,4,201945
7,12,127,9,187,331,9,29,0,692,788,1480,9,4,201945
7,13,109,19,141,308,1,52,0,630,617,1247,9,4,201945
8,1,86,7,298,130,23,25,5,574,539,1113,4,4,201945
8,2,153,41,421,308,28,47,0,998,1162,2160,17,4,201945
8,3,123,19,243,258,41,57,17,758,817,1575,4,4,201945
8,4,88,11,247,194,27,89,37,693,772,1465,11,4,201945
8,5,131,50,214,181,22,42,1,641,617,1258,10,4,201945
8,6,124,30,181,215,20,70,14,654,659,1313,10,6,201945
8,7,143,80,116,169,13,60,0,581,594,1175,8,4,201945
8,8,165,41,289,410,9,109,4,1027,1056,2083,10,4,201945
8,9,113,26,116,75,28,61,3,422,474,896,10,4,201945
9,1,59,12,103,99,58,43,3,377,390,767,5,4,201945
9,2,231,37,410,531,106,124,58,1497,1467,2964,12,4,201945
9,3,106,11,229,237,72,59,21,735,770,1505,7,4,201945
9,4,99,11,271,277,73,59,0,790,874,1664,11,4,201945
9,5,80,26,160,169,68,61,2,566,539,1105,7,4,201945
9,6,63,7,129,123,75,67,7,471,468,939,7,4,201945
9,7,58,4,257,201,2,23,11,556,529,1085,9,4,201945
9,8,65,9,182,230,30,46,29,591,592,1183,5,4,201945
9,9,62,10,145,169,51,43,0,480,565,1045,5,4,201945
9,10,56,10,267,161,38,38,32,602,619,1221,6,4,201945
9,11,78,13,245,324,84,82,7,833,833,1666,7,4,201945
9,12,134,9,339,376,39,81,38,1016,1038,2054,11,4,201945
9,13,80,13,200,204,64,30,14,605,550,1155,4,4,201945
9,14,55,9,158,177,37,47,7,490,511,1001,5,4,201945
9,15,151,16,697,595,33,105,24,1621,1483,3104,10,4.5,201945
9,16,130,122,238,395,57,60,2,1004,1037,2041,15,4,201945
9,17,80,11,207,186,21,41,2,548,467,1015,6,4,201945
9,18,97,7,205,300,71,74,33,787,732,1519,12,4,201945
9,19,141,24,196,252,95,58,31,797,725,1522,5,4,201945
9,20,31,4,58,80,33,4,0,210,232,442,5,4,201945
9,21,43,5,77,136,49,27,1,338,423,761,3,4,201945
9,22,99,8,137,152,66,36,13,511,559,1070,5,4,201945
9,23,72,19,267,263,53,39,1,714,651,1365,6,4,201945
9,24,212,18,391,430,179,106,5,1341,1337,2678,14,4,201945
10,1,147,15,150,157,42,111,16,638,819,1457,12,3.5,201945
10,2,168,14,201,204,16,78,16,697,673,1370,10,4,201945
10,3,113,27,146,151,15,84,23,559,742,1301,11,4,201945
10,4,173,22,244,323,18,91,2,873,935,1808,12,4.5,201945
11,1,113,98,116,228,31,56,2,644,596,1240,6,4,201945
11,2,122,28,200,151,72,59,10,642,544,1186,7,4,201945
11,3,124,26,178,179,25,73,6,611,529,1140,3,4,201945
11,4,100,39,122,191,45,64,1,562,495,1057,8,4.333333333,201945
11,5,160,43,268,370,10,93,9,953,855,1808,7,4,201945
11,6,88,18,137,174,21,34,3,475,499,974,8,4,201945
11,7,122,42,196,408,14,33,1,816,662,1478,9,4,201945
11,8,107,31,172,316,63,61,4,754,787,1541,9,4,201945
11,9,134,34,214,332,5,74,11,804,776,1580,10,4,201945
11,10,137,40,176,180,18,84,35,670,600,1270,10,4,201945
11,11,132,39,205,259,10,81,0,726,678,1404,5,4,201945
11,12,104,38,282,279,23,69,7,802,761,1563,7,4,201945
11,13,125,28,144,131,36,49,13,526,504,1030,8,4,201945
11,14,100,24,189,133,54,42,3,545,547,1092,8,4,201945
11,15,92,26,131,174,17,49,12,501,475,976,9,4,201945
12,1,81,32,128,105,36,30,1,413,415,828,10,4,201945
12,2,85,12,151,247,6,43,6,550,611,1161,10,4,201945
12,3,110,20,174,242,9,34,0,589,457,1046,11,3.8,201945
12,4,120,19,176,272,18,40,1,646,745,1391,9,4,201945
12,5,136,19,129,282,7,24,7,604,557,1161,10,4,201945
12,6,119,18,177,351,45,15,9,734,616,1350,10,4,201945
12,7,126,17,158,250,156,44,18,769,542,1311,6,4,201945
12,8,98,13,85,183,4,21,0,404,698,1102,9,4,201945
12,9,123,18,151,305,19,28,0,644,750,1394,9,4,201945
13,1,113,11,59,106,20,17,9,335,418,753,9,4,201945
13,2,202,14,140,282,106,92,42,878,478,1356,6,4,201945
13,3,86,21,120,116,65,71,2,481,600,1081,12,4,201945
13,4,145,12,171,166,43,42,27,606,657,1263,9,4,201945
13,5,156,8,269,215,44,88,21,801,868,1669,9,4,201945
13,6,210,36,360,389,39,97,12,1143,1221,2364,11,4,201945
13,7,107,8,173,233,36,29,0,586,670,1256,8,4,201945
14,1,118,27,106,85,85,47,10,478,427,905,6,4,201945
14,2,121,14,126,53,60,99,2,475,478,953,5,4,201945
14,3,215,33,296,93,11,123,1,772,668,1440,8,4,201945
14,4,94,9,245,204,19,74,5,650,592,1242,10,4,201945
14,5,115,18,300,152,21,48,0,654,691,1345,9,4,201945
14,6,156,10,402,167,21,46,0,802,701,1503,11,4,201945
14,7,88,16,188,114,0,23,0,429,372,801,6,4,201945
14,8,244,35,598,500,30,149,3,1559,1458,3017,11,4.25,201945
14,9,86,11,159,182,14,36,0,488,403,891,11,4,201945
14,10,142,16,313,201,9,74,3,758,702,1460,7,4,201945
14,11,130,15,211,190,39,90,23,698,632,1330,4,4,201945
14,12,177,22,463,116,29,49,0,856,753,1609,9,4,201945
14,13,132,14,346,184,12,79,3,770,708,1478,6,4,201945
14,14,112,14,213,168,21,73,17,618,583,1201,7,4,201945
14,15,140,32,196,122,57,85,4,636,570,1206,10,4,201945
14,16,113,25,222,128,41,65,6,600,488,1088,5,4,201945
14,17,131,15,161,46,39,62,4,458,433,891,7,4,201945
14,18,162,24,272,80,65,56,10,669,588,1257,9,4,201945
14,19,165,27,216,142,32,76,8,666,631,1297,8,4,201945
14,20,147,19,292,181,1,72,0,712,579,1291,10,4,201945
15,1,93,9,92,67,185,47,0,493,538,1031,7,4,201945
15,2,63,10,112,160,85,28,6,464,509,973,6,4,201945
15,3,129,15,130,155,152,40,12,633,755,1388,10,4,201945
15,4,143,10,145,216,27,58,10,609,585,1194,4,4,201945
15,5,101,37,140,157,14,36,0,485,576,1061,8,4,201945
15,6,115,9,170,271,30,56,7,658,617,1275,7,4,201945
15,7,111,4,232,157,56,59,9,628,562,1190,10,4,201945
15,8,46,5,111,162,12,27,4,367,390,757,4,4,201945
15,9,100,8,100,63,96,57,0,424,446,870,9,4,201945
15,10,70,3,118,254,9,40,1,495,482,977,6,4,201945
15,11,120,15,160,236,29,46,4,610,646,1256,8,4,201945
15,12,129,12,296,323,55,37,0,852,898,1750,8,4,201945
15,13,68,14,119,130,92,43,0,466,400,866,8,4,201945
15,14,51,15,78,132,20,24,3,323,354,677,4,4,201945
15,15,118,80,142,248,52,43,7,690,651,1341,6,4,201945
15,16,129,20,183,325,17,59,9,742,831,1573,8,4,201945
15,17,87,10,135,167,23,59,19,500,517,1017,8,4,201945
15,18,112,27,169,254,24,76,3,665,713,1378,7,4,201945
15,19,141,36,253,388,30,92,23,963,934,1897,10,4,201945
15,20,53,15,185,149,18,18,0,438,435,873,6,4,201945
15,21,60,7,69,85,18,44,9,292,351,643,6,4,201945
15,22,177,73,330,432,22,108,39,1181,1213,2394,14,4,201945
15,23,67,31,143,186,10,57,1,495,615,1110,6,4,201945
15,24,54,11,120,155,27,28,1,396,509,905,4,4,201945
15,25,87,15,125,173,20,38,10,468,547,1015,6,4,201945
15,26,80,4,130,160,60,40,0,474,426,900,9,5,201945
15,27,112,8,242,305,23,73,30,793,848,1641,9,4,201945
15,28,126,12,297,213,46,46,6,746,824,1570,9,4,201945
15,29,143,21,242,393,12,100,12,923,931,1854,8,4,201945
15,30,146,14,260,257,43,48,20,788,781,1569,16,4,201945
15,31,85,99,105,190,7,13,0,499,532,1031,6,4,201945
15,32,89,5,134,222,32,32,1,515,589,1104,9,4,201945
15,33,82,16,190,214,27,41,0,570,576,1146,7,4,201945
15,34,85,7,152,278,7,41,6,576,563,1139,8,4,201945
15,35,103,9,144,315,1,88,2,662,779,1441,9,4,201945
15,36,119,10,123,204,95,59,1,611,705,1316,9,4,201945
15,37,137,21,166,318,53,74,15,784,775,1559,7,4,201945
15,38,78,20,167,178,39,31,2,515,634,1149,6,4,201945
15,39,99,15,141,172,26,51,5,509,514,1023,4,4,201945
15,40,130,24,112,245,79,62,3,655,778,1433,9,4,201945
15,41,158,17,347,346,40,53,11,972,1019,1991,13,4,201945
16,1,110,14,208,101,7,12,0,452,495,947,7,4,201945
16,2,64,19,93,100,13,36,0,325,343,668,9,4,201945
16,3,80,14,83,119,28,34,1,359,437,796,10,4,201945
16,4,151,23,184,79,35,55,0,527,630,1157,8,4,201945
16,5,137,16,144,168,29,60,18,572,518,1090,10,4,201945
16,6,84,37,126,91,32,49,0,419,460,879,12,4,201945
16,7,121,23,175,150,19,41,4,533,600,1133,9,4,201945
16,8,177,22,432,358,8,58,3,1058,1042,2100,12,4,201945
16,9,114,12,184,214,2,69,0,595,660,1255,9,4,201945
16,10,77,12,188,187,13,40,0,517,544,1061,6,4,201945
16,11,124,24,109,80,42,60,1,440,475,915,10,4,201945
16,12,120,21,155,120,26,52,6,500,520,1020,10,4,201945
17,1,113,36,272,313,30,53,4,821,727,1548,9,5,201945
17,2,79,9,170,287,10,60,4,619,582,1201,8,4,201945
17,3,116,16,238,290,33,52,0,745,864,1609,8,4,201945
17,4,101,6,229,273,20,40,9,678,651,1329,10,4,201945
17,5,65,8,103,89,8,42,0,315,231,546,5,4,201945
18,1,109,6,100,106,26,47,28,422,465,887,7,4,201945
18,2,173,29,258,283,23,74,0,840,843,1683,9,4.333333333,201945
18,3,96,12,225,178,7,47,0,565,487,1052,8,4,201945
19,1,204,17,239,225,5,90,7,787,804,1591,9,4,201945
19,2,188,15,468,284,11,115,0,1081,1197,2278,9,4,201945
19,3,209,16,546,250,16,90,3,1130,1244,2374,7,4,201945
19,4,97,7,140,120,41,91,39,535,522,1057,5,4,201945
19,5,236,26,462,395,20,150,35,1324,1495,2819,8,4,201945
19,6,58,8,210,208,4,90,2,580,559,1139,5,4,201945
19,7,117,12,409,140,1,50,0,729,836,1565,10,4,201945
19,8,50,3,117,79,4,24,0,277,306,583,7,4,201945
19,9,132,14,196,176,28,69,3,618,496,1114,9,4,201945
19,10,104,14,288,191,8,94,15,714,694,1408,6,5,201945
19,11,249,30,444,601,13,233,27,1597,1688,3285,13,4,201945
19,12,157,15,422,158,11,41,4,808,806,1614,13,4,201945
20,1,103,7,103,105,31,35,27,411,445,856,8,4,201945
20,2,51,6,84,64,8,11,3,227,326,553,6,4,201945
20,3,50,9,87,69,80,23,25,343,673,1016,6,4,201945
20,4,56,6,47,58,8,29,8,212,370,582,6,4,201945
20,5,68,7,107,130,18,19,2,351,490,841,11,4,201945
20,6,80,3,63,82,66,57,25,376,574,950,8,4,201945
20,7,141,9,147,237,21,46,0,601,494,1095,8,4,201945
20,8,184,13,399,367,38,72,11,1084,1265,2349,14,4.5,201945
20,9,87,10,85,78,52,29,7,348,518,866,8,4,201945
20,10,131,9,218,96,14,28,22,518,736,1254,9,4,201945
21,1,129,9,201,125,25,21,0,510,678,1188,9,4,201945
21,2,100,43,142,66,49,22,0,422,575,997,9,4,201945
21,3,95,1,122,123,33,77,7,458,718,1176,8,4,201945
21,4,39,4,51,37,39,21,6,197,669,866,7,4,201945
21,5,107,12,223,152,11,19,3,527,733,1260,8,4,201945
21,6,129,5,240,219,43,69,14,719,707,1426,6,4,201945
21,7,146,4,95,113,38,58,5,459,847,1306,9,4,201945
21,8,96,8,205,99,33,40,9,490,702,1192,9,4,201945
21,9,110,15,304,255,40,60,4,788,872,1660,9,4,201945
21,10,92,6,252,214,13,72,18,667,951,1618,7,4,201945
21,11,44,3,83,70,16,14,2,232,277,509,4,4,201945
21,12,206,12,471,338,86,88,157,1358,1504,2862,16,4.5,201945
21,13,91,11,215,115,21,48,3,504,640,1144,8,4,201945
21,14,84,9,107,65,61,60,4,390,663,1053,12,4,201945
21,15,100,2,208,175,9,47,17,558,643,1201,7,4,201945
22,1,112,28,144,206,18,50,1,559,596,1155,11,4,201945
22,2,103,34,182,172,100,37,0,628,629,1257,7,4,201945
22,3,170,37,523,455,17,74,0,1276,1287,2563,9,4,201945
22,4,99,23,472,305,11,54,4,968,969,1937,9,4.5,201945
22,5,113,13,262,173,32,51,14,658,662,1320,10,4,201945
23,1,188,8,827,228,21,48,6,1326,1185,2511,14,4,201945
23,2,110,13,280,229,36,16,0,684,727,1411,8,4,201945
23,3,135,9,588,316,30,44,0,1122,1155,2277,19,0,201945
23,4,105,5,364,221,30,37,9,771,739,1510,6,4,201945
24,1,100,24,97,146,16,33,2,418,545,963,10,4,201945
24,2,83,16,183,114,9,48,1,454,453,907,6,4,201945
24,3,91,46,126,130,78,36,3,510,525,1035,9,4,201945
24,4,82,24,100,151,30,81,18,486,526,1012,5,4,201945
24,5,153,36,429,346,13,58,0,1035,1082,2117,10,4.333333333,201945
24,6,89,50,278,199,52,57,7,732,721,1453,6,4,201945
24,7,62,15,74,122,49,16,0,338,407,745,9,4,201945
25,1,94,4,183,219,27,46,12,585,538,1123,13,4,201945
25,2,155,27,264,287,8,49,0,790,719,1509,7,4,201945
25,3,97,7,154,259,19,70,8,614,595,1209,8,4,201945
25,4,123,17,114,153,45,21,1,474,446,920,8,4,201945
25,5,124,10,231,313,26,44,4,752,633,1385,8,4,201945
25,6,120,7,233,239,34,79,11,723,667,1390,8,4,201945
25,7,161,15,301,333,9,36,0,855,706,1561,6,4,201945
26,1,116,14,221,169,3,83,0,606,564,1170,9,4,201945
26,2,140,10,228,302,2,66,16,764,671,1435,12,4,201945
26,3,171,16,280,396,10,135,3,1011,923,1934,13,4,201945
26,4,93,12,125,117,36,38,8,429,515,944,9,4,201945
26,5,110,7,137,136,19,100,0,509,535,1044,15,4.5,201945
26,6,146,14,190,250,22,131,0,753,659,1412,10,4,201945
26,7,93,9,104,151,41,41,0,439,437,876,10,4,201945
27,1,72,8,124,122,67,29,0,422,603,1025,8,4,201945
27,2,135,13,148,326,17,38,0,677,635,1312,8,4,201945
27,3,118,5,99,283,7,28,0,540,714,1254,7,4,201945
27,4,122,10,227,501,18,48,4,930,970,1900,8,4.5,201945
27,5,38,2,64,196,13,5,1,319,275,594,6,4,201945
27,6,97,9,148,329,3,64,0,650,756,1406,8,4,201945
28,1,109,18,314,199,5,50,0,695,766,1461,13,4,201945
28,2,98,9,264,201,16,64,33,685,845,1530,15,4,201945
28,3,94,7,184,98,8,38,1,430,517,947,7,4,201945
28,4,182,17,308,189,25,83,30,834,888,1722,17,4,201945
28,5,104,7,151,276,5,77,19,639,778,1417,10,4.25,201945
28,6,80,10,111,129,31,30,4,395,542,937,13,4,201945
28,7,148,13,308,196,47,72,18,802,837,1639,13,4,201945
28,8,85,7,153,162,39,56,2,504,530,1034,12,4,201945
28,9,111,7,244,177,19,68,11,637,559,1196,11,4,201945
29,1,101,13,188,222,15,65,3,607,766,1373,7,4,201945
29,2,119,8,147,300,20,77,37,708,819,1527,11,4.333333333,201945
29,3,57,8,95,179,10,40,0,389,514,903,6,4,201945
30,1,40,6,92,78,32,21,5,274,383,657,7,3.666666667,201945
30,2,61,5,60,44,21,18,38,247,368,615,9,4,201945
30,3,100,12,138,88,86,43,26,493,521,1014,6,4,201945
30,4,58,10,202,89,26,22,0,407,423,830,8,4,201945
30,5,73,7,159,159,10,39,2,449,518,967,7,4,201945
30,6,100,7,121,107,28,38,10,411,558,969,9,4,201945
30,7,101,6,131,114,31,33,26,442,544,986,11,4,201945
30,8,129,13,309,159,41,52,6,709,634,1343,11,4,201945
30,9,125,4,120,125,49,55,15,493,504,997,8,4,201945
30,10,94,9,176,152,13,57,34,535,615,1150,6,4,201945
30,11,98,8,241,243,9,50,1,650,660,1310,5,4,201945
30,12,126,6,414,281,18,69,0,914,885,1799,10,4,201945
30,13,168,12,128,148,93,78,29,656,691,1347,10,4,201945
30,14,81,15,197,93,135,30,7,558,547,1105,8,4,201945
30,15,123,8,171,184,75,81,46,688,668,1356,11,4,201945
30,16,97,8,217,217,29,88,42,698,683,1381,10,4,201945
30,17,150,22,237,149,16,79,27,680,659,1339,8,4,201945
30,18,105,6,81,82,14,28,20,336,432,768,8,4,201945
30,19,143,7,224,155,28,60,1,618,497,1115,13,4,201945
30,20,119,9,151,362,69,50,0,760,721,1481,10,4,201945
31,1,92,14,197,37,166,20,0,526,594,1120,8,4,201945
31,2,44,7,72,14,134,31,0,302,325,627,6,4,201945
31,3,289,50,707,401,131,73,6,1657,1694,3351,20,4,201945
31,4,86,9,219,138,32,48,25,557,588,1145,4,4,201945
31,5,84,11,129,118,48,61,4,455,565,1020,7,4,201945
32,1,122,30,132,105,29,60,25,503,567,1070,12,4,201945
32,2,116,38,140,66,63,89,20,532,605,1137,13,4,201945
32,3,128,40,130,290,10,111,1,710,533,1243,13,4,201945
32,4,117,40,174,168,14,58,11,582,525,1107,13,4.2,201945
1,1,197,33,290,231,66,60,8,885,917,1802,13,5.5,201946
1,2,278,89,615,451,64,114,8,1619,1358,2977,10,6.666666667,201946
1,3,170,56,496,383,23,124,8,1260,1330,2590,9,6.333333333,201946
2,1,179,22,312,235,31,168,35,982,860,1842,11,6,201946
2,2,150,21,243,325,12,196,0,947,1203,2150,7,6,201946
2,3,201,10,406,431,22,163,47,1280,1514,2794,12,6,201946
2,4,158,19,690,210,38,22,5,1142,1159,2301,9,6.5,201946
2,5,163,22,610,247,223,136,6,1407,1778,3185,11,6,201946
2,6,192,18,524,348,21,118,1,1222,1426,2648,8,6.5,201946
2,7,181,29,534,327,48,85,19,1223,1390,2613,12,5.75,201946
2,8,156,23,469,289,25,119,29,1110,1565,2675,7,7,201946
3,1,134,16,242,209,48,92,2,743,921,1664,13,5.666666667,201946
3,2,62,30,403,180,40,17,1,733,1127,1860,9,6,201946
4,1,129,27,214,367,106,69,19,931,1002,1933,11,5.5,201946
4,2,172,12,265,293,49,68,45,904,963,1867,14,5.4,201946
5,1,226,21,317,335,24,93,3,1019,1431,2450,9,5.666666667,201946
5,2,274,16,270,309,28,50,0,947,919,1866,10,6,201946
5,3,215,21,306,487,105,108,62,1304,1430,2734,11,5.333333333,201946
5,4,226,40,480,525,16,70,19,1376,1889,3265,11,6.25,201946
5,5,221,15,300,516,15,61,25,1153,1436,2589,10,6,201946
5,6,188,13,278,365,16,54,35,949,1057,2006,10,5.5,201946
5,7,233,18,228,394,21,91,16,1001,1200,2201,10,6,201946
6,1,296,15,188,188,14,30,35,766,792,1558,12,6,201946
6,2,91,17,220,163,51,52,12,606,924,1530,9,5.666666667,201946
7,1,247,17,157,173,28,30,4,656,991,1647,9,5.25,201946
7,2,127,5,83,1181,146,16,0,1558,600,2158,9,5.25,201946
7,3,154,11,123,101,97,22,1,509,1167,1676,7,5.333333333,201946
7,4,159,12,90,243,35,19,78,636,882,1518,11,5.4,201946
7,5,355,16,261,445,91,57,0,1225,1198,2423,11,5.666666667,201946
7,6,197,15,341,257,39,55,4,908,1271,2179,8,5.666666667,201946
7,7,264,31,300,275,131,58,8,1067,729,1796,8,5.5,201946
7,8,162,14,219,571,160,57,1,1184,919,2103,12,5.25,201946
7,9,168,12,247,442,63,97,8,1037,1170,2207,10,6,201946
7,10,158,10,267,286,13,16,0,750,556,1306,9,5.25,201946
7,11,81,1,70,48,15,23,0,238,441,679,6,5.333333333,201946
7,12,172,8,268,395,11,44,0,898,1118,2016,9,5.5,201946
7,13,98,15,101,244,2,43,0,503,800,1303,9,5.25,201946
8,1,133,16,476,120,31,20,3,799,999,1798,4,6,201946
8,2,261,93,589,417,36,42,2,1440,1744,3184,17,5.75,201946
8,3,191,63,335,311,61,61,35,1057,1191,2248,4,6,201946
8,4,136,36,310,246,43,95,55,921,1207,2128,11,6,201946
8,5,148,40,259,214,39,39,0,739,873,1612,10,5.25,201946
8,6,175,65,281,238,38,94,28,919,1104,2023,10,8,201946
8,7,116,87,186,202,12,53,0,656,1053,1709,8,5.25,201946
8,8,225,69,462,625,24,177,7,1589,1526,3115,10,7,201946
8,9,163,26,132,124,59,67,0,571,660,1231,10,5.2,201946
9,1,89,20,128,112,111,43,7,510,628,1138,5,6,201946
9,2,296,98,548,607,173,107,84,1913,2516,4429,12,6,201946
9,3,156,21,317,322,163,93,54,1126,1301,2427,7,6,201946
9,4,150,27,300,343,192,48,4,1064,1342,2406,11,6,201946
9,5,97,76,244,220,90,65,0,792,997,1789,7,6,201946
9,6,64,35,161,128,127,60,17,592,714,1306,7,6,201946
9,7,63,18,351,205,2,18,26,683,941,1624,9,6,201946
9,8,88,32,183,219,35,54,35,646,873,1519,5,6,201946
9,9,65,10,199,226,69,42,0,611,737,1348,5,6,201946
9,10,71,20,304,216,20,26,34,691,990,1681,6,6,201946
9,11,127,21,324,415,206,79,2,1174,1482,2656,7,7,201946
9,12,157,23,338,362,46,90,52,1068,1681,2749,11,6,201946
9,13,89,11,232,223,105,44,23,727,977,1704,4,6,201946
9,14,67,23,275,211,50,11,11,648,866,1514,5,6,201946
9,15,159,32,611,526,48,84,36,1496,2665,4161,10,6.5,201946
9,16,233,357,319,629,41,56,15,1650,1870,3520,15,6,201946
9,17,100,11,226,200,50,30,6,623,891,1514,6,6,201946
9,18,119,19,251,315,120,83,50,957,1372,2329,12,6,201946
9,19,146,44,265,306,163,73,54,1051,1318,2369,5,6,201946
9,20,40,31,56,95,52,3,0,277,358,635,5,6,201946
9,21,102,23,142,212,100,31,0,610,709,1319,3,6,201946
9,22,127,13,196,173,124,42,8,683,885,1568,5,6,201946
9,23,139,26,433,331,41,54,4,1028,1197,2225,6,7,201946
9,24,228,55,445,417,310,68,26,1549,2262,3811,14,6,201946
10,1,160,39,164,257,9,92,22,743,787,1530,12,4.666666667,201946
10,2,155,19,257,301,27,109,19,887,1050,1937,10,5.25,201946
10,3,166,40,213,249,38,99,43,848,932,1780,11,5.4,201946
10,4,284,39,349,549,33,137,5,1396,1434,2830,12,7,201946
11,1,162,108,169,252,79,74,3,847,898,1745,6,5.666666667,201946
11,2,197,36,316,216,107,69,14,955,1033,1988,7,6,201946
11,3,105,32,158,201,25,88,3,612,954,1566,3,6,201946
11,4,130,48,190,175,73,85,5,706,895,1601,8,6,201946
11,5,231,69,346,474,30,145,31,1326,1515,2841,7,6.5,201946
11,6,88,18,137,174,21,34,3,475,499,974,8,6,201946
11,7,196,88,409,539,26,42,1,1301,1531,2832,9,5.5,201946
11,8,152,46,257,417,90,90,7,1059,1099,2158,9,5.5,201946
11,9,142,69,249,395,19,104,25,1003,1421,2424,10,5.666666667,201946
11,10,167,51,231,172,42,78,55,796,998,1794,10,5.6,201946
11,11,184,106,249,371,13,76,1,1000,1151,2151,5,6,201946
11,12,186,90,415,450,22,66,12,1241,1297,2538,7,6.5,201946
11,13,165,43,270,163,49,58,14,762,693,1455,8,5.5,201946
11,14,164,49,272,194,88,40,1,808,810,1618,8,5.5,201946
11,15,125,59,230,245,17,53,29,758,691,1449,9,6,201946
12,1,90,31,118,123,85,30,0,477,602,1079,10,5.2,201946
12,2,154,16,193,412,16,79,6,876,983,1859,10,5.5,201946
12,3,147,13,200,316,5,36,0,717,891,1608,11,5,201946
12,4,203,15,304,461,27,73,0,1083,1126,2209,9,6,201946
12,5,174,23,193,289,5,33,18,735,760,1495,10,5.25,201946
12,6,109,15,342,477,14,9,9,975,1149,2124,10,5.25,201946
12,7,141,20,195,368,21,52,1,798,1065,1863,6,5.5,201946
12,8,154,18,147,279,2,37,0,637,640,1277,9,5.25,201946
12,9,175,28,329,491,18,36,4,1081,1071,2152,9,5.666666667,201946
13,1,245,24,150,320,62,48,33,882,723,1605,9,5.333333333,201946
13,2,120,19,89,183,68,65,28,572,692,1264,6,5.333333333,201946
13,3,161,30,190,163,109,96,6,755,997,1752,12,5.25,201946
13,4,191,17,291,288,80,61,45,973,1086,2059,9,5.666666667,201946
13,5,219,19,333,306,80,123,35,1115,1361,2476,9,5.75,201946
13,6,252,143,476,445,59,81,10,1466,2102,3568,11,6,201946
13,7,194,26,304,313,68,37,0,942,987,1929,8,5.5,201946
14,1,137,40,121,82,97,46,8,531,587,1118,6,5.5,201946
14,2,99,17,138,38,109,47,0,448,668,1116,5,5.666666667,201946
14,3,176,33,309,84,24,118,3,747,818,1565,8,5.4,201946
14,4,166,25,291,271,18,110,12,893,874,1767,10,6,201946
14,5,154,37,467,153,37,48,0,896,878,1774,9,5.5,201946
14,6,184,20,563,240,9,31,0,1047,1179,2226,11,6,201946
14,7,73,17,254,121,1,10,0,476,639,1115,6,6,201946
14,8,300,49,687,481,38,122,5,1682,2352,4034,11,6.25,201946
14,9,121,20,249,201,19,29,5,644,737,1381,11,6,201946
14,10,143,64,349,186,5,103,14,864,1223,2087,7,6.5,201946
14,11,104,22,257,209,64,97,23,776,1043,1819,4,6,201946
14,12,171,31,566,112,29,23,0,932,1258,2190,9,5.5,201946
14,13,131,23,463,167,11,57,1,853,1139,1992,6,6,201946
14,14,108,27,310,205,41,76,12,779,956,1735,7,6,201946
14,15,200,38,284,128,138,75,3,866,944,1810,10,5.6,201946
14,16,111,26,273,139,82,53,3,687,925,1612,5,6,201946
14,17,130,40,175,75,47,79,5,551,826,1377,7,5.25,201946
14,18,166,40,307,111,87,51,29,791,837,1628,9,5.4,201946
14,19,179,18,353,145,20,46,16,777,816,1593,8,5.25,201946
14,20,159,24,320,191,3,53,0,750,813,1563,10,5.666666667,201946
15,1,143,21,154,58,252,68,0,696,683,1379,7,5.333333333,201946
15,2,110,19,187,198,154,33,8,709,917,1626,6,6,201946
15,3,187,21,163,159,276,44,29,879,1169,2048,10,5.666666667,201946
15,4,156,11,234,271,54,78,11,815,1044,1859,4,6,201946
15,5,169,31,255,253,29,39,15,791,885,1676,8,5.666666667,201946
15,6,160,11,214,350,29,71,33,868,1228,2096,7,6.5,201946
15,7,129,12,481,183,87,69,11,972,996,1968,10,6,201946
15,8,92,3,139,183,14,40,15,486,681,1167,4,6,201946
15,9,195,14,137,112,125,143,1,727,904,1631,9,5.75,201946
15,10,91,10,194,304,22,71,7,699,821,1520,6,6,201946
15,11,154,24,305,239,28,49,21,820,1070,1890,8,6,201946
15,12,193,16,450,408,60,68,0,1195,1536,2731,8,6,201946
15,13,95,23,184,188,144,59,0,693,780,1473,8,6,201946
15,14,44,36,108,179,58,21,1,447,584,1031,4,6,201946
15,15,115,152,174,256,69,26,7,799,1145,1944,6,6,201946
15,16,207,33,304,570,20,93,24,1251,1419,2670,8,6,201946
15,17,130,12,144,212,25,83,39,645,881,1526,8,6,201946
15,18,189,34,249,322,28,123,3,948,1156,2104,7,5.666666667,201946
15,19,157,126,346,601,50,84,41,1405,1664,3069,10,6,201946
15,20,59,29,240,157,8,19,5,517,1137,1654,6,6,201946
15,21,127,10,116,162,48,87,16,566,587,1153,6,5.5,201946
15,22,220,129,463,537,22,108,48,1527,1990,3517,14,6,201946
15,23,120,45,182,246,19,60,1,673,930,1603,6,5.333333333,201946
15,24,92,25,193,206,37,45,5,603,837,1440,4,6,201946
15,25,142,26,249,230,47,58,15,767,999,1766,6,6,201946
15,26,110,8,163,189,130,26,2,628,714,1342,9,7,201946
15,27,151,20,316,356,25,82,28,978,1347,2325,9,5.666666667,201946
15,28,213,33,451,303,25,54,8,1087,1337,2424,9,5.666666667,201946
15,29,162,54,388,466,15,75,14,1174,1521,2695,8,6,201946
15,30,240,41,345,392,92,69,32,1211,1308,2519,16,6,201946
15,31,132,304,106,293,11,20,0,866,992,1858,6,6,201946
15,32,151,17,218,299,93,61,2,841,908,1749,9,6,201946
15,33,146,41,312,305,55,38,0,897,1088,1985,7,6,201946
15,34,152,13,165,387,21,54,7,799,981,1780,8,6,201946
15,35,251,10,231,438,9,124,3,1066,1344,2410,9,5.666666667,201946
15,36,211,16,223,388,59,74,1,972,942,1914,9,5.5,201946
15,37,170,22,253,380,113,95,27,1060,1380,2440,7,6,201946
15,38,153,66,241,257,59,37,12,825,1026,1851,6,5.5,201946
15,39,153,13,178,235,33,94,6,712,843,1555,4,6,201946
15,40,203,66,218,363,97,105,6,1058,1299,2357,9,6,201946
15,41,212,53,479,502,89,65,17,1417,1651,3068,13,6,201946
16,1,142,23,343,135,18,7,0,668,629,1297,7,5.333333333,201946
16,2,99,30,91,123,23,43,0,409,408,817,9,5.25,201946
16,3,150,28,125,189,33,44,0,569,659,1228,10,5.25,201946
16,4,180,28,253,123,75,59,0,718,931,1649,8,5.5,201946
16,5,133,30,181,145,53,82,21,645,865,1510,10,5.666666667,201946
16,6,149,63,197,125,55,39,0,628,647,1275,12,5.5,201946
16,7,211,53,239,201,41,62,1,808,825,1633,9,5.5,201946
16,8,235,40,611,498,14,70,4,1472,1690,3162,12,6,201946
16,9,161,19,292,329,10,59,0,870,1021,1891,9,6.5,201946
16,10,122,22,317,237,23,45,0,766,822,1588,6,6,201946
16,11,165,34,237,170,66,78,1,751,939,1690,10,5.4,201946
16,12,146,34,246,159,27,65,1,678,635,1313,10,5.25,201946
17,1,117,80,302,348,40,54,4,945,1314,2259,9,8,201946
17,2,118,11,259,334,13,53,12,800,926,1726,8,5.666666667,201946
17,3,166,24,389,311,47,62,3,1002,1025,2027,8,5.5,201946
17,4,145,21,275,399,29,78,15,962,1018,1980,10,5.666666667,201946
17,5,70,6,145,107,20,37,0,385,509,894,5,5.5,201946
18,1,147,15,101,122,33,46,34,498,563,1061,7,5.25,201946
18,2,252,32,384,368,36,127,1,1200,1311,2511,8,6.666666667,201946
18,3,153,18,343,247,7,29,0,797,875,1672,8,5.75,201946
19,1,324,24,306,239,12,105,17,1027,1332,2359,9,6,201946
19,2,226,29,845,319,14,93,0,1526,1705,3231,9,6,201946
19,3,264,33,776,339,29,82,1,1524,1938,3462,7,6,201946
19,4,121,10,152,98,57,81,75,594,849,1443,5,6,201946
19,5,271,28,620,521,25,189,61,1715,1980,3695,8,6,201946
19,6,50,12,176,224,9,84,9,564,812,1376,5,6,201946
19,7,220,17,501,198,8,34,0,978,1084,2062,10,5.25,201946
19,8,53,5,177,114,5,17,1,372,478,850,7,6,201946
19,9,199,18,353,259,24,65,4,922,1233,2155,9,5.25,201946
19,10,98,18,407,148,6,36,1,714,1095,1809,6,7,201946
19,11,285,83,548,813,15,299,39,2082,2566,4648,13,6.333333333,201946
19,12,162,17,599,184,16,38,3,1019,1171,2190,13,5.666666667,201946
20,1,133,9,140,171,46,44,56,599,762,1361,8,5.5,201946
20,2,101,13,135,96,21,14,8,388,572,960,6,5.333333333,201946
20,3,83,10,116,103,122,24,14,472,599,1071,6,5.333333333,201946
20,4,107,5,63,74,41,40,22,352,569,921,6,5.333333333,201946
20,5,125,22,256,255,35,28,0,721,872,1593,11,5.25,201946
20,6,131,4,87,120,89,82,50,563,718,1281,8,5.25,201946
20,7,129,13,212,239,37,29,1,660,931,1591,8,5.75,201946
20,8,302,71,792,589,32,93,10,1889,2182,4071,14,7,201946
20,9,152,10,150,153,105,47,16,633,950,1583,8,5.666666667,201946
20,10,183,7,356,150,26,24,13,759,865,1624,9,5.25,201946
21,1,150,18,247,187,39,28,1,670,825,1495,9,5.4,201946
21,2,126,25,189,120,57,33,0,550,824,1374,9,5.2,201946
21,3,172,9,246,176,95,117,29,844,1017,1861,8,5.5,201946
21,4,130,9,154,54,104,27,7,485,783,1268,7,5.25,201946
21,5,186,23,500,190,9,33,15,956,1089,2045,8,5.666666667,201946
21,6,153,23,355,264,127,101,53,1076,1459,2535,6,7,201946
21,7,322,10,151,209,69,69,0,830,1148,1978,9,5.666666667,201946
21,8,183,22,384,175,48,91,35,938,800,1738,9,5.2,201946
21,9,183,23,606,316,74,57,29,1288,1314,2602,9,6,201946
21,10,132,14,414,314,33,107,52,1066,1446,2512,7,6,201946
21,11,107,6,186,114,24,13,11,461,421,882,4,6,201946
21,12,242,30,670,417,148,78,189,1774,2481,4255,16,7,201946
21,13,173,21,408,173,47,105,2,929,1196,2125,8,5.666666667,201946
21,14,145,15,208,117,124,71,12,692,961,1653,12,5.333333333,201946
21,15,133,10,208,224,29,85,24,713,1059,1772,7,5.5,201946
22,1,192,50,188,287,33,68,4,822,889,1711,11,5.2,201946
22,2,120,26,202,164,125,27,5,669,1010,1679,7,5.5,201946
22,3,270,68,748,601,18,89,0,1794,1781,3575,9,5.666666667,201946
22,4,203,44,612,445,12,60,4,1380,1594,2974,9,6.5,201946
22,5,191,18,313,216,52,71,12,873,999,1872,10,5,201946
23,1,211,13,834,241,55,28,6,1388,2080,3468,14,5.6,201946
23,2,143,15,373,210,28,24,0,793,1200,1993,8,5.25,201946
23,3,210,11,835,460,14,36,4,1570,1874,3444,19,0,201946
23,4,143,7,455,255,44,44,18,966,1202,2168,6,5.5,201946
24,1,117,53,143,200,10,64,0,587,611,1198,10,5.2,201946
24,2,119,35,194,151,16,69,2,586,673,1259,6,5.5,201946
24,3,167,29,143,139,78,35,1,592,653,1245,9,5.25,201946
24,4,106,23,137,158,45,107,32,608,813,1421,5,5.5,201946
24,5,209,48,678,530,9,57,0,1531,1755,3286,10,6.666666667,201946
24,6,164,141,376,254,39,36,2,1012,1119,2131,6,6,201946
24,7,161,23,136,221,80,18,0,639,718,1357,9,5.25,201946
25,1,153,15,302,339,50,49,23,931,778,1709,13,5.75,201946
25,2,215,73,356,380,17,44,0,1085,1312,2397,7,6,201946
25,3,187,11,263,373,20,82,12,948,1003,1951,8,5.6,201946
25,4,152,19,185,257,101,19,0,733,758,1491,8,5.333333333,201946
25,5,143,14,261,366,18,51,23,876,969,1845,8,5.666666667,201946
25,6,239,12,314,348,60,114,20,1107,1070,2177,8,5.75,201946
25,7,231,12,472,396,6,21,1,1139,1322,2461,6,6,201946
26,1,188,19,299,288,21,105,0,920,1016,1936,9,5.5,201946
26,2,200,18,328,383,8,113,14,1064,1191,2255,12,5.4,201946
26,3,262,38,373,411,16,205,18,1323,1676,2999,13,6.5,201946
26,4,116,23,208,183,49,52,17,648,615,1263,9,5.2,201946
26,5,180,9,193,206,15,111,0,714,733,1447,15,6,201946
26,6,195,27,202,295,15,189,2,925,1094,2019,10,5.333333333,201946
26,7,108,16,149,211,62,43,0,589,730,1319,10,5.5,201946
27,1,123,10,114,152,98,20,0,517,508,1025,8,5.5,201946
27,2,123,22,126,321,24,44,1,661,902,1563,8,5.666666667,201946
27,3,158,11,127,454,8,54,10,822,781,1603,7,5.666666667,201946
27,4,191,17,300,606,21,51,15,1201,1452,2653,8,6.5,201946
27,5,93,10,106,214,24,21,8,476,516,992,6,5.333333333,201946
27,6,125,9,141,352,5,50,0,682,839,1521,8,5.5,201946
28,1,188,43,547,323,6,33,0,1140,1251,2391,13,6,201946
28,2,159,22,587,238,26,57,59,1148,1158,2306,15,6,201946
28,3,90,11,143,105,10,47,7,413,674,1087,7,5.333333333,201946
28,4,336,30,445,320,69,104,61,1365,1452,2817,17,6,201946
28,5,88,18,202,278,13,108,30,737,1028,1765,10,5.5,201946
28,6,125,9,138,227,35,44,6,584,525,1109,13,5.166666667,201946
28,7,143,20,389,243,89,73,34,991,1284,2275,13,6,201946
28,8,105,10,169,205,50,77,8,624,794,1418,13,7,201946
28,9,160,23,394,228,38,80,22,945,1001,1946,11,5.75,201946
29,1,184,36,298,357,33,96,8,1012,1189,2201,7,5.5,201946
29,2,194,21,210,512,43,157,142,1279,1336,2615,11,6.333333333,201946
29,3,130,35,130,349,16,64,2,726,665,1391,6,5.666666667,201946
30,1,120,16,136,133,79,60,7,551,654,1205,7,5.333333333,201946
30,2,115,7,183,70,40,29,64,508,496,1004,9,5.25,201946
30,3,103,6,118,134,136,45,39,581,777,1358,6,5.666666667,201946
30,4,83,11,291,128,19,14,0,546,746,1292,8,6,201946
30,5,75,7,288,184,17,23,4,598,791,1389,7,5.5,201946
30,6,128,9,283,256,25,59,9,769,838,1607,9,5.333333333,201946
30,7,112,13,204,149,83,48,58,667,786,1453,11,5.25,201946
30,8,166,21,446,222,112,51,7,1025,1256,2281,11,5.4,201946
30,9,150,21,180,133,76,75,29,664,761,1425,8,5.5,201946
30,10,114,15,344,223,13,70,22,801,790,1591,6,6.5,201946
30,11,96,13,302,241,9,29,0,690,796,1486,5,5.5,201946
30,12,171,14,594,313,11,80,0,1183,1578,2761,10,6.25,201946
30,13,195,10,157,203,113,77,41,796,1062,1858,10,5.4,201946
30,14,123,11,213,109,133,33,6,628,785,1413,8,5.5,201946
30,15,233,21,249,237,155,121,43,1059,1042,2101,11,5.666666667,201946
30,16,132,13,245,302,36,89,79,896,1048,1944,10,5.333333333,201946
30,17,138,22,280,196,33,62,46,777,844,1621,8,5.5,201946
30,18,156,18,112,129,61,49,37,562,547,1109,8,5.25,201946
30,19,121,12,295,99,15,20,1,563,920,1483,13,5.6,201946
30,20,119,4,182,319,63,60,0,747,974,1721,10,5.4,201946
31,1,165,28,404,26,236,17,0,876,946,1822,8,5.5,201946
31,2,69,20,101,11,201,43,0,445,460,905,6,6,201946
31,3,348,141,927,503,249,57,1,2226,2549,4775,20,6.333333333,201946
31,4,89,9,256,140,76,50,46,666,887,1553,4,6,201946
31,5,88,21,133,125,88,63,31,549,696,1245,7,5.333333333,201946
32,1,142,65,191,168,60,66,49,741,815,1556,12,5.2,201946
32,2,181,51,191,97,111,91,21,743,807,1550,13,5.142857143,201946
32,3,165,78,186,312,11,97,1,850,1120,1970,13,5.6,201946
32,4,175,91,238,284,25,86,17,916,1040,1956,13,5.4,201946
1,1,191,34,272,222,48,59,2,828,395,1223,13,5.5,201947
1,2,246,64,535,408,69,112,11,1445,374,1819,10,6.666666667,201947
1,3,191,85,552,389,50,142,15,1424,367,1791,9,6.333333333,201947
2,1,190,13,411,301,39,153,60,1167,288,1455,11,6,201947
2,2,215,19,305,337,10,227,0,1113,381,1494,7,6,201947
2,3,271,10,403,475,24,177,53,1413,490,1903,12,6,201947
2,4,231,19,831,262,76,55,17,1491,270,1761,9,6.5,201947
2,5,226,16,667,364,220,167,10,1670,462,2132,11,6,201947
2,6,208,16,491,361,27,135,0,1238,353,1591,8,6.5,201947
2,7,216,28,514,396,29,92,21,1296,544,1840,12,5.75,201947
2,8,211,22,515,399,35,109,31,1322,391,1713,7,7,201947
3,1,194,22,291,275,50,104,2,938,305,1243,13,5.666666667,201947
3,2,180,38,620,286,55,54,1,1234,303,1537,9,6,201947
4,1,177,29,253,406,132,89,40,1126,374,1500,11,5.5,201947
4,2,143,13,264,317,63,69,47,916,311,1227,14,5.4,201947
5,1,236,10,373,386,24,110,10,1149,376,1525,9,5.666666667,201947
5,2,166,15,321,266,33,37,0,838,545,1383,10,6,201947
5,3,171,38,242,459,49,83,59,1101,380,1481,11,5.333333333,201947
5,4,253,34,564,658,26,119,32,1686,545,2231,11,6,201947
5,5,170,18,390,583,19,97,35,1312,352,1664,10,6,201947
5,6,159,15,255,310,19,53,36,847,326,1173,10,6,201947
5,7,191,13,303,391,10,68,20,996,468,1464,10,6,201947
6,1,269,16,275,267,15,59,32,933,260,1193,13,6.2,201947
6,2,174,9,308,199,63,97,25,875,310,1185,9,5.666666667,201947
7,1,246,3,176,162,25,15,2,629,640,1269,9,5.25,201947
7,2,202,7,88,647,35,22,0,1001,1163,2164,9,5.25,201947
7,3,300,5,189,189,186,42,1,912,448,1360,7,5.333333333,201947
7,4,217,12,126,241,12,31,32,671,337,1008,11,5.4,201947
7,5,372,15,288,450,68,65,0,1258,279,1537,11,5.666666667,201947
7,6,234,12,446,328,59,86,5,1170,381,1551,9,6,201947
7,7,245,20,348,314,157,78,2,1164,568,1732,8,5.25,201947
7,8,228,16,257,513,200,72,6,1292,601,1893,12,5.25,201947
7,9,210,13,314,467,60,79,16,1159,375,1534,9,5.666666667,201947
7,10,204,5,292,395,24,44,0,964,722,1686,9,5.5,201947
7,11,144,7,129,79,23,29,0,411,216,627,6,5.333333333,201947
7,12,237,8,308,448,14,52,0,1067,370,1437,9,5.5,201947
7,13,98,17,157,344,5,35,0,656,501,1157,9,5.25,201947
8,1,168,8,507,164,27,22,4,900,183,1083,4,6,201947
8,2,290,54,660,433,25,55,6,1523,579,2102,17,5.75,201947
8,3,233,38,395,343,45,75,33,1162,304,1466,4,6,201947
8,4,203,34,454,333,39,120,62,1245,331,1576,11,6,201947
8,5,179,51,260,297,54,41,1,883,539,1422,10,5.25,201947
8,6,143,44,254,222,39,82,21,805,227,1032,9,7,201947
8,7,167,91,167,276,11,59,0,771,579,1350,8,5.25,201947
8,8,247,45,452,627,22,176,5,1574,445,2019,10,7,201947
8,9,142,26,153,126,75,72,10,604,456,1060,10,5.2,201947
9,1,79,17,115,126,83,55,8,483,121,604,5,6,201947
9,2,414,125,855,879,233,206,116,2828,784,3612,12,6,201947
9,3,194,17,345,370,169,95,64,1254,385,1639,7,6,201947
9,4,201,24,449,473,190,76,2,1415,332,1747,11,6,201947
9,5,143,82,260,290,124,58,0,957,341,1298,7,6,201947
9,6,104,25,180,178,141,80,22,730,213,943,7,6,201947
9,7,79,9,428,298,3,36,35,888,289,1177,9,6,201947
9,8,95,27,306,369,61,99,56,1013,250,1263,5,6,201947
9,9,141,15,255,309,113,62,5,900,198,1098,5,6,201947
9,10,133,23,461,357,38,58,55,1125,332,1457,6,6,201947
9,11,212,23,424,495,237,111,18,1520,387,1907,7,7,201947
9,12,257,27,570,629,49,122,94,1748,537,2285,11,6,201947
9,13,119,16,294,325,122,82,40,998,298,1296,4,6,201947
9,14,104,22,317,235,67,67,20,832,207,1039,5,6,201947
9,15,263,15,1139,975,57,173,68,2690,818,3508,10,6.5,201947
9,16,224,286,394,665,34,84,8,1695,518,2213,15,6,201947
9,17,132,10,328,255,52,43,3,823,260,1083,6,6,201947
9,18,184,21,338,475,147,112,102,1379,397,1776,12,6,201947
9,19,205,61,326,315,231,74,37,1249,380,1629,5,6,201947
9,20,71,30,106,127,83,9,0,426,96,522,5,6,201947
9,21,132,10,172,268,121,39,9,751,205,956,3,6,201947
9,22,196,15,218,305,150,68,31,983,227,1210,5,6,201947
9,23,174,12,591,433,73,70,3,1356,341,1697,6,7,201947
9,24,337,70,620,683,380,125,15,2230,679,2909,14,6,201947
10,1,161,22,163,253,31,100,36,766,499,1265,12,4.666666667,201947
10,2,184,25,278,337,24,101,16,965,378,1343,10,5.25,201947
10,3,152,24,184,204,28,134,40,766,465,1231,11,5.4,201947
10,4,224,20,352,502,38,139,1,1276,463,1739,11,6.5,201947
11,1,169,98,186,339,71,66,4,933,286,1219,6,5.666666667,201947
11,2,197,47,335,234,123,88,15,1039,341,1380,7,6,201947
11,3,164,30,203,265,34,117,7,820,216,1036,3,6,201947
11,4,168,67,221,281,65,102,8,912,335,1247,8,6,201947
11,5,276,90,405,585,35,161,24,1576,418,1994,7,6.5,201947
11,6,119,31,238,271,42,84,10,795,176,971,8,6,201947
11,7,190,64,278,445,21,39,0,1037,659,1696,9,5.5,201947
11,8,142,53,273,429,91,100,22,1110,448,1558,9,5.5,201947
11,9,198,77,334,571,17,149,17,1363,332,1695,10,5.666666667,201947
11,10,212,50,261,288,37,94,69,1011,365,1376,10,5.6,201947
11,11,166,69,313,399,19,102,0,1068,273,1341,5,6,201947
11,12,214,86,498,481,32,95,17,1423,320,1743,7,6.5,201947
11,13,156,35,211,182,56,48,25,713,279,992,8,5.5,201947
11,14,159,48,258,195,98,64,3,825,341,1166,8,5.5,201947
11,15,135,80,223,281,29,59,12,819,362,1181,9,6,201947
12,1,125,32,171,150,61,49,0,588,293,881,10,5.2,201947
12,2,190,26,286,469,21,97,6,1095,323,1418,10,5.5,201947
12,3,146,30,205,340,16,51,0,788,444,1232,11,5.2,201947
12,4,203,18,285,444,34,61,0,1045,258,1303,9,6,201947
12,5,206,31,275,314,10,37,18,891,649,1540,10,5.25,201947
12,6,102,13,259,438,64,15,16,907,296,1203,10,5.25,201947
12,7,174,22,216,429,25,74,24,964,255,1219,6,5.5,201947
12,8,179,26,157,252,1,32,0,647,557,1204,9,5.25,201947
12,9,190,28,306,457,44,45,1,1071,311,1382,9,5.666666667,201947
13,1,284,19,146,323,90,52,36,950,321,1271,9,5.333333333,201947
13,2,213,22,117,224,87,76,31,770,360,1130,6,5.333333333,201947
13,3,209,34,190,198,119,147,3,900,321,1221,12,5.25,201947
13,4,257,21,297,306,91,71,35,1078,388,1466,9,5.666666667,201947
13,5,307,17,427,367,125,140,46,1429,314,1743,9,5.75,201947
13,6,307,108,592,696,103,112,29,1947,645,2592,11,6,201947
13,7,174,18,294,364,40,40,2,932,364,1296,8,5.5,201947
14,1,133,50,139,77,113,58,7,577,270,847,6,5.5,201947
14,2,217,32,243,106,105,132,0,835,244,1079,5,5.666666667,201947
14,3,282,22,419,134,19,159,11,1046,659,1705,8,5.4,201947
14,4,174,14,333,293,22,100,11,947,236,1183,10,6,201947
14,5,189,31,499,232,21,67,1,1040,629,1669,9,5.5,201947
14,6,230,18,611,317,21,51,0,1248,313,1561,11,6,201947
14,7,113,23,277,178,0,17,0,608,189,797,6,6,201947
14,8,425,50,999,705,66,183,4,2432,637,3069,11,6,201947
14,9,147,14,327,306,25,57,2,878,188,1066,11,6,201947
14,10,189,57,544,275,14,102,26,1207,382,1589,7,6.5,201947
14,11,202,27,318,294,74,122,37,1074,224,1298,4,6,201947
14,12,266,29,590,201,37,52,0,1175,491,1666,9,5.5,201947
14,13,206,34,537,270,12,79,7,1145,338,1483,6,6,201947
14,14,161,30,363,325,57,139,31,1106,558,1664,7,6,201947
14,15,238,51,259,166,138,86,3,941,381,1322,10,5.6,201947
14,16,155,29,340,197,70,71,6,868,278,1146,5,6,201947
14,17,129,22,213,79,63,83,16,605,451,1056,7,5.25,201947
14,18,218,36,401,144,110,74,21,1004,505,1509,9,5.4,201947
14,19,207,35,310,201,54,79,15,901,500,1401,8,5.25,201947
14,20,226,22,394,256,6,63,0,967,464,1431,10,5.666666667,201947
15,1,163,17,147,85,279,64,0,755,312,1067,7,5.333333333,201947
15,2,138,25,222,260,151,36,10,842,239,1081,6,6,201947
15,3,256,31,215,237,330,79,56,1204,460,1664,10,5.666666667,201947
15,4,202,14,241,356,55,84,29,981,334,1315,4,6,201947
15,5,194,62,337,283,41,61,8,986,311,1297,8,5.666666667,201947
15,6,194,8,284,472,36,91,35,1120,303,1423,7,6.5,201947
15,7,172,18,411,224,93,76,6,1000,341,1341,10,6,201947
15,8,104,20,189,242,22,45,14,636,189,825,4,6,201947
15,9,194,13,131,120,190,147,6,801,498,1299,9,5.75,201947
15,10,134,6,197,360,25,89,5,816,259,1075,6,6,201947
15,11,215,51,326,377,62,57,17,1105,285,1390,8,6,201947
15,12,245,12,561,507,83,84,0,1492,435,1927,8,6,201947
15,13,120,24,190,224,145,79,0,782,257,1039,8,6,201947
15,14,81,27,142,219,51,39,1,560,178,738,4,6,201947
15,15,162,178,238,394,62,44,6,1084,363,1447,6,6,201947
15,16,216,33,339,592,27,108,19,1334,429,1763,8,6,201947
15,17,164,23,211,265,48,94,52,857,273,1130,8,6,201947
15,18,225,48,324,401,38,129,7,1172,596,1768,7,5.666666667,201947
15,19,227,78,482,720,32,131,43,1713,508,2221,10,6,201947
15,20,84,33,283,208,22,43,3,676,355,1031,6,6,201947
15,21,95,7,120,176,24,78,22,522,192,714,6,5.5,201947
15,22,305,116,617,795,51,143,45,2072,651,2723,14,6,201947
15,23,163,34,233,337,33,76,3,879,570,1449,6,5.333333333,201947
15,24,129,26,229,286,37,53,6,766,600,1366,4,6,201947
15,25,204,30,275,275,59,81,11,935,672,1607,6,6,201947
15,26,132,10,187,255,151,39,2,776,357,1133,9,7,201947
15,27,243,24,418,465,30,101,34,1315,451,1766,9,5.666666667,201947
15,28,224,37,527,383,47,54,11,1283,484,1767,9,5.666666667,201947
15,29,218,42,507,626,9,122,26,1550,484,2034,8,6,201947
15,30,259,39,374,453,89,73,26,1313,432,1745,16,6,201947
15,31,143,281,154,273,13,35,0,899,277,1176,6,6,201947
15,32,215,19,250,343,75,55,2,959,238,1197,9,6,201947
15,33,199,28,385,382,38,63,0,1095,262,1357,7,6,201947
15,34,180,13,228,461,34,61,13,990,281,1271,8,6,201947
15,35,246,16,294,501,4,149,5,1215,486,1701,9,5.666666667,201947
15,36,172,20,190,350,72,61,1,866,574,1440,9,5.5,201947
15,37,234,25,334,489,142,128,22,1374,373,1747,7,6,201947
15,38,181,56,328,347,86,50,8,1056,339,1395,6,5.5,201947
15,39,174,18,235,320,36,83,4,870,245,1115,4,6,201947
15,40,238,77,250,432,110,99,6,1212,434,1646,9,6,201947
15,41,240,46,542,551,80,104,14,1577,604,2181,13,6,201947
16,1,155,27,320,137,17,19,1,676,409,1085,7,5.333333333,201947
16,2,128,36,119,147,30,46,0,506,298,804,9,5.25,201947
16,3,231,47,187,312,66,99,0,942,460,1402,10,5.25,201947
16,4,216,35,276,154,85,89,0,855,415,1270,8,5.5,201947
16,5,223,36,210,277,68,90,24,928,307,1235,10,5.666666667,201947
16,6,184,71,239,171,49,47,0,761,382,1143,12,5.5,201947
16,7,160,34,260,230,51,68,3,806,312,1118,9,5.5,201947
16,8,263,33,719,576,18,88,9,1706,459,2165,12,6,201947
16,9,245,23,392,402,6,82,0,1150,271,1421,9,6.5,201947
16,10,146,17,343,348,19,57,0,930,228,1158,6,6,201947
16,11,200,31,273,211,105,94,0,914,565,1479,10,5.4,201947
16,12,141,31,204,148,21,59,2,606,326,932,10,5.25,201947
17,1,201,52,472,574,46,88,5,1438,387,1825,9,8,201947
17,2,168,20,282,424,25,65,3,987,375,1362,8,5.666666667,201947
17,3,246,25,526,442,40,86,1,1366,458,1824,8,5.5,201947
17,4,204,17,402,446,35,73,16,1193,345,1538,10,5.666666667,201947
17,5,131,18,182,146,26,63,0,566,288,854,5,5.5,201947
18,1,126,14,97,136,27,55,49,504,292,796,7,5.25,201947
18,2,246,29,345,408,42,118,1,1189,307,1496,9,7,201947
18,3,175,26,394,233,12,57,0,897,490,1387,8,5.75,201947
19,1,178,15,338,300,9,135,16,991,547,1538,9,6,201947
19,2,256,27,721,377,18,110,0,1509,469,1978,9,6,201947
19,3,248,23,670,339,54,94,4,1432,794,2226,7,6,201947
19,4,124,12,166,142,47,106,50,647,219,866,5,6,201947
19,5,314,18,537,544,26,192,45,1676,583,2259,8,6,201947
19,6,91,10,244,333,8,117,4,807,272,1079,5,6,201947
19,7,172,19,526,176,6,46,1,946,610,1556,10,5.5,201947
19,8,59,10,163,122,3,28,0,385,112,497,7,6,201947
19,9,178,19,302,262,21,68,12,862,533,1395,9,5.25,201947
19,10,151,13,448,229,22,98,13,974,297,1271,6,7,201947
19,11,340,55,580,852,17,310,49,2203,671,2874,13,6.333333333,201947
19,12,172,6,487,195,13,54,5,932,725,1657,13,5.666666667,201947
20,1,188,13,190,203,68,44,56,762,280,1042,8,5.5,201947
20,2,193,27,206,160,24,23,13,646,614,1260,6,5.333333333,201947
20,3,84,7,178,121,133,38,17,578,202,780,6,5.333333333,201947
20,4,100,16,87,90,44,66,22,425,225,650,6,5.333333333,201947
20,5,116,11,277,235,35,24,1,699,328,1027,11,5.25,201947
20,6,205,7,120,146,100,106,52,736,557,1293,8,5.25,201947
20,7,173,20,236,330,39,44,0,842,263,1105,8,5.75,201947
20,8,390,65,875,705,76,124,18,2253,747,3000,13,6.5,201947
20,9,262,20,267,235,146,70,18,1018,581,1599,8,5.666666667,201947
20,10,181,9,356,129,36,32,14,757,400,1157,9,5.25,201947
21,1,181,18,337,209,42,33,4,824,591,1415,9,5.4,201947
21,2,213,92,274,179,141,72,0,971,624,1595,9,5.2,201947
21,3,283,20,320,342,137,135,30,1267,602,1869,8,5.5,201947
21,4,199,11,228,84,150,77,10,759,384,1143,7,5.25,201947
21,5,201,26,532,245,12,45,6,1067,340,1407,8,5.666666667,201947
21,6,227,15,437,370,169,146,54,1418,374,1792,6,7,201947
21,7,405,11,218,272,127,123,2,1158,357,1515,9,5.666666667,201947
21,8,132,5,199,124,50,58,24,592,553,1145,9,5.2,201947
21,9,202,30,617,408,83,80,17,1437,383,1820,9,6,201947
21,10,232,23,494,359,37,117,91,1353,504,1857,7,6,201947
21,11,102,2,196,110,36,25,12,483,102,585,4,6,201947
21,12,403,42,969,621,218,140,308,2701,653,3354,16,7,201947
21,13,207,21,498,233,37,115,4,1115,382,1497,8,5.666666667,201947
21,14,216,17,235,150,165,85,18,886,532,1418,12,5.333333333,201947
21,15,262,14,408,352,54,169,43,1302,426,1728,7,5.5,201947
22,1,163,28,148,286,23,58,1,707,315,1022,11,4.2,201947
22,2,158,36,213,214,111,41,0,773,334,1107,7,4.5,201947
22,3,264,86,835,637,18,102,0,1942,827,2769,9,6,201947
22,4,205,35,709,466,25,75,3,1518,437,1955,8,6,201947
22,5,174,26,370,209,51,55,13,898,341,1239,10,5.5,201947
23,1,234,8,1035,307,58,55,20,1717,678,2395,14,5.6,201947
23,2,195,19,413,285,35,23,0,970,542,1512,8,5.25,201947
23,3,278,8,927,532,38,57,3,1843,413,2256,19,0,201947
23,4,159,9,501,284,33,47,13,1046,374,1420,6,5.5,201947
24,1,114,39,115,180,22,54,1,525,356,881,10,5.2,201947
24,2,129,31,240,187,28,60,0,675,528,1203,6,5.5,201947
24,3,138,41,130,172,84,33,2,600,411,1011,9,5.25,201947
24,4,156,26,208,203,46,97,46,782,446,1228,5,5.5,201947
24,5,271,64,735,607,17,88,0,1782,611,2393,10,6.666666667,201947
24,6,173,110,432,313,81,50,3,1162,326,1488,6,6,201947
24,7,146,21,144,198,103,24,0,636,352,988,9,5.25,201947
25,1,189,12,312,329,49,42,27,960,360,1320,13,5.75,201947
25,2,226,62,316,450,10,59,0,1123,340,1463,7,6,201947
25,3,150,13,227,345,26,78,9,848,292,1140,8,5.6,201947
25,4,148,27,215,258,85,21,0,754,486,1240,8,5.333333333,201947
25,5,219,18,349,452,19,60,20,1137,352,1489,8,5.666666667,201947
25,6,175,10,325,352,58,101,19,1040,443,1483,8,5.75,201947
25,7,258,14,496,514,7,54,0,1343,410,1753,6,6,201947
26,1,178,12,334,241,9,92,0,866,397,1263,9,5.5,201947
26,2,215,16,358,424,4,98,39,1154,467,1621,12,5.4,201947
26,3,335,27,486,492,5,214,14,1573,565,2138,13,6.5,201947
26,4,123,23,251,183,57,63,23,723,357,1080,9,5.2,201947
26,5,171,20,258,254,32,139,0,874,328,1202,15,6,201947
26,6,250,16,225,356,25,188,1,1061,413,1474,10,5.333333333,201947
26,7,155,21,187,259,64,65,0,751,206,957,10,5.5,201947
27,1,127,9,155,169,97,27,0,584,197,781,8,5.5,201947
27,2,176,14,165,401,21,50,0,827,265,1092,8,5.666666667,201947
27,3,158,9,123,428,7,51,5,781,279,1060,7,5.666666667,201947
27,4,212,15,329,649,34,64,10,1313,372,1685,8,6.5,201947
27,5,80,3,73,166,39,13,1,375,327,702,6,5,201947
27,6,190,9,223,558,11,85,1,1077,522,1599,8,5.5,201947
28,1,150,22,371,265,6,41,0,855,487,1342,13,6,201947
28,2,142,14,353,231,18,54,46,858,387,1245,15,6,201947
28,3,110,11,208,134,9,44,6,522,531,1053,7,5.333333333,201947
28,4,212,26,344,264,45,94,59,1044,395,1439,17,6,201947
28,5,159,18,219,359,11,107,46,919,495,1414,9,5.25,201947
28,6,165,17,154,253,47,41,2,679,567,1246,13,5.166666667,201947
28,7,195,31,483,312,104,78,45,1248,370,1618,13,6,201947
28,8,124,17,239,299,73,85,5,842,250,1092,12,6,201947
28,9,125,10,272,192,29,69,29,726,248,974,11,5.75,201947
29,1,214,47,319,440,43,92,10,1165,443,1608,7,5.5,201947
29,2,219,19,227,539,34,122,113,1273,442,1715,11,6,201947
29,3,133,28,155,353,22,69,2,762,284,1046,6,5.666666667,201947
30,1,108,15,121,171,80,32,12,539,164,703,7,5.333333333,201947
30,2,139,17,175,81,30,16,65,523,183,706,9,5.25,201947
30,3,176,12,180,142,186,62,86,844,315,1159,6,5.666666667,201947
30,4,91,23,381,186,29,47,1,758,174,932,8,6,201947
30,5,128,14,332,216,20,39,1,750,200,950,7,5.5,201947
30,6,139,17,330,315,50,48,18,917,435,1352,9,5.333333333,201947
30,7,223,18,309,225,94,70,73,1012,276,1288,11,5.25,201947
30,8,215,24,525,249,88,59,2,1162,652,1814,11,5.4,201947
30,9,223,7,236,160,101,108,32,867,317,1184,8,5.5,201947
30,10,182,17,450,248,39,97,36,1069,178,1247,6,6.5,201947
30,11,166,15,417,365,15,36,0,1014,357,1371,5,5.5,201947
30,12,218,14,729,431,24,89,1,1506,349,1855,10,6.25,201947
30,13,219,14,241,192,143,135,79,1023,351,1374,10,5.4,201947
30,14,137,15,267,156,193,30,16,814,256,1070,8,5.5,201947
30,15,238,17,255,269,166,128,67,1140,370,1510,11,5.666666667,201947
30,16,174,18,308,423,76,110,84,1193,349,1542,10,5.333333333,201947
30,17,192,23,286,246,24,53,49,873,446,1319,8,5.5,201947
30,18,185,15,121,105,49,69,37,581,233,814,8,5.25,201947
30,19,184,10,397,199,49,54,1,894,338,1232,13,5.6,201947
30,20,137,16,206,396,81,99,0,935,306,1241,10,5.4,201947
31,1,169,15,355,50,282,34,0,905,616,1521,8,5.5,201947
31,2,85,11,133,20,251,45,0,545,365,910,6,5.333333333,201947
31,3,380,124,1208,655,248,105,3,2723,763,3486,21,6.666666667,201947
31,4,93,18,350,178,153,68,48,908,303,1211,4,6,201947
31,5,142,22,268,162,139,78,19,830,752,1582,7,5.333333333,201947
32,1,154,59,179,188,70,68,56,774,316,1090,12,5.2,201947
32,2,183,38,222,135,135,98,46,857,317,1174,13,5.142857143,201947
32,3,153,50,178,303,6,113,1,804,411,1215,13,5.6,201947
32,4,158,98,266,298,30,101,23,974,374,1348,12,5.2,201947
1,1,164,37,215,227,60,79,5,787,238,1025,13,4.5,201948
1,2,215,31,453,427,38,112,9,1285,372,1657,10,5.666666667,201948
1,3,158,47,433,395,32,102,12,1179,241,1420,9,5.333333333,201948
2,1,153,10,259,251,39,95,44,851,346,1197,11,5,201948
2,2,165,4,231,347,3,139,0,889,231,1120,7,5,201948
2,3,205,4,336,380,22,141,54,1142,298,1440,11,4.666666667,201948
2,4,143,5,511,202,53,46,14,974,189,1163,9,5.5,201948
2,5,187,8,539,255,153,108,1,1251,330,1581,11,5,201948
2,6,156,11,395,296,29,101,0,988,138,1126,8,5.5,201948
2,7,190,17,377,273,16,68,17,958,171,1129,12,4.75,201948
2,8,152,7,438,319,28,88,41,1073,205,1278,7,6,201948
3,1,147,12,205,251,36,97,6,754,200,954,13,4.666666667,201948
3,2,138,23,474,230,43,54,0,962,190,1152,9,5,201948
4,1,150,27,190,301,112,64,12,856,206,1062,11,4.5,201948
4,2,176,14,297,351,63,70,60,1031,185,1216,14,4.4,201948
5,1,178,15,348,361,35,90,10,1037,275,1312,9,4.666666667,201948
5,2,235,16,270,388,36,65,0,1010,579,1589,10,5,201948
5,3,170,29,270,457,90,97,71,1184,392,1576,11,4.333333333,201948
5,4,228,27,522,581,17,98,25,1498,487,1985,11,5,201948
5,5,169,24,301,575,10,96,32,1207,160,1367,10,5,201948
5,6,135,15,223,288,17,39,40,757,222,979,10,5,201948
5,7,161,13,294,410,3,65,9,955,173,1128,10,5,201948
6,1,197,12,254,245,18,46,48,820,172,992,13,5.2,201948
6,2,131,11,249,180,50,79,27,727,286,1013,9,4.666666667,201948
7,1,231,2,88,125,73,12,2,533,243,776,9,4.25,201948
7,2,137,2,67,406,17,14,0,643,943,1586,9,3.5,201948
7,3,206,14,147,163,125,41,0,696,263,959,7,4.333333333,201948
7,4,191,6,152,210,0,30,31,620,366,986,11,4.4,201948
7,5,231,12,178,342,34,63,0,860,137,997,11,4.666666667,201948
7,6,160,15,361,276,50,66,11,939,314,1253,8,4.666666667,201948
7,7,214,15,231,227,79,51,7,824,321,1145,8,4.5,201948
7,8,190,9,162,423,73,59,2,918,449,1367,12,4.25,201948
7,9,160,12,235,405,25,85,15,937,227,1164,9,4.666666667,201948
7,10,128,5,168,289,13,29,0,632,779,1411,9,4.5,201948
7,11,81,1,111,46,17,12,0,268,94,362,6,4.333333333,201948
7,12,172,5,209,383,14,44,0,827,284,1111,9,4.5,201948
7,13,95,15,140,226,1,28,1,506,143,649,9,4.25,201948
8,1,138,5,372,157,13,21,4,710,77,787,4,5,201948
8,2,187,39,471,348,23,49,0,1117,310,1427,17,4.75,201948
8,3,147,22,339,325,34,68,28,963,144,1107,4,5,201948
8,4,136,17,306,243,30,101,52,885,192,1077,11,5,201948
8,5,160,31,181,259,25,38,0,694,532,1226,10,4.25,201948
8,6,144,19,192,241,35,81,13,725,143,868,9,6,201948
8,7,118,67,143,208,3,51,0,590,360,950,8,4.25,201948
8,8,190,23,450,602,15,141,7,1428,283,1711,10,6,201948
8,9,121,29,151,140,60,97,11,609,385,994,10,4,201948
9,1,70,9,134,127,101,37,10,488,116,604,5,5,201948
9,2,345,82,702,779,181,146,100,2335,442,2777,12,5,201948
9,3,136,18,321,370,124,93,63,1125,200,1325,7,5,201948
9,4,169,25,308,426,159,55,8,1150,237,1387,11,5,201948
9,5,88,59,225,284,110,66,0,832,170,1002,7,5,201948
9,6,68,15,160,155,133,68,22,621,158,779,7,5,201948
9,7,70,10,355,244,5,35,31,750,211,961,9,5,201948
9,8,94,10,225,323,47,60,47,806,198,1004,5,5,201948
9,9,93,8,179,260,95,55,5,695,139,834,5,5,201948
9,10,93,10,405,262,29,63,27,889,292,1181,6,5,201948
9,11,163,11,334,452,180,85,7,1232,252,1484,7,6,201948
9,12,187,18,390,498,47,89,60,1289,261,1550,11,5,201948
9,13,101,15,278,268,117,53,44,876,199,1075,4,5,201948
9,14,99,6,208,228,85,62,22,710,159,869,5,5,201948
9,15,206,29,889,790,52,148,82,2196,463,2659,10,5.5,201948
9,16,176,188,351,610,53,79,9,1466,305,1771,15,5,201948
9,17,102,9,242,258,48,47,3,709,162,871,6,5,201948
9,18,136,11,292,419,109,94,85,1146,210,1356,12,5,201948
9,19,160,27,242,284,159,76,39,987,188,1175,5,5,201948
9,20,33,26,67,111,34,4,0,275,84,359,5,5,201948
9,21,77,8,108,176,82,26,5,482,101,583,3,5,201948
9,22,111,10,205,220,100,56,27,729,118,847,5,5,201948
9,23,141,9,469,377,73,64,4,1137,232,1369,6,6,201948
9,24,220,38,453,616,308,134,22,1791,349,2140,14,5,201948
10,1,90,38,144,208,14,76,42,612,514,1126,12,3.833333333,201948
10,2,151,17,240,265,31,102,31,837,222,1059,10,4.25,201948
10,3,133,32,132,173,28,69,39,606,151,757,11,4.4,201948
10,4,218,26,311,446,18,112,0,1131,301,1432,11,5.5,201948
11,1,136,80,161,244,44,72,2,739,164,903,6,4.666666667,201948
11,2,117,42,241,162,82,85,18,747,207,954,7,5,201948
11,3,117,32,208,217,25,88,4,691,141,832,3,5,201948
11,4,127,44,166,211,41,68,1,658,177,835,8,5,201948
11,5,197,75,323,492,27,130,39,1283,271,1554,7,5.5,201948
11,6,97,28,204,221,31,57,7,645,130,775,8,5,201948
11,7,132,41,232,474,18,54,0,951,182,1133,9,4.5,201948
11,8,154,51,208,342,81,76,14,926,198,1124,9,4.5,201948
11,9,179,55,267,459,8,98,23,1089,193,1282,10,4.666666667,201948
11,10,153,39,216,179,38,98,66,789,139,928,10,4.6,201948
11,11,169,34,300,378,15,73,0,969,170,1139,5,5,201948
11,12,162,62,367,458,17,60,10,1136,179,1315,7,5.5,201948
11,13,125,39,197,153,53,52,17,636,227,863,8,4.5,201948
11,14,137,29,236,178,80,44,3,707,121,828,8,4.5,201948
11,15,111,37,175,209,20,42,20,614,99,713,9,5,201948
12,1,101,28,176,153,73,21,2,554,111,665,10,4,201948
12,2,124,20,175,398,13,57,1,788,308,1096,10,4.5,201948
12,3,156,7,188,274,12,38,1,676,229,905,11,4.2,201948
12,4,165,19,267,406,24,41,0,922,247,1169,9,5,201948
12,5,141,27,196,202,1,30,11,608,145,753,10,4.25,201948
12,6,122,13,149,248,17,27,13,589,361,950,10,4.25,201948
12,7,122,14,182,385,10,59,15,787,247,1034,6,4,201948
12,8,139,12,138,262,2,36,0,589,110,699,9,4.25,201948
12,9,144,21,265,396,29,46,3,904,255,1159,9,4.666666667,201948
13,1,201,17,130,292,81,38,38,797,131,928,9,4.333333333,201948
13,2,86,9,65,109,51,46,20,386,90,476,6,4.333333333,201948
13,3,124,6,122,136,78,52,1,519,137,656,12,4.25,201948
13,4,203,21,232,260,91,71,47,925,226,1151,9,4.666666667,201948
13,5,204,13,306,324,93,110,39,1089,175,1264,9,4.75,201948
13,6,248,44,528,613,64,83,28,1608,361,1969,11,5,201948
13,7,121,7,240,338,39,47,2,794,192,986,8,4.5,201948
14,1,103,43,136,81,88,54,8,513,178,691,6,4.5,201948
14,2,143,18,212,86,81,100,7,647,115,762,5,4.666666667,201948
14,3,168,26,333,93,27,133,6,786,332,1118,8,4.4,201948
14,4,132,15,270,265,20,72,8,782,167,949,10,5,201948
14,5,146,17,335,185,30,63,1,777,132,909,9,4.5,201948
14,6,165,14,434,283,17,36,1,950,78,1028,11,5,201948
14,7,94,11,239,0,153,0,18,515,112,627,6,5,201948
14,8,283,36,773,667,23,169,3,1954,241,2195,11,5.25,201948
14,9,93,17,188,292,24,68,4,686,57,743,11,5,201948
14,10,148,53,458,269,8,73,14,1023,196,1219,7,5.5,201948
14,11,149,17,257,228,91,91,42,875,86,961,4,5,201948
14,12,185,21,495,190,30,45,0,966,98,1064,9,4.5,201948
14,13,171,18,403,263,10,85,3,953,98,1051,6,5,201948
14,14,99,19,310,258,34,91,29,840,231,1071,7,5,201948
14,15,158,44,245,158,73,62,2,742,276,1018,10,4.6,201948
14,16,143,22,301,165,51,59,7,748,140,888,5,5,201948
14,17,110,25,139,54,40,62,7,437,118,555,7,4.25,201948
14,18,156,25,292,121,100,73,38,805,163,968,9,4.4,201948
14,19,108,17,210,137,29,45,16,562,78,640,8,4.25,201948
14,20,153,19,332,166,3,58,0,731,96,827,10,4.666666667,201948
15,1,137,9,98,68,189,46,0,547,119,666,7,4.333333333,201948
15,2,125,12,163,222,101,38,21,682,116,798,6,5,201948
15,3,155,21,142,177,239,45,53,832,144,976,10,4.666666667,201948
15,4,140,22,161,333,33,47,17,753,152,905,4,5,201948
15,5,145,38,238,235,29,41,12,738,231,969,8,4.666666667,201948
15,6,145,10,195,397,25,69,34,875,152,1027,7,5.5,201948
15,7,124,13,282,223,71,74,12,799,175,974,10,5,201948
15,8,80,14,140,233,13,30,22,532,90,622,4,5,201948
15,9,182,10,126,65,131,102,0,616,188,804,9,4.75,201948
15,10,83,6,165,318,19,49,8,648,107,755,6,5,201948
15,11,154,22,241,313,48,44,9,831,161,992,8,5,201948
15,12,165,9,382,402,59,48,1,1066,157,1223,8,5,201948
15,13,87,17,144,193,137,66,0,644,105,749,8,5,201948
15,14,61,22,125,188,33,38,3,470,86,556,4,5,201948
15,15,146,108,213,296,62,48,7,880,197,1077,6,5,201948
15,16,164,19,268,507,33,80,22,1093,197,1290,8,5,201948
15,17,98,8,121,210,35,70,43,585,95,680,8,5,201948
15,18,139,15,208,262,21,98,8,751,194,945,7,4.666666667,201948
15,19,173,60,385,657,45,83,42,1445,247,1692,10,5,201948
15,20,64,20,253,229,26,31,5,628,137,765,6,5,201948
15,21,65,11,75,131,27,43,12,364,61,425,6,4.5,201948
15,22,227,80,477,652,26,116,43,1621,274,1895,14,5,201948
15,23,101,30,156,256,11,52,5,611,155,766,6,4.333333333,201948
15,24,94,17,177,208,31,44,11,582,187,769,4,5,201948
15,25,148,33,158,270,55,70,7,741,242,983,6,5,201948
15,26,114,8,170,224,112,43,1,672,117,789,9,6,201948
15,27,124,15,244,318,15,68,49,833,140,973,9,4.333333333,201948
15,28,187,26,424,307,41,59,24,1068,254,1322,9,4.666666667,201948
15,29,166,25,353,517,10,81,7,1159,182,1341,8,5,201948
15,30,199,27,290,400,76,65,25,1082,195,1277,16,5,201948
15,31,104,172,138,230,15,23,0,682,110,792,6,5,201948
15,32,111,11,199,345,53,41,5,765,140,905,9,5,201948
15,33,155,28,334,319,40,69,0,945,86,1031,7,5,201948
15,34,133,12,166,382,21,54,14,782,140,922,8,5,201948
15,35,186,12,223,399,6,102,11,939,147,1086,9,4.666666667,201948
15,36,161,15,198,322,60,61,0,817,158,975,9,4.5,201948
15,37,155,17,246,372,91,83,27,991,212,1203,7,5,201948
15,38,122,34,185,256,60,37,7,701,98,799,6,4,201948
15,39,144,12,169,285,42,74,3,729,78,807,4,5,201948
15,40,155,39,134,283,86,74,0,771,180,951,9,4.333333333,201948
15,41,162,39,372,402,72,55,25,1127,267,1394,13,5,201948
16,1,98,13,210,99,16,11,1,448,228,676,7,4.333333333,201948
16,2,61,33,68,111,14,36,0,323,58,381,9,4.25,201948
16,3,142,13,91,177,19,42,0,484,253,737,10,4.25,201948
16,4,124,19,175,110,59,65,0,552,110,662,8,4.5,201948
16,5,138,16,168,169,58,67,24,640,152,792,10,4.666666667,201948
16,6,85,54,138,147,26,35,0,485,196,681,12,4.5,201948
16,7,108,24,151,196,29,34,1,543,214,757,9,4.5,201948
16,8,224,33,508,512,16,76,8,1377,254,1631,12,5,201948
16,9,163,20,276,351,8,64,0,882,202,1084,9,5.5,201948
16,10,106,13,254,244,20,54,0,691,133,824,6,5,201948
16,11,137,26,165,144,77,78,0,627,229,856,10,4.4,201948
16,12,125,32,192,153,33,62,3,600,98,698,10,4.25,201948
17,1,198,31,405,479,37,59,7,1216,241,1457,9,7,201948
17,2,103,9,231,348,17,51,9,768,263,1031,8,4.666666667,201948
17,3,168,18,343,365,37,54,0,985,219,1204,8,4.5,201948
17,4,164,14,261,329,25,53,16,862,158,1020,10,4.666666667,201948
17,5,93,14,111,143,12,32,0,405,121,526,5,4.5,201948
18,1,80,9,90,96,32,45,28,380,85,465,7,4.25,201948
18,2,198,29,290,385,38,95,1,1036,201,1237,9,6,201948
18,3,104,15,228,198,10,60,0,615,139,754,8,4.75,201948
19,1,167,24,314,298,20,133,37,993,209,1202,9,5,201948
19,2,253,24,639,407,10,107,0,1440,300,1740,9,5,201948
19,3,240,29,576,391,53,102,5,1396,238,1634,7,5,201948
19,4,111,5,159,131,51,100,73,630,146,776,5,5,201948
19,5,251,19,518,540,43,165,68,1604,305,1909,8,5,201948
19,6,84,8,213,266,4,82,2,659,141,800,5,5,201948
19,7,132,16,365,181,9,58,0,761,291,1052,10,4.25,201948
19,8,69,6,153,117,6,9,0,360,68,428,7,5,201948
19,9,109,15,182,107,26,41,22,502,498,1000,9,4.25,201948
19,10,140,9,301,215,11,125,18,819,211,1030,6,6,201948
19,11,334,46,567,843,19,285,79,2173,462,2635,13,5.333333333,201948
19,12,163,12,542,198,12,46,7,980,278,1258,13,4.666666667,201948
20,1,138,13,146,179,51,36,39,602,72,674,8,4.5,201948
20,2,125,17,166,128,33,23,12,504,373,877,6,4.333333333,201948
20,3,93,17,141,97,161,41,19,569,196,765,6,4.333333333,201948
20,4,54,5,59,74,86,71,7,356,46,402,6,4,201948
20,5,97,8,199,278,55,41,0,678,246,924,11,4.25,201948
20,6,125,1,69,102,87,64,37,485,217,702,8,4.25,201948
20,7,115,10,194,284,44,50,1,698,239,937,8,4.5,201948
20,8,323,52,645,600,87,121,25,1853,558,2411,14,6,201948
20,9,170,14,227,144,116,44,8,723,212,935,8,4.333333333,201948
20,10,125,17,331,136,28,17,4,658,167,825,9,4.25,201948
21,1,159,9,263,218,30,37,0,716,264,980,9,4.4,201948
21,2,150,49,205,131,56,41,0,632,284,916,9,4.2,201948
21,3,219,15,254,233,78,121,12,932,334,1266,8,4.5,201948
21,4,111,5,92,53,100,39,9,409,231,640,7,4.25,201948
21,5,178,27,446,237,19,57,13,977,183,1160,8,4.666666667,201948
21,6,200,9,330,353,128,110,52,1182,216,1398,6,6,201948
21,7,301,13,177,234,68,113,0,906,208,1114,9,4.666666667,201948
21,8,124,14,176,130,39,46,31,560,327,887,9,4.2,201948
21,9,164,23,473,371,90,74,23,1218,230,1448,9,5,201948
21,10,153,21,404,356,21,116,65,1136,241,1377,7,5,201948
21,11,66,7,140,106,29,28,17,393,81,474,4,5,201948
21,12,267,34,788,540,134,145,257,2165,421,2586,16,6,201948
21,13,125,8,348,202,32,97,6,818,215,1033,8,4.666666667,201948
21,14,163,17,176,127,143,74,16,716,356,1072,12,4.333333333,201948
21,15,220,10,332,324,35,88,29,1038,273,1311,7,4.5,201948
22,1,127,36,146,299,17,44,2,671,222,893,11,4.2,201948
22,2,125,29,242,218,97,39,2,752,209,961,7,4.5,201948
22,3,136,124,695,599,18,101,0,1673,390,2063,9,4.666666667,201948
22,4,177,36,549,440,14,65,4,1285,279,1564,9,5.5,201948
22,5,125,16,297,263,67,69,22,859,187,1046,10,4.5,201948
23,1,201,9,872,254,50,47,16,1449,491,1940,14,4.6,201948
23,2,118,12,435,207,47,24,0,843,236,1079,8,4.25,201948
23,3,211,11,775,529,43,51,0,1620,301,1921,19,0,201948
23,4,148,7,429,265,35,31,16,931,235,1166,6,4.5,201948
24,1,118,64,173,242,16,48,0,661,202,863,10,4.2,201948
24,2,95,22,204,182,15,59,3,580,205,785,6,4.5,201948
24,3,100,40,98,131,42,43,2,456,149,605,9,4.25,201948
24,4,106,15,167,192,54,73,40,647,125,772,5,4.5,201948
24,5,185,54,560,522,15,77,0,1413,401,1814,10,5.666666667,201948
24,6,126,114,309,300,56,52,1,958,247,1205,6,5,201948
24,7,121,15,132,212,63,12,0,555,70,625,9,4.25,201948
25,1,94,10,200,239,25,29,33,630,229,859,13,4.75,201948
25,2,182,61,308,348,6,78,0,983,240,1223,7,5,201948
25,3,109,13,215,349,18,65,10,779,193,972,8,4.6,201948
25,4,89,10,135,208,35,15,0,492,252,744,8,4.333333333,201948
25,5,145,13,244,369,12,53,5,841,198,1039,8,4.666666667,201948
25,6,125,8,243,277,44,92,20,809,400,1209,8,4.75,201948
25,7,177,15,386,415,9,44,0,1046,248,1294,6,5,201948
26,1,143,12,250,274,8,78,0,765,154,919,9,4.5,201948
26,2,157,9,281,326,5,73,11,862,187,1049,12,4.4,201948
26,3,213,13,296,468,16,170,17,1193,459,1652,13,5.5,201948
26,4,92,13,160,151,44,50,10,520,215,735,9,4.2,201948
26,5,140,10,167,186,25,98,0,626,178,804,15,5,201948
26,6,142,12,201,280,20,137,0,792,198,990,10,4.333333333,201948
26,7,115,10,148,181,44,49,0,547,133,680,10,4.5,201948
27,1,171,10,195,264,112,23,0,775,500,1275,8,4.5,201948
27,2,248,19,239,463,25,55,1,1050,272,1322,8,4.666666667,201948
27,3,154,8,118,419,6,46,5,756,291,1047,7,4.666666667,201948
27,4,196,23,319,649,22,67,11,1287,349,1636,8,5.5,201948
27,5,82,9,138,256,72,29,7,593,299,892,6,4.333333333,201948
27,6,126,16,181,484,5,47,0,859,178,1037,8,4.5,201948
28,1,179,18,415,329,8,45,0,994,265,1259,13,5,201948
28,2,152,16,373,260,20,74,61,956,377,1333,15,5,201948
28,3,77,9,159,103,13,38,9,408,160,568,7,4.333333333,201948
28,4,233,22,377,291,44,105,76,1148,236,1384,17,5,201948
28,5,161,14,199,289,9,96,61,829,291,1120,10,4.5,201948
28,6,112,23,120,214,37,37,4,547,309,856,13,4.166666667,201948
28,7,167,29,351,272,95,89,50,1053,174,1227,13,5,201948
28,8,127,19,184,218,60,41,9,658,147,805,12,5,201948
28,9,115,6,300,198,33,62,23,737,134,871,11,4.75,201948
29,1,159,17,278,385,35,109,4,987,154,1141,7,4.5,201948
29,2,167,11,191,446,31,109,84,1039,236,1275,10,4.666666667,201948
29,3,98,15,132,328,16,69,6,664,336,1000,6,4.666666667,201948
30,1,102,7,155,131,73,48,12,528,50,578,7,4.333333333,201948
30,2,107,9,133,94,45,31,104,523,115,638,9,4.25,201948
30,3,158,12,148,133,134,66,45,696,117,813,6,4.666666667,201948
30,4,112,10,323,167,35,38,0,685,130,815,8,5,201948
30,5,120,14,272,213,35,24,5,683,151,834,7,4.5,201948
30,6,117,10,230,191,23,43,8,622,376,998,9,4.333333333,201948
30,7,142,14,166,160,87,36,42,647,91,738,11,4.25,201948
30,8,167,26,427,227,110,49,16,1022,377,1399,11,4.4,201948
30,9,141,10,175,145,67,75,36,649,146,795,8,4.5,201948
30,10,127,17,359,237,35,62,52,889,390,1279,6,5.5,201948
30,11,101,8,311,263,7,31,0,721,226,947,5,4.5,201948
30,12,166,19,591,393,20,100,2,1291,262,1553,10,5.25,201948
30,13,121,6,100,175,83,58,37,580,133,713,10,4.4,201948
30,14,131,12,194,118,150,37,7,649,131,780,8,4.5,201948
30,15,198,23,245,258,103,122,83,1032,288,1320,11,4.666666667,201948
30,16,136,15,241,318,57,91,83,941,163,1104,10,4.333333333,201948
30,17,106,14,239,229,26,63,46,723,421,1144,8,4.5,201948
30,18,162,20,127,161,52,49,43,614,94,708,8,4.25,201948
30,19,145,4,352,216,30,42,2,791,164,955,13,4.6,201948
30,20,109,7,137,327,84,71,0,735,140,875,10,4.4,201948
31,1,110,15,251,29,209,19,0,633,320,953,8,4.5,201948
31,2,57,9,64,9,152,27,0,318,284,602,6,4.333333333,201948
31,3,343,65,1050,589,187,82,0,2316,440,2756,21,5.666666667,201948
31,4,90,13,243,132,166,60,51,755,182,937,4,5,201948
31,5,123,13,151,132,92,47,26,584,225,809,7,4.333333333,201948
32,1,129,29,127,144,40,59,49,577,191,768,12,4.4,201948
32,2,110,27,134,92,77,70,15,525,115,640,13,4.142857143,201948
32,3,147,53,142,354,1,100,0,797,235,1032,13,4.6,201948
32,4,187,66,232,251,35,113,14,898,373,1271,13,4.4,201948
1,1,216,41,368,233,98,77,4,1037,870,1907,13,5.5,201949
1,2,263,47,583,477,70,103,16,1559,1523,3082,10,6.666666667,201949
1,3,184,56,484,437,50,115,42,1368,1032,2400,9,6.333333333,201949
2,1,167,13,331,266,48,112,53,990,690,1680,11,6,201949
2,2,176,16,283,395,13,169,0,1052,809,1861,7,6,201949
2,3,245,8,425,419,14,169,72,1352,847,2199,12,6,201949
2,4,172,9,599,220,66,45,21,1132,833,1965,9,6.5,201949
2,5,233,20,609,287,194,135,13,1491,958,2449,11,6,201949
2,6,197,11,409,334,32,112,5,1100,806,1906,8,6.5,201949
2,7,227,31,459,306,45,113,28,1209,781,1990,12,5.75,201949
2,8,158,12,416,344,32,123,56,1141,575,1716,7,7,201949
3,1,136,6,224,253,20,65,10,714,580,1294,13,5.5,201949
3,2,123,10,461,218,41,36,0,889,929,1818,9,6,201949
4,1,201,38,285,431,119,91,31,1196,685,1881,11,5.5,201949
4,2,152,10,282,347,76,88,62,1017,529,1546,14,5.4,201949
5,1,241,16,437,367,55,130,20,1266,808,2074,9,5.666666667,201949
5,2,189,22,276,419,31,58,0,995,823,1818,10,6,201949
5,3,203,21,278,469,107,127,82,1287,1260,2547,11,5.333333333,201949
5,4,244,32,571,595,22,100,29,1593,1268,2861,11,6,201949
5,5,187,22,317,554,18,74,44,1216,824,2040,10,6,201949
5,6,177,21,305,355,7,48,47,960,593,1553,10,6,201949
5,7,183,13,308,434,7,88,26,1059,670,1729,10,6,201949
6,1,265,14,297,254,22,57,42,951,567,1518,13,6.2,201949
6,2,144,15,289,201,62,89,37,837,599,1436,9,5.666666667,201949
7,1,247,10,218,131,222,31,3,862,209,1071,9,5.25,201949
7,2,134,6,70,1109,15,18,0,1352,1430,2782,9,5.25,201949
7,3,363,1,261,169,178,55,0,1027,414,1441,7,5,201949
7,4,290,12,162,323,17,42,71,917,543,1460,11,5.4,201949
7,5,286,13,181,427,47,86,0,1040,770,1810,11,5.666666667,201949
7,6,231,12,461,334,71,101,11,1221,568,1789,9,6,201949
7,7,256,26,340,341,129,89,4,1185,779,1964,8,5.5,201949
7,8,230,10,196,605,89,70,2,1202,837,2039,12,5.25,201949
7,9,186,19,333,478,45,133,15,1209,701,1910,9,5.666666667,201949
7,10,178,12,277,407,27,27,0,928,528,1456,9,5.5,201949
7,11,124,6,163,128,32,41,0,494,233,727,6,5.333333333,201949
7,12,244,18,334,516,6,43,0,1161,856,2017,9,5.5,201949
7,13,113,18,110,324,2,47,0,614,338,952,9,5.25,201949
8,1,141,10,379,195,20,38,13,796,577,1373,4,6,201949
8,2,269,66,574,462,24,62,0,1457,1021,2478,17,5.75,201949
8,3,201,32,371,330,34,78,46,1092,877,1969,4,6,201949
8,4,193,28,375,287,40,112,65,1100,438,1538,11,6,201949
8,5,226,56,291,337,51,79,0,1040,558,1598,10,5.25,201949
8,6,150,40,260,285,48,90,22,895,675,1570,10,8,201949
8,7,160,74,186,244,4,71,0,739,763,1502,8,5.25,201949
8,8,207,38,519,690,12,158,6,1630,1083,2713,11,8,201949
8,9,150,35,153,116,46,104,14,618,511,1129,10,5.2,201949
9,1,101,14,131,143,122,50,11,572,386,958,5,6,201949
9,2,365,120,806,932,201,173,144,2741,1834,4575,12,6,201949
9,3,157,13,353,404,174,86,79,1266,763,2029,7,6,201949
9,4,175,30,414,476,200,64,3,1362,738,2100,11,6,201949
9,5,136,75,291,279,97,53,0,931,454,1385,7,6,201949
9,6,94,20,200,210,140,82,30,776,388,1164,7,6,201949
9,7,77,13,430,303,6,27,30,886,767,1653,9,6,201949
9,8,88,8,266,362,60,68,57,909,620,1529,5,6,201949
9,9,119,11,242,262,84,72,6,796,635,1431,5,6,201949
9,10,108,21,483,377,33,68,51,1141,946,2087,6,6,201949
9,11,161,18,445,476,260,99,18,1477,603,2080,7,7,201949
9,12,206,27,533,567,74,94,109,1610,784,2394,11,6,201949
9,13,120,7,308,296,122,80,51,984,479,1463,4,6,201949
9,14,107,19,253,301,70,67,32,849,793,1642,5,6,201949
9,15,246,29,997,919,77,136,79,2483,1089,3572,10,6.5,201949
9,16,219,188,447,706,52,76,13,1701,794,2495,15,6,201949
9,17,130,10,284,316,59,62,1,862,723,1585,6,6,201949
9,18,141,14,308,436,146,94,114,1253,592,1845,12,6,201949
9,19,204,53,284,348,195,73,54,1211,346,1557,5,6,201949
9,20,47,16,84,85,53,9,1,295,204,499,5,6,201949
9,21,121,2,182,249,89,35,5,683,169,852,3,6,201949
9,22,155,5,214,284,136,64,34,892,425,1317,5,6,201949
9,23,164,22,533,433,94,59,15,1320,554,1874,6,7,201949
9,24,250,35,524,633,374,160,35,2011,585,2596,14,6,201949
10,1,179,27,192,232,20,80,70,800,964,1764,12,4.833333333,201949
10,2,239,31,289,375,21,105,33,1093,1013,2106,10,5.25,201949
10,3,147,32,198,255,26,103,39,800,575,1375,11,5.4,201949
10,4,308,34,395,587,28,132,0,1484,898,2382,12,7,201949
11,1,167,76,190,293,58,65,11,860,572,1432,6,5.666666667,201949
11,2,184,50,348,280,119,87,20,1088,660,1748,7,6,201949
11,3,146,35,244,271,28,109,13,846,348,1194,3,6,201949
11,4,149,58,209,280,82,91,1,870,474,1344,8,6,201949
11,5,250,99,409,496,24,143,31,1452,935,2387,7,6.5,201949
11,6,119,29,221,238,29,68,5,709,866,1575,8,6,201949
11,7,222,53,359,557,30,70,0,1291,749,2040,9,5.5,201949
11,8,183,53,232,419,97,70,14,1068,746,1814,9,5.25,201949
11,9,187,86,351,492,20,107,28,1271,661,1932,10,5.666666667,201949
11,10,218,56,254,270,55,110,74,1037,477,1514,10,5.6,201949
11,11,194,47,328,417,15,88,0,1089,700,1789,5,6,201949
11,12,200,80,439,477,36,73,17,1322,858,2180,7,6.5,201949
11,13,152,50,250,173,66,70,29,790,391,1181,8,5.5,201949
11,14,171,46,344,251,111,64,3,990,391,1381,8,5.5,201949
11,15,148,45,219,312,20,47,32,823,421,1244,9,6,201949
12,1,135,39,231,185,71,56,7,724,357,1081,10,5.2,201949
12,2,206,28,292,499,21,90,8,1144,1054,2198,10,5.5,201949
12,3,162,15,251,358,19,48,0,853,570,1423,11,5.2,201949
12,4,179,23,304,511,32,74,0,1123,1098,2221,9,6,201949
12,5,217,37,270,382,5,35,30,976,471,1447,10,5.25,201949
12,6,155,18,231,413,29,16,15,877,1254,2131,10,5.25,201949
12,7,201,29,244,484,39,74,24,1095,650,1745,6,5.5,201949
12,8,146,25,175,319,1,44,0,710,347,1057,9,5.25,201949
12,9,184,32,402,422,27,41,0,1108,1073,2181,9,5.666666667,201949
13,1,251,19,213,374,98,61,56,1072,551,1623,9,5.333333333,201949
13,2,174,28,134,238,108,91,47,820,365,1185,6,5.333333333,201949
13,3,191,60,189,242,99,171,0,952,491,1443,12,5.25,201949
13,4,264,17,302,317,86,106,71,1163,638,1801,9,5.666666667,201949
13,5,271,16,441,376,92,120,51,1367,661,2028,9,5.75,201949
13,6,357,100,634,698,76,103,20,1988,912,2900,11,6,201949
13,7,225,24,329,377,60,42,2,1059,659,1718,8,5.5,201949
14,1,144,51,162,95,129,78,8,667,203,870,6,5.5,201949
14,2,156,22,221,112,92,105,12,720,287,1007,5,5.666666667,201949
14,3,229,28,429,112,14,155,8,975,157,1132,8,5.4,201949
14,4,165,24,339,340,31,96,13,1008,1080,2088,10,6,201949
14,5,198,29,481,228,59,75,7,1077,798,1875,9,5.5,201949
14,6,193,22,617,307,15,55,0,1209,666,1875,11,6,201949
14,7,115,18,271,157,0,35,0,596,318,914,6,6,201949
14,8,347,59,916,728,43,195,4,2292,1286,3578,11,6.25,201949
14,9,106,12,250,286,18,59,5,736,508,1244,11,6,201949
14,10,184,80,459,300,7,90,10,1130,715,1845,7,6.5,201949
14,11,152,19,269,255,90,124,45,954,582,1536,4,6,201949
14,12,220,22,573,187,28,57,2,1089,679,1768,9,5.5,201949
14,13,201,34,537,255,10,93,9,1139,539,1678,6,6,201949
14,14,138,33,365,304,60,111,56,1067,485,1552,7,6,201949
14,15,203,39,271,172,131,68,3,887,498,1385,10,5.6,201949
14,16,158,34,389,183,71,82,8,925,331,1256,5,6,201949
14,17,141,37,224,70,41,110,15,638,111,749,7,5.25,201949
14,18,211,39,372,139,104,96,44,1005,272,1277,9,5.4,201949
14,19,220,30,331,228,35,89,39,972,129,1101,8,5.25,201949
14,20,226,33,399,288,6,89,0,1041,60,1101,10,5.666666667,201949
15,1,153,22,152,96,326,56,0,805,342,1147,7,5.333333333,201949
15,2,150,22,208,253,149,41,13,836,466,1302,6,6,201949
15,3,217,28,203,295,379,76,82,1280,540,1820,10,5.333333333,201949
15,4,170,15,193,324,41,78,25,846,579,1425,4,5,201949
15,5,160,47,302,273,46,50,19,897,536,1433,8,5.666666667,201949
15,6,163,12,268,433,34,85,29,1024,537,1561,7,6.5,201949
15,7,148,17,395,211,104,80,7,962,662,1624,10,6,201949
15,8,86,22,143,221,17,24,21,534,316,850,4,6,201949
15,9,189,8,157,124,167,150,0,795,295,1090,9,5.5,201949
15,10,127,7,185,347,31,67,9,773,360,1133,6,6,201949
15,11,167,17,264,379,47,53,24,951,450,1401,8,6,201949
15,12,216,9,489,538,69,69,0,1390,716,2106,8,6,201949
15,13,77,18,145,204,134,66,2,646,356,1002,8,6,201949
15,14,80,35,153,223,42,35,6,574,280,854,4,6,201949
15,15,143,139,255,368,64,40,9,1018,509,1527,6,6,201949
15,16,204,16,304,580,31,95,14,1244,700,1944,8,6,201949
15,17,153,15,165,274,44,66,66,783,440,1223,8,6,201949
15,18,210,29,314,419,51,116,11,1150,496,1646,7,5.666666667,201949
15,19,210,41,450,773,52,130,49,1705,667,2372,10,6,201949
15,20,82,32,309,250,17,36,9,735,300,1035,6,6,201949
15,21,127,14,113,173,42,77,24,570,179,749,6,5.5,201949
15,22,284,125,558,717,45,134,88,1951,864,2815,14,6,201949
15,23,186,17,242,374,36,83,5,943,242,1185,6,5.333333333,201949
15,24,114,26,216,273,42,42,2,715,136,851,4,5,201949
15,25,176,22,242,274,61,98,10,883,192,1075,6,6,201949
15,26,107,10,200,231,129,48,1,726,328,1054,9,7,201949
15,27,210,23,424,439,39,108,76,1319,522,1841,9,5.666666667,201949
15,28,192,26,550,364,51,89,11,1283,571,1854,9,5.666666667,201949
15,29,191,24,426,595,17,96,37,1386,321,1707,8,6,201949
15,30,232,35,340,367,55,56,43,1128,359,1487,16,5.5,201949
15,31,159,225,144,289,14,31,0,862,359,1221,6,6,201949
15,32,151,16,203,339,62,62,3,836,479,1315,9,6,201949
15,33,147,24,314,311,37,46,1,880,361,1241,7,5,201949
15,34,240,15,226,476,17,79,9,1062,456,1518,8,6,201949
15,35,226,22,266,492,9,130,18,1163,295,1458,9,5.666666667,201949
15,36,203,26,218,383,44,56,0,930,203,1133,9,5.5,201949
15,37,185,16,274,403,109,94,40,1121,525,1646,7,6,201949
15,38,186,53,329,375,75,61,16,1095,302,1397,6,5.5,201949
15,39,145,15,184,248,50,81,10,733,282,1015,4,6,201949
15,40,234,53,210,423,118,128,13,1179,475,1654,9,5.333333333,201949
15,41,241,51,491,542,92,73,24,1514,664,2178,13,6,201949
16,1,160,33,288,165,24,18,4,692,581,1273,7,5.333333333,201949
16,2,134,48,171,155,19,56,0,583,239,822,9,5.25,201949
16,3,176,25,147,283,44,64,0,739,467,1206,10,5.25,201949
16,4,176,35,320,179,91,133,0,934,467,1401,8,5.5,201949
16,5,209,31,205,217,82,97,69,910,487,1397,10,5.666666667,201949
16,6,173,55,225,171,40,43,0,707,520,1227,12,5.5,201949
16,7,206,58,274,287,52,75,3,955,608,1563,9,5.5,201949
16,8,272,22,598,659,17,89,4,1661,1053,2714,12,6,201949
16,9,179,29,376,407,11,79,1,1082,917,1999,9,6.5,201949
16,10,144,22,295,297,33,49,0,840,508,1348,6,5.5,201949
16,11,165,22,243,196,81,90,1,798,498,1296,10,5.4,201949
16,12,128,22,288,201,31,62,7,739,262,1001,10,5.25,201949
17,1,176,43,425,548,57,100,9,1358,649,2007,9,8,201949
17,2,136,10,268,377,13,73,18,895,556,1451,8,5.666666667,201949
17,3,205,22,432,435,48,57,1,1200,812,2012,8,5.5,201949
17,4,172,29,397,419,23,67,37,1144,589,1733,10,5.666666667,201949
17,5,106,10,182,162,30,34,0,524,334,858,5,5.5,201949
18,1,189,23,134,184,54,56,44,684,442,1126,7,5.25,201949
18,2,247,40,385,432,61,122,1,1288,1089,2377,9,7,201949
18,3,177,17,390,268,12,74,0,938,633,1571,8,5.75,201949
19,1,194,22,341,362,18,167,46,1150,549,1699,9,6,201949
19,2,293,25,801,481,17,132,0,1749,415,2164,9,6,201949
19,3,278,23,731,467,42,116,4,1661,1102,2763,7,6,201949
19,4,142,8,218,137,86,107,105,803,352,1155,5,6,201949
19,5,344,28,627,730,41,207,57,2034,1009,3043,8,6,201949
19,6,63,11,250,337,7,93,8,769,680,1449,5,6,201949
19,7,191,8,540,211,10,60,1,1021,547,1568,10,5.5,201949
19,8,87,8,163,132,6,29,0,425,251,676,7,6,201949
19,9,132,13,228,189,29,107,19,717,586,1303,9,5.25,201949
19,10,155,17,396,311,14,147,42,1082,422,1504,6,7,201949
19,11,379,46,607,958,16,314,87,2407,1147,3554,13,6.333333333,201949
19,12,208,12,560,206,6,68,9,1069,482,1551,13,5.666666667,201949
20,1,171,11,193,236,62,51,67,791,383,1174,8,5.5,201949
20,2,194,17,242,154,23,29,8,667,346,1013,6,5.333333333,201949
20,3,121,8,178,138,106,62,42,655,518,1173,6,5.333333333,201949
20,4,116,12,82,99,47,90,29,475,260,735,6,4.666666667,201949
20,5,154,25,296,391,40,46,0,952,754,1706,11,5.25,201949
20,6,151,7,141,135,154,137,69,794,833,1627,8,5.25,201949
20,7,166,16,262,366,52,54,9,925,678,1603,8,5.75,201949
20,8,367,62,749,682,117,168,60,2205,908,3113,14,7,201949
20,9,175,11,220,203,144,40,20,813,551,1364,8,5.666666667,201949
20,10,154,13,407,161,42,21,5,803,399,1202,9,5.25,201949
21,1,155,15,244,203,43,24,12,696,590,1286,9,5.4,201949
21,2,144,30,235,149,83,46,0,687,355,1042,9,5.2,201949
21,3,236,16,280,281,132,139,43,1127,764,1891,8,5.5,201949
21,4,104,13,219,75,124,40,11,586,450,1036,7,5.25,201949
21,5,195,22,440,267,29,55,23,1031,588,1619,8,5.666666667,201949
21,6,192,25,381,320,172,136,62,1288,749,2037,6,7,201949
21,7,363,6,186,227,82,97,1,962,639,1601,9,5.666666667,201949
21,8,146,13,298,164,78,86,42,827,636,1463,9,5.2,201949
21,9,182,38,583,406,83,90,27,1409,787,2196,9,6,201949
21,10,175,14,444,378,30,131,98,1270,734,2004,7,6,201949
21,11,75,4,178,110,31,26,11,435,295,730,4,6,201949
21,12,283,38,808,518,149,160,282,2238,1170,3408,16,7,201949
21,13,181,23,448,216,39,101,7,1015,480,1495,8,5.666666667,201949
21,14,195,10,233,144,167,101,30,880,376,1256,12,5.333333333,201949
21,15,241,5,346,334,48,127,58,1159,435,1594,7,5.5,201949
22,1,189,47,198,358,26,70,3,891,416,1307,11,5.2,201949
22,2,161,34,280,298,145,56,9,983,589,1572,7,5.5,201949
22,3,261,66,775,645,16,119,0,1882,1209,3091,9,6,201949
22,4,176,29,604,510,31,76,2,1428,971,2399,9,6.5,201949
22,5,128,14,313,239,49,62,11,816,578,1394,10,5.5,201949
23,1,230,9,1028,302,62,57,31,1719,1435,3154,14,5.6,201949
23,2,188,23,509,283,37,30,0,1070,940,2010,8,5.25,201949
23,3,243,16,894,521,47,57,1,1779,1319,3098,19,0,201949
23,4,131,10,546,320,30,59,20,1116,1165,2281,6,5.5,201949
24,1,173,54,187,294,25,76,2,811,364,1175,10,5.2,201949
24,2,111,26,243,186,34,42,6,648,362,1010,6,5.5,201949
24,3,163,40,136,189,87,32,0,647,280,927,9,5.25,201949
24,4,181,39,206,208,53,132,77,896,393,1289,5,5.5,201949
24,5,240,83,710,639,19,92,0,1783,1120,2903,10,6.666666667,201949
24,6,153,114,394,358,78,55,0,1152,725,1877,6,6,201949
24,7,212,34,234,318,92,27,0,917,394,1311,9,5.25,201949
25,1,133,13,241,286,70,48,22,813,650,1463,13,5,201949
25,2,172,66,293,416,5,56,0,1008,693,1701,7,6,201949
25,3,171,16,301,465,39,117,14,1123,628,1751,8,5.6,201949
25,4,146,28,186,263,77,23,0,723,506,1229,8,5,201949
25,5,170,20,322,459,23,64,8,1066,627,1693,8,5.666666667,201949
25,6,151,9,276,310,59,81,15,901,1014,1915,8,5,201949
25,7,221,24,489,493,5,47,0,1279,883,2162,6,6,201949
26,1,185,13,296,255,4,112,0,865,605,1470,9,5.5,201949
26,2,146,14,269,320,5,73,19,846,538,1384,12,5.4,201949
26,3,199,15,327,414,25,185,32,1197,941,2138,13,6.5,201949
26,4,103,15,154,144,51,53,8,528,510,1038,9,5.2,201949
26,5,113,10,158,200,25,95,0,601,333,934,15,6,201949
26,6,208,11,199,283,26,143,1,871,641,1512,10,5.333333333,201949
26,7,124,20,168,230,57,41,0,640,400,1040,10,5.5,201949
27,1,168,11,193,286,113,38,0,809,597,1406,8,5.5,201949
27,2,269,14,294,541,49,55,0,1222,559,1781,8,5.666666667,201949
27,3,190,15,146,501,16,63,5,936,639,1575,7,5.666666667,201949
27,4,200,16,361,677,35,72,8,1369,846,2215,9,7,201949
27,5,103,2,93,281,44,18,0,541,387,928,6,5.333333333,201949
27,6,118,10,204,515,5,69,1,922,448,1370,8,5.5,201949
28,1,212,24,500,403,11,76,0,1226,851,2077,13,6,201949
28,2,183,21,460,326,31,84,81,1186,971,2157,15,6,201949
28,3,116,15,200,157,19,56,24,587,444,1031,7,5.333333333,201949
28,4,298,36,515,344,72,134,104,1503,1030,2533,17,6,201949
28,5,168,21,250,438,14,112,75,1078,686,1764,10,5.5,201949
28,6,134,14,181,217,52,56,11,665,482,1147,13,5.166666667,201949
28,7,259,28,463,322,115,115,80,1382,730,2112,13,6,201949
28,8,150,14,216,287,100,76,11,854,641,1495,13,7,201949
28,9,201,17,411,253,37,84,53,1056,794,1850,11,5.75,201949
29,1,225,34,362,499,55,83,6,1264,854,2118,7,5.5,201949
29,2,231,20,243,518,37,114,156,1319,880,2199,11,6.333333333,201949
29,3,122,16,175,344,16,66,8,747,691,1438,6,5.666666667,201949
30,1,143,14,180,183,116,52,16,704,225,929,7,5.333333333,201949
30,2,192,20,199,97,127,54,124,813,267,1080,9,5.25,201949
30,3,183,11,217,138,142,48,82,821,397,1218,6,5.666666667,201949
30,4,81,12,332,157,29,37,0,648,331,979,8,6,201949
30,5,151,21,369,278,39,51,11,920,484,1404,7,5.5,201949
30,6,167,13,310,254,44,70,9,867,601,1468,9,5.333333333,201949
30,7,180,25,335,214,99,82,88,1023,387,1410,11,5.25,201949
30,8,237,29,555,247,95,70,11,1244,490,1734,11,5.4,201949
30,9,193,12,224,210,97,106,52,894,443,1337,8,5.5,201949
30,10,179,23,469,278,26,77,54,1106,879,1985,7,7,201949
30,11,121,15,374,409,21,48,0,988,525,1513,5,5.5,201949
30,12,243,14,721,461,38,105,4,1586,842,2428,10,6.25,201949
30,13,218,7,237,246,184,91,82,1065,565,1630,10,5.4,201949
30,14,135,19,269,163,239,45,16,886,489,1375,8,5.5,201949
30,15,265,17,325,285,172,145,112,1321,757,2078,11,5.666666667,201949
30,16,162,11,293,350,79,97,133,1125,703,1828,10,5.333333333,201949
30,17,189,16,308,263,22,75,56,929,543,1472,8,5.5,201949
30,18,182,17,146,111,49,76,48,629,303,932,8,5.25,201949
30,19,191,14,422,259,36,78,2,1002,380,1382,13,5.6,201949
30,20,139,10,170,463,87,83,0,952,601,1553,10,5.4,201949
31,1,161,21,346,66,298,29,0,921,537,1458,8,5.5,201949
31,2,69,9,112,10,203,34,0,437,331,768,6,5.333333333,201949
31,3,389,103,1203,680,230,89,0,2694,1491,4185,21,6.666666667,201949
31,4,115,11,289,150,180,63,71,879,500,1379,4,6,201949
31,5,150,16,181,175,140,58,29,749,403,1152,7,5.333333333,201949
32,1,182,50,241,204,55,94,76,902,804,1706,12,5.2,201949
32,2,235,51,223,164,128,111,47,959,616,1575,13,5.142857143,201949
32,3,215,66,228,467,22,126,2,1126,786,1912,13,5.6,201949
32,4,211,134,292,419,43,84,36,1219,737,1956,13,5.4,201949
1,1,167,46,260,263,75,80,2,893,1064,1957,13,5.5,201950
1,2,230,42,477,467,89,111,21,1437,1581,3018,10,6.666666667,201950
1,3,212,62,524,391,61,101,64,1415,1381,2796,9,6.333333333,201950
2,1,175,10,319,270,49,90,65,978,1106,2084,11,6,201950
2,2,159,19,264,434,7,188,0,1071,960,2031,7,6,201950
2,3,205,12,486,434,28,151,91,1407,1290,2697,12,6,201950
2,4,140,12,528,193,77,29,25,1004,1566,2570,9,6.5,201950
2,5,190,7,545,283,216,110,13,1364,1413,2777,11,6,201950
2,6,141,18,408,263,49,130,4,1013,1183,2196,7,6,201950
2,7,200,18,387,304,33,98,24,1064,1030,2094,12,5.75,201950
2,8,146,17,436,350,38,121,64,1172,1072,2244,7,7,201950
3,1,223,16,289,332,45,92,12,1009,880,1889,13,5.666666667,201950
3,2,149,15,506,272,41,31,1,1015,1442,2457,9,6,201950
4,1,160,18,247,396,153,63,17,1054,1009,2063,11,5.5,201950
4,2,234,11,400,448,78,108,63,1342,1289,2631,14,5.4,201950
5,1,207,16,390,433,36,111,23,1216,1066,2282,9,5.666666667,201950
5,2,163,17,230,376,43,58,1,888,921,1809,10,6,201950
5,3,189,37,320,537,101,88,89,1361,1532,2893,11,5.333333333,201950
5,4,237,46,476,595,21,105,53,1533,1989,3522,11,6,201950
5,5,181,18,328,668,18,70,39,1322,1116,2438,10,6,201950
5,6,133,13,230,322,18,47,77,840,876,1716,10,6,201950
5,7,173,13,291,411,4,70,22,984,1421,2405,10,6,201950
6,1,217,20,282,281,14,85,63,962,803,1765,13,6.2,201950
6,2,155,11,298,210,59,85,46,864,783,1647,9,5.666666667,201950
7,1,245,8,142,158,45,16,1,615,737,1352,9,5.25,201950
7,2,195,6,76,619,18,29,0,943,1953,2896,9,5.25,201950
7,3,177,2,120,134,122,37,1,593,629,1222,7,5.333333333,201950
7,4,145,6,135,202,2,29,33,552,860,1412,11,5.4,201950
7,5,278,10,218,402,35,65,0,1008,1594,2602,11,5.666666667,201950
7,6,239,18,416,325,54,78,15,1145,1209,2354,9,6,201950
7,7,237,28,268,286,156,89,5,1069,1106,2175,8,5.5,201950
7,8,227,13,272,575,119,106,25,1337,1500,2837,12,5.25,201950
7,9,179,15,286,491,50,75,10,1106,935,2041,9,5.666666667,201950
7,10,179,8,201,383,31,64,0,866,759,1625,9,5.25,201950
7,11,129,3,148,119,36,36,0,471,402,873,6,5.333333333,201950
7,12,206,13,264,495,10,38,0,1026,1338,2364,9,5.5,201950
7,13,104,7,81,193,2,31,0,418,468,886,9,5,201950
8,1,166,8,382,158,38,34,28,814,816,1630,4,6,201950
8,2,246,67,543,465,34,47,1,1403,1217,2620,17,5.75,201950
8,3,221,45,430,402,46,58,76,1278,918,2196,4,6,201950
8,4,153,34,377,323,53,99,68,1107,1001,2108,11,6,201950
8,5,139,47,208,272,28,37,0,731,596,1327,10,5.25,201950
8,6,176,56,278,307,41,87,31,976,809,1785,10,8,201950
8,7,144,53,191,243,6,57,0,694,828,1522,8,5.25,201950
8,8,261,39,517,760,23,164,10,1774,1407,3181,10,7,201950
8,9,143,28,163,148,52,119,23,676,500,1176,10,5.2,201950
9,1,99,16,136,145,95,41,25,557,379,936,5,6,201950
9,2,350,123,693,840,249,139,150,2544,2240,4784,12,6,201950
9,3,165,14,363,433,146,72,129,1322,882,2204,7,6,201950
9,4,210,30,365,419,231,62,5,1322,1257,2579,11,6,201950
9,5,146,10,276,302,100,98,0,932,676,1608,7,6,201950
9,6,93,17,171,206,145,73,47,752,686,1438,7,6,201950
9,7,76,8,394,300,1,24,36,839,941,1780,9,6,201950
9,8,69,23,243,321,70,50,70,846,861,1707,5,6,201950
9,9,88,12,196,294,100,62,12,764,696,1460,5,6,201950
9,10,109,32,434,410,39,72,36,1132,983,2115,6,6,201950
9,11,154,16,394,573,246,75,18,1476,1224,2700,7,7,201950
9,12,182,22,454,584,90,99,128,1559,1352,2911,11,6,201950
9,13,110,24,290,257,137,67,50,935,832,1767,4,6,201950
9,14,117,23,241,246,77,72,46,822,1184,2006,5,6,201950
9,15,219,24,852,866,88,146,114,2309,1991,4300,10,6.5,201950
9,16,226,238,371,701,90,65,30,1721,1636,3357,15,6,201950
9,17,120,15,282,286,54,53,1,811,919,1730,6,6,201950
9,18,143,18,276,438,130,78,155,1238,1056,2294,12,6,201950
9,19,190,58,258,344,202,68,75,1195,799,1994,5,6,201950
9,20,60,29,80,113,55,24,2,363,424,787,5,6,201950
9,21,113,6,145,260,69,41,13,647,671,1318,3,6,201950
9,22,141,18,195,273,163,77,44,911,826,1737,5,6,201950
9,23,151,15,506,480,67,60,29,1308,1232,2540,6,7,201950
9,24,229,26,461,624,416,125,28,1909,1782,3691,14,6,201950
10,1,176,15,211,243,16,126,61,848,879,1727,12,4.666666667,201950
10,2,221,29,305,315,23,125,49,1067,1187,2254,10,5.25,201950
10,3,181,42,229,292,43,114,63,964,915,1879,11,5.4,201950
10,4,242,31,407,575,34,128,2,1419,1182,2601,12,7,201950
11,1,204,106,194,272,57,55,14,902,870,1772,6,5.666666667,201950
11,2,222,61,258,227,136,101,21,1026,979,2005,7,6,201950
11,3,157,35,234,279,27,124,15,871,715,1586,3,6,201950
11,4,150,76,193,261,74,97,7,858,805,1663,8,6,201950
11,5,248,73,361,555,43,135,32,1447,1325,2772,7,6.5,201950
11,6,109,38,203,264,38,59,10,721,974,1695,8,6,201950
11,7,210,41,317,460,15,62,1,1106,1466,2572,9,5.5,201950
11,8,158,58,232,464,112,80,7,1111,1091,2202,9,5.5,201950
11,9,228,66,263,439,29,99,32,1156,1134,2290,10,5.666666667,201950
11,10,212,65,245,281,54,102,105,1064,891,1955,10,5.6,201950
11,11,180,54,284,420,15,96,0,1049,957,2006,5,6,201950
11,12,213,67,418,517,37,75,14,1341,1128,2469,7,6.5,201950
11,13,161,60,230,180,69,55,31,786,962,1748,8,5.5,201950
11,14,173,45,316,232,115,48,9,938,1209,2147,8,5.5,201950
11,15,135,51,200,280,19,61,19,765,685,1450,9,6,201950
12,1,87,34,137,128,92,25,1,504,366,870,10,5,201950
12,2,194,27,216,518,22,83,4,1064,1385,2449,10,5.5,201950
12,3,154,20,228,311,21,56,0,790,899,1689,11,5.2,201950
12,4,219,21,313,492,40,77,1,1163,1520,2683,9,6,201950
12,5,137,12,203,239,6,36,23,656,607,1263,10,5.25,201950
12,6,130,13,185,238,20,25,0,611,632,1243,10,5.25,201950
12,7,198,22,201,422,9,78,30,960,970,1930,6,5.5,201950
12,8,198,18,195,256,2,28,0,697,567,1264,9,5.25,201950
12,9,164,26,294,462,51,45,10,1052,1220,2272,9,5.666666667,201950
13,1,258,33,141,341,123,52,37,985,737,1722,9,5.333333333,201950
13,2,133,9,105,200,91,83,35,656,587,1243,6,5.333333333,201950
13,3,152,22,197,192,121,97,5,786,687,1473,12,5.25,201950
13,4,255,13,249,324,96,59,42,1038,913,1951,9,5.666666667,201950
13,5,258,21,386,378,128,139,80,1390,1148,2538,9,5.75,201950
13,6,355,86,570,746,65,95,49,1966,1433,3399,11,6,201950
13,7,191,27,322,416,52,32,0,1040,1036,2076,8,5.5,201950
14,1,123,58,187,106,140,63,4,681,622,1303,6,5.5,201950
14,2,126,34,223,122,114,106,6,731,721,1452,5,5.666666667,201950
14,3,211,31,414,134,15,131,5,941,1167,2108,8,5.4,201950
14,4,156,20,288,369,21,111,19,984,907,1891,10,6,201950
14,5,170,17,399,202,39,49,6,882,1169,2051,9,5.5,201950
14,6,226,18,603,331,31,57,2,1268,1136,2404,11,6,201950
14,7,102,14,280,172,0,25,0,593,541,1134,6,6,201950
14,8,318,50,902,729,57,171,15,2242,2120,4362,11,6.25,201950
14,9,125,21,255,299,29,63,3,795,712,1507,11,6,201950
14,10,142,53,565,302,14,81,35,1192,1348,2540,7,6.5,201950
14,11,138,32,243,256,103,89,70,931,1000,1931,4,6,201950
14,12,253,30,639,189,45,43,0,1199,1104,2303,9,5.5,201950
14,13,167,30,546,251,11,80,5,1090,1150,2240,6,6,201950
14,14,114,22,333,301,42,102,43,957,1173,2130,7,6,201950
14,15,239,44,325,218,130,98,8,1062,1243,2305,10,5.6,201950
14,16,99,31,320,185,76,54,12,777,616,1393,5,6,201950
14,17,131,37,237,88,50,123,29,695,431,1126,7,5.25,201950
14,18,183,26,351,148,106,91,43,948,868,1816,9,5.4,201950
14,19,211,43,396,190,70,75,49,1034,663,1697,8,5.25,201950
14,20,179,21,423,241,7,71,0,942,871,1813,10,5.666666667,201950
15,1,168,19,155,111,359,80,0,892,739,1631,7,5.333333333,201950
15,2,108,16,218,232,132,22,23,751,698,1449,6,6,201950
15,3,219,33,191,303,416,59,103,1324,1010,2334,10,5.666666667,201950
15,4,171,20,194,360,80,62,22,909,938,1847,4,6,201950
15,5,167,34,332,294,48,41,24,940,1043,1983,8,5.666666667,201950
15,6,158,15,259,478,39,61,35,1045,976,2021,7,6.5,201950
15,7,130,16,402,250,92,85,18,993,995,1988,10,6,201950
15,8,93,21,166,236,17,34,11,578,606,1184,4,6,201950
15,9,171,14,144,118,194,173,1,815,603,1418,9,5.75,201950
15,10,103,8,178,376,31,71,14,781,705,1486,6,6,201950
15,11,151,19,289,374,48,57,22,960,1005,1965,8,6,201950
15,12,190,15,510,487,77,70,2,1351,1273,2624,8,6,201950
15,13,115,23,176,219,160,70,3,766,684,1450,8,6,201950
15,14,71,41,129,219,35,45,7,547,495,1042,4,6,201950
15,15,145,136,212,362,93,45,15,1008,941,1949,6,6,201950
15,16,195,27,304,576,23,70,26,1221,1261,2482,8,6,201950
15,17,113,19,170,267,38,62,71,740,900,1640,8,6,201950
15,18,199,43,285,434,47,120,12,1140,1011,2151,7,5.666666667,201950
15,19,177,95,422,855,26,104,42,1721,1772,3493,10,6,201950
15,20,64,32,289,248,27,32,5,697,857,1554,6,6,201950
15,21,73,12,99,190,48,64,36,522,524,1046,6,5.5,201950
15,22,250,102,578,688,48,122,98,1886,1812,3698,14,6,201950
15,23,147,16,248,379,38,78,4,910,968,1878,6,5.333333333,201950
15,24,105,27,199,289,39,40,11,710,415,1125,4,6,201950
15,25,154,20,241,273,52,57,14,811,656,1467,6,6,201950
15,26,130,8,215,251,140,57,2,803,743,1546,9,7,201950
15,27,178,25,374,429,40,106,86,1238,1116,2354,9,5.666666667,201950
15,28,228,34,529,380,46,68,29,1314,1238,2552,9,5.666666667,201950
15,29,223,20,523,698,20,120,42,1646,1163,2809,8,6,201950
15,30,254,41,442,436,70,71,58,1372,1330,2702,16,6,201950
15,31,134,199,184,267,15,35,0,834,823,1657,6,6,201950
15,32,166,13,195,383,92,45,11,905,988,1893,9,6,201950
15,33,179,24,370,415,52,60,1,1101,972,2073,7,6,201950
15,34,219,13,230,491,24,62,22,1061,940,2001,8,6,201950
15,35,215,25,299,548,10,141,15,1253,1202,2455,9,5.666666667,201950
15,36,202,21,231,423,136,79,2,1094,1255,2349,9,5.5,201950
15,37,205,27,287,466,164,97,55,1301,1252,2553,7,6,201950
15,38,132,44,261,340,77,52,30,936,1036,1972,6,5.5,201950
15,39,137,24,253,288,41,110,4,857,846,1703,4,6,201950
15,40,220,33,210,438,162,136,5,1204,1055,2259,9,6,201950
15,41,212,48,493,520,106,64,40,1483,1635,3118,13,6,201950
16,1,158,20,321,140,7,9,0,655,468,1123,7,5.333333333,201950
16,2,119,44,134,155,17,68,0,537,486,1023,9,5.25,201950
16,3,208,22,124,290,47,68,1,760,768,1528,10,5.25,201950
16,4,199,46,294,165,79,72,0,855,834,1689,8,5.5,201950
16,5,177,43,210,208,69,97,63,867,814,1681,10,5.666666667,201950
16,6,131,58,188,177,57,55,0,666,645,1311,12,5.5,201950
16,7,223,53,306,294,63,61,4,1004,897,1901,9,5.5,201950
16,8,253,43,679,690,18,88,10,1781,1849,3630,12,6,201950
16,9,191,32,345,378,10,86,1,1043,1605,2648,9,6.5,201950
16,10,100,14,260,284,25,48,0,731,741,1472,6,6,201950
16,11,175,32,254,211,115,76,1,864,782,1646,10,5.4,201950
16,12,142,16,214,190,19,59,8,648,400,1048,10,5.25,201950
17,1,151,54,431,513,45,68,6,1268,1098,2366,9,8,201950
17,2,127,8,305,412,21,53,30,956,855,1811,8,5.666666667,201950
17,3,202,23,413,492,69,66,0,1265,1023,2288,8,5.5,201950
17,4,177,16,321,418,40,49,48,1069,997,2066,10,5.666666667,201950
17,5,118,10,164,141,31,42,0,506,430,936,5,5.5,201950
18,1,135,23,125,145,41,47,55,571,486,1057,7,5.25,201950
18,2,202,47,389,484,49,125,1,1297,1558,2855,9,7,201950
18,3,119,17,322,238,2,33,0,731,550,1281,8,5.75,201950
19,1,184,17,375,380,28,144,72,1200,1305,2505,9,6,201950
19,2,261,22,698,472,28,108,0,1589,1310,2899,9,6,201950
19,3,292,22,714,465,55,120,3,1671,1775,3446,7,6,201950
19,4,129,17,205,152,96,92,126,817,642,1459,5,6,201950
19,5,328,26,595,670,52,185,99,1955,1321,3276,8,6,201950
19,6,88,5,221,347,8,85,1,755,992,1747,5,6,201950
19,7,146,9,437,207,13,55,2,869,825,1694,10,5.5,201950
19,8,55,8,169,134,6,17,0,389,562,951,7,6,201950
19,9,209,17,260,299,42,75,16,918,976,1894,9,5.25,201950
19,10,154,8,400,323,20,130,55,1090,913,2003,6,7,201950
19,11,368,56,618,1001,22,338,142,2545,2715,5260,13,6.333333333,201950
19,12,170,9,617,226,19,65,14,1120,1486,2606,13,5.666666667,201950
20,1,196,16,207,211,91,61,62,844,805,1649,8,5.5,201950
20,2,84,10,149,116,38,23,1,421,383,804,6,5.333333333,201950
20,3,79,9,130,116,143,51,46,574,607,1181,6,5.333333333,201950
20,4,105,11,80,88,100,71,20,475,485,960,6,5.333333333,201950
20,5,70,7,189,222,27,20,1,536,474,1010,11,5.25,201950
20,6,132,6,97,130,88,91,51,595,606,1201,8,5.25,201950
20,7,147,17,190,373,41,46,9,823,807,1630,8,5.75,201950
20,8,353,31,785,620,105,169,63,2126,1503,3629,14,7,201950
20,9,207,15,209,183,163,57,29,863,876,1739,8,5.666666667,201950
20,10,133,12,323,114,20,31,3,636,727,1363,9,5.25,201950
21,1,173,18,312,221,43,41,3,811,787,1598,9,5.4,201950
21,2,160,85,255,162,136,53,1,852,928,1780,9,5.2,201950
21,3,255,26,287,327,123,140,65,1223,1100,2323,8,5.5,201950
21,4,144,8,140,77,119,33,11,532,559,1091,7,5.25,201950
21,5,196,29,478,278,25,52,25,1083,1277,2360,8,5.666666667,201950
21,6,188,16,343,333,226,150,81,1337,1089,2426,6,7,201950
21,7,325,18,194,251,95,76,0,959,958,1917,9,5.666666667,201950
21,8,137,16,387,152,74,107,59,932,797,1729,9,5.2,201950
21,9,185,28,505,392,98,88,46,1342,1412,2754,9,6,201950
21,10,161,22,475,355,32,125,110,1280,1258,2538,7,6,201950
21,11,75,8,173,96,57,25,22,456,433,889,4,6,201950
21,12,278,49,857,595,231,157,291,2458,2119,4577,16,7,201950
21,13,153,22,471,203,75,113,14,1051,1019,2070,8,5.666666667,201950
21,14,185,35,248,155,194,82,29,928,803,1731,12,5.333333333,201950
21,15,224,10,360,321,58,121,60,1154,1577,2731,7,5.5,201950
22,1,156,41,172,362,24,53,1,809,784,1593,11,5.2,201950
22,2,148,37,273,268,117,43,4,890,1056,1946,7,5.5,201950
22,3,292,59,733,621,27,107,0,1839,1810,3649,9,6,201950
22,4,187,39,600,544,24,86,6,1486,1289,2775,9,6.5,201950
22,5,183,37,325,262,81,81,17,986,939,1925,10,5.5,201950
23,1,211,12,988,322,53,54,26,1666,1804,3470,14,5.6,201950
23,2,150,18,339,242,13,31,0,793,1005,1798,8,5.25,201950
23,3,223,12,842,486,62,47,2,1674,1475,3149,19,0,201950
23,4,149,9,565,341,43,47,27,1181,997,2178,6,5.5,201950
24,1,108,44,125,200,18,55,2,552,587,1139,10,5.2,201950
24,2,124,37,233,216,35,84,3,732,573,1305,6,5.5,201950
24,3,155,57,171,232,84,54,0,753,745,1498,9,5.25,201950
24,4,149,36,184,208,67,74,85,803,689,1492,5,5.5,201950
24,5,282,60,659,591,11,89,0,1692,1549,3241,10,6.666666667,201950
24,6,151,119,366,352,65,58,0,1111,969,2080,6,6,201950
24,7,164,31,211,314,135,31,0,886,891,1777,9,5.25,201950
25,1,159,8,261,360,39,38,41,906,867,1773,13,5.75,201950
25,2,218,98,421,568,15,90,0,1410,1102,2512,7,6,201950
25,3,188,14,287,511,53,111,29,1193,1111,2304,8,5.6,201950
25,4,148,32,208,346,71,37,0,842,791,1633,8,5.333333333,201950
25,5,137,10,272,474,18,74,8,993,1070,2063,8,5.666666667,201950
25,6,172,18,259,354,75,118,32,1028,1165,2193,8,5.75,201950
25,7,191,14,462,508,12,54,0,1241,1550,2791,6,6,201950
26,1,192,16,339,337,5,93,0,982,854,1836,9,5.5,201950
26,2,156,15,282,422,6,90,23,994,1098,2092,12,5.4,201950
26,3,218,43,361,499,24,185,36,1366,1419,2785,13,6.5,201950
26,4,93,20,202,192,62,52,19,640,638,1278,9,5.2,201950
26,5,126,21,187,265,27,94,0,720,911,1631,15,6,201950
26,6,186,20,225,345,13,144,3,936,958,1894,10,5.333333333,201950
26,7,140,32,170,242,68,49,0,701,813,1514,10,5.5,201950
27,1,158,12,172,252,127,36,0,757,685,1442,8,5.5,201950
27,2,184,16,242,506,37,75,0,1060,1139,2199,8,5.666666667,201950
27,3,171,3,118,529,6,55,6,888,775,1663,7,5.666666667,201950
27,4,196,10,333,701,18,64,24,1346,1412,2758,8,6.5,201950
27,5,123,5,140,310,22,43,20,663,632,1295,6,5.333333333,201950
27,6,136,14,169,551,7,75,0,952,1043,1995,8,5.5,201950
28,1,177,32,454,369,19,43,0,1094,912,2006,13,6,201950
28,2,198,21,396,286,29,84,104,1118,1549,2667,15,6,201950
28,3,139,23,258,179,15,45,31,690,518,1208,7,5.333333333,201950
28,4,276,26,405,307,74,91,136,1315,1139,2454,17,6,201950
28,5,142,25,213,370,8,86,59,903,832,1735,10,5.5,201950
28,6,97,14,127,223,27,37,18,543,790,1333,13,5.166666667,201950
28,7,240,39,468,312,152,86,100,1397,1719,3116,13,6,201950
28,8,144,19,252,228,85,49,7,784,1298,2082,12,6,201950
28,9,150,14,279,213,49,74,64,843,1534,2377,11,5.75,201950
29,1,187,31,312,419,34,85,6,1074,972,2046,7,5.5,201950
29,2,183,22,237,519,37,112,139,1249,1109,2358,11,6.333333333,201950
29,3,131,18,136,404,25,70,8,792,901,1693,6,5.666666667,201950
30,1,109,12,161,168,64,67,19,600,666,1266,7,5.333333333,201950
30,2,175,15,182,108,50,40,128,698,561,1259,9,5.25,201950
30,3,190,8,246,151,178,65,74,912,805,1717,6,5.666666667,201950
30,4,132,12,306,190,51,26,0,717,612,1329,8,6,201950
30,5,130,17,399,256,31,44,4,881,475,1356,7,5.5,201950
30,6,136,9,309,309,51,73,5,892,1107,1999,9,5.333333333,201950
30,7,149,19,197,188,70,42,82,747,585,1332,11,5.25,201950
30,8,188,18,519,293,135,58,13,1224,1171,2395,11,5.4,201950
30,9,190,12,181,178,123,96,72,852,1001,1853,8,5.5,201950
30,10,162,14,508,280,43,90,81,1178,1078,2256,6,6.5,201950
30,11,147,17,407,432,18,40,0,1061,1319,2380,5,5.5,201950
30,12,213,13,788,460,36,87,6,1603,1291,2894,10,6.25,201950
30,13,173,19,187,205,146,92,78,900,933,1833,10,5.4,201950
30,14,158,20,266,173,175,46,7,845,746,1591,8,5.5,201950
30,15,206,19,264,265,139,101,133,1127,814,1941,11,5.666666667,201950
30,16,150,7,284,327,54,80,142,1044,1129,2173,10,5.333333333,201950
30,17,134,19,275,236,29,55,47,795,816,1611,8,4.5,201950
30,18,244,19,118,169,46,42,34,672,818,1490,8,5.25,201950
30,19,106,15,283,198,31,48,2,683,837,1520,13,5.6,201950
30,20,124,13,169,382,84,50,1,823,1066,1889,10,5.4,201950
31,1,179,27,357,48,324,32,0,967,638,1605,8,5.5,201950
31,2,79,18,110,11,187,27,0,432,426,858,6,5.333333333,201950
31,3,401,119,1188,714,251,107,1,2781,2311,5092,21,6.666666667,201950
31,4,123,11,317,177,212,44,56,940,658,1598,4,6,201950
31,5,140,14,235,173,160,66,33,821,555,1376,7,5.333333333,201950
32,1,140,49,181,191,54,77,90,782,800,1582,12,5.2,201950
32,2,113,45,134,106,110,98,31,637,771,1408,13,5.142857143,201950
32,3,140,45,188,388,8,92,0,861,831,1692,13,5.6,201950
32,4,182,64,278,339,32,92,44,1031,1041,2072,13,5.4,201950
1,1,147,26,264,175,75,42,6,735,759,1494,13,5.5,201951
1,2,198,45,407,376,58,74,18,1176,904,2080,10,6.666666667,201951
1,3,152,40,398,304,40,95,50,1079,1074,2153,9,6.333333333,201951
2,1,168,14,292,299,49,126,73,1021,805,1826,11,6,201951
2,2,143,16,235,397,12,167,0,970,938,1908,7,6,201951
2,3,230,22,357,430,29,112,104,1284,1044,2328,12,6,201951
2,4,169,6,482,202,54,17,19,949,1165,2114,9,6.5,201951
2,5,195,17,542,258,228,120,27,1387,1368,2755,11,6,201951
2,6,199,18,374,345,64,167,4,1171,974,2145,8,6.5,201951
2,7,242,24,413,345,48,86,35,1193,1128,2321,12,5.75,201951
2,8,169,12,391,330,20,138,84,1144,1048,2192,7,7,201951
3,1,208,17,308,288,38,97,12,968,877,1845,13,5.666666667,201951
3,2,138,19,445,213,48,24,0,887,685,1572,9,6,201951
4,1,184,36,234,383,123,75,52,1087,988,2075,11,5.5,201951
4,2,104,9,213,286,59,48,63,782,916,1698,14,5,201951
5,1,210,23,362,415,41,114,30,1195,1195,2390,9,5.666666667,201951
5,2,159,23,224,308,25,33,2,774,807,1581,10,6,201951
5,3,182,25,313,555,72,92,94,1333,1001,2334,11,5.333333333,201951
5,4,204,29,447,555,17,70,57,1379,1255,2634,11,6,201951
5,5,172,16,300,585,8,64,63,1208,1193,2401,10,6,201951
5,6,139,23,210,292,9,28,64,765,779,1544,10,6,201951
5,7,172,7,221,364,9,65,18,856,880,1736,11,6.5,201951
6,1,308,17,231,256,19,45,65,941,791,1732,13,6.2,201951
6,2,124,25,252,208,99,65,63,836,735,1571,9,5.666666667,201951
7,1,234,5,168,125,29,30,0,591,733,1324,9,5.25,201951
7,2,173,9,68,337,47,22,0,656,1615,2271,9,5.25,201951
7,3,190,8,150,195,122,22,1,688,635,1323,7,5.333333333,201951
7,4,140,5,73,130,7,14,10,379,640,1019,11,5.4,201951
7,5,208,22,203,312,53,57,1,856,977,1833,11,5.666666667,201951
7,6,162,9,346,252,55,51,18,893,1068,1961,8,5.666666667,201951
7,7,245,27,335,264,172,80,8,1131,1104,2235,8,5.5,201951
7,8,248,17,345,563,175,83,55,1486,856,2342,12,5.25,201951
7,9,111,22,252,403,76,51,6,921,903,1824,9,5.666666667,201951
7,10,156,8,219,432,40,54,0,909,727,1636,9,5.5,201951
7,11,99,3,146,108,19,51,0,426,287,713,6,5.333333333,201951
7,12,180,2,211,367,8,24,10,802,774,1576,9,5.5,201951
7,13,89,17,69,241,0,26,0,442,378,820,9,5.25,201951
8,1,132,11,329,163,41,21,4,701,688,1389,4,6,201951
8,2,237,47,472,399,30,31,0,1216,1062,2278,17,5.75,201951
8,3,186,39,280,329,36,60,54,984,914,1898,4,6,201951
8,4,146,25,353,263,44,73,58,962,1467,2429,11,6,201951
8,5,204,66,247,360,65,46,0,988,688,1676,10,5.25,201951
8,6,154,50,218,263,56,72,36,849,756,1605,10,8,201951
8,7,152,84,167,294,10,49,0,756,532,1288,8,5.25,201951
8,8,216,39,455,755,19,113,9,1606,1285,2891,10,7,201951
8,9,119,19,124,111,61,78,20,532,475,1007,10,5,201951
9,1,96,13,118,115,123,25,8,498,434,932,5,6,201951
9,2,304,134,543,622,247,129,164,2143,2027,4170,12,6,201951
9,3,178,13,318,364,171,73,135,1252,927,2179,7,6,201951
9,4,174,20,319,359,205,34,3,1114,980,2094,11,6,201951
9,5,201,6,205,216,75,194,0,897,847,1744,7,6,201951
9,6,82,15,138,149,178,43,43,648,557,1205,7,6,201951
9,7,79,7,382,237,4,11,32,752,632,1384,9,6,201951
9,8,73,23,203,254,45,42,74,714,638,1352,5,6,201951
9,9,92,10,175,227,110,31,2,647,685,1332,5,6,201951
9,10,87,16,472,307,27,54,25,988,775,1763,6,6,201951
9,11,137,16,319,440,290,68,42,1312,1086,2398,7,7,201951
9,12,242,18,420,445,65,68,121,1379,1339,2718,11,6,201951
9,13,113,13,252,230,139,43,61,851,776,1627,4,6,201951
9,14,91,41,303,244,56,34,19,788,429,1217,5,6,201951
9,15,218,31,882,788,70,105,156,2250,1802,4052,10,6.5,201951
9,16,209,317,253,572,66,37,30,1484,1340,2824,15,6,201951
9,17,118,14,263,248,42,36,12,733,593,1326,6,6,201951
9,18,150,22,202,346,130,67,173,1090,972,2062,12,6,201951
9,19,157,72,213,282,175,56,95,1050,857,1907,5,6,201951
9,20,48,37,53,103,72,14,1,328,197,525,5,6,201951
9,21,99,8,107,205,113,21,11,564,580,1144,3,6,201951
9,22,121,8,139,232,164,44,40,748,703,1451,5,6,201951
9,23,124,13,497,408,98,34,17,1191,993,2184,6,7,201951
9,24,220,32,413,531,498,110,27,1831,1674,3505,14,6,201951
10,1,106,25,147,218,14,103,75,688,541,1229,12,5,201951
10,2,172,33,238,331,29,95,56,954,700,1654,10,5.25,201951
10,3,124,33,151,205,50,74,85,722,684,1406,11,5.4,201951
10,4,190,26,320,512,17,105,7,1177,1053,2230,12,7,201951
11,1,118,49,117,188,29,45,18,564,697,1261,6,5.666666667,201951
11,2,169,49,255,183,136,97,20,909,858,1767,7,6,201951
11,3,117,39,233,257,28,92,22,788,590,1378,3,6,201951
11,4,140,50,175,225,104,69,7,770,748,1518,7,5.666666667,201951
11,5,209,79,276,470,31,97,40,1202,1243,2445,7,6.5,201951
11,6,117,27,173,152,42,50,6,567,226,793,8,6,201951
11,7,151,64,272,354,18,41,2,902,956,1858,9,5.5,201951
11,8,142,40,192,374,75,61,12,896,890,1786,9,5.5,201951
11,9,165,111,233,407,12,57,22,1007,1136,2143,10,5.666666667,201951
11,10,196,62,181,236,36,86,83,880,672,1552,10,5.6,201951
11,11,143,92,223,347,17,63,0,885,717,1602,5,6,201951
11,12,178,75,312,450,40,54,25,1134,1053,2187,7,6.5,201951
11,13,127,31,214,136,70,59,27,664,612,1276,8,5.5,201951
11,14,168,49,246,181,146,49,4,843,795,1638,8,5.5,201951
11,15,118,27,155,185,22,47,11,565,622,1187,9,6,201951
12,1,96,31,156,125,107,35,2,552,614,1166,10,5.2,201951
12,2,145,22,208,436,24,68,9,912,611,1523,10,5.5,201951
12,3,173,21,217,288,16,43,0,758,762,1520,11,5.2,201951
12,4,195,15,234,442,29,56,0,971,710,1681,9,6,201951
12,5,144,24,213,327,1,21,25,755,702,1457,10,5,201951
12,6,84,13,191,392,28,6,2,716,411,1127,10,5.25,201951
12,7,180,21,219,349,26,49,8,852,937,1789,6,5.5,201951
12,8,138,23,155,293,1,24,0,634,660,1294,9,4.5,201951
12,9,136,21,234,359,34,30,8,822,544,1366,9,5.666666667,201951
13,1,342,35,194,371,88,43,79,1152,824,1976,9,5.333333333,201951
13,2,219,15,131,188,125,72,46,796,643,1439,6,5.333333333,201951
13,3,206,57,167,235,150,80,15,910,851,1761,12,5.25,201951
13,4,222,23,224,263,81,34,48,895,815,1710,9,5.666666667,201951
13,5,244,20,397,358,115,98,66,1298,1188,2486,9,5.75,201951
13,6,265,139,490,584,90,93,34,1695,1789,3484,11,6,201951
13,7,238,19,275,331,46,30,0,939,749,1688,8,5.5,201951
14,1,127,43,127,71,145,54,2,569,652,1221,6,5.5,201951
14,2,128,26,167,87,128,93,20,649,661,1310,5,5.666666667,201951
14,3,230,29,453,106,41,106,5,970,952,1922,8,5.4,201951
14,4,133,22,343,296,37,91,21,943,538,1481,10,6,201951
14,5,177,32,467,184,66,48,4,978,1035,2013,9,5.5,201951
14,6,213,15,587,279,24,37,1,1156,1087,2243,11,6,201951
14,7,99,24,292,154,0,12,0,581,538,1119,6,6,201951
14,8,308,46,897,622,68,144,7,2092,1641,3733,11,6,201951
14,9,101,29,225,297,13,42,5,712,579,1291,11,6,201951
14,10,176,68,515,272,10,79,44,1164,798,1962,7,6.5,201951
14,11,148,19,269,217,153,88,75,969,821,1790,4,6,201951
14,12,184,36,620,177,35,38,1,1091,1043,2134,9,5.5,201951
14,13,163,19,561,223,11,61,4,1042,1005,2047,6,6,201951
14,14,118,28,276,252,72,96,62,904,923,1827,7,6,201951
14,15,194,45,235,158,168,65,7,872,860,1732,10,5.6,201951
14,16,129,27,389,189,89,46,13,882,723,1605,5,6,201951
14,17,124,39,205,64,25,94,28,579,637,1216,7,5.25,201951
14,18,182,51,378,128,119,84,39,981,1001,1982,9,5.4,201951
14,19,177,22,289,147,62,28,47,772,898,1670,8,5.25,201951
14,20,169,22,356,239,9,58,0,853,909,1762,10,5.666666667,201951
15,1,151,23,140,87,380,34,0,815,904,1719,7,5.333333333,201951
15,2,111,9,198,238,160,35,7,758,652,1410,6,6,201951
15,3,189,27,171,227,374,58,120,1166,877,2043,10,5.666666667,201951
15,4,157,21,209,333,64,57,52,893,697,1590,4,6,201951
15,5,126,38,258,219,46,43,36,766,734,1500,8,5.666666667,201951
15,6,158,15,250,444,32,62,43,1004,841,1845,7,6.5,201951
15,7,147,11,431,149,97,87,24,946,642,1588,10,6,201951
15,8,87,12,134,224,24,32,31,544,412,956,4,6,201951
15,9,179,11,141,111,201,174,2,819,737,1556,9,5.75,201951
15,10,94,12,140,278,34,39,16,613,632,1245,6,6,201951
15,11,138,16,272,295,42,40,24,827,735,1562,8,6,201951
15,12,210,7,341,421,79,51,2,1111,1073,2184,8,6,201951
15,13,96,19,151,188,202,59,1,716,601,1317,8,6,201951
15,14,72,42,139,195,59,32,6,545,465,1010,4,6,201951
15,15,142,161,194,300,90,30,8,925,786,1711,6,6,201951
15,16,164,32,265,430,23,42,19,975,941,1916,8,6,201951
15,17,123,14,152,202,34,61,90,676,274,950,8,6,201951
15,18,184,25,287,373,46,102,27,1044,805,1849,7,5.666666667,201951
15,19,166,100,358,826,30,82,79,1641,1172,2813,10,6,201951
15,20,77,36,246,193,21,17,13,603,654,1257,6,6,201951
15,21,101,9,90,127,59,67,22,475,540,1015,6,5.5,201951
15,22,246,128,593,721,53,71,108,1920,1577,3497,14,6,201951
15,23,139,7,197,254,61,55,1,714,976,1690,6,5.333333333,201951
15,24,97,46,157,228,38,18,10,594,597,1191,4,6,201951
15,25,157,24,226,260,58,54,12,791,1074,1865,6,6,201951
15,26,95,10,154,223,176,22,6,686,589,1275,9,7,201951
15,27,167,21,345,392,28,72,81,1106,1034,2140,9,5.666666667,201951
15,28,213,38,510,323,56,34,20,1194,1097,2291,9,5.666666667,201951
15,29,178,26,436,532,24,94,35,1325,1109,2434,8,6,201951
15,30,197,28,282,378,68,43,86,1082,1059,2141,16,6,201951
15,31,122,256,95,241,4,25,0,743,704,1447,6,6,201951
15,32,126,13,204,274,75,29,10,731,646,1377,9,6,201951
15,33,124,26,341,269,83,37,0,880,985,1865,7,6,201951
15,34,205,17,185,478,27,40,26,978,798,1776,8,6,201951
15,35,214,16,206,429,11,127,10,1013,1033,2046,9,5.666666667,201951
15,36,197,19,223,429,69,74,2,1013,888,1901,9,5.5,201951
15,37,173,18,227,332,175,80,35,1040,796,1836,7,6,201951
15,38,131,64,200,255,72,34,23,779,896,1675,6,5.5,201951
15,39,142,11,181,197,44,69,1,645,699,1344,4,6,201951
15,40,196,56,178,377,151,66,13,1037,855,1892,9,6,201951
15,41,187,40,378,454,57,87,47,1250,1087,2337,13,6,201951
16,1,120,17,315,131,16,15,0,614,567,1181,7,5.333333333,201951
16,2,100,42,114,125,16,56,0,453,426,879,9,5.25,201951
16,3,189,37,133,270,57,71,0,757,599,1356,10,5,201951
16,4,156,43,244,156,109,79,0,787,585,1372,8,5.5,201951
16,5,186,35,195,230,79,87,62,874,774,1648,10,5.666666667,201951
16,6,141,72,223,121,47,27,0,631,518,1149,12,5.5,201951
16,7,177,59,194,182,41,42,6,701,630,1331,9,5.5,201951
16,8,244,33,602,597,21,48,12,1557,1311,2868,12,6,201951
16,9,169,24,283,416,14,49,1,956,601,1557,9,6.5,201951
16,10,86,23,255,242,25,33,0,664,579,1243,6,6,201951
16,11,198,31,276,221,145,73,3,947,812,1759,10,5.4,201951
16,12,163,39,277,173,34,61,3,750,941,1691,10,5.25,201951
17,1,168,43,423,492,59,50,2,1237,996,2233,9,8,201951
17,2,119,10,238,363,11,63,36,840,836,1676,8,5.666666667,201951
17,3,152,18,351,400,75,55,1,1052,828,1880,8,5.5,201951
17,4,140,13,301,400,38,59,54,1005,916,1921,10,5.666666667,201951
17,5,118,16,134,106,35,29,0,438,422,860,5,5.5,201951
18,1,162,21,117,146,43,42,63,594,536,1130,7,5.25,201951
18,2,199,40,368,346,67,123,2,1145,843,1988,9,7,201951
18,3,146,20,340,212,14,35,0,767,743,1510,8,5.75,201951
19,1,180,19,326,295,15,108,52,995,1025,2020,9,6,201951
19,2,274,15,712,418,19,70,0,1508,1389,2897,9,6,201951
19,3,261,23,665,400,53,82,9,1493,1425,2918,7,6,201951
19,4,125,19,163,133,98,74,131,743,626,1369,5,6,201951
19,5,250,24,575,457,27,114,93,1540,1559,3099,8,6,201951
19,6,77,16,172,314,3,87,16,685,604,1289,5,6,201951
19,7,181,11,475,230,10,45,0,952,1066,2018,10,5.5,201951
19,8,58,17,119,117,1,15,0,327,314,641,7,6,201951
19,9,174,27,282,245,35,55,17,835,681,1516,9,5.25,201951
19,10,139,24,518,226,6,79,38,1030,640,1670,6,7,201951
19,11,285,70,522,953,31,243,146,2250,1959,4209,13,6.333333333,201951
19,12,155,13,480,165,10,26,21,870,1083,1953,13,5.666666667,201951
20,1,143,6,155,155,65,43,51,618,575,1193,8,5.5,201951
20,2,90,7,92,90,31,25,4,339,482,821,6,5.333333333,201951
20,3,92,11,130,110,132,38,36,549,640,1189,6,5.333333333,201951
20,4,96,9,61,99,41,86,39,431,261,692,6,5.333333333,201951
20,5,117,9,249,233,28,20,0,656,879,1535,11,5.25,201951
20,6,129,11,74,132,134,95,51,626,648,1274,8,5.25,201951
20,7,138,21,210,314,42,45,14,784,853,1637,8,5.75,201951
20,8,356,28,767,573,82,209,71,2086,1705,3791,14,7,201951
20,9,188,14,158,151,192,67,23,793,735,1528,8,5.666666667,201951
20,10,163,13,419,175,28,29,9,836,1010,1846,9,5.25,201951
21,1,130,4,257,180,82,26,3,682,588,1270,9,5.4,201951
21,2,95,34,213,120,58,37,0,557,620,1177,9,5.2,201951
21,3,199,9,227,316,123,111,42,1027,876,1903,8,5.5,201951
21,4,100,7,162,75,107,44,1,496,430,926,7,5.25,201951
21,5,122,11,435,204,30,32,35,869,579,1448,8,5.666666667,201951
21,6,175,21,401,294,227,101,69,1288,1043,2331,6,7,201951
21,7,375,16,177,187,74,89,1,919,900,1819,9,5.666666667,201951
21,8,147,20,317,137,58,101,100,880,645,1525,9,5.2,201951
21,9,151,39,466,320,75,37,38,1126,1002,2128,9,6,201951
21,10,125,11,463,314,36,95,99,1143,1056,2199,7,6,201951
21,11,59,4,168,97,36,8,11,383,283,666,4,6,201951
21,12,270,44,756,541,207,120,295,2233,1954,4187,16,7,201951
21,13,142,14,516,188,69,113,4,1046,743,1789,8,5.666666667,201951
21,14,165,19,212,108,176,75,16,771,861,1632,12,5.333333333,201951
21,15,193,7,297,234,56,113,54,954,725,1679,7,5.5,201951
22,1,126,47,173,289,32,46,0,713,737,1450,11,5.2,201951
22,2,148,34,193,221,146,30,3,775,850,1625,7,5.5,201951
22,3,211,67,643,549,16,65,0,1551,1546,3097,9,6,201951
22,4,164,32,576,440,22,39,9,1282,1260,2542,9,6.5,201951
22,5,115,14,264,176,60,33,18,680,622,1302,10,5.25,201951
23,1,199,6,863,324,50,39,34,1515,1191,2706,14,5.6,201951
23,2,168,16,385,220,21,17,1,828,718,1546,9,5.5,201951
23,3,197,16,771,472,36,34,0,1526,1995,3521,19,0,201951
23,4,173,9,451,270,26,41,34,1004,574,1578,6,5.5,201951
24,1,120,56,94,193,29,44,3,539,733,1272,10,5.2,201951
24,2,117,31,166,136,51,53,3,557,631,1188,6,5.5,201951
24,3,133,65,137,184,75,40,2,636,480,1116,9,5.25,201951
24,4,182,33,195,211,48,103,67,839,688,1527,5,5.5,201951
24,5,238,68,568,551,12,48,0,1485,1290,2775,10,6.666666667,201951
24,6,132,131,318,257,56,22,1,917,842,1759,6,6,201951
24,7,225,22,200,271,114,19,0,851,763,1614,9,5.25,201951
25,1,130,19,224,315,58,41,34,821,775,1596,13,5.75,201951
25,2,209,90,327,421,9,55,0,1111,1128,2239,7,6,201951
25,3,166,15,282,411,38,101,15,1028,799,1827,8,5.6,201951
25,4,135,30,198,240,149,26,2,780,571,1351,8,5.333333333,201951
25,5,150,16,274,443,27,60,32,1002,935,1937,8,5.666666667,201951
25,6,175,17,272,383,83,85,34,1049,819,1868,8,5.75,201951
25,7,189,17,446,439,14,34,0,1139,867,2006,6,6,201951
26,1,163,12,239,290,11,86,0,801,640,1441,9,5.5,201951
26,2,155,13,246,395,3,79,23,914,880,1794,12,5.4,201951
26,3,251,34,324,433,20,177,35,1274,1184,2458,13,6.5,201951
26,4,144,30,210,187,73,59,10,713,561,1274,9,5.2,201951
26,5,114,11,161,206,33,101,0,626,700,1326,15,6,201951
26,6,220,17,162,302,19,172,6,898,794,1692,10,5.333333333,201951
26,7,138,18,160,223,65,42,1,647,517,1164,10,5.5,201951
27,1,122,11,118,194,139,22,0,606,554,1160,8,5.5,201951
27,2,132,15,163,381,25,24,2,742,726,1468,8,5.666666667,201951
27,3,156,7,100,407,9,33,3,715,687,1402,7,5.666666667,201951
27,4,197,12,309,727,22,35,26,1328,1310,2638,8,6.5,201951
27,5,77,5,87,224,9,14,0,416,414,830,6,5.333333333,201951
27,6,121,10,148,426,11,50,0,766,774,1540,8,5.5,201951
28,1,155,21,401,328,5,28,0,938,657,1595,13,6,201951
28,2,159,20,378,248,22,48,63,938,648,1586,15,6,201951
28,3,62,14,132,99,18,36,28,389,413,802,7,5.333333333,201951
28,4,235,20,376,240,62,71,102,1106,1131,2237,17,6,201951
28,5,189,26,194,331,20,72,79,911,892,1803,9,5.25,201951
28,6,99,6,110,185,33,36,10,479,423,902,13,5.166666667,201951
28,7,201,29,399,320,148,63,84,1244,848,2092,13,6,201951
28,8,152,18,183,252,89,58,10,762,490,1252,13,7,201951
28,9,132,18,250,202,35,57,44,738,515,1253,11,5.75,201951
29,1,170,25,238,465,42,81,10,1031,1075,2106,7,5.5,201951
29,2,178,21,188,482,41,108,202,1220,1068,2288,10,6,201951
29,3,70,17,107,282,13,45,9,543,494,1037,6,5.666666667,201951
30,1,113,13,215,193,122,66,22,744,564,1308,7,5.333333333,201951
30,2,142,16,183,98,60,48,169,716,516,1232,9,5.25,201951
30,3,147,30,236,137,242,49,80,921,688,1609,6,5.666666667,201951
30,4,87,13,395,154,23,17,0,689,539,1228,8,6,201951
30,5,125,15,432,223,14,24,12,845,726,1571,7,5.5,201951
30,6,106,9,309,251,58,35,16,784,599,1383,9,5.333333333,201951
30,7,156,20,261,187,97,70,85,876,657,1533,11,5.25,201951
30,8,171,28,491,213,119,49,7,1078,1176,2254,11,5.4,201951
30,9,149,11,169,150,136,68,52,735,653,1388,8,5.5,201951
30,10,135,14,483,224,28,69,65,1018,620,1638,7,7,201951
30,11,120,20,345,317,8,23,1,834,696,1530,5,5.5,201951
30,12,184,13,718,383,28,59,4,1389,1190,2579,10,6.25,201951
30,13,189,19,223,210,154,113,87,995,979,1974,10,5.4,201951
30,14,118,6,179,125,162,35,11,636,610,1246,8,5.5,201951
30,15,188,18,307,221,156,80,104,1074,1139,2213,11,5.666666667,201951
30,16,151,13,319,341,66,82,150,1122,1090,2212,10,5.333333333,201951
30,17,156,24,325,248,34,54,81,922,809,1731,8,5.5,201951
30,18,152,14,120,114,90,56,29,575,510,1085,8,5.25,201951
30,19,146,13,351,169,60,56,7,802,1060,1862,13,5.6,201951
30,20,143,13,153,392,53,49,0,803,964,1767,10,5.2,201951
31,1,148,18,313,39,243,16,0,777,640,1417,8,5.5,201951
31,2,75,7,92,9,200,24,0,407,430,837,6,5.333333333,201951
31,3,380,116,1031,709,267,67,0,2570,2291,4861,21,6.666666667,201951
31,4,73,10,299,167,154,41,68,812,986,1798,4,6,201951
31,5,92,5,163,177,111,45,27,620,692,1312,7,5.333333333,201951
32,1,172,54,191,182,50,56,89,794,704,1498,12,5.2,201951
32,2,204,55,175,121,169,113,44,881,889,1770,13,5.142857143,201951
32,3,164,77,178,365,6,98,7,895,769,1664,13,5.6,201951
32,4,154,109,238,362,23,57,32,975,1071,2046,13,5.4,201951
1,1,163,34,210,265,58,45,8,783,752,1535,13,5.5,201952
1,2,177,46,342,414,66,69,16,1130,1015,2145,10,6.333333333,201952
1,3,164,48,347,343,64,96,65,1127,962,2089,9,6,201952
2,1,169,13,242,285,62,116,82,969,856,1825,11,6,201952
2,2,149,15,237,401,12,170,0,984,932,1916,7,6,201952
2,3,229,7,392,396,28,115,112,1279,1119,2398,11,5.666666667,201952
2,4,168,6,403,194,71,30,19,891,512,1403,9,6,201952
2,5,214,17,541,270,222,109,35,1408,1255,2663,11,6,201952
2,6,142,17,381,355,51,129,6,1081,951,2032,8,6.5,201952
2,7,184,14,388,329,38,66,35,1054,917,1971,12,5.75,201952
2,8,167,13,369,337,34,94,97,1111,1181,2292,7,7,201952
3,1,155,12,237,252,36,56,29,777,570,1347,12,5.666666667,201952
3,2,121,8,330,199,34,33,0,725,343,1068,9,5.666666667,201952
4,1,166,31,218,426,126,71,47,1085,794,1879,11,5.25,201952
4,2,134,15,253,336,83,50,122,993,700,1693,14,5.2,201952
5,1,155,11,275,349,57,75,20,942,1042,1984,9,5.666666667,201952
5,2,108,17,165,276,21,28,0,615,481,1096,10,6,201952
5,3,82,11,189,320,56,53,122,833,687,1520,11,5.333333333,201952
5,4,162,27,355,460,21,59,35,1119,546,1665,11,5.75,201952
5,5,138,10,228,494,25,50,36,981,992,1973,10,6,201952
5,6,126,11,206,234,10,41,66,694,623,1317,10,6,201952
5,7,104,20,260,402,7,57,14,864,408,1272,10,6,201952
6,1,194,15,282,273,24,71,87,946,936,1882,12,6,201952
6,2,134,14,290,235,62,64,62,861,766,1627,9,5.666666667,201952
7,1,234,7,142,192,110,10,1,696,412,1108,9,5.25,201952
7,2,178,8,97,520,55,8,1,867,1143,2010,9,5.25,201952
7,3,185,9,148,102,128,27,2,601,424,1025,7,5.333333333,201952
7,4,181,3,114,211,5,46,14,574,272,846,11,5.4,201952
7,5,208,6,202,412,122,51,0,1001,547,1548,11,5.666666667,201952
7,6,190,8,317,291,40,63,26,935,572,1507,8,5.333333333,201952
7,7,215,17,223,276,132,71,12,946,806,1752,8,5.5,201952
7,8,184,11,181,424,75,53,36,964,1260,2224,12,5.25,201952
7,9,184,4,290,461,22,75,32,1068,979,2047,9,5.666666667,201952
7,10,199,10,233,376,12,54,0,884,720,1604,9,5.5,201952
7,11,118,6,102,106,25,56,0,413,214,627,6,5.333333333,201952
7,12,172,7,256,557,19,35,4,1050,367,1417,9,5.5,201952
7,13,126,14,88,427,1,43,0,699,756,1455,9,5.25,201952
8,1,84,2,236,146,32,22,14,536,556,1092,4,6,201952
8,2,237,35,445,439,27,26,3,1212,990,2202,16,5.5,201952
8,3,131,13,229,269,28,50,30,750,844,1594,4,6,201952
8,4,142,35,309,249,67,93,89,984,532,1516,11,6,201952
8,5,215,44,213,333,46,53,0,904,906,1810,10,5.25,201952
8,6,130,29,225,254,37,64,40,779,653,1432,9,7,201952
8,7,114,55,133,237,10,49,0,598,294,892,7,5.25,201952
8,8,200,34,389,668,17,112,23,1443,1226,2669,10,6,201952
8,9,171,36,182,173,70,123,54,809,666,1475,10,5.2,201952
9,1,81,12,96,129,116,32,19,485,446,931,5,6,201952
9,2,266,71,537,658,238,145,148,2063,1750,3813,12,6,201952
9,3,137,16,267,345,141,78,135,1119,970,2089,7,6,201952
9,4,150,25,304,392,190,58,12,1131,950,2081,11,6,201952
9,5,152,8,194,304,69,177,0,904,736,1640,7,6,201952
9,6,75,21,142,162,138,42,74,654,534,1188,7,6,201952
9,7,62,9,363,222,0,25,51,732,262,994,9,6,201952
9,8,69,13,204,278,62,35,76,737,512,1249,5,6,201952
9,9,93,7,171,244,101,36,3,655,466,1121,5,6,201952
9,10,83,16,380,366,38,49,22,954,699,1653,6,6,201952
9,11,112,13,262,379,216,52,17,1051,1047,2098,7,6,201952
9,12,146,27,408,542,77,99,172,1471,1172,2643,11,6,201952
9,13,85,12,217,250,139,52,34,789,768,1557,4,6,201952
9,14,53,8,140,203,54,33,48,539,139,678,5,6,201952
9,15,205,27,750,846,65,138,108,2139,1992,4131,10,6.5,201952
9,16,178,114,332,599,113,83,18,1437,1367,2804,15,6,201952
9,17,94,6,246,294,57,56,15,768,295,1063,6,6,201952
9,18,161,11,205,406,128,74,149,1134,1069,2203,12,6,201952
9,19,136,58,176,264,159,61,92,946,1087,2033,5,6,201952
9,20,34,17,84,106,69,7,5,322,167,489,5,6,201952
9,21,99,9,132,186,84,35,21,566,480,1046,3,6,201952
9,22,126,9,137,247,138,36,45,738,616,1354,5,6,201952
9,23,114,13,355,363,120,46,23,1034,887,1921,6,6,201952
9,24,211,38,422,524,358,122,36,1711,1401,3112,14,6,201952
10,1,202,47,187,259,32,105,86,918,417,1335,12,5,201952
10,2,165,12,259,319,16,86,79,936,268,1204,9,5.25,201952
10,3,124,22,135,246,35,62,50,674,375,1049,11,5.4,201952
10,4,199,16,300,500,23,101,5,1144,970,2114,12,6.5,201952
11,1,109,65,129,186,47,47,13,596,603,1199,6,5.666666667,201952
11,2,145,47,217,175,138,102,18,842,541,1383,7,6,201952
11,3,102,38,165,227,28,88,25,673,722,1395,3,6,201952
11,4,121,53,131,178,72,77,3,635,556,1191,7,5.666666667,201952
11,5,167,64,299,467,35,93,10,1135,961,2096,7,6,201952
11,6,89,31,172,205,50,41,19,607,267,874,8,6,201952
11,7,181,50,298,425,32,55,1,1042,675,1717,9,5.25,201952
11,8,140,43,171,374,78,67,18,891,669,1560,9,5.5,201952
11,9,159,63,239,376,14,80,22,953,755,1708,10,5.666666667,201952
11,10,274,64,219,290,31,139,120,1137,781,1918,10,5.6,201952
11,11,150,32,259,344,16,68,0,869,824,1693,5,6,201952
11,12,163,61,306,467,23,69,8,1097,1089,2186,7,6,201952
11,13,197,42,219,186,69,96,45,854,413,1267,8,5.5,201952
11,14,182,51,262,238,92,77,4,906,524,1430,8,5.5,201952
11,15,134,35,192,278,29,73,11,752,645,1397,9,6,201952
12,1,138,39,207,145,66,28,6,629,449,1078,10,5.2,201952
12,2,164,25,191,459,16,73,3,931,291,1222,10,5.5,201952
12,3,164,26,290,414,22,53,0,969,584,1553,11,5.2,201952
12,4,174,16,274,478,40,66,1,1049,266,1315,9,5.666666667,201952
12,5,217,26,229,276,2,42,70,862,417,1279,10,5.25,201952
12,6,103,13,210,216,37,13,10,602,706,1308,10,5.25,201952
12,7,148,15,192,413,6,57,10,841,646,1487,6,5.5,201952
12,8,165,10,154,279,2,30,0,640,326,966,9,5.25,201952
12,9,162,31,291,438,63,29,6,1020,344,1364,9,5.666666667,201952
13,1,226,18,133,337,142,37,48,941,589,1530,9,5.333333333,201952
13,2,142,14,76,194,83,69,45,623,431,1054,6,5.333333333,201952
13,3,131,24,136,170,123,48,8,640,414,1054,12,5.25,201952
13,4,231,20,244,322,108,57,79,1061,792,1853,9,5.666666667,201952
13,5,255,11,314,317,105,98,75,1175,911,2086,9,5.75,201952
13,6,297,33,481,671,68,76,37,1663,1416,3079,11,5.666666667,201952
13,7,153,9,280,324,43,26,0,835,488,1323,8,5.5,201952
14,1,146,44,155,82,133,51,9,620,315,935,6,5.5,201952
14,2,147,21,189,101,89,47,5,599,449,1048,5,5.666666667,201952
14,3,183,19,327,142,13,112,3,799,485,1284,8,5.4,201952
14,4,127,23,295,295,24,87,24,875,504,1379,10,6,201952
14,5,199,15,344,201,73,56,11,899,251,1150,9,5.5,201952
14,6,196,15,525,310,21,35,2,1104,824,1928,11,6,201952
14,7,91,19,232,161,0,22,0,525,362,887,6,6,201952
14,8,279,46,867,740,53,158,2,2145,1515,3660,11,6.25,201952
14,9,77,11,200,269,21,52,11,641,553,1194,11,6,201952
14,10,136,68,449,268,7,69,35,1032,544,1576,7,6,201952
14,11,117,21,165,199,85,82,83,752,587,1339,4,6,201952
14,12,205,15,486,173,29,43,1,952,680,1632,9,5.5,201952
14,13,168,27,456,254,18,70,10,1003,662,1665,6,6,201952
14,14,99,27,277,298,40,91,38,870,541,1411,7,6,201952
14,15,193,51,240,177,126,89,12,888,391,1279,10,5.6,201952
14,16,135,31,355,171,76,59,17,844,714,1558,5,6,201952
14,17,132,20,156,73,44,62,21,508,460,968,7,5.25,201952
14,18,204,28,317,91,125,80,39,884,630,1514,9,5.4,201952
14,19,166,34,287,188,40,57,48,820,685,1505,8,5.25,201952
14,20,124,20,259,199,4,42,0,648,716,1364,10,5.666666667,201952
15,1,101,8,111,104,228,52,0,604,392,996,7,5.333333333,201952
15,2,119,13,213,224,175,18,17,779,662,1441,6,6,201952
15,3,175,26,167,218,314,41,112,1053,783,1836,10,5.666666667,201952
15,4,169,20,172,348,54,55,41,859,608,1467,4,6,201952
15,5,126,29,240,244,26,47,12,724,415,1139,8,5.666666667,201952
15,6,131,9,239,421,42,50,59,951,761,1712,7,6,201952
15,7,110,13,274,195,113,66,29,800,693,1493,10,6,201952
15,8,63,18,117,229,22,27,22,498,422,920,4,6,201952
15,9,136,8,127,104,186,126,4,691,589,1280,9,5.75,201952
15,10,89,4,142,350,26,45,15,671,658,1329,6,6,201952
15,11,121,41,262,340,85,52,20,921,799,1720,8,6,201952
15,12,166,16,360,354,53,53,1,1003,933,1936,8,6,201952
15,13,88,22,154,197,181,70,2,714,540,1254,8,6,201952
15,14,73,21,115,214,49,32,7,511,377,888,4,6,201952
15,15,129,148,220,298,73,31,14,913,771,1684,6,6,201952
15,16,145,22,287,495,29,67,41,1086,992,2078,8,6,201952
15,17,103,16,184,224,36,48,101,712,325,1037,8,6,201952
15,18,186,29,313,354,43,89,21,1035,805,1840,7,5.666666667,201952
15,19,165,48,383,731,36,98,81,1542,1330,2872,10,6,201952
15,20,71,12,235,239,37,29,22,645,317,962,6,6,201952
15,21,79,10,119,169,55,34,47,513,379,892,6,5.5,201952
15,22,221,78,425,656,46,78,87,1591,1316,2907,14,6,201952
15,23,116,9,187,292,25,59,2,690,339,1029,6,5.333333333,201952
15,24,82,24,161,221,42,26,22,578,611,1189,4,6,201952
15,25,150,16,211,252,32,53,9,723,800,1523,6,6,201952
15,26,113,7,186,266,153,41,9,775,609,1384,9,7,201952
15,27,158,11,322,353,47,76,78,1045,858,1903,9,5.666666667,201952
15,28,149,26,410,307,23,48,21,984,822,1806,9,5.666666667,201952
15,29,150,19,317,603,24,93,46,1252,1161,2413,8,6,201952
15,30,206,28,280,417,76,44,89,1140,1053,2193,16,6,201952
15,31,106,281,76,226,8,10,0,707,618,1325,6,6,201952
15,32,135,10,204,343,85,31,18,826,590,1416,9,6,201952
15,33,144,20,321,366,61,44,0,956,909,1865,7,6,201952
15,34,130,11,171,373,14,48,27,774,674,1448,8,6,201952
15,35,173,11,225,473,16,90,16,1004,826,1830,9,5.666666667,201952
15,36,144,16,201,411,18,62,0,852,422,1274,9,5.5,201952
15,37,171,16,209,387,197,68,86,1134,890,2024,7,6,201952
15,38,129,59,244,348,66,38,29,913,708,1621,6,5.5,201952
15,39,106,13,168,240,55,69,1,652,576,1228,4,6,201952
15,40,212,44,223,430,159,90,12,1170,917,2087,9,6,201952
15,41,210,25,449,464,100,65,55,1368,1075,2443,13,6,201952
16,1,154,35,361,153,30,32,0,765,373,1138,7,5.333333333,201952
16,2,140,40,146,175,13,80,0,594,286,880,9,5.25,201952
16,3,190,28,142,259,59,52,4,734,529,1263,10,5,201952
16,4,211,40,264,147,75,93,0,830,561,1391,8,5.5,201952
16,5,222,31,195,250,60,85,45,888,526,1414,10,5.666666667,201952
16,6,148,46,213,192,60,32,0,691,413,1104,12,5.5,201952
16,7,203,30,225,266,54,74,10,862,431,1293,9,5.5,201952
16,8,231,40,566,650,12,65,9,1573,887,2460,12,6,201952
16,9,166,28,266,365,11,61,7,904,223,1127,9,6,201952
16,10,120,19,267,298,23,29,0,756,722,1478,6,6,201952
16,11,171,31,296,207,147,71,5,928,569,1497,10,5.4,201952
16,12,130,20,177,157,23,43,11,561,538,1099,10,5.25,201952
17,1,143,30,348,520,80,61,3,1185,1189,2374,9,7,201952
17,2,110,5,212,350,19,53,38,787,577,1364,8,5.666666667,201952
17,3,229,34,395,522,54,62,1,1297,934,2231,8,5.5,201952
17,4,195,11,287,391,38,53,50,1025,924,1949,10,5.666666667,201952
17,5,79,8,149,121,22,24,1,404,340,744,5,5.5,201952
18,1,138,10,114,173,27,57,40,559,311,870,7,5.25,201952
18,2,218,30,330,408,80,112,3,1181,650,1831,9,6.333333333,201952
18,3,169,12,329,250,14,43,0,817,633,1450,8,5.5,201952
19,1,147,20,215,262,18,84,57,803,662,1465,9,6,201952
19,2,174,22,482,429,23,70,0,1200,1491,2691,9,6,201952
19,3,176,17,448,359,46,76,8,1130,832,1962,7,6,201952
19,4,83,7,98,87,55,43,77,450,493,943,5,6,201952
19,5,199,18,361,451,27,128,81,1265,1501,2766,8,6,201952
19,6,45,9,119,244,2,53,14,486,258,744,5,6,201952
19,7,107,6,259,140,6,36,0,554,473,1027,10,5,201952
19,8,36,6,101,109,6,20,0,278,109,387,7,6,201952
19,9,91,12,153,141,31,36,25,489,429,918,9,4.5,201952
19,10,85,9,142,226,10,70,35,577,826,1403,6,7,201952
19,11,249,22,423,769,17,175,129,1784,1368,3152,13,6,201952
19,12,118,8,382,154,15,40,5,722,415,1137,13,5.666666667,201952
20,1,153,19,154,174,61,40,40,641,350,991,7,5.5,201952
20,2,131,20,195,186,43,32,3,610,213,823,6,5.333333333,201952
20,3,119,16,140,117,140,35,41,608,337,945,6,5.333333333,201952
20,4,114,7,97,111,45,86,30,490,253,743,6,5,201952
20,5,144,16,276,433,23,31,0,923,521,1444,11,5.25,201952
20,6,142,9,118,116,132,125,101,743,358,1101,8,5.25,201952
20,7,172,11,234,320,50,40,0,827,495,1322,7,5.75,201952
20,8,320,31,540,623,100,107,112,1833,1816,3649,15,8,201952
20,9,230,15,168,175,217,59,43,907,395,1302,8,5.666666667,201952
20,10,146,11,336,143,29,20,8,693,247,940,9,5.25,201952
21,1,151,17,269,197,70,33,3,740,373,1113,9,5.4,201952
21,2,86,96,148,97,90,37,0,554,338,892,9,5.2,201952
21,3,156,13,216,269,119,96,30,899,628,1527,8,5.5,201952
21,4,110,4,131,70,117,34,4,470,260,730,6,5.25,201952
21,5,172,13,445,235,18,23,23,929,732,1661,8,5.666666667,201952
21,6,138,8,254,220,194,116,56,986,974,1960,6,6,201952
21,7,267,9,196,232,94,72,0,870,636,1506,9,5.666666667,201952
21,8,130,15,233,146,61,62,79,726,661,1387,9,5.2,201952
21,9,135,32,517,347,97,73,67,1268,1076,2344,9,6,201952
21,10,119,18,354,289,56,60,88,984,802,1786,7,5.5,201952
21,11,65,5,160,104,42,17,21,414,352,766,4,6,201952
21,12,242,26,715,503,230,118,380,2214,1750,3964,16,6.5,201952
21,13,166,18,526,266,48,105,14,1143,770,1913,8,5.666666667,201952
21,14,157,23,165,135,150,67,38,735,512,1247,12,5.333333333,201952
21,15,197,12,293,332,52,100,56,1042,675,1717,7,5.5,201952
22,1,185,31,152,275,26,35,1,705,489,1194,11,5.2,201952
22,2,134,28,219,230,108,45,6,770,281,1051,7,5.5,201952
22,3,194,46,638,613,21,75,0,1587,1356,2943,9,5.666666667,201952
22,4,180,36,515,499,30,51,13,1324,1062,2386,9,6.5,201952
22,5,104,15,258,212,50,54,46,739,663,1402,10,5.5,201952
23,1,214,8,781,297,58,42,24,1424,1152,2576,14,5.6,201952
23,2,159,10,305,273,15,25,0,787,309,1096,8,5.25,201952
23,3,187,4,634,423,46,42,1,1337,1184,2521,19,0,201952
23,4,143,8,392,276,41,38,56,954,756,1710,6,5.5,201952
24,1,87,35,103,189,6,40,0,460,344,804,10,5.2,201952
24,2,86,13,146,174,10,51,4,484,357,841,6,5.5,201952
24,3,129,43,130,205,77,33,0,617,343,960,9,5.25,201952
24,4,154,18,183,223,52,62,95,787,507,1294,5,5.5,201952
24,5,183,37,451,502,21,50,5,1249,1082,2331,10,6.333333333,201952
24,6,123,112,245,294,37,56,0,867,962,1829,6,6,201952
24,7,155,19,189,297,108,18,0,786,177,963,9,5.25,201952
25,1,134,8,219,346,42,46,33,828,409,1237,13,5.75,201952
25,2,181,58,306,424,15,74,0,1058,612,1670,7,5.5,201952
25,3,139,13,247,460,61,80,9,1009,410,1419,8,5.6,201952
25,4,123,22,144,295,138,24,0,746,328,1074,8,5.333333333,201952
25,5,133,10,247,458,32,54,34,968,629,1597,8,5.666666667,201952
25,6,143,6,256,310,67,65,32,879,248,1127,8,5.75,201952
25,7,191,27,455,518,3,45,0,1239,590,1829,6,6,201952
26,1,165,9,249,311,5,89,0,828,611,1439,9,5.5,201952
26,2,165,9,192,336,4,56,17,779,573,1352,12,5.4,201952
26,3,154,25,254,335,28,156,62,1014,780,1794,13,6,201952
26,4,115,20,225,219,65,52,5,701,378,1079,9,5.2,201952
26,5,117,12,148,231,24,98,0,630,466,1096,15,6,201952
26,6,213,20,206,331,34,135,16,955,696,1651,10,5.333333333,201952
26,7,115,22,152,223,55,41,0,608,439,1047,10,5.5,201952
27,1,100,5,89,200,78,24,1,497,472,969,8,5.5,201952
27,2,150,10,172,444,15,39,0,830,775,1605,8,5.666666667,201952
27,3,142,8,109,459,8,39,5,770,661,1431,7,5.666666667,201952
27,4,148,9,263,720,31,50,26,1247,969,2216,8,6,201952
27,5,95,1,88,254,13,15,9,475,284,759,6,5.333333333,201952
27,6,132,4,157,395,3,46,0,737,788,1525,7,5.5,201952
28,1,125,19,276,364,2,38,0,824,881,1705,13,6,201952
28,2,140,13,277,206,36,53,126,851,255,1106,15,5.666666667,201952
28,3,92,9,187,129,13,39,27,496,297,793,7,5.333333333,201952
28,4,197,14,275,266,49,97,102,1000,934,1934,17,6,201952
28,5,148,25,213,393,5,82,84,950,633,1583,9,5.25,201952
28,6,153,14,136,385,43,37,8,776,545,1321,13,5.166666667,201952
28,7,190,30,346,258,94,51,88,1057,636,1693,13,6,201952
28,8,140,20,190,295,65,58,15,783,212,995,13,7,201952
28,9,129,15,206,175,33,37,60,655,182,837,11,5.75,201952
29,1,189,21,276,445,26,80,0,1037,967,2004,7,5.5,201952
29,2,166,23,181,452,31,68,166,1087,1000,2087,11,6,201952
29,3,115,10,137,383,24,59,9,737,348,1085,6,5.666666667,201952
30,1,77,4,149,127,48,35,6,446,260,706,7,5.333333333,201952
30,2,125,8,167,88,84,28,143,643,233,876,8,5.25,201952
30,3,142,16,236,126,231,60,95,906,469,1375,6,5.666666667,201952
30,4,82,16,330,166,53,28,0,675,601,1276,8,6,201952
30,5,111,11,244,187,31,40,9,633,571,1204,7,5.5,201952
30,6,141,19,290,260,70,42,16,838,484,1322,9,5.333333333,201952
30,7,120,15,274,232,140,44,67,892,68,960,11,5.25,201952
30,8,162,35,760,271,235,62,12,1537,664,2201,11,5.4,201952
30,9,166,9,153,153,137,83,80,781,332,1113,8,5.5,201952
30,10,137,14,541,307,57,57,147,1260,286,1546,6,6,201952
30,11,123,10,361,410,19,36,0,959,260,1219,5,5.5,201952
30,12,190,14,698,432,44,82,8,1468,1037,2505,10,6,201952
30,13,174,10,173,229,171,80,91,928,374,1302,10,5.4,201952
30,14,124,16,222,186,184,42,23,797,510,1307,8,5.5,201952
30,15,198,15,288,270,174,101,189,1235,882,2117,11,5.666666667,201952
30,16,170,13,384,569,257,98,223,1714,674,2388,10,5.333333333,201952
30,17,142,27,340,282,64,64,90,1009,432,1441,8,5.5,201952
30,18,200,15,106,186,102,56,53,718,313,1031,8,5.25,201952
30,19,129,11,369,279,75,59,3,925,357,1282,13,5.6,201952
30,20,110,22,149,523,134,54,1,993,232,1225,10,5.4,201952
31,1,145,18,300,44,287,35,0,829,777,1606,8,5.5,201952
31,2,92,9,117,16,292,43,0,569,281,850,6,5.333333333,201952
31,3,323,62,877,792,202,83,0,2339,1904,4243,20,6,201952
31,4,98,12,261,170,153,43,83,820,607,1427,4,6,201952
31,5,115,20,223,157,138,56,8,717,421,1138,6,5.333333333,201952
32,1,140,33,120,125,52,49,71,590,212,802,12,5.2,201952
32,2,148,28,140,81,95,90,23,605,268,873,13,5.142857143,201952
32,3,157,22,168,299,8,77,2,733,531,1264,13,5.4,201952
32,4,174,60,189,301,17,84,47,872,570,1442,12,5.2,201952
1,1,0,0,0,0,0,0,0,0,0,0,0,0,201953
1,2,0,0,0,0,0,0,0,0,0,0,0,0,201953
1,3,0,0,0,0,0,0,0,0,0,0,0,0,201953
2,1,0,0,0,0,0,0,0,0,0,0,0,0,201953
2,2,0,0,0,0,0,0,0,0,0,0,0,0,201953
2,3,0,0,0,0,0,0,0,0,0,0,0,0,201953
2,4,0,0,0,0,0,0,0,0,0,0,0,0,201953
2,5,0,0,0,0,0,0,0,0,0,0,0,0,201953
2,6,0,0,0,0,0,0,0,0,0,0,0,0,201953
2,7,0,0,0,0,0,0,0,0,0,0,0,0,201953
2,8,0,0,0,0,0,0,0,0,0,0,0,0,201953
3,1,0,0,0,0,0,0,0,0,0,0,0,0,201953
3,2,0,0,0,0,0,0,0,0,0,0,0,0,201953
4,1,0,0,0,0,0,0,0,0,0,0,0,0,201953
4,2,0,0,0,0,0,0,0,0,0,0,0,0,201953
5,1,96,2,195,239,15,59,23,629,543,1172,9,3.666666667,201953
5,2,39,11,91,157,9,22,0,329,232,561,10,4,201953
5,3,59,8,117,223,46,46,74,573,200,773,11,3.333333333,201953
5,4,96,19,278,419,14,70,70,966,249,1215,11,4,201953
5,5,73,8,146,273,7,42,56,605,255,860,10,4,201953
5,6,74,5,109,182,9,26,43,448,166,614,10,4,201953
5,7,63,13,187,298,2,44,22,629,135,764,10,4,201953
6,1,0,0,0,0,0,0,0,0,0,0,0,0,201953
6,2,0,0,0,0,0,0,0,0,0,0,0,0,201953
7,1,0,0,0,0,0,0,0,0,0,0,0,0,201953
7,2,0,0,0,0,0,0,0,0,0,0,0,0,201953
7,3,0,0,0,0,0,0,0,0,0,0,0,0,201953
7,4,0,0,0,0,0,0,0,0,0,0,0,0,201953
7,5,0,0,0,0,0,0,0,0,0,0,0,0,201953
7,6,0,0,0,0,0,0,0,0,0,0,0,0,201953
7,7,0,0,0,0,0,0,0,0,0,0,0,0,201953
7,8,0,0,0,0,0,0,0,0,0,0,0,0,201953
7,9,0,0,0,0,0,0,0,0,0,0,0,0,201953
7,10,0,0,0,0,0,0,0,0,0,0,0,0,201953
7,11,0,0,0,0,0,0,0,0,0,0,0,0,201953
7,12,0,0,0,0,0,0,0,0,0,0,0,0,201953
7,13,0,0,0,0,0,0,0,0,0,0,0,0,201953
8,1,0,0,0,0,0,0,0,0,0,0,0,0,201953
8,2,0,0,0,0,0,0,0,0,0,0,0,0,201953
8,3,0,0,0,0,0,0,0,0,0,0,0,0,201953
8,4,0,0,0,0,0,0,0,0,0,0,0,0,201953
8,5,0,0,0,0,0,0,0,0,0,0,0,0,201953
8,6,0,0,0,0,0,0,0,0,0,0,0,0,201953
8,7,0,0,0,0,0,0,0,0,0,0,0,0,201953
8,8,0,0,0,0,0,0,0,0,0,0,0,0,201953
8,9,0,0,0,0,0,0,0,0,0,0,0,0,201953
9,1,0,0,0,0,0,0,0,0,0,0,0,0,201953
9,2,0,0,0,0,0,0,0,0,0,0,0,0,201953
9,3,0,0,0,0,0,0,0,0,0,0,0,0,201953
9,4,0,0,0,0,0,0,0,0,0,0,0,0,201953
9,5,0,0,0,0,0,0,0,0,0,0,0,0,201953
9,6,0,0,0,0,0,0,0,0,0,0,0,0,201953
9,7,0,0,0,0,0,0,0,0,0,0,0,0,201953
9,8,0,0,0,0,0,0,0,0,0,0,0,0,201953
9,9,0,0,0,0,0,0,0,0,0,0,0,0,201953
9,10,0,0,0,0,0,0,0,0,0,0,0,0,201953
9,11,0,0,0,0,0,0,0,0,0,0,0,0,201953
9,12,0,0,0,0,0,0,0,0,0,0,0,0,201953
9,13,0,0,0,0,0,0,0,0,0,0,0,0,201953
9,14,0,0,0,0,0,0,0,0,0,0,0,0,201953
9,15,0,0,0,0,0,0,0,0,0,0,0,0,201953
9,16,0,0,0,0,0,0,0,0,0,0,0,0,201953
9,17,0,0,0,0,0,0,0,0,0,0,0,0,201953
9,18,0,0,0,0,0,0,0,0,0,0,0,0,201953
9,19,0,0,0,0,0,0,0,0,0,0,0,0,201953
9,20,0,0,0,0,0,0,0,0,0,0,0,0,201953
9,21,0,0,0,0,0,0,0,0,0,0,0,0,201953
9,22,0,0,0,0,0,0,0,0,0,0,0,0,201953
9,23,0,0,0,0,0,0,0,0,0,0,0,0,201953
9,24,0,0,0,0,0,0,0,0,0,0,0,0,201953
10,1,0,0,0,0,0,0,0,0,0,0,0,0,201953
10,2,0,0,0,0,0,0,0,0,0,0,0,0,201953
10,3,0,0,0,0,0,0,0,0,0,0,0,0,201953
10,4,0,0,0,0,0,0,0,0,0,0,0,0,201953
11,1,0,0,0,0,0,0,0,0,0,0,0,0,201953
11,2,0,0,0,0,0,0,0,0,0,0,0,0,201953
11,3,0,0,0,0,0,0,0,0,0,0,0,0,201953
11,4,0,0,0,0,0,0,0,0,0,0,0,0,201953
11,5,0,0,0,0,0,0,0,0,0,0,0,0,201953
11,6,0,0,0,0,0,0,0,0,0,0,0,0,201953
11,7,0,0,0,0,0,0,0,0,0,0,0,0,201953
11,8,0,0,0,0,0,0,0,0,0,0,0,0,201953
11,9,0,0,0,0,0,0,0,0,0,0,0,0,201953
11,10,0,0,0,0,0,0,0,0,0,0,0,0,201953
11,11,0,0,0,0,0,0,0,0,0,0,0,0,201953
11,12,0,0,0,0,0,0,0,0,0,0,0,0,201953
11,13,0,0,0,0,0,0,0,0,0,0,0,0,201953
11,14,0,0,0,0,0,0,0,0,0,0,0,0,201953
11,15,0,0,0,0,0,0,0,0,0,0,0,0,201953
12,1,0,0,0,0,0,0,0,0,0,0,0,0,201953
12,2,0,0,0,0,0,0,0,0,0,0,0,0,201953
12,3,0,0,0,0,0,0,0,0,0,0,0,0,201953
12,4,0,0,0,0,0,0,0,0,0,0,0,0,201953
12,5,0,0,0,0,0,0,0,0,0,0,0,0,201953
12,6,0,0,0,0,0,0,0,0,0,0,0,0,201953
12,7,0,0,0,0,0,0,0,0,0,0,0,0,201953
12,8,0,0,0,0,0,0,0,0,0,0,0,0,201953
12,9,0,0,0,0,0,0,0,0,0,0,0,0,201953
13,1,84,4,54,105,42,12,5,306,98,404,9,3.333333333,201953
13,2,85,6,46,112,44,36,30,359,137,496,6,3.333333333,201953
13,3,66,7,105,97,99,34,0,408,81,489,12,3.25,201953
13,4,89,10,125,197,68,29,60,578,171,749,9,3.666666667,201953
13,5,108,9,193,162,84,40,63,659,247,906,9,3.75,201953
13,6,113,19,268,461,28,63,45,997,280,1277,11,3.666666667,201953
13,7,68,6,112,193,19,25,0,423,124,547,8,3.5,201953
14,1,0,0,0,0,0,0,0,0,0,0,0,0,201953
14,2,0,0,0,0,0,0,0,0,0,0,0,0,201953
14,3,0,0,0,0,0,0,0,0,0,0,0,0,201953
14,4,0,0,0,0,0,0,0,0,0,0,0,0,201953
14,5,0,0,0,0,0,0,0,0,0,0,0,0,201953
14,6,0,0,0,0,0,0,0,0,0,0,0,0,201953
14,7,0,0,0,0,0,0,0,0,0,0,0,0,201953
14,8,0,0,0,0,0,0,0,0,0,0,0,0,201953
14,9,0,0,0,0,0,0,0,0,0,0,0,0,201953
14,10,0,0,0,0,0,0,0,0,0,0,0,0,201953
14,11,0,0,0,0,0,0,0,0,0,0,0,0,201953
14,12,0,0,0,0,0,0,0,0,0,0,0,0,201953
14,13,0,0,0,0,0,0,0,0,0,0,0,0,201953
14,14,0,0,0,0,0,0,0,0,0,0,0,0,201953
14,15,0,0,0,0,0,0,0,0,0,0,0,0,201953
14,16,0,0,0,0,0,0,0,0,0,0,0,0,201953
14,17,0,0,0,0,0,0,0,0,0,0,0,0,201953
14,18,0,0,0,0,0,0,0,0,0,0,0,0,201953
14,19,0,0,0,0,0,0,0,0,0,0,0,0,201953
14,20,0,0,0,0,0,0,0,0,0,0,0,0,201953
15,1,0,0,0,0,0,0,0,0,0,0,0,0,201953
15,2,0,0,0,0,0,0,0,0,0,0,0,0,201953
15,3,0,0,0,0,0,0,0,0,0,0,0,0,201953
15,4,0,0,0,0,0,0,0,0,0,0,0,0,201953
15,5,0,0,0,0,0,0,0,0,0,0,0,0,201953
15,6,0,0,0,0,0,0,0,0,0,0,0,0,201953
15,7,0,0,0,0,0,0,0,0,0,0,0,0,201953
15,8,0,0,0,0,0,0,0,0,0,0,0,0,201953
15,9,0,0,0,0,0,0,0,0,0,0,0,0,201953
15,10,0,0,0,0,0,0,0,0,0,0,0,0,201953
15,11,0,0,0,0,0,0,0,0,0,0,0,0,201953
15,12,0,0,0,0,0,0,0,0,0,0,0,0,201953
15,13,0,0,0,0,0,0,0,0,0,0,0,0,201953
15,14,0,0,0,0,0,0,0,0,0,0,0,0,201953
15,15,0,0,0,0,0,0,0,0,0,0,0,0,201953
15,16,0,0,0,0,0,0,0,0,0,0,0,0,201953
15,17,0,0,0,0,0,0,0,0,0,0,0,0,201953
15,18,0,0,0,0,0,0,0,0,0,0,0,0,201953
15,19,0,0,0,0,0,0,0,0,0,0,0,0,201953
15,20,0,0,0,0,0,0,0,0,0,0,0,0,201953
15,21,0,0,0,0,0,0,0,0,0,0,0,0,201953
15,22,0,0,0,0,0,0,0,0,0,0,0,0,201953
15,23,0,0,0,0,0,0,0,0,0,0,0,0,201953
15,24,0,0,0,0,0,0,0,0,0,0,0,0,201953
15,25,0,0,0,0,0,0,0,0,0,0,0,0,201953
15,26,0,0,0,0,0,0,0,0,0,0,0,0,201953
15,27,0,0,0,0,0,0,0,0,0,0,0,0,201953
15,28,0,0,0,0,0,0,0,0,0,0,0,0,201953
15,29,0,0,0,0,0,0,0,0,0,0,0,0,201953
15,30,0,0,0,0,0,0,0,0,0,0,0,0,201953
15,31,0,0,0,0,0,0,0,0,0,0,0,0,201953
15,32,0,0,0,0,0,0,0,0,0,0,0,0,201953
15,33,0,0,0,0,0,0,0,0,0,0,0,0,201953
15,34,0,0,0,0,0,0,0,0,0,0,0,0,201953
15,35,0,0,0,0,0,0,0,0,0,0,0,0,201953
15,36,0,0,0,0,0,0,0,0,0,0,0,0,201953
15,37,0,0,0,0,0,0,0,0,0,0,0,0,201953
15,38,0,0,0,0,0,0,0,0,0,0,0,0,201953
15,39,0,0,0,0,0,0,0,0,0,0,0,0,201953
15,40,0,0,0,0,0,0,0,0,0,0,0,0,201953
15,41,0,0,0,0,0,0,0,0,0,0,0,0,201953
16,1,0,0,0,0,0,0,0,0,0,0,0,0,201953
16,2,0,0,0,0,0,0,0,0,0,0,0,0,201953
16,3,0,0,0,0,0,0,0,0,0,0,0,0,201953
16,4,0,0,0,0,0,0,0,0,0,0,0,0,201953
16,5,0,0,0,0,0,0,0,0,0,0,0,0,201953
16,6,0,0,0,0,0,0,0,0,0,0,0,0,201953
16,7,0,0,0,0,0,0,0,0,0,0,0,0,201953
16,8,0,0,0,0,0,0,0,0,0,0,0,0,201953
16,9,0,0,0,0,0,0,0,0,0,0,0,0,201953
16,10,0,0,0,0,0,0,0,0,0,0,0,0,201953
16,11,0,0,0,0,0,0,0,0,0,0,0,0,201953
16,12,0,0,0,0,0,0,0,0,0,0,0,0,201953
17,1,0,0,0,0,0,0,0,0,0,0,0,0,201953
17,2,0,0,0,0,0,0,0,0,0,0,0,0,201953
17,3,0,0,0,0,0,0,0,0,0,0,0,0,201953
17,4,0,0,0,0,0,0,0,0,0,0,0,0,201953
17,5,0,0,0,0,0,0,0,0,0,0,0,0,201953
18,1,0,0,0,0,0,0,0,0,0,0,0,0,201953
18,2,0,0,0,0,0,0,0,0,0,0,0,0,201953
18,3,0,0,0,0,0,0,0,0,0,0,0,0,201953
19,1,0,0,0,0,0,0,0,0,0,0,0,0,201953
19,2,0,0,0,0,0,0,0,0,0,0,0,0,201953
19,3,0,0,0,0,0,0,0,0,0,0,0,0,201953
19,4,0,0,0,0,0,0,0,0,0,0,0,0,201953
19,5,0,0,0,0,0,0,0,0,0,0,0,0,201953
19,6,0,0,0,0,0,0,0,0,0,0,0,0,201953
19,7,0,0,0,0,0,0,0,0,0,0,0,0,201953
19,8,0,0,0,0,0,0,0,0,0,0,0,0,201953
19,9,0,0,0,0,0,0,0,0,0,0,0,0,201953
19,10,0,0,0,0,0,0,0,0,0,0,0,0,201953
19,11,0,0,0,0,0,0,0,0,0,0,0,0,201953
19,12,0,0,0,0,0,0,0,0,0,0,0,0,201953
20,1,0,0,0,0,0,0,0,0,0,0,0,0,201953
20,2,0,0,0,0,0,0,0,0,0,0,0,0,201953
20,3,0,0,0,0,0,0,0,0,0,0,0,0,201953
20,4,0,0,0,0,0,0,0,0,0,0,0,0,201953
20,5,0,0,0,0,0,0,0,0,0,0,0,0,201953
20,6,0,0,0,0,0,0,0,0,0,0,0,0,201953
20,7,0,0,0,0,0,0,0,0,0,0,0,0,201953
20,8,0,0,0,0,0,0,0,0,0,0,0,0,201953
20,9,0,0,0,0,0,0,0,0,0,0,0,0,201953
20,10,0,0,0,0,0,0,0,0,0,0,0,0,201953
21,1,0,0,0,0,0,0,0,0,0,0,0,0,201953
21,2,0,0,0,0,0,0,0,0,0,0,0,0,201953
21,3,0,0,0,0,0,0,0,0,0,0,0,0,201953
21,4,0,0,0,0,0,0,0,0,0,0,0,0,201953
21,5,0,0,0,0,0,0,0,0,0,0,0,0,201953
21,6,0,0,0,0,0,0,0,0,0,0,0,0,201953
21,7,0,0,0,0,0,0,0,0,0,0,0,0,201953
21,8,0,0,0,0,0,0,0,0,0,0,0,0,201953
21,9,0,0,0,0,0,0,0,0,0,0,0,0,201953
21,10,0,0,0,0,0,0,0,0,0,0,0,0,201953
21,11,0,0,0,0,0,0,0,0,0,0,0,0,201953
21,12,0,0,0,0,0,0,0,0,0,0,0,0,201953
21,13,0,0,0,0,0,0,0,0,0,0,0,0,201953
21,14,0,0,0,0,0,0,0,0,0,0,0,0,201953
21,15,0,0,0,0,0,0,0,0,0,0,0,0,201953
22,1,0,0,0,0,0,0,0,0,0,0,0,0,201953
22,2,0,0,0,0,0,0,0,0,0,0,0,0,201953
22,3,0,0,0,0,0,0,0,0,0,0,0,0,201953
22,4,0,0,0,0,0,0,0,0,0,0,0,0,201953
22,5,0,0,0,0,0,0,0,0,0,0,0,0,201953
23,1,0,0,0,0,0,0,0,0,0,0,0,0,201953
23,2,0,0,0,0,0,0,0,0,0,0,0,0,201953
23,3,0,0,0,0,0,0,0,0,0,0,0,0,201953
23,4,0,0,0,0,0,0,0,0,0,0,0,0,201953
24,1,0,0,0,0,0,0,0,0,0,0,0,0,201953
24,2,0,0,0,0,0,0,0,0,0,0,0,0,201953
24,3,0,0,0,0,0,0,0,0,0,0,0,0,201953
24,4,0,0,0,0,0,0,0,0,0,0,0,0,201953
24,5,0,0,0,0,0,0,0,0,0,0,0,0,201953
24,6,0,0,0,0,0,0,0,0,0,0,0,0,201953
24,7,0,0,0,0,0,0,0,0,0,0,0,0,201953
25,1,0,0,0,0,0,0,0,0,0,0,0,0,201953
25,2,0,0,0,0,0,0,0,0,0,0,0,0,201953
25,3,0,0,0,0,0,0,0,0,0,0,0,0,201953
25,4,0,0,0,0,0,0,0,0,0,0,0,0,201953
25,5,0,0,0,0,0,0,0,0,0,0,0,0,201953
25,6,0,0,0,0,0,0,0,0,0,0,0,0,201953
25,7,0,0,0,0,0,0,0,0,0,0,0,0,201953
26,1,0,0,0,0,0,0,0,0,0,0,0,0,201953
26,2,0,0,0,0,0,0,0,0,0,0,0,0,201953
26,3,0,0,0,0,0,0,0,0,0,0,0,0,201953
26,4,0,0,0,0,0,0,0,0,0,0,0,0,201953
26,5,0,0,0,0,0,0,0,0,0,0,0,0,201953
26,6,0,0,0,0,0,0,0,0,0,0,0,0,201953
26,7,0,0,0,0,0,0,0,0,0,0,0,0,201953
27,1,0,0,0,0,0,0,0,0,0,0,0,0,201953
27,2,0,0,0,0,0,0,0,0,0,0,0,0,201953
27,3,0,0,0,0,0,0,0,0,0,0,0,0,201953
27,4,0,0,0,0,0,0,0,0,0,0,0,0,201953
27,5,0,0,0,0,0,0,0,0,0,0,0,0,201953
27,6,0,0,0,0,0,0,0,0,0,0,0,0,201953
28,1,0,0,0,0,0,0,0,0,0,0,0,0,201953
28,2,0,0,0,0,0,0,0,0,0,0,0,0,201953
28,3,0,0,0,0,0,0,0,0,0,0,0,0,201953
28,4,0,0,0,0,0,0,0,0,0,0,0,0,201953
28,5,0,0,0,0,0,0,0,0,0,0,0,0,201953
28,6,0,0,0,0,0,0,0,0,0,0,0,0,201953
28,7,0,0,0,0,0,0,0,0,0,0,0,0,201953
28,8,0,0,0,0,0,0,0,0,0,0,0,0,201953
28,9,0,0,0,0,0,0,0,0,0,0,0,0,201953
29,1,0,0,0,0,0,0,0,0,0,0,0,0,201953
29,2,0,0,0,0,0,0,0,0,0,0,0,0,201953
29,3,0,0,0,0,0,0,0,0,0,0,0,0,201953
30,1,0,0,0,0,0,0,0,0,0,0,0,0,201953
30,2,0,0,0,0,0,0,0,0,0,0,0,0,201953
30,3,0,0,0,0,0,0,0,0,0,0,0,0,201953
30,4,0,0,0,0,0,0,0,0,0,0,0,0,201953
30,5,0,0,0,0,0,0,0,0,0,0,0,0,201953
30,6,0,0,0,0,0,0,0,0,0,0,0,0,201953
30,7,0,0,0,0,0,0,0,0,0,0,0,0,201953
30,8,0,0,0,0,0,0,0,0,0,0,0,0,201953
30,9,0,0,0,0,0,0,0,0,0,0,0,0,201953
30,10,0,0,0,0,0,0,0,0,0,0,0,0,201953
30,11,0,0,0,0,0,0,0,0,0,0,0,0,201953
30,12,0,0,0,0,0,0,0,0,0,0,0,0,201953
30,13,0,0,0,0,0,0,0,0,0,0,0,0,201953
30,14,0,0,0,0,0,0,0,0,0,0,0,0,201953
30,15,0,0,0,0,0,0,0,0,0,0,0,0,201953
30,16,0,0,0,0,0,0,0,0,0,0,0,0,201953
30,17,0,0,0,0,0,0,0,0,0,0,0,0,201953
30,18,0,0,0,0,0,0,0,0,0,0,0,0,201953
30,19,0,0,0,0,0,0,0,0,0,0,0,0,201953
30,20,0,0,0,0,0,0,0,0,0,0,0,0,201953
31,1,0,0,0,0,0,0,0,0,0,0,0,0,201953
31,2,0,0,0,0,0,0,0,0,0,0,0,0,201953
31,3,0,0,0,0,0,0,0,0,0,0,0,0,201953
31,4,0,0,0,0,0,0,0,0,0,0,0,0,201953
31,5,0,0,0,0,0,0,0,0,0,0,0,0,201953
32,1,0,0,0,0,0,0,0,0,0,0,0,0,201953
32,2,0,0,0,0,0,0,0,0,0,0,0,0,201953
32,3,0,0,0,0,0,0,0,0,0,0,0,0,201953
32,4,0,0,0,0,0,0,0,0,0,0,0,0,201953
1,1,0,0,0,0,0,0,0,0,0,0,0,0,201954
1,2,0,0,0,0,0,0,0,0,0,0,0,0,201954
1,3,0,0,0,0,0,0,0,0,0,0,0,0,201954
2,1,0,0,0,0,0,0,0,0,0,0,0,0,201954
2,2,0,0,0,0,0,0,0,0,0,0,0,0,201954
2,3,0,0,0,0,0,0,0,0,0,0,0,0,201954
2,4,0,0,0,0,0,0,0,0,0,0,0,0,201954
2,5,0,0,0,0,0,0,0,0,0,0,0,0,201954
2,6,0,0,0,0,0,0,0,0,0,0,0,0,201954
2,7,0,0,0,0,0,0,0,0,0,0,0,0,201954
2,8,0,0,0,0,0,0,0,0,0,0,0,0,201954
3,1,0,0,0,0,0,0,0,0,0,0,0,0,201954
3,2,0,0,0,0,0,0,0,0,0,0,0,0,201954
4,1,0,0,0,0,0,0,0,0,0,0,0,0,201954
4,2,0,0,0,0,0,0,0,0,0,0,0,0,201954
5,1,35,3,58,96,7,18,0,217,83,300,9,1,201954
5,2,19,7,49,59,4,7,0,145,61,206,10,1,201954
5,3,19,3,50,68,11,14,18,183,54,237,11,1,201954
5,4,43,13,113,142,6,19,26,362,63,425,11,1,201954
5,5,40,4,50,110,4,15,16,239,55,294,10,1,201954
5,6,32,0,59,71,3,9,28,202,32,234,10,1,201954
5,7,22,2,67,82,0,16,13,202,36,238,10,1,201954
6,1,0,0,0,0,0,0,0,0,0,0,0,0,201954
6,2,0,0,0,0,0,0,0,0,0,0,0,0,201954
7,1,0,0,0,0,0,0,0,0,0,0,0,0,201954
7,2,0,0,0,0,0,0,0,0,0,0,0,0,201954
7,3,0,0,0,0,0,0,0,0,0,0,0,0,201954
7,4,0,0,0,0,0,0,0,0,0,0,0,0,201954
7,5,0,0,0,0,0,0,0,0,0,0,0,0,201954
7,6,0,0,0,0,0,0,0,0,0,0,0,0,201954
7,7,0,0,0,0,0,0,0,0,0,0,0,0,201954
7,8,0,0,0,0,0,0,0,0,0,0,0,0,201954
7,9,0,0,0,0,0,0,0,0,0,0,0,0,201954
7,10,0,0,0,0,0,0,0,0,0,0,0,0,201954
7,11,0,0,0,0,0,0,0,0,0,0,0,0,201954
7,12,0,0,0,0,0,0,0,0,0,0,0,0,201954
7,13,0,0,0,0,0,0,0,0,0,0,0,0,201954
8,1,0,0,0,0,0,0,0,0,0,0,0,0,201954
8,2,0,0,0,0,0,0,0,0,0,0,0,0,201954
8,3,0,0,0,0,0,0,0,0,0,0,0,0,201954
8,4,0,0,0,0,0,0,0,0,0,0,0,0,201954
8,5,0,0,0,0,0,0,0,0,0,0,0,0,201954
8,6,0,0,0,0,0,0,0,0,0,0,0,0,201954
8,7,0,0,0,0,0,0,0,0,0,0,0,0,201954
8,8,0,0,0,0,0,0,0,0,0,0,0,0,201954
8,9,0,0,0,0,0,0,0,0,0,0,0,0,201954
9,1,0,0,0,0,0,0,0,0,0,0,0,0,201954
9,2,0,0,0,0,0,0,0,0,0,0,0,0,201954
9,3,0,0,0,0,0,0,0,0,0,0,0,0,201954
9,4,0,0,0,0,0,0,0,0,0,0,0,0,201954
9,5,0,0,0,0,0,0,0,0,0,0,0,0,201954
9,6,0,0,0,0,0,0,0,0,0,0,0,0,201954
9,7,0,0,0,0,0,0,0,0,0,0,0,0,201954
9,8,0,0,0,0,0,0,0,0,0,0,0,0,201954
9,9,0,0,0,0,0,0,0,0,0,0,0,0,201954
9,10,0,0,0,0,0,0,0,0,0,0,0,0,201954
9,11,0,0,0,0,0,0,0,0,0,0,0,0,201954
9,12,0,0,0,0,0,0,0,0,0,0,0,0,201954
9,13,0,0,0,0,0,0,0,0,0,0,0,0,201954
9,14,0,0,0,0,0,0,0,0,0,0,0,0,201954
9,15,0,0,0,0,0,0,0,0,0,0,0,0,201954
9,16,0,0,0,0,0,0,0,0,0,0,0,0,201954
9,17,0,0,0,0,0,0,0,0,0,0,0,0,201954
9,18,0,0,0,0,0,0,0,0,0,0,0,0,201954
9,19,0,0,0,0,0,0,0,0,0,0,0,0,201954
9,20,0,0,0,0,0,0,0,0,0,0,0,0,201954
9,21,0,0,0,0,0,0,0,0,0,0,0,0,201954
9,22,0,0,0,0,0,0,0,0,0,0,0,0,201954
9,23,0,0,0,0,0,0,0,0,0,0,0,0,201954
9,24,0,0,0,0,0,0,0,0,0,0,0,0,201954
10,1,0,0,0,0,0,0,0,0,0,0,0,0,201954
10,2,0,0,0,0,0,0,0,0,0,0,0,0,201954
10,3,0,0,0,0,0,0,0,0,0,0,0,0,201954
10,4,0,0,0,0,0,0,0,0,0,0,0,0,201954
11,1,0,0,0,0,0,0,0,0,0,0,0,0,201954
11,2,0,0,0,0,0,0,0,0,0,0,0,0,201954
11,3,0,0,0,0,0,0,0,0,0,0,0,0,201954
11,4,0,0,0,0,0,0,0,0,0,0,0,0,201954
11,5,0,0,0,0,0,0,0,0,0,0,0,0,201954
11,6,0,0,0,0,0,0,0,0,0,0,0,0,201954
11,7,0,0,0,0,0,0,0,0,0,0,0,0,201954
11,8,0,0,0,0,0,0,0,0,0,0,0,0,201954
11,9,0,0,0,0,0,0,0,0,0,0,0,0,201954
11,10,0,0,0,0,0,0,0,0,0,0,0,0,201954
11,11,0,0,0,0,0,0,0,0,0,0,0,0,201954
11,12,0,0,0,0,0,0,0,0,0,0,0,0,201954
11,13,0,0,0,0,0,0,0,0,0,0,0,0,201954
11,14,0,0,0,0,0,0,0,0,0,0,0,0,201954
11,15,0,0,0,0,0,0,0,0,0,0,0,0,201954
12,1,0,0,0,0,0,0,0,0,0,0,0,0,201954
12,2,0,0,0,0,0,0,0,0,0,0,0,0,201954
12,3,0,0,0,0,0,0,0,0,0,0,0,0,201954
12,4,0,0,0,0,0,0,0,0,0,0,0,0,201954
12,5,0,0,0,0,0,0,0,0,0,0,0,0,201954
12,6,0,0,0,0,0,0,0,0,0,0,0,0,201954
12,7,0,0,0,0,0,0,0,0,0,0,0,0,201954
12,8,0,0,0,0,0,0,0,0,0,0,0,0,201954
12,9,0,0,0,0,0,0,0,0,0,0,0,0,201954
13,1,18,1,19,32,11,2,0,83,24,107,9,1,201954
13,2,17,1,24,33,18,9,15,117,18,135,6,1,201954
13,3,21,7,34,43,14,6,2,127,19,146,12,1,201954
13,4,29,6,47,69,20,6,13,190,28,218,9,1,201954
13,5,29,0,63,56,18,16,19,201,88,289,9,1,201954
13,6,43,10,97,146,17,13,19,345,66,411,11,1,201954
13,7,19,5,48,61,9,4,0,146,23,169,8,1,201954
14,1,0,0,0,0,0,0,0,0,0,0,0,0,201954
14,2,0,0,0,0,0,0,0,0,0,0,0,0,201954
14,3,0,0,0,0,0,0,0,0,0,0,0,0,201954
14,4,0,0,0,0,0,0,0,0,0,0,0,0,201954
14,5,0,0,0,0,0,0,0,0,0,0,0,0,201954
14,6,0,0,0,0,0,0,0,0,0,0,0,0,201954
14,7,0,0,0,0,0,0,0,0,0,0,0,0,201954
14,8,0,0,0,0,0,0,0,0,0,0,0,0,201954
14,9,0,0,0,0,0,0,0,0,0,0,0,0,201954
14,10,0,0,0,0,0,0,0,0,0,0,0,0,201954
14,11,0,0,0,0,0,0,0,0,0,0,0,0,201954
14,12,0,0,0,0,0,0,0,0,0,0,0,0,201954
14,13,0,0,0,0,0,0,0,0,0,0,0,0,201954
14,14,0,0,0,0,0,0,0,0,0,0,0,0,201954
14,15,0,0,0,0,0,0,0,0,0,0,0,0,201954
14,16,0,0,0,0,0,0,0,0,0,0,0,0,201954
14,17,0,0,0,0,0,0,0,0,0,0,0,0,201954
14,18,0,0,0,0,0,0,0,0,0,0,0,0,201954
14,19,0,0,0,0,0,0,0,0,0,0,0,0,201954
14,20,0,0,0,0,0,0,0,0,0,0,0,0,201954
15,1,0,0,0,0,0,0,0,0,0,0,0,0,201954
15,2,0,0,0,0,0,0,0,0,0,0,0,0,201954
15,3,0,0,0,0,0,0,0,0,0,0,0,0,201954
15,4,0,0,0,0,0,0,0,0,0,0,0,0,201954
15,5,0,0,0,0,0,0,0,0,0,0,0,0,201954
15,6,0,0,0,0,0,0,0,0,0,0,0,0,201954
15,7,0,0,0,0,0,0,0,0,0,0,0,0,201954
15,8,0,0,0,0,0,0,0,0,0,0,0,0,201954
15,9,0,0,0,0,0,0,0,0,0,0,0,0,201954
15,10,0,0,0,0,0,0,0,0,0,0,0,0,201954
15,11,0,0,0,0,0,0,0,0,0,0,0,0,201954
15,12,0,0,0,0,0,0,0,0,0,0,0,0,201954
15,13,0,0,0,0,0,0,0,0,0,0,0,0,201954
15,14,0,0,0,0,0,0,0,0,0,0,0,0,201954
15,15,0,0,0,0,0,0,0,0,0,0,0,0,201954
15,16,0,0,0,0,0,0,0,0,0,0,0,0,201954
15,17,0,0,0,0,0,0,0,0,0,0,0,0,201954
15,18,0,0,0,0,0,0,0,0,0,0,0,0,201954
15,19,0,0,0,0,0,0,0,0,0,0,0,0,201954
15,20,0,0,0,0,0,0,0,0,0,0,0,0,201954
15,21,0,0,0,0,0,0,0,0,0,0,0,0,201954
15,22,0,0,0,0,0,0,0,0,0,0,0,0,201954
15,23,0,0,0,0,0,0,0,0,0,0,0,0,201954
15,24,0,0,0,0,0,0,0,0,0,0,0,0,201954
15,25,0,0,0,0,0,0,0,0,0,0,0,0,201954
15,26,0,0,0,0,0,0,0,0,0,0,0,0,201954
15,27,0,0,0,0,0,0,0,0,0,0,0,0,201954
15,28,0,0,0,0,0,0,0,0,0,0,0,0,201954
15,29,0,0,0,0,0,0,0,0,0,0,0,0,201954
15,30,0,0,0,0,0,0,0,0,0,0,0,0,201954
15,31,0,0,0,0,0,0,0,0,0,0,0,0,201954
15,32,0,0,0,0,0,0,0,0,0,0,0,0,201954
15,33,0,0,0,0,0,0,0,0,0,0,0,0,201954
15,34,0,0,0,0,0,0,0,0,0,0,0,0,201954
15,35,0,0,0,0,0,0,0,0,0,0,0,0,201954
15,36,0,0,0,0,0,0,0,0,0,0,0,0,201954
15,37,0,0,0,0,0,0,0,0,0,0,0,0,201954
15,38,0,0,0,0,0,0,0,0,0,0,0,0,201954
15,39,0,0,0,0,0,0,0,0,0,0,0,0,201954
15,40,0,0,0,0,0,0,0,0,0,0,0,0,201954
15,41,0,0,0,0,0,0,0,0,0,0,0,0,201954
16,1,0,0,0,0,0,0,0,0,0,0,0,0,201954
16,2,0,0,0,0,0,0,0,0,0,0,0,0,201954
16,3,0,0,0,0,0,0,0,0,0,0,0,0,201954
16,4,0,0,0,0,0,0,0,0,0,0,0,0,201954
16,5,0,0,0,0,0,0,0,0,0,0,0,0,201954
16,6,0,0,0,0,0,0,0,0,0,0,0,0,201954
16,7,0,0,0,0,0,0,0,0,0,0,0,0,201954
16,8,0,0,0,0,0,0,0,0,0,0,0,0,201954
16,9,0,0,0,0,0,0,0,0,0,0,0,0,201954
16,10,0,0,0,0,0,0,0,0,0,0,0,0,201954
16,11,0,0,0,0,0,0,0,0,0,0,0,0,201954
16,12,0,0,0,0,0,0,0,0,0,0,0,0,201954
17,1,0,0,0,0,0,0,0,0,0,0,0,0,201954
17,2,0,0,0,0,0,0,0,0,0,0,0,0,201954
17,3,0,0,0,0,0,0,0,0,0,0,0,0,201954
17,4,0,0,0,0,0,0,0,0,0,0,0,0,201954
17,5,0,0,0,0,0,0,0,0,0,0,0,0,201954
18,1,0,0,0,0,0,0,0,0,0,0,0,0,201954
18,2,0,0,0,0,0,0,0,0,0,0,0,0,201954
18,3,0,0,0,0,0,0,0,0,0,0,0,0,201954
19,1,0,0,0,0,0,0,0,0,0,0,0,0,201954
19,2,0,0,0,0,0,0,0,0,0,0,0,0,201954
19,3,0,0,0,0,0,0,0,0,0,0,0,0,201954
19,4,0,0,0,0,0,0,0,0,0,0,0,0,201954
19,5,0,0,0,0,0,0,0,0,0,0,0,0,201954
19,6,0,0,0,0,0,0,0,0,0,0,0,0,201954
19,7,0,0,0,0,0,0,0,0,0,0,0,0,201954
19,8,0,0,0,0,0,0,0,0,0,0,0,0,201954
19,9,0,0,0,0,0,0,0,0,0,0,0,0,201954
19,10,0,0,0,0,0,0,0,0,0,0,0,0,201954
19,11,0,0,0,0,0,0,0,0,0,0,0,0,201954
19,12,0,0,0,0,0,0,0,0,0,0,0,0,201954
20,1,0,0,0,0,0,0,0,0,0,0,0,0,201954
20,2,0,0,0,0,0,0,0,0,0,0,0,0,201954
20,3,0,0,0,0,0,0,0,0,0,0,0,0,201954
20,4,0,0,0,0,0,0,0,0,0,0,0,0,201954
20,5,0,0,0,0,0,0,0,0,0,0,0,0,201954
20,6,0,0,0,0,0,0,0,0,0,0,0,0,201954
20,7,0,0,0,0,0,0,0,0,0,0,0,0,201954
20,8,0,0,0,0,0,0,0,0,0,0,0,0,201954
20,9,0,0,0,0,0,0,0,0,0,0,0,0,201954
20,10,0,0,0,0,0,0,0,0,0,0,0,0,201954
21,1,0,0,0,0,0,0,0,0,0,0,0,0,201954
21,2,0,0,0,0,0,0,0,0,0,0,0,0,201954
21,3,0,0,0,0,0,0,0,0,0,0,0,0,201954
21,4,0,0,0,0,0,0,0,0,0,0,0,0,201954
21,5,0,0,0,0,0,0,0,0,0,0,0,0,201954
21,6,0,0,0,0,0,0,0,0,0,0,0,0,201954
21,7,0,0,0,0,0,0,0,0,0,0,0,0,201954
21,8,0,0,0,0,0,0,0,0,0,0,0,0,201954
21,9,0,0,0,0,0,0,0,0,0,0,0,0,201954
21,10,0,0,0,0,0,0,0,0,0,0,0,0,201954
21,11,0,0,0,0,0,0,0,0,0,0,0,0,201954
21,12,0,0,0,0,0,0,0,0,0,0,0,0,201954
21,13,0,0,0,0,0,0,0,0,0,0,0,0,201954
21,14,0,0,0,0,0,0,0,0,0,0,0,0,201954
21,15,0,0,0,0,0,0,0,0,0,0,0,0,201954
22,1,0,0,0,0,0,0,0,0,0,0,0,0,201954
22,2,0,0,0,0,0,0,0,0,0,0,0,0,201954
22,3,0,0,0,0,0,0,0,0,0,0,0,0,201954
22,4,0,0,0,0,0,0,0,0,0,0,0,0,201954
22,5,0,0,0,0,0,0,0,0,0,0,0,0,201954
23,1,0,0,0,0,0,0,0,0,0,0,0,0,201954
23,2,0,0,0,0,0,0,0,0,0,0,0,0,201954
23,3,0,0,0,0,0,0,0,0,0,0,0,0,201954
23,4,0,0,0,0,0,0,0,0,0,0,0,0,201954
24,1,0,0,0,0,0,0,0,0,0,0,0,0,201954
24,2,0,0,0,0,0,0,0,0,0,0,0,0,201954
24,3,0,0,0,0,0,0,0,0,0,0,0,0,201954
24,4,0,0,0,0,0,0,0,0,0,0,0,0,201954
24,5,0,0,0,0,0,0,0,0,0,0,0,0,201954
24,6,0,0,0,0,0,0,0,0,0,0,0,0,201954
24,7,0,0,0,0,0,0,0,0,0,0,0,0,201954
25,1,0,0,0,0,0,0,0,0,0,0,0,0,201954
25,2,0,0,0,0,0,0,0,0,0,0,0,0,201954
25,3,0,0,0,0,0,0,0,0,0,0,0,0,201954
25,4,0,0,0,0,0,0,0,0,0,0,0,0,201954
25,5,0,0,0,0,0,0,0,0,0,0,0,0,201954
25,6,0,0,0,0,0,0,0,0,0,0,0,0,201954
25,7,0,0,0,0,0,0,0,0,0,0,0,0,201954
26,1,0,0,0,0,0,0,0,0,0,0,0,0,201954
26,2,0,0,0,0,0,0,0,0,0,0,0,0,201954
26,3,0,0,0,0,0,0,0,0,0,0,0,0,201954
26,4,0,0,0,0,0,0,0,0,0,0,0,0,201954
26,5,0,0,0,0,0,0,0,0,0,0,0,0,201954
26,6,0,0,0,0,0,0,0,0,0,0,0,0,201954
26,7,0,0,0,0,0,0,0,0,0,0,0,0,201954
27,1,0,0,0,0,0,0,0,0,0,0,0,0,201954
27,2,0,0,0,0,0,0,0,0,0,0,0,0,201954
27,3,0,0,0,0,0,0,0,0,0,0,0,0,201954
27,4,0,0,0,0,0,0,0,0,0,0,0,0,201954
27,5,0,0,0,0,0,0,0,0,0,0,0,0,201954
27,6,0,0,0,0,0,0,0,0,0,0,0,0,201954
28,1,0,0,0,0,0,0,0,0,0,0,0,0,201954
28,2,0,0,0,0,0,0,0,0,0,0,0,0,201954
28,3,0,0,0,0,0,0,0,0,0,0,0,0,201954
28,4,0,0,0,0,0,0,0,0,0,0,0,0,201954
28,5,0,0,0,0,0,0,0,0,0,0,0,0,201954
28,6,0,0,0,0,0,0,0,0,0,0,0,0,201954
28,7,0,0,0,0,0,0,0,0,0,0,0,0,201954
28,8,0,0,0,0,0,0,0,0,0,0,0,0,201954
28,9,0,0,0,0,0,0,0,0,0,0,0,0,201954
29,1,0,0,0,0,0,0,0,0,0,0,0,0,201954
29,2,0,0,0,0,0,0,0,0,0,0,0,0,201954
29,3,0,0,0,0,0,0,0,0,0,0,0,0,201954
30,1,0,0,0,0,0,0,0,0,0,0,0,0,201954
30,2,0,0,0,0,0,0,0,0,0,0,0,0,201954
30,3,0,0,0,0,0,0,0,0,0,0,0,0,201954
30,4,0,0,0,0,0,0,0,0,0,0,0,0,201954
30,5,0,0,0,0,0,0,0,0,0,0,0,0,201954
30,6,0,0,0,0,0,0,0,0,0,0,0,0,201954
30,7,0,0,0,0,0,0,0,0,0,0,0,0,201954
30,8,0,0,0,0,0,0,0,0,0,0,0,0,201954
30,9,0,0,0,0,0,0,0,0,0,0,0,0,201954
30,10,0,0,0,0,0,0,0,0,0,0,0,0,201954
30,11,0,0,0,0,0,0,0,0,0,0,0,0,201954
30,12,0,0,0,0,0,0,0,0,0,0,0,0,201954
30,13,0,0,0,0,0,0,0,0,0,0,0,0,201954
30,14,0,0,0,0,0,0,0,0,0,0,0,0,201954
30,15,0,0,0,0,0,0,0,0,0,0,0,0,201954
30,16,0,0,0,0,0,0,0,0,0,0,0,0,201954
30,17,0,0,0,0,0,0,0,0,0,0,0,0,201954
30,18,0,0,0,0,0,0,0,0,0,0,0,0,201954
30,19,0,0,0,0,0,0,0,0,0,0,0,0,201954
30,20,0,0,0,0,0,0,0,0,0,0,0,0,201954
31,1,0,0,0,0,0,0,0,0,0,0,0,0,201954
31,2,0,0,0,0,0,0,0,0,0,0,0,0,201954
31,3,0,0,0,0,0,0,0,0,0,0,0,0,201954
31,4,0,0,0,0,0,0,0,0,0,0,0,0,201954
31,5,0,0,0,0,0,0,0,0,0,0,0,0,201954
32,1,0,0,0,0,0,0,0,0,0,0,0,0,201954
32,2,0,0,0,0,0,0,0,0,0,0,0,0,201954
32,3,0,0,0,0,0,0,0,0,0,0,0,0,201954
32,4,0,0,0,0,0,0,0,0,0,0,0,0,201954
1,1,116,16,153,177,39,76,11,588,353,941,13,2.5,202001
1,2,159,30,335,374,46,192,9,1145,410,1555,10,3.333333333,202001
1,3,134,42,299,268,50,222,34,1049,391,1440,9,3,202001
2,1,97,9,201,184,38,260,23,812,274,1086,11,3,202001
2,2,79,4,129,205,8,287,0,712,354,1066,7,3,202001
2,3,97,2,163,188,6,228,29,713,273,986,11,2.666666667,202001
2,4,78,7,368,119,73,96,21,762,123,885,9,3,202001
2,5,104,5,345,188,98,274,4,1018,268,1286,11,3,202001
2,6,82,6,170,136,23,204,0,621,229,850,7,3,202001
2,7,101,6,253,216,28,76,34,714,272,986,12,2.75,202001
2,8,77,6,168,154,22,107,51,585,292,877,7,4,202001
3,1,81,7,135,127,23,89,0,462,217,679,10,2.333333333,202001
3,2,40,4,198,128,14,77,0,461,144,605,9,2.666666667,202001
4,1,102,18,150,290,85,121,12,778,258,1036,11,2.25,202001
4,2,75,7,130,196,22,97,18,545,196,741,14,2.2,202001
5,1,104,7,226,277,37,71,34,756,192,948,9,2.666666667,202001
5,2,65,15,121,213,10,19,4,447,207,654,10,3,202001
5,3,43,12,142,182,40,53,35,507,172,679,11,2.333333333,202001
5,4,97,13,287,401,13,54,57,922,281,1203,11,3.25,202001
5,5,68,9,144,243,10,51,116,641,237,878,10,3,202001
5,6,69,8,147,196,18,31,77,546,199,745,10,4,202001
5,7,66,9,164,271,2,36,11,559,160,719,10,3,202001
6,1,179,3,150,184,9,195,30,750,261,1011,11,2.8,202001
6,2,87,9,180,115,33,103,14,541,239,780,9,2.666666667,202001
7,1,61,2,64,85,10,8,0,230,124,354,9,2.25,202001
7,2,43,2,22,236,2,10,0,315,53,368,9,2.25,202001
7,3,104,3,104,126,146,32,0,515,46,561,7,2.333333333,202001
7,4,78,1,50,81,1,14,8,233,36,269,11,2.4,202001
7,5,113,6,90,216,14,88,0,527,73,600,11,2.666666667,202001
7,6,82,2,153,157,17,113,6,530,108,638,8,2.333333333,202001
7,7,89,6,100,128,29,66,4,422,101,523,8,2.5,202001
7,8,98,2,66,154,19,92,6,437,324,761,12,2.25,202001
7,9,77,11,138,262,40,118,8,654,115,769,9,2.666666667,202001
7,10,67,4,96,295,7,66,0,535,56,591,9,2.5,202001
7,11,42,2,54,39,23,20,0,180,9,189,6,2.333333333,202001
7,12,88,4,185,320,11,36,0,644,61,705,9,2.5,202001
7,13,23,2,28,145,0,4,0,202,17,219,9,2.25,202001
8,1,73,5,194,97,21,98,5,493,119,612,4,3,202001
8,2,154,56,357,291,24,95,8,985,146,1131,16,2.5,202001
8,3,92,11,162,181,19,77,67,609,128,737,4,3,202001
8,4,89,15,229,161,22,187,45,748,87,835,11,3,202001
8,5,100,27,113,201,26,40,0,507,171,678,10,2.25,202001
8,6,101,21,169,192,23,167,16,689,132,821,9,4,202001
8,7,95,29,169,120,13,108,0,534,152,686,7,2.25,202001
8,8,125,23,242,367,5,356,1,1119,236,1355,10,3,202001
8,9,53,9,75,52,43,60,47,339,108,447,10,2,202001
9,1,34,1,65,85,27,89,2,303,79,382,5,3,202001
9,2,150,64,262,356,109,420,35,1396,509,1905,12,3,202001
9,3,45,4,112,169,67,161,22,580,208,788,7,3,202001
9,4,98,12,209,343,109,217,3,991,174,1165,11,3,202001
9,5,96,6,114,157,26,257,1,657,176,833,7,3,202001
9,6,52,8,79,118,91,146,31,525,142,667,7,3,202001
9,7,42,3,222,137,5,75,16,500,112,612,9,3,202001
9,8,36,8,130,187,25,164,20,570,170,740,5,3,202001
9,9,30,4,50,108,32,89,1,314,64,378,5,3,202001
9,10,47,17,229,193,37,160,21,704,316,1020,6,3,202001
9,11,37,7,152,255,86,160,14,711,253,964,7,3,202001
9,12,100,15,256,331,26,306,33,1067,342,1409,11,3,202001
9,13,58,5,157,145,67,166,7,605,168,773,4,3,202001
9,14,41,1,132,116,30,133,13,466,56,522,5,3,202001
9,15,128,9,442,458,38,326,34,1435,547,1982,9,3,202001
9,16,114,149,188,441,68,138,9,1107,379,1486,15,3,202001
9,17,44,7,111,167,17,84,2,432,58,490,6,3,202001
9,18,72,7,121,218,93,249,33,793,260,1053,12,3,202001
9,19,73,13,112,160,89,184,38,669,349,1018,5,3,202001
9,20,32,4,44,75,29,29,6,219,33,252,5,3,202001
9,21,55,5,86,148,50,131,28,503,110,613,3,3,202001
9,22,86,5,88,137,78,155,15,564,151,715,5,3,202001
9,23,56,8,248,178,81,108,7,686,274,960,6,3,202001
9,24,107,12,249,308,204,295,23,1198,311,1509,14,3,202001
10,1,80,8,105,162,19,64,79,517,375,892,10,1.833333333,202001
10,2,89,10,210,277,27,99,15,727,131,858,9,2.25,202001
10,3,83,22,76,97,23,105,39,445,130,575,11,2.4,202001
10,4,135,8,256,436,10,153,9,1007,250,1257,11,3,202001
11,1,66,30,86,112,30,102,8,434,184,618,6,2.666666667,202001
11,2,75,14,129,87,68,136,11,520,119,639,7,3,202001
11,3,45,17,83,136,14,128,2,425,133,558,3,3,202001
11,4,71,20,63,117,21,96,0,388,95,483,7,2.666666667,202001
11,5,120,40,231,417,27,151,44,1030,242,1272,7,3,202001
11,6,83,30,194,193,25,126,9,660,94,754,8,3,202001
11,7,102,45,250,335,19,110,2,863,158,1021,9,2.5,202001
11,8,81,33,109,274,83,92,16,688,169,857,9,2.75,202001
11,9,76,44,166,301,9,99,20,715,162,877,10,2.666666667,202001
11,10,134,27,109,145,20,204,24,663,229,892,10,2.6,202001
11,11,103,22,159,248,10,126,0,668,288,956,5,3,202001
11,12,102,50,280,374,14,215,10,1045,217,1262,7,3,202001
11,13,64,25,127,108,34,63,10,431,84,515,8,2.5,202001
11,14,86,26,156,114,47,76,3,508,188,696,8,2.5,202001
11,15,81,21,131,187,14,99,11,544,154,698,9,3,202001
12,1,50,9,66,51,21,87,2,286,167,453,10,2.2,202001
12,2,79,11,98,235,24,196,11,654,185,839,10,2.5,202001
12,3,42,5,79,115,4,32,0,277,89,366,11,2.2,202001
12,4,100,8,163,253,36,97,4,661,104,765,9,2.666666667,202001
12,5,72,9,75,125,2,40,37,360,108,468,10,2.25,202001
12,6,47,8,70,104,3,14,4,250,38,288,10,2.25,202001
12,7,65,7,81,190,7,134,58,542,80,622,6,2.5,202001
12,8,83,11,92,123,1,22,0,332,53,385,9,2.25,202001
12,9,52,6,151,221,39,45,2,516,57,573,9,2.666666667,202001
13,1,57,3,71,110,27,18,14,300,64,364,9,2.333333333,202001
13,2,66,6,61,82,55,25,33,328,59,387,6,2.333333333,202001
13,3,49,9,54,80,61,15,9,277,62,339,12,2.25,202001
13,4,73,5,147,182,53,16,15,491,84,575,9,2.666666667,202001
13,5,73,9,171,145,57,68,52,575,109,684,9,2.75,202001
13,6,105,37,249,379,56,87,14,927,165,1092,11,2.666666667,202001
13,7,82,8,134,216,35,19,0,494,59,553,8,2.5,202001
14,1,54,12,64,36,33,54,5,258,57,315,6,2.5,202001
14,2,75,10,69,70,37,102,1,364,71,435,5,2.666666667,202001
14,3,100,6,165,66,14,103,0,454,180,634,8,2.4,202001
14,4,85,15,227,235,18,236,12,828,96,924,10,3,202001
14,5,62,8,185,101,5,80,6,447,63,510,9,2.5,202001
14,6,107,12,423,176,10,99,4,831,120,951,11,3,202001
14,7,36,5,157,95,0,33,0,326,56,382,6,3,202001
14,8,168,14,480,464,26,301,6,1459,274,1733,10,3,202001
14,9,80,11,197,243,24,139,5,699,110,809,11,3,202001
14,10,70,44,255,123,0,140,8,640,109,749,7,3,202001
14,11,53,7,73,88,27,167,17,432,96,528,4,3,202001
14,12,70,6,264,82,10,42,0,474,75,549,9,2.5,202001
14,13,71,10,263,119,7,119,5,594,97,691,6,3,202001
14,14,63,7,170,171,28,216,7,662,135,797,7,3,202001
14,15,96,11,119,55,64,156,2,503,113,616,10,2.6,202001
14,16,66,19,174,108,30,110,3,510,137,647,5,3,202001
14,17,50,3,85,34,10,86,4,272,118,390,7,2.25,202001
14,18,133,16,164,66,45,94,20,538,149,687,9,2.4,202001
14,19,93,11,138,83,8,93,18,444,191,635,8,2.25,202001
14,20,87,6,237,156,3,52,1,542,139,681,10,2.666666667,202001
15,1,61,4,47,43,141,106,0,402,67,469,7,2.333333333,202001
15,2,79,7,117,157,147,94,3,604,91,695,6,3,202001
15,3,77,11,100,130,145,137,20,620,156,776,10,2.666666667,202001
15,4,50,8,125,175,39,96,17,510,115,625,4,3,202001
15,5,90,15,156,173,19,56,7,516,369,885,8,2.666666667,202001
15,6,79,2,130,257,34,152,23,677,189,866,7,3,202001
15,7,72,3,173,118,25,134,0,525,134,659,10,3,202001
15,8,61,11,98,163,16,69,20,438,81,519,4,3,202001
15,9,84,4,46,61,65,124,2,386,156,542,9,2.5,202001
15,10,65,2,91,202,22,132,13,527,147,674,6,3,202001
15,11,80,27,178,303,34,116,26,764,218,982,8,3,202001
15,12,113,12,206,276,70,113,0,790,215,1005,8,3,202001
15,13,43,12,83,115,70,85,0,408,118,526,8,3,202001
15,14,46,15,71,131,33,89,3,388,90,478,4,3,202001
15,15,66,89,150,234,53,71,5,668,162,830,6,3,202001
15,16,148,22,184,391,22,229,5,1001,208,1209,8,3,202001
15,17,64,9,94,169,12,149,34,531,186,717,8,3,202001
15,18,89,11,150,218,19,116,23,626,187,813,7,2.666666667,202001
15,19,104,27,226,410,20,275,31,1093,299,1392,10,3,202001
15,20,32,11,124,127,24,74,4,396,83,479,6,3,202001
15,21,40,2,38,85,13,77,12,267,43,310,6,2.5,202001
15,22,157,80,294,470,23,191,64,1279,382,1661,14,3,202001
15,23,70,4,105,194,19,103,0,495,78,573,6,2.333333333,202001
15,24,59,15,107,156,31,80,28,476,127,603,4,3,202001
15,25,94,21,119,178,40,72,10,534,132,666,6,3,202001
15,26,55,3,66,101,66,55,1,347,88,435,9,4,202001
15,27,86,11,200,199,15,135,37,683,134,817,9,2.666666667,202001
15,28,97,26,256,195,19,49,10,652,144,796,9,2.666666667,202001
15,29,110,7,213,408,8,217,36,999,407,1406,8,3,202001
15,30,151,28,238,309,63,141,46,976,167,1143,16,3,202001
15,31,65,198,76,161,5,7,0,512,124,636,6,3,202001
15,32,99,8,111,225,42,126,9,620,96,716,9,3,202001
15,33,96,15,172,235,24,85,0,627,124,751,7,3,202001
15,34,96,10,101,319,16,44,12,598,105,703,8,3,202001
15,35,76,9,143,258,6,98,14,604,134,738,9,2.666666667,202001
15,36,81,3,98,150,24,102,0,458,88,546,9,2.5,202001
15,37,97,14,114,229,60,180,9,703,193,896,7,3,202001
15,38,84,27,122,205,35,97,15,585,86,671,6,2.5,202001
15,39,91,10,118,191,31,136,1,578,109,687,4,3,202001
15,40,122,32,124,259,117,120,1,775,156,931,9,3,202001
15,41,151,34,305,388,60,158,22,1118,230,1348,13,3,202001
16,1,53,6,100,74,7,36,0,276,66,342,7,2.333333333,202001
16,2,72,14,66,84,9,60,0,305,84,389,9,2.25,202001
16,3,91,9,51,165,24,58,0,398,106,504,10,2.25,202001
16,4,95,24,149,66,27,66,0,427,132,559,8,2.5,202001
16,5,103,13,82,71,32,114,26,441,127,568,10,2.666666667,202001
16,6,99,27,98,106,29,76,0,435,100,535,12,2.5,202001
16,7,133,24,154,149,20,55,3,538,186,724,9,2.5,202001
16,8,114,17,317,317,5,115,11,896,175,1071,12,3,202001
16,9,95,7,167,251,13,107,6,646,59,705,9,3,202001
16,10,71,17,216,212,13,113,1,643,121,764,6,3,202001
16,11,76,17,81,103,45,107,2,431,149,580,10,2.4,202001
16,12,71,14,91,85,22,88,1,372,165,537,10,2.25,202001
17,1,77,17,208,274,37,125,9,747,249,996,8,3,202001
17,2,76,7,143,269,10,145,14,664,173,837,8,2.666666667,202001
17,3,126,11,198,267,24,175,4,805,290,1095,8,2.5,202001
17,4,86,6,163,278,31,76,5,645,208,853,10,2.666666667,202001
17,5,39,5,54,72,23,61,1,255,52,307,5,2.5,202001
18,1,52,7,44,55,7,51,9,225,108,333,7,2.25,202001
18,2,128,25,260,291,44,178,0,926,277,1203,8,3,202001
18,3,93,9,161,126,7,42,3,441,144,585,8,2.5,202001
19,1,74,9,181,197,23,138,42,664,124,788,9,3,202001
19,2,117,12,356,315,11,105,0,916,325,1241,9,3,202001
19,3,97,11,308,274,29,112,2,833,144,977,7,3,202001
19,4,65,3,67,66,34,158,26,419,111,530,5,3,202001
19,5,99,9,216,342,11,277,33,987,214,1201,8,3,202001
19,6,36,2,111,131,2,126,4,412,67,479,5,3,202001
19,7,76,7,252,106,3,43,0,487,169,656,10,2.5,202001
19,8,25,12,109,124,1,23,1,295,35,330,7,3,202001
19,9,48,2,51,42,13,86,0,242,101,343,9,2.25,202001
19,10,42,3,120,105,9,151,6,436,142,578,5,3,202001
19,11,127,12,244,471,15,363,67,1299,272,1571,13,3,202001
19,12,90,3,265,119,10,95,18,600,105,705,13,2.666666667,202001
20,1,82,3,87,140,35,45,14,406,72,478,7,2.5,202001
20,2,42,10,100,90,26,25,3,296,69,365,6,2.333333333,202001
20,3,44,7,77,62,101,134,20,445,66,511,6,2.333333333,202001
20,4,69,2,67,74,25,81,15,333,55,388,6,2.333333333,202001
20,5,49,3,146,138,11,52,0,399,62,461,11,2.25,202001
20,6,81,4,58,111,54,42,42,392,76,468,8,2.25,202001
20,7,79,5,99,179,34,56,5,457,67,524,7,2.75,202001
20,8,179,10,472,312,28,358,16,1375,406,1781,13,3,202001
20,9,99,6,136,110,82,98,12,543,70,613,8,2.666666667,202001
20,10,89,7,143,72,2,53,5,371,45,416,9,2.25,202001
21,1,82,8,186,143,23,56,1,499,81,580,9,2.4,202001
21,2,63,24,115,74,50,32,0,358,72,430,9,2.2,202001
21,3,127,7,174,141,42,218,17,726,151,877,8,2.5,202001
21,4,65,4,67,30,37,49,12,264,91,355,6,2.25,202001
21,5,105,11,350,181,22,97,7,773,150,923,8,2.666666667,202001
21,6,93,8,148,153,76,207,17,702,223,925,6,3,202001
21,7,190,5,111,179,49,113,0,647,142,789,9,2.666666667,202001
21,8,80,3,111,88,36,98,15,431,186,617,9,2.2,202001
21,9,124,25,320,266,90,178,37,1040,228,1268,9,3,202001
21,10,101,13,300,179,29,160,40,822,196,1018,7,2.5,202001
21,11,52,4,156,74,42,62,10,400,66,466,4,3,202001
21,12,157,26,569,395,136,294,183,1760,413,2173,15,3,202001
21,13,74,4,230,117,22,150,7,604,108,712,8,2.666666667,202001
21,14,53,11,91,56,54,70,6,341,83,424,12,2.333333333,202001
21,15,116,6,165,231,27,228,26,799,167,966,7,2.5,202001
22,1,95,20,117,260,22,45,21,580,132,712,11,2.2,202001
22,2,58,15,111,138,73,37,2,434,73,507,7,2.5,202001
22,3,170,46,494,499,22,183,6,1420,322,1742,9,2.666666667,202001
22,4,125,30,456,373,19,236,3,1242,246,1488,8,3,202001
22,5,94,20,244,198,57,118,14,745,180,925,10,2.5,202001
23,1,99,2,490,201,16,75,0,883,223,1106,14,2.6,202001
23,2,76,9,264,217,14,49,0,629,90,719,8,2.25,202001
23,3,108,4,467,330,33,66,22,1030,194,1224,19,0,202001
23,4,66,1,206,151,14,78,24,540,113,653,6,2.5,202001
24,1,54,49,52,118,5,33,0,311,145,456,10,2.2,202001
24,2,63,6,131,139,14,68,7,428,184,612,6,2.5,202001
24,3,91,27,82,119,50,44,2,415,146,561,9,2.25,202001
24,4,45,8,60,98,17,150,16,394,138,532,5,2.5,202001
24,5,102,35,406,480,15,107,1,1146,279,1425,9,3,202001
24,6,77,84,223,193,46,186,2,811,176,987,6,3,202001
24,7,74,3,88,147,52,16,2,382,69,451,9,2.25,202001
25,1,60,3,119,194,15,72,38,501,89,590,13,2.75,202001
25,2,89,37,214,362,5,80,0,787,140,927,7,2.5,202001
25,3,65,8,113,201,15,118,3,523,155,678,8,2.6,202001
25,4,59,22,95,144,47,44,2,413,110,523,8,2.333333333,202001
25,5,82,9,228,326,7,86,47,785,126,911,8,2.666666667,202001
25,6,85,6,130,184,31,138,35,609,80,689,8,2.75,202001
25,7,96,12,326,323,5,74,0,836,148,984,6,3,202001
26,1,83,3,135,170,1,101,0,493,154,647,9,2.5,202001
26,2,81,7,186,228,10,67,36,615,109,724,12,2.4,202001
26,3,116,12,198,288,24,215,29,882,158,1040,13,3,202001
26,4,30,14,93,94,18,30,2,281,55,336,9,2.2,202001
26,5,76,10,130,149,26,131,0,522,71,593,14,2.5,202001
26,6,85,4,86,153,17,125,0,470,91,561,10,2.333333333,202001
26,7,50,6,84,144,31,30,4,349,70,419,10,2.5,202001
27,1,49,4,82,124,59,56,8,382,47,429,8,2.5,202001
27,2,64,10,117,304,10,64,3,572,110,682,8,2.666666667,202001
27,3,64,5,81,293,11,112,0,566,145,711,7,2.666666667,202001
27,4,64,4,146,375,15,172,13,789,135,924,7,2.5,202001
27,5,39,1,49,129,13,41,0,272,71,343,6,2.333333333,202001
27,6,55,3,93,266,8,98,4,527,86,613,7,2.5,202001
28,1,70,12,235,214,7,62,0,600,132,732,13,3,202001
28,2,84,6,272,157,12,204,73,808,65,873,15,2.666666667,202001
28,3,47,1,100,102,4,54,17,325,46,371,7,2.333333333,202001
28,4,157,10,239,214,40,166,124,950,165,1115,17,3,202001
28,5,76,14,95,177,21,203,22,608,91,699,9,2.25,202001
28,6,74,10,75,183,24,52,3,421,109,530,13,2.166666667,202001
28,7,115,5,210,179,63,233,8,813,155,968,13,3,202001
28,8,86,5,154,170,34,98,45,592,81,673,12,3,202001
28,9,84,5,170,116,35,96,14,520,38,558,11,2.75,202001
29,1,115,11,136,226,19,143,3,653,184,837,7,2.5,202001
29,2,126,3,155,373,24,210,58,949,256,1205,10,2.666666667,202001
29,3,84,6,65,232,16,134,3,540,111,651,6,2.666666667,202001
30,1,31,1,53,59,13,43,1,201,60,261,7,2.333333333,202001
30,2,90,10,81,98,15,61,81,436,87,523,8,2.25,202001
30,3,68,5,99,83,53,128,23,459,47,506,6,2.666666667,202001
30,4,40,2,167,94,22,63,0,388,88,476,8,3,202001
30,5,47,6,156,150,37,48,3,447,112,559,7,2.5,202001
30,6,96,6,152,116,14,63,1,448,86,534,9,2.333333333,202001
30,7,59,5,121,111,107,60,70,533,23,556,11,2.25,202001
30,8,78,14,302,147,57,99,5,702,128,830,11,2.4,202001
30,9,82,2,84,99,44,149,12,472,96,568,8,2.5,202001
30,10,111,10,313,199,24,257,29,943,65,1008,6,3,202001
30,11,71,6,251,246,5,74,0,653,45,698,5,2.5,202001
30,12,87,7,343,215,12,180,0,844,150,994,10,3,202001
30,13,117,7,96,101,52,211,23,607,76,683,10,2.4,202001
30,14,35,5,120,86,101,87,2,436,36,472,8,2.5,202001
30,15,101,11,142,149,66,186,24,679,149,828,11,2.666666667,202001
30,16,94,6,199,356,51,155,94,955,110,1065,10,2.333333333,202001
30,17,65,9,159,153,25,112,25,548,137,685,8,2.5,202001
30,18,63,8,38,46,26,52,9,242,53,295,8,2.25,202001
30,19,68,4,138,123,12,127,7,479,78,557,13,2.6,202001
30,20,65,4,72,216,44,86,1,488,60,548,10,2.4,202001
31,1,84,6,178,30,149,43,0,490,233,723,8,2.5,202001
31,2,20,4,45,11,83,72,0,235,171,406,6,2.333333333,202001
31,3,168,70,598,511,71,145,0,1563,280,1843,20,3,202001
31,4,71,2,165,114,135,111,33,631,144,775,4,3,202001
31,5,48,5,87,120,57,65,1,383,61,444,6,2.333333333,202001
32,1,69,20,73,76,24,54,45,361,148,509,12,2.2,202001
32,2,145,11,51,56,51,119,10,443,256,699,13,2.142857143,202001
32,3,64,15,110,203,4,114,8,518,225,743,13,2.2,202001
32,4,52,12,71,141,5,99,12,392,106,498,12,2.2,202001
1,1,287,58,401,469,133,242,23,1613,1360,2973,13,5.5,202002
1,2,404,81,728,645,91,557,9,2515,2144,4659,10,6.333333333,202002
1,3,276,97,741,498,71,513,43,2239,2383,4622,9,6,202002
2,1,256,22,451,350,62,699,74,1914,933,2847,11,6,202002
2,2,191,4,341,411,13,573,0,1533,1976,3509,7,6,202002
2,3,231,1,416,396,28,626,39,1737,1794,3531,12,6,202002
2,4,242,11,759,277,110,211,31,1641,1480,3121,9,6,202002
2,5,258,14,680,308,203,650,12,2125,1409,3534,11,6,202002
2,6,198,8,359,304,51,422,1,1343,1397,2740,7,6,202002
2,7,259,24,493,419,71,163,70,1499,1384,2883,12,5.75,202002
2,8,193,11,396,363,32,236,80,1311,1711,3022,7,7,202002
3,1,217,14,368,380,59,268,9,1315,862,2177,12,5.666666667,202002
3,2,142,11,505,273,57,211,0,1199,935,2134,9,5.666666667,202002
4,1,271,28,422,562,157,396,31,1867,904,2771,11,5.25,202002
4,2,295,16,493,476,70,365,64,1779,1170,2949,14,5.2,202002
5,1,371,23,781,829,110,206,124,2444,1833,4277,9,7,202002
5,2,346,44,531,843,83,167,8,2022,1036,3058,10,7,202002
5,3,270,47,534,891,178,168,229,2317,1773,4090,11,7,202002
5,4,482,61,1063,1312,60,250,222,3450,1476,4926,11,7,202002
5,5,334,32,596,1100,59,110,359,2590,1255,3845,10,7,202002
5,6,301,38,571,648,46,103,272,1979,997,2976,10,7,202002
5,7,341,37,573,920,52,115,47,2085,908,2993,10,7,202002
6,1,322,13,421,342,9,622,40,1769,1536,3305,11,5.8,202002
6,2,181,19,375,233,53,311,25,1197,1397,2594,9,5.666666667,202002
7,1,295,6,203,436,7,48,0,995,649,1644,9,5.25,202002
7,2,186,16,127,1317,57,59,0,1762,741,2503,9,5.25,202002
7,3,321,2,246,265,262,125,1,1222,308,1530,7,5.333333333,202002
7,4,306,7,172,358,10,70,45,968,337,1305,11,5.4,202002
7,5,313,29,215,463,46,220,3,1289,1273,2562,11,5.666666667,202002
7,6,260,24,441,387,56,305,23,1496,1318,2814,9,5.666666667,202002
7,7,139,81,188,294,214,179,90,1185,1039,2224,8,5.25,202002
7,8,224,6,163,363,65,191,52,1064,1433,2497,12,5.25,202002
7,9,221,10,323,536,54,320,9,1473,1096,2569,9,5.666666667,202002
7,10,192,3,185,693,18,160,0,1251,1154,2405,9,5.5,202002
7,11,156,3,173,133,64,71,0,600,127,727,6,5.333333333,202002
7,12,305,13,529,856,33,110,2,1848,980,2828,9,5.5,202002
7,13,75,8,151,851,8,38,0,1131,162,1293,9,5.25,202002
8,1,184,9,370,166,29,219,13,990,1155,2145,4,6,202002
8,2,442,96,1040,753,49,247,20,2647,1410,4057,16,5.5,202002
8,3,209,22,383,382,45,129,183,1353,1854,3207,4,6,202002
8,4,249,32,586,537,57,425,89,1975,497,2472,11,6,202002
8,5,222,72,453,569,117,151,9,1593,1192,2785,10,5.25,202002
8,6,231,86,449,544,75,353,37,1775,1200,2975,10,8,202002
8,7,202,91,291,340,10,209,0,1143,718,1861,7,5.25,202002
8,8,322,34,493,720,16,798,7,2390,1607,3997,10,6,202002
8,9,186,34,244,156,59,231,102,1012,548,1560,10,4.8,202002
9,1,76,9,110,130,67,174,7,573,594,1167,5,6,202002
9,2,309,82,577,704,188,777,44,2681,3206,5887,12,6,202002
9,3,115,17,242,332,85,328,45,1164,1568,2732,7,6,202002
9,4,237,67,522,664,232,437,5,2164,2662,4826,11,6,202002
9,5,193,11,263,306,80,371,3,1227,1165,2392,7,6,202002
9,6,113,13,177,227,141,365,34,1070,816,1886,7,6,202002
9,7,104,13,562,332,7,203,20,1241,1263,2504,9,6,202002
9,8,95,11,267,278,37,312,16,1016,1507,2523,5,6,202002
9,9,150,9,247,270,89,351,4,1120,937,2057,5,6,202002
9,10,117,19,443,461,61,290,9,1400,1272,2672,6,6,202002
9,11,160,14,350,396,169,416,32,1537,1594,3131,7,6,202002
9,12,218,26,554,677,60,558,57,2150,1594,3744,11,6,202002
9,13,124,17,321,352,97,327,16,1254,1120,2374,4,6,202002
9,14,94,11,192,260,58,233,16,864,701,1565,5,6,202002
9,15,249,22,912,913,63,754,54,2967,2595,5562,10,6.5,202002
9,16,231,242,457,764,92,350,13,2149,1898,4047,15,6,202002
9,17,117,5,301,254,54,225,4,960,784,1744,6,6,202002
9,18,142,19,268,439,119,544,34,1565,1426,2991,12,6,202002
9,19,178,45,237,318,149,460,26,1413,1760,3173,5,6,202002
9,20,88,4,144,183,62,149,19,649,291,940,5,6,202002
9,21,142,9,192,303,85,269,40,1040,602,1642,3,6,202002
9,22,198,15,214,307,154,322,37,1247,950,2197,5,6,202002
9,23,151,12,507,444,156,304,4,1578,1446,3024,6,6,202002
9,24,242,50,491,644,372,586,33,2418,2379,4797,14,6,202002
10,1,332,46,407,379,77,436,144,1821,817,2638,12,4.833333333,202002
10,2,298,34,465,639,60,276,50,1822,1308,3130,9,5.25,202002
10,3,272,53,282,324,69,450,121,1571,862,2433,11,5.4,202002
10,4,346,37,647,937,35,519,27,2548,2133,4681,12,6.5,202002
11,1,238,105,255,369,81,272,25,1345,759,2104,6,5.666666667,202002
11,2,219,76,373,215,210,331,21,1445,781,2226,7,6,202002
11,3,141,35,225,229,31,265,2,928,994,1922,3,6,202002
11,4,174,92,211,257,70,307,1,1112,677,1789,8,6,202002
11,5,317,97,482,785,37,250,76,2044,1511,3555,7,6,202002
11,6,212,49,361,358,64,246,22,1312,792,2104,8,6,202002
11,7,270,81,459,825,38,302,2,1977,1150,3127,9,5.5,202002
11,8,259,79,330,581,176,344,17,1786,1303,3089,9,5.75,202002
11,9,252,74,309,542,18,370,24,1589,1316,2905,10,5.666666667,202002
11,10,326,48,281,313,52,548,47,1615,1066,2681,10,5.6,202002
11,11,215,55,357,502,21,251,0,1401,1866,3267,5,6,202002
11,12,292,97,545,643,28,450,10,2065,1155,3220,7,6,202002
11,13,229,65,260,299,56,312,28,1249,686,1935,8,5.5,202002
11,14,230,52,406,305,114,244,0,1351,1252,2603,8,5.5,202002
11,15,223,35,288,375,31,250,29,1231,1378,2609,9,6,202002
12,1,170,31,283,223,69,273,2,1051,471,1522,10,5.2,202002
12,2,227,34,235,489,16,533,21,1555,1243,2798,10,5.5,202002
12,3,215,26,305,456,22,173,0,1197,780,1977,11,5.2,202002
12,4,272,23,493,642,55,343,3,1831,1952,3783,9,5.666666667,202002
12,5,166,26,244,273,2,134,69,914,337,1251,10,5.25,202002
12,6,175,16,268,306,30,42,10,847,565,1412,10,5.25,202002
12,7,212,18,264,457,158,394,15,1518,834,2352,6,4.5,202002
12,8,221,12,187,390,3,140,1,954,597,1551,9,5.25,202002
12,9,228,45,472,640,55,168,15,1623,1089,2712,9,5.666666667,202002
13,1,312,31,246,484,164,72,73,1382,623,2005,9,5.333333333,202002
13,2,322,21,191,366,199,142,82,1323,778,2101,6,5.333333333,202002
13,3,288,78,383,408,288,106,38,1589,898,2487,12,5.25,202002
13,4,407,39,478,548,220,129,110,1931,973,2904,9,5.666666667,202002
13,5,394,27,660,490,237,199,171,2178,1154,3332,9,5.75,202002
13,6,436,76,783,1066,98,265,83,2807,1783,4590,11,5.666666667,202002
13,7,289,47,628,657,91,88,1,1801,1130,2931,8,5.5,202002
14,1,160,43,177,96,158,120,19,773,283,1056,6,5.5,202002
14,2,187,15,184,105,77,232,3,803,588,1391,5,5.666666667,202002
14,3,315,22,425,141,17,302,2,1224,712,1936,8,5.4,202002
14,4,256,24,455,420,36,516,6,1713,1180,2893,10,6,202002
14,5,237,32,566,280,47,346,10,1518,730,2248,9,5.5,202002
14,6,245,20,767,342,28,316,1,1719,1191,2910,11,6,202002
14,7,110,18,348,200,0,101,0,777,614,1391,6,6,202002
14,8,434,58,1265,852,68,698,2,3377,2462,5839,11,6.25,202002
14,9,188,19,369,420,44,350,28,1418,1017,2435,11,6,202002
14,10,193,121,558,276,0,231,24,1403,1060,2463,7,6,202002
14,11,114,9,120,158,38,337,32,808,1609,2417,4,6,202002
14,12,228,15,585,212,40,135,0,1215,1042,2257,9,5.5,202002
14,13,186,17,489,250,16,255,10,1223,1132,2355,6,6,202002
14,14,153,15,284,315,27,532,13,1339,1562,2901,7,6,202002
14,15,299,51,268,202,165,416,4,1405,749,2154,10,5.6,202002
14,16,158,39,389,225,86,240,8,1145,1037,2182,5,6,202002
14,17,170,26,259,109,61,214,5,844,464,1308,7,5.25,202002
14,18,306,39,472,153,161,247,59,1437,610,2047,9,5.4,202002
14,19,263,45,461,235,86,249,46,1385,789,2174,8,5.25,202002
14,20,249,28,583,352,10,145,0,1367,982,2349,10,5.666666667,202002
15,1,113,12,151,81,295,217,0,869,508,1377,7,5.333333333,202002
15,2,203,27,329,319,191,202,18,1289,1237,2526,6,6,202002
15,3,231,24,205,297,361,378,60,1556,1128,2684,10,5.666666667,202002
15,4,156,23,202,344,79,202,27,1033,1138,2171,4,6,202002
15,5,224,25,417,341,55,198,5,1265,848,2113,8,5.666666667,202002
15,6,228,19,331,518,38,303,61,1498,1343,2841,7,6,202002
15,7,211,11,377,233,71,338,0,1241,1153,2394,10,6,202002
15,8,142,12,239,359,22,247,25,1046,620,1666,4,6,202002
15,9,240,16,209,147,193,418,2,1225,719,1944,9,5.75,202002
15,10,174,8,221,439,38,322,11,1213,819,2032,6,6,202002
15,11,198,41,356,506,89,291,34,1515,1024,2539,8,6,202002
15,12,305,29,597,550,156,247,1,1885,1530,3415,8,6,202002
15,13,93,25,150,198,131,182,0,779,1395,2174,8,6,202002
15,14,76,38,168,280,51,186,15,814,591,1405,4,6,202002
15,15,137,205,250,453,92,132,11,1280,1774,3054,6,6,202002
15,16,309,37,477,774,55,503,16,2171,1424,3595,8,6,202002
15,17,176,11,211,330,35,385,38,1186,957,2143,8,6,202002
15,18,237,37,361,521,50,313,50,1569,1152,2721,7,5.666666667,202002
15,19,229,49,483,784,37,467,90,2139,1742,3881,10,6,202002
15,20,96,30,309,289,25,151,7,907,640,1547,6,6,202002
15,21,140,13,113,177,43,223,25,734,514,1248,6,5.5,202002
15,22,330,199,704,867,59,364,104,2627,2117,4744,14,6,202002
15,23,234,20,335,457,49,259,3,1357,630,1987,6,5.333333333,202002
15,24,137,52,264,409,62,192,41,1157,1034,2191,4,6,202002
15,25,183,44,258,302,54,230,18,1089,1630,2719,6,6,202002
15,26,112,7,181,278,148,225,0,951,800,1751,9,7,202002
15,27,259,19,499,544,35,365,101,1822,1360,3182,9,5.666666667,202002
15,28,267,38,563,443,68,165,29,1573,1274,2847,9,5.666666667,202002
15,29,261,38,495,738,12,553,51,2148,1814,3962,8,6,202002
15,30,355,39,471,605,105,324,79,1978,2302,4280,16,6,202002
15,31,157,439,121,328,14,19,0,1078,567,1645,6,6,202002
15,32,225,8,301,435,82,301,8,1360,914,2274,9,6,202002
15,33,250,30,466,483,65,181,0,1475,1015,2490,7,6,202002
15,34,198,16,262,629,40,127,25,1297,1042,2339,8,6,202002
15,35,280,19,308,685,9,251,30,1582,1030,2612,9,5.666666667,202002
15,36,263,20,300,463,98,387,14,1545,570,2115,9,5.5,202002
15,37,258,30,302,470,141,440,37,1678,916,2594,7,6,202002
15,38,261,84,342,352,88,252,24,1403,743,2146,6,5.5,202002
15,39,218,27,287,359,61,322,1,1275,853,2128,4,6,202002
15,40,300,102,335,467,263,354,1,1822,1650,3472,9,6,202002
15,41,401,54,686,745,126,424,43,2479,1821,4300,13,6,202002
16,1,140,38,337,167,17,115,3,817,496,1313,7,5.333333333,202002
16,2,157,64,120,169,29,223,10,772,414,1186,9,5.25,202002
16,3,258,36,207,362,132,249,7,1251,778,2029,10,5.25,202002
16,4,220,41,389,179,83,138,0,1050,807,1857,8,5.5,202002
16,5,191,20,202,250,67,285,20,1035,907,1942,10,5.666666667,202002
16,6,228,62,291,289,59,272,0,1201,496,1697,12,5.5,202002
16,7,256,49,332,327,57,196,11,1228,992,2220,9,5.5,202002
16,8,259,52,709,655,25,331,13,2044,1544,3588,12,6,202002
16,9,219,44,357,464,21,317,3,1425,776,2201,9,6,202002
16,10,229,37,519,497,31,252,0,1565,884,2449,6,6,202002
16,11,189,48,279,244,114,430,6,1310,852,2162,10,5.4,202002
16,12,213,31,286,205,18,346,4,1103,536,1639,10,5.25,202002
17,1,241,33,554,690,87,290,10,1905,1391,3296,9,7,202002
17,2,182,16,348,469,13,300,23,1351,1058,2409,8,5.666666667,202002
17,3,325,18,493,618,42,448,0,1944,1431,3375,8,5.5,202002
17,4,241,28,484,639,40,224,13,1669,1211,2880,10,5.666666667,202002
17,5,149,15,171,175,30,158,3,701,476,1177,5,5.5,202002
18,1,188,27,170,190,62,208,82,927,749,1676,7,5.25,202002
18,2,348,55,539,510,77,593,2,2124,1146,3270,8,6,202002
18,3,246,20,465,328,19,182,1,1261,965,2226,8,5.5,202002
19,1,254,20,410,437,27,440,66,1654,1080,2734,9,6,202002
19,2,275,20,822,577,36,243,0,1973,1849,3822,9,6,202002
19,3,311,28,714,461,77,260,9,1860,1630,3490,7,6,202002
19,4,126,5,179,151,71,326,90,948,721,1669,5,6,202002
19,5,390,26,620,596,33,807,53,2525,1926,4451,8,6,202002
19,6,104,8,208,260,4,406,3,993,733,1726,5,6,202002
19,7,246,11,609,302,8,211,2,1389,1002,2391,10,5.5,202002
19,8,140,22,322,228,3,69,9,793,433,1226,7,6,202002
19,9,210,13,304,348,53,312,3,1243,735,1978,9,5.25,202002
19,10,102,11,231,221,14,314,10,903,1009,1912,6,7,202002
19,11,370,36,521,918,19,992,104,2960,2578,5538,13,6,202002
19,12,258,9,795,282,26,171,36,1577,826,2403,13,5.666666667,202002
20,1,251,14,270,317,159,167,72,1250,868,2118,7,5.5,202002
20,2,207,50,377,241,53,127,3,1058,317,1375,6,5.333333333,202002
20,3,135,16,213,169,320,354,33,1240,542,1782,6,5.333333333,202002
20,4,191,8,122,160,40,215,39,775,334,1109,6,5.333333333,202002
20,5,157,12,326,397,31,155,0,1078,635,1713,11,5.25,202002
20,6,213,7,172,290,212,105,120,1119,621,1740,8,5.25,202002
20,7,174,16,211,428,42,123,16,1010,806,1816,7,5.75,202002
20,8,437,25,763,592,104,874,37,2832,2306,5138,15,7,202002
20,9,298,13,366,252,234,325,21,1509,921,2430,8,5.666666667,202002
20,10,284,12,647,216,42,187,16,1404,846,2250,9,5.25,202002
21,1,231,18,370,292,51,172,1,1135,672,1807,9,5.4,202002
21,2,198,105,340,254,124,88,0,1109,606,1715,9,5.2,202002
21,3,294,18,297,289,108,463,37,1506,889,2395,8,5.5,202002
21,4,170,9,189,70,162,117,24,741,336,1077,6,5.25,202002
21,5,288,19,704,331,38,225,22,1627,873,2500,8,5.666666667,202002
21,6,180,11,371,325,123,480,18,1508,1181,2689,6,6,202002
21,7,427,21,327,367,82,296,3,1523,923,2446,9,5.666666667,202002
21,8,158,22,290,187,85,282,56,1080,653,1733,9,5.2,202002
21,9,244,38,751,516,122,357,43,2071,1317,3388,9,6,202002
21,10,214,20,524,400,58,341,76,1633,987,2620,7,5.5,202002
21,11,93,9,375,148,54,124,4,807,719,1526,4,6,202002
21,12,329,57,1028,781,225,537,326,3283,2363,5646,15,6,202002
21,13,243,14,526,246,56,485,6,1576,1206,2782,8,5.666666667,202002
21,14,201,12,283,129,157,201,13,996,521,1517,12,5.333333333,202002
21,15,305,19,439,322,23,437,27,1572,1100,2672,7,5.5,202002
22,1,325,90,268,574,54,130,15,1456,849,2305,11,5.2,202002
22,2,185,33,306,322,183,119,11,1159,994,2153,7,5.5,202002
22,3,379,91,1154,968,21,406,6,3025,1785,4810,9,5.666666667,202002
22,4,335,46,886,705,34,511,5,2522,1604,4126,9,6.5,202002
22,5,237,20,532,341,101,250,42,1523,836,2359,10,5.5,202002
23,1,243,7,1215,348,50,288,14,2165,2061,4226,14,5.6,202002
23,2,271,36,900,661,47,131,3,2049,856,2905,8,5.25,202002
23,3,297,18,1164,733,65,189,38,2504,1715,4219,19,0,202002
23,4,176,15,587,334,45,161,40,1358,1555,2913,6,5.5,202002
24,1,199,140,207,398,23,98,5,1070,254,1324,10,5.2,202002
24,2,170,21,271,219,32,144,32,889,1039,1928,6,5.5,202002
24,3,295,85,252,371,133,124,3,1263,769,2032,9,5.25,202002
24,4,195,18,221,207,38,416,65,1160,305,1465,5,5.5,202002
24,5,299,81,878,804,32,212,2,2308,1869,4177,10,6.333333333,202002
24,6,300,158,602,438,81,341,1,1921,1229,3150,6,6,202002
24,7,361,24,328,478,154,60,1,1406,406,1812,9,5.25,202002
25,1,213,10,353,372,42,235,115,1340,1005,2345,13,5.75,202002
25,2,268,80,519,608,14,295,0,1784,1066,2850,7,5.5,202002
25,3,263,12,363,694,60,449,8,1849,1139,2988,8,5.6,202002
25,4,222,49,290,399,188,161,3,1312,583,1895,8,5.333333333,202002
25,5,284,22,646,663,33,292,92,2032,1219,3251,8,5.666666667,202002
25,6,262,17,429,401,79,420,69,1677,1228,2905,8,5.75,202002
25,7,319,32,837,715,26,194,1,2124,1262,3386,6,6,202002
26,1,210,15,400,393,16,291,0,1325,881,2206,9,5.5,202002
26,2,277,17,540,652,19,213,68,1786,925,2711,12,5.4,202002
26,3,309,31,483,625,39,490,30,2007,1124,3131,13,6,202002
26,4,181,54,348,312,169,91,12,1167,553,1720,9,5.2,202002
26,5,181,10,299,353,51,308,0,1202,700,1902,15,6,202002
26,6,250,11,194,283,25,330,1,1094,969,2063,10,5.333333333,202002
26,7,174,26,219,383,114,83,16,1015,710,1725,10,5.5,202002
27,1,204,12,245,341,149,156,6,1113,765,1878,8,5.5,202002
27,2,267,33,325,800,43,201,1,1670,809,2479,8,5.666666667,202002
27,3,271,18,248,824,27,320,0,1708,908,2616,7,5.666666667,202002
27,4,238,9,462,973,30,421,16,2149,1244,3393,8,6,202002
27,5,177,7,128,441,34,193,0,980,317,1297,6,5.333333333,202002
27,6,182,12,238,674,15,304,0,1425,915,2340,7,5.5,202002
28,1,344,36,729,633,15,253,0,2010,1256,3266,13,6,202002
28,2,297,18,627,460,53,483,209,2147,1034,3181,15,5.666666667,202002
28,3,173,12,357,275,21,133,41,1012,274,1286,7,5.333333333,202002
28,4,431,38,674,430,119,454,214,2360,1534,3894,17,6,202002
28,5,238,18,303,436,34,465,60,1554,971,2525,10,5.5,202002
28,6,216,30,197,676,175,195,4,1493,655,2148,13,5.166666667,202002
28,7,271,43,444,395,148,623,10,1934,1391,3325,13,6,202002
28,8,207,14,305,319,90,333,105,1373,827,2200,12,6,202002
28,9,255,19,491,263,43,292,52,1415,1014,2429,11,5.75,202002
29,1,312,33,342,492,55,446,8,1688,1103,2791,7,5.5,202002
29,2,299,11,344,711,41,539,117,2062,1152,3214,10,5.666666667,202002
29,3,207,17,205,499,29,266,7,1230,616,1846,6,5.666666667,202002
30,1,142,12,220,270,103,179,15,941,586,1527,7,5.333333333,202002
30,2,205,20,237,162,49,175,173,1021,467,1488,8,5.25,202002
30,3,230,15,353,222,184,390,85,1479,1024,2503,6,5.666666667,202002
30,4,108,12,420,212,50,190,0,992,770,1762,8,6,202002
30,5,157,9,470,273,42,169,34,1154,772,1926,7,5.5,202002
30,6,180,9,396,320,61,158,11,1135,430,1565,9,5.333333333,202002
30,7,221,40,427,262,162,201,127,1440,931,2371,11,5.25,202002
30,8,234,29,861,464,162,310,16,2076,906,2982,11,5.4,202002
30,9,235,4,262,199,129,319,29,1177,863,2040,8,5.5,202002
30,10,212,19,666,379,38,509,37,1860,1957,3817,6,6,202002
30,11,164,20,620,546,47,223,1,1621,1604,3225,5,5.5,202002
30,12,240,12,840,493,37,474,2,2098,1687,3785,10,6,202002
30,13,286,15,299,313,190,519,93,1715,1153,2868,10,5.4,202002
30,14,163,13,339,235,182,295,39,1266,926,2192,8,5.5,202002
30,15,336,20,294,327,166,470,76,1689,1334,3023,11,5.666666667,202002
30,16,229,12,447,754,244,336,190,2212,1070,3282,10,5.333333333,202002
30,17,180,22,472,332,46,356,84,1492,405,1897,8,5.5,202002
30,18,251,14,117,156,51,192,30,811,345,1156,8,5.25,202002
30,19,232,13,511,347,55,257,43,1458,937,2395,13,5.6,202002
30,20,222,14,225,660,160,292,1,1574,679,2253,10,5.4,202002
31,1,156,19,362,48,355,200,0,1140,879,2019,8,5.5,202002
31,2,137,7,151,18,191,284,0,788,589,1377,6,5.333333333,202002
31,3,509,150,1603,1216,297,412,0,4187,2807,6994,20,6,202002
31,4,149,13,361,238,201,313,62,1337,926,2263,4,6,202002
31,5,157,14,211,231,119,333,3,1068,505,1573,6,5.333333333,202002
32,1,200,44,218,207,72,244,51,1036,703,1739,12,5.2,202002
32,2,309,44,218,173,119,299,45,1207,915,2122,13,5.142857143,202002
32,3,237,35,269,470,8,481,2,1502,1145,2647,13,5.4,202002
32,4,233,49,295,382,32,258,23,1272,686,1958,13,5.4,202002
1,1,275,73,460,431,99,200,24,1562,968,2530,13,5.5,202003
1,2,314,64,774,576,82,433,12,2255,1492,3747,10,6.333333333,202003
1,3,293,95,740,464,62,426,60,2140,1121,3261,9,6,202003
2,1,244,16,434,312,51,565,60,1682,1081,2763,11,6,202003
2,2,184,10,340,406,16,539,0,1495,1091,2586,7,6,202003
2,3,231,2,399,367,15,608,37,1659,1445,3104,12,6,202003
2,4,234,9,718,229,97,180,35,1502,1507,3009,9,6,202003
2,5,266,15,618,320,190,556,9,1974,1520,3494,11,6,202003
2,6,173,17,396,288,41,410,1,1326,1143,2469,8,6.5,202003
2,7,268,14,551,379,73,192,73,1550,1180,2730,12,5.75,202003
2,8,209,15,373,315,43,266,63,1284,1490,2774,7,7,202003
3,1,230,20,453,400,37,289,21,1450,910,2360,12,5.666666667,202003
3,2,150,20,622,250,70,245,1,1358,1279,2637,9,5.666666667,202003
4,1,259,34,449,522,202,351,43,1860,1038,2898,11,5.25,202003
4,2,277,20,494,521,160,283,97,1852,1657,3509,14,5.2,202003
5,1,333,45,731,781,66,156,103,2215,1481,3696,9,5.666666667,202003
5,2,441,43,590,927,77,220,15,2313,749,3062,10,5.2,202003
5,3,268,47,534,874,121,180,223,2247,1285,3532,11,5.333333333,202003
5,4,573,75,1172,1385,47,277,221,3750,1680,5430,11,5.75,202003
5,5,379,54,615,1058,50,146,282,2584,1541,4125,10,6,202003
5,6,353,45,565,672,46,112,278,2071,1043,3114,10,5.5,202003
5,7,419,49,514,761,50,155,30,1978,831,2809,10,5.5,202003
6,1,315,14,448,311,13,474,27,1602,1145,2747,12,6,202003
6,2,194,23,385,272,67,308,26,1275,678,1953,9,5.666666667,202003
7,1,348,11,292,312,113,89,1,1166,917,2083,9,5.25,202003
7,2,249,11,164,1350,24,32,0,1830,1523,3353,9,5.25,202003
7,3,334,7,229,172,150,88,1,981,1151,2132,7,5.333333333,202003
7,4,286,12,178,294,8,80,50,908,555,1463,11,5.2,202003
7,5,278,17,287,457,38,180,0,1257,1426,2683,11,5.666666667,202003
7,6,233,10,495,328,74,333,9,1482,920,2402,9,5.666666667,202003
7,7,262,19,354,353,202,213,20,1423,1031,2454,8,5.5,202003
7,8,224,14,157,491,83,195,59,1223,1560,2783,12,5.25,202003
7,9,210,13,322,448,47,343,11,1394,1036,2430,9,5.666666667,202003
7,10,213,10,225,526,18,151,0,1143,696,1839,9,5.5,202003
7,11,185,5,284,156,41,89,0,760,481,1241,6,5.333333333,202003
7,12,250,4,416,662,22,71,10,1435,1120,2555,9,5.5,202003
7,13,120,24,119,631,0,65,0,959,861,1820,9,5.25,202003
8,1,134,11,342,171,21,176,9,864,1133,1997,4,6,202003
8,2,430,120,1036,740,79,203,9,2617,1389,4006,16,5.5,202003
8,3,212,39,401,369,52,121,132,1326,1267,2593,4,6,202003
8,4,240,40,530,425,66,332,97,1730,1072,2802,11,6,202003
8,5,276,94,411,525,98,131,4,1539,1118,2657,10,5.25,202003
8,6,202,68,471,430,62,274,26,1533,895,2428,10,8,202003
8,7,234,116,304,391,13,207,0,1265,886,2151,7,5.25,202003
8,8,307,42,542,710,18,654,5,2278,1677,3955,10,6,202003
8,9,253,25,272,208,83,253,117,1211,1064,2275,10,5.2,202003
9,1,68,12,151,134,108,177,8,658,544,1202,5,6,202003
9,2,389,106,731,772,230,746,50,3024,2310,5334,12,6,202003
9,3,113,11,310,261,83,374,22,1174,1348,2522,7,6,202003
9,4,250,40,605,656,212,421,3,2187,1714,3901,11,6,202003
9,5,246,8,255,288,78,305,0,1180,1205,2385,7,6,202003
9,6,134,28,207,177,133,286,32,997,615,1612,7,6,202003
9,7,114,8,563,297,12,162,26,1182,1077,2259,9,6,202003
9,8,94,14,276,310,47,260,17,1018,846,1864,5,6,202003
9,9,154,19,241,313,109,291,6,1133,857,1990,5,6,202003
9,10,114,9,419,381,49,278,11,1261,1417,2678,6,6,202003
9,11,171,21,355,364,185,429,30,1555,1541,3096,7,6,202003
9,12,241,28,675,658,71,552,60,2285,1463,3748,11,6,202003
9,13,136,23,362,330,81,324,7,1263,884,2147,4,6,202003
9,14,108,5,241,263,52,12,212,893,768,1661,5,6,202003
9,15,270,22,1039,824,76,637,58,2926,2399,5325,10,6.5,202003
9,16,268,253,511,647,120,307,22,2128,1751,3879,15,6,202003
9,17,119,15,315,292,32,211,7,991,782,1773,6,6,202003
9,18,163,25,317,397,155,483,51,1591,1309,2900,12,6,202003
9,19,204,43,307,352,160,474,19,1559,1391,2950,5,6,202003
9,20,75,7,145,186,85,132,11,641,473,1114,5,6,202003
9,21,156,6,252,272,128,252,25,1091,742,1833,3,6,202003
9,22,185,20,214,279,133,300,22,1153,872,2025,5,6,202003
9,23,141,18,520,405,133,255,1,1473,1183,2656,6,6,202003
9,24,309,60,512,610,330,516,38,2375,2257,4632,14,6,202003
10,1,264,49,350,344,40,320,127,1494,916,2410,12,5,202003
10,2,282,34,468,636,72,265,56,1813,1000,2813,9,5.25,202003
10,3,239,51,325,356,54,442,126,1593,987,2580,11,5.4,202003
10,4,338,36,615,839,27,494,10,2359,1564,3923,12,6.5,202003
11,1,258,91,260,345,86,293,19,1352,734,2086,6,5.666666667,202003
11,2,249,77,359,269,178,378,11,1521,1000,2521,7,6,202003
11,3,138,35,245,214,35,235,2,904,815,1719,3,6,202003
11,4,178,59,287,287,85,320,1,1217,826,2043,8,6,202003
11,5,331,92,520,769,42,275,54,2083,1421,3504,7,6,202003
11,6,210,50,372,373,68,232,19,1324,616,1940,8,6,202003
11,7,293,68,445,547,37,295,0,1685,1309,2994,9,5.5,202003
11,8,291,82,373,613,156,327,8,1850,1067,2917,9,5.75,202003
11,9,279,84,350,585,21,400,12,1731,1260,2991,10,5.666666667,202003
11,10,344,73,354,364,48,506,52,1741,1209,2950,10,5.6,202003
11,11,264,83,373,521,17,213,0,1471,1052,2523,5,6,202003
11,12,292,97,545,643,28,450,10,2065,1155,3220,7,6,202003
11,13,268,73,312,250,71,360,35,1369,879,2248,8,5.5,202003
11,14,253,70,452,306,108,263,0,1452,990,2442,8,5.5,202003
11,15,207,42,301,329,25,290,29,1223,989,2212,9,6,202003
12,1,188,51,222,147,123,295,2,1028,671,1699,10,5.2,202003
12,2,218,22,287,466,32,467,3,1495,1306,2801,10,5.5,202003
12,3,242,21,339,573,39,166,0,1380,1149,2529,11,5.2,202003
12,4,217,17,480,593,50,331,0,1688,1346,3034,9,5.666666667,202003
12,5,213,28,349,277,36,111,52,1066,919,1985,10,5.25,202003
12,6,146,17,280,248,36,70,22,819,676,1495,10,5.25,202003
12,7,230,17,317,411,16,430,43,1464,1316,2780,6,5.5,202003
12,8,227,24,248,394,6,146,0,1045,1084,2129,9,5.25,202003
12,9,211,34,400,611,66,163,27,1512,1242,2754,9,5.666666667,202003
13,1,402,40,341,585,168,89,102,1727,1318,3045,9,5.333333333,202003
13,2,297,34,305,408,186,161,95,1486,634,2120,6,5.333333333,202003
13,3,389,54,468,510,304,93,58,1876,828,2704,12,5.25,202003
13,4,473,54,614,654,194,129,83,2201,968,3169,9,5.666666667,202003
13,5,354,24,477,702,232,137,137,2063,1440,3503,9,5.75,202003
13,6,513,103,903,1250,58,229,30,3086,1863,4949,11,5.666666667,202003
13,7,421,59,675,857,98,98,0,2208,1118,3326,8,5.5,202003
14,1,182,44,201,79,155,98,11,770,772,1542,6,5.5,202003
14,2,194,34,246,108,104,244,1,931,969,1900,5,5.666666667,202003
14,3,255,37,479,135,24,333,3,1266,1133,2399,8,5.4,202003
14,4,263,21,398,342,27,525,12,1588,1024,2612,10,6,202003
14,5,184,37,558,242,36,277,7,1341,989,2330,9,5.5,202003
14,6,280,19,808,355,26,228,6,1722,1386,3108,11,6,202003
14,7,152,14,382,214,0,76,0,838,665,1503,6,6,202003
14,8,398,57,1278,806,93,620,6,3258,2879,6137,11,6,202003
14,9,157,18,430,416,42,278,12,1353,903,2256,11,6,202003
14,10,183,81,509,232,3,253,32,1293,1252,2545,7,6,202003
14,11,111,12,141,139,34,291,27,755,1009,1764,4,6,202003
14,12,258,25,592,163,48,119,0,1205,1132,2337,9,5.5,202003
14,13,202,28,449,236,18,281,9,1223,1143,2366,6,6,202003
14,14,183,32,322,281,44,512,9,1383,1132,2515,7,6,202003
14,15,264,47,314,185,113,424,9,1356,980,2336,10,5.6,202003
14,16,159,23,344,173,68,226,11,1004,1065,2069,5,6,202003
14,17,215,51,290,76,52,232,13,929,659,1588,7,5.25,202003
14,18,231,56,350,112,140,207,53,1149,889,2038,9,5.4,202003
14,19,306,51,460,223,110,301,38,1489,914,2403,8,5.25,202003
14,20,305,34,594,431,11,144,1,1520,1050,2570,10,5.666666667,202003
15,1,214,28,177,106,380,314,0,1219,1007,2226,7,5.333333333,202003
15,2,175,22,384,338,199,159,17,1294,1232,2526,6,6,202003
15,3,221,33,220,246,385,378,61,1544,1480,3024,10,5.666666667,202003
15,4,174,27,227,380,66,199,25,1098,937,2035,4,6,202003
15,5,229,36,497,353,52,186,15,1368,960,2328,8,5.666666667,202003
15,6,189,19,372,553,50,271,44,1498,1212,2710,7,6,202003
15,7,152,11,412,249,99,339,0,1262,1241,2503,10,6,202003
15,8,141,19,254,301,36,208,25,984,592,1576,4,6,202003
15,9,235,20,195,129,215,410,1,1205,955,2160,9,5.75,202003
15,10,163,13,254,391,46,321,19,1207,773,1980,6,6,202003
15,11,224,48,363,439,72,229,30,1405,964,2369,8,6,202003
15,12,284,14,641,554,145,228,1,1867,1433,3300,8,6,202003
15,13,95,15,170,234,126,214,1,855,796,1651,8,6,202003
15,14,89,50,157,254,41,198,12,801,831,1632,4,6,202003
15,15,161,243,314,404,95,125,6,1348,1387,2735,6,6,202003
15,16,311,50,574,704,49,472,28,2188,1244,3432,8,6,202003
15,17,177,20,217,301,52,327,49,1143,812,1955,8,6,202003
15,18,301,44,467,530,55,304,39,1740,1478,3218,7,5.666666667,202003
15,19,216,85,583,856,39,358,91,2228,1888,4116,10,6,202003
15,20,109,33,365,290,26,137,12,972,742,1714,6,6,202003
15,21,129,12,125,145,59,226,36,732,540,1272,6,5.5,202003
15,22,335,181,718,881,58,367,77,2617,1906,4523,14,6,202003
15,23,254,22,395,443,49,232,5,1400,1283,2683,6,5.333333333,202003
15,24,183,59,304,348,52,174,34,1154,832,1986,4,6,202003
15,25,231,58,318,268,71,246,11,1203,870,2073,6,6,202003
15,26,164,12,198,222,152,231,0,979,817,1796,9,7,202003
15,27,238,31,573,501,45,384,62,1834,1244,3078,9,5.666666667,202003
15,28,264,41,567,364,81,212,34,1563,1323,2886,9,5.666666667,202003
15,29,287,26,541,725,20,515,33,2147,1551,3698,8,6,202003
15,30,333,61,554,614,96,283,69,2010,1345,3355,16,6,202003
15,31,117,398,124,278,4,24,1,946,1066,2012,6,6,202003
15,32,235,22,334,480,77,266,4,1418,992,2410,9,6,202003
15,33,243,28,556,470,55,202,0,1554,1044,2598,7,6,202003
15,34,200,16,333,508,22,158,5,1242,1120,2362,8,6,202003
15,35,301,20,372,778,20,259,33,1783,1303,3086,9,5.666666667,202003
15,36,306,22,353,488,100,358,18,1645,1343,2988,9,5.5,202003
15,37,278,23,436,577,147,520,39,2020,1467,3487,7,6,202003
15,38,270,76,418,419,101,201,16,1501,1037,2538,6,5.5,202003
15,39,235,21,350,374,64,276,1,1321,816,2137,4,6,202003
15,40,334,95,359,541,245,410,14,1998,1455,3453,9,6,202003
15,41,441,56,766,776,157,406,50,2652,1806,4458,13,6,202003
16,1,174,23,341,200,20,122,1,881,677,1558,7,5.333333333,202003
16,2,129,32,128,180,21,217,9,716,372,1088,9,5.25,202003
16,3,274,45,247,347,53,255,3,1224,800,2024,10,5.25,202003
16,4,218,54,372,203,85,144,0,1076,983,2059,8,5.5,202003
16,5,186,31,237,224,93,294,26,1091,1115,2206,10,5.666666667,202003
16,6,217,54,339,248,69,277,0,1204,985,2189,12,5.5,202003
16,7,275,61,353,358,75,205,21,1348,1121,2469,9,5.5,202003
16,8,270,38,771,598,13,360,21,2071,1776,3847,12,6,202003
16,9,190,36,376,414,21,262,6,1305,1018,2323,9,6,202003
16,10,184,40,511,471,40,234,1,1481,846,2327,6,6,202003
16,11,245,49,328,228,122,363,13,1348,977,2325,10,5.4,202003
16,12,176,39,259,159,32,262,2,929,903,1832,10,5.25,202003
17,1,218,22,564,634,84,273,5,1800,1263,3063,9,7,202003
17,2,177,23,349,399,20,243,27,1238,925,2163,8,5.666666667,202003
17,3,239,31,501,565,48,408,0,1792,1096,2888,8,5.5,202003
17,4,242,25,511,608,57,155,19,1617,1001,2618,10,5.666666667,202003
17,5,166,16,156,201,48,194,0,781,528,1309,5,5.5,202003
18,1,221,25,197,202,52,221,111,1029,704,1733,7,5.25,202003
18,2,254,29,485,431,55,548,1,1803,1202,3005,8,6,202003
18,3,219,20,494,316,16,136,1,1202,764,1966,8,5.5,202003
19,1,195,16,342,388,28,362,49,1380,1315,2695,9,6,202003
19,2,312,28,895,548,33,220,0,2036,1771,3807,9,6,202003
19,3,313,28,726,456,60,280,9,1872,1555,3427,7,6,202003
19,4,148,7,201,157,57,302,69,941,868,1809,5,6,202003
19,5,365,23,611,641,38,715,44,2437,2012,4449,8,7,202003
19,6,93,5,207,323,8,312,12,960,720,1680,5,6,202003
19,7,235,18,728,333,11,152,1,1478,1182,2660,10,5.25,202003
19,8,123,19,324,250,7,58,6,787,369,1156,7,6,202003
19,9,303,25,427,408,46,414,57,1680,1119,2799,9,5.25,202003
19,10,107,13,266,179,13,313,12,903,1137,2040,6,7,202003
19,11,407,48,569,841,24,882,79,2850,2296,5146,13,6,202003
19,12,257,21,786,240,24,220,52,1600,1045,2645,13,5.666666667,202003
20,1,262,19,266,262,114,142,66,1131,824,1955,7,5.5,202003
20,2,139,20,218,237,73,100,12,799,388,1187,6,5.333333333,202003
20,3,161,18,243,152,215,229,20,1038,552,1590,6,5.333333333,202003
20,4,166,8,107,120,57,256,43,757,406,1163,6,5.333333333,202003
20,5,183,23,378,433,55,127,2,1201,687,1888,11,5.25,202003
20,6,142,8,163,233,190,116,120,972,446,1418,8,5.25,202003
20,7,214,18,243,423,52,115,12,1077,955,2032,7,5.75,202003
20,8,498,86,754,703,95,913,36,3085,2170,5255,15,7,202003
20,9,303,16,282,233,249,297,35,1415,1127,2542,8,5.666666667,202003
20,10,187,19,546,247,47,155,7,1208,852,2060,9,5.25,202003
21,1,272,19,418,253,79,188,1,1230,1111,2341,9,5.4,202003
21,2,192,25,413,254,103,155,1,1143,813,1956,9,5.2,202003
21,3,283,16,420,274,90,438,32,1553,1252,2805,8,5.5,202003
21,4,158,8,157,81,171,144,16,735,642,1377,6,5.25,202003
21,5,254,34,765,320,36,212,22,1643,1119,2762,8,5.666666667,202003
21,6,207,14,385,304,106,501,12,1529,1388,2917,6,6,202003
21,7,457,9,311,310,82,299,0,1468,1037,2505,9,5.666666667,202003
21,8,274,12,532,210,130,349,30,1537,1170,2707,9,5.2,202003
21,9,262,35,721,535,137,279,47,2016,1341,3357,9,6,202003
21,10,226,13,481,390,42,273,45,1470,1034,2504,7,5.5,202003
21,11,91,5,293,161,52,117,11,730,529,1259,4,6,202003
21,12,360,43,1037,683,213,497,358,3191,2481,5672,16,6.5,202003
21,13,254,21,519,291,50,416,6,1557,1240,2797,8,5.666666667,202003
21,14,194,22,242,138,138,260,12,1006,815,1821,12,5.333333333,202003
21,15,266,10,413,361,60,399,42,1551,1111,2662,7,5.5,202003
22,1,284,85,314,474,45,135,20,1357,1003,2360,11,5.2,202003
22,2,205,34,318,341,163,116,9,1186,795,1981,7,5.5,202003
22,3,362,95,1127,899,23,360,13,2879,1708,4587,9,5.666666667,202003
22,4,249,62,944,648,31,419,6,2359,1582,3941,9,6.5,202003
22,5,219,44,516,340,104,252,29,1504,789,2293,10,5.5,202003
23,1,283,12,1259,366,70,283,17,2290,1834,4124,14,5.6,202003
23,2,200,35,750,454,52,82,0,1573,978,2551,8,5.25,202003
23,3,348,21,1289,667,58,163,29,2575,2342,4917,19,0,202003
23,4,170,13,513,339,57,136,61,1289,978,2267,6,5.5,202003
24,1,203,75,197,366,25,154,0,1020,759,1779,10,5.2,202003
24,2,163,25,300,256,37,148,22,951,629,1580,6,5.5,202003
24,3,221,89,244,393,163,121,20,1251,669,1920,9,5.25,202003
24,4,195,29,254,179,56,338,51,1102,1154,2256,5,5.5,202003
24,5,296,96,834,743,26,240,10,2245,1609,3854,10,6.333333333,202003
24,6,260,140,577,446,143,248,1,1815,999,2814,6,6,202003
24,7,227,28,297,405,168,62,0,1187,1180,2367,9,5.25,202003
25,1,198,9,359,378,57,264,104,1369,1136,2505,13,5.75,202003
25,2,241,116,529,550,13,309,0,1758,1224,2982,7,5.5,202003
25,3,213,24,441,737,116,319,17,1867,1185,3052,8,5.6,202003
25,4,213,18,268,391,239,134,1,1264,927,2191,8,5.333333333,202003
25,5,263,29,577,635,47,300,60,1911,1105,3016,8,5.666666667,202003
25,6,235,6,430,418,81,337,63,1570,1231,2801,8,5.75,202003
25,7,302,23,815,711,22,183,0,2056,1562,3618,6,6,202003
26,1,220,20,491,367,28,291,0,1417,1110,2527,9,5.5,202003
26,2,250,19,567,513,11,241,65,1666,1207,2873,12,5.4,202003
26,3,252,33,427,544,45,482,33,1816,1360,3176,13,6,202003
26,4,227,41,423,310,117,106,9,1233,917,2150,9,5.2,202003
26,5,196,17,358,332,41,350,2,1296,726,2022,15,6,202003
26,6,215,20,226,273,19,359,2,1114,954,2068,10,5.333333333,202003
26,7,181,47,319,339,139,86,23,1134,842,1976,10,5.5,202003
27,1,250,27,363,414,203,197,11,1465,788,2253,8,5.5,202003
27,2,275,21,324,744,30,158,2,1554,1147,2701,8,5.666666667,202003
27,3,247,15,264,623,21,287,0,1457,906,2363,7,5.666666667,202003
27,4,240,13,469,881,24,380,12,2019,1474,3493,8,6,202003
27,5,132,11,191,426,46,190,0,996,757,1753,6,5.333333333,202003
27,6,204,16,231,581,14,249,6,1301,702,2003,7,5.5,202003
28,1,233,38,674,558,17,177,0,1697,1185,2882,13,6,202003
28,2,258,19,679,348,34,387,188,1913,1647,3560,15,5.666666667,202003
28,3,151,15,330,229,6,134,47,912,623,1535,7,5.333333333,202003
28,4,328,32,550,349,109,386,96,1850,1239,3089,17,4.666666667,202003
28,5,209,30,281,431,29,498,52,1530,1066,2596,10,5.5,202003
28,6,183,23,223,704,111,177,16,1437,917,2354,13,5.166666667,202003
28,7,248,34,491,348,120,598,31,1870,1653,3523,13,6,202003
28,8,172,16,326,253,70,321,57,1215,973,2188,13,7,202003
28,9,187,12,389,214,39,296,57,1194,1184,2378,11,5.75,202003
29,1,259,40,356,575,51,397,12,1690,1283,2973,7,5.5,202003
29,2,260,18,326,657,37,440,117,1855,1257,3112,11,6,202003
29,3,166,17,211,478,29,264,6,1171,705,1876,6,5.666666667,202003
30,1,165,14,301,234,161,158,28,1061,676,1737,7,5.333333333,202003
30,2,181,19,218,147,116,192,151,1024,701,1725,8,5.25,202003
30,3,195,9,309,172,159,257,68,1169,825,1994,6,5.666666667,202003
30,4,136,10,395,184,41,197,0,963,746,1709,8,6,202003
30,5,180,12,406,287,52,151,22,1110,818,1928,7,5.5,202003
30,6,214,15,406,301,47,202,23,1208,1000,2208,9,5.333333333,202003
30,7,203,20,368,213,154,163,110,1231,1411,2642,11,5.25,202003
30,8,212,28,784,293,123,268,4,1712,1365,3077,11,5.4,202003
30,9,238,8,231,206,118,324,28,1153,843,1996,8,5.5,202003
30,10,197,19,563,313,35,410,36,1573,1272,2845,6,6,202003
30,11,141,16,610,433,19,157,3,1379,869,2248,5,5.5,202003
30,12,237,20,909,490,41,482,7,2186,1591,3777,10,6,202003
30,13,277,17,245,222,125,392,102,1380,1067,2447,10,5.4,202003
30,14,176,26,339,198,175,289,17,1220,1045,2265,8,5.5,202003
30,15,233,21,306,267,151,502,73,1553,1333,2886,11,5.666666667,202003
30,16,210,8,413,509,83,278,155,1656,1348,3004,10,5.333333333,202003
30,17,178,26,362,274,64,329,67,1300,931,2231,8,5.5,202003
30,18,292,24,111,189,51,195,53,915,951,1866,8,5.25,202003
30,19,199,11,424,240,44,249,25,1192,977,2169,13,5.6,202003
30,20,195,17,252,583,191,324,6,1568,1103,2671,10,5.4,202003
31,1,186,21,388,60,320,164,0,1139,945,2084,8,5.5,202003
31,2,128,9,159,27,155,302,0,780,378,1158,6,5.333333333,202003
31,3,463,140,1618,997,251,326,0,3795,2988,6783,21,6.333333333,202003
31,4,120,14,407,235,175,227,80,1258,863,2121,4,6,202003
31,5,179,13,193,268,105,331,5,1094,836,1930,6,5.333333333,202003
32,1,241,59,282,240,73,275,60,1230,903,2133,12,5.2,202003
32,2,308,60,211,140,148,288,39,1194,1075,2269,13,5.142857143,202003
32,3,220,44,240,453,13,366,8,1344,1371,2715,13,5.4,202003
32,4,261,71,363,435,48,296,49,1523,1375,2898,12,5.2,202003
1,1,242,60,400,402,118,182,36,1440,679,2119,13,5.5,202004
1,2,316,37,743,516,71,423,7,2113,1480,3593,10,6.333333333,202004
1,3,214,101,658,398,70,420,45,1906,1188,3094,9,6,202004
2,1,218,18,413,321,52,522,75,1619,1445,3064,11,6,202004
2,2,201,11,328,387,4,513,0,1444,815,2259,7,6,202004
2,3,257,13,438,366,21,577,30,1702,1299,3001,12,6,202004
2,4,223,9,762,226,124,166,27,1537,1009,2546,9,6,202004
2,5,261,20,717,323,169,565,4,2059,1651,3710,11,6,202004
2,6,210,16,375,286,35,413,3,1338,1012,2350,8,6.5,202004
2,7,256,21,512,340,56,217,75,1477,1040,2517,12,5.75,202004
2,8,182,11,388,301,26,239,63,1210,1129,2339,7,7,202004
3,1,208,21,371,366,56,254,12,1288,962,2250,12,5.666666667,202004
3,2,165,19,634,253,53,243,1,1368,998,2366,9,5.666666667,202004
4,1,250,27,405,455,129,265,37,1568,1303,2871,11,5.25,202004
4,2,222,17,419,411,90,212,77,1448,1149,2597,14,5.2,202004
5,1,60,16,179,545,2,56,0,858,1441,2299,9,5.666666667,202004
5,2,7,1,7,568,2,3,0,588,1275,1863,10,5.2,202004
5,3,52,19,155,639,80,60,12,1017,1135,2152,11,5.333333333,202004
5,4,34,15,162,580,6,65,1,863,2068,2931,11,5.75,202004
5,5,86,19,216,722,10,61,22,1136,1765,2901,10,6,202004
5,6,57,15,133,366,6,23,30,630,1432,2062,10,5.5,202004
5,7,51,6,62,297,3,33,69,521,1323,1844,10,5.5,202004
6,1,255,23,416,276,21,430,30,1451,1157,2608,12,6,202004
6,2,180,11,361,254,40,316,32,1194,861,2055,9,5.666666667,202004
7,1,272,8,172,212,33,61,2,760,735,1495,9,5.25,202004
7,2,273,13,183,875,177,49,0,1570,645,2215,9,5.25,202004
7,3,231,7,223,230,213,99,0,1003,1011,2014,7,5.333333333,202004
7,4,254,5,165,377,17,94,20,932,441,1373,11,5.4,202004
7,5,240,10,192,376,42,169,0,1029,914,1943,11,5.666666667,202004
7,6,225,13,454,365,51,271,16,1395,883,2278,9,5.666666667,202004
7,7,266,11,342,335,125,274,10,1363,1219,2582,8,5.5,202004
7,8,309,38,245,405,70,248,32,1347,1734,3081,12,5.25,202004
7,9,211,12,320,409,31,332,11,1326,879,2205,9,5.666666667,202004
7,10,190,8,222,501,55,129,0,1105,686,1791,9,5.5,202004
7,11,114,8,175,105,40,64,0,506,300,806,6,5.333333333,202004
7,12,236,9,391,625,20,83,12,1376,1126,2502,9,5.5,202004
7,13,81,3,79,776,2,33,0,974,475,1449,9,5.25,202004
8,1,145,10,372,180,25,176,3,911,652,1563,4,6,202004
8,2,320,89,890,697,29,200,15,2240,1533,3773,16,5.5,202004
8,3,197,30,401,375,45,112,118,1278,1143,2421,4,6,202004
8,4,201,44,555,411,56,344,65,1676,1136,2812,11,6,202004
8,5,269,85,470,535,76,175,5,1615,618,2233,10,5.25,202004
8,6,220,59,426,413,63,228,31,1440,1024,2464,9,7,202004
8,7,252,159,281,406,12,205,0,1315,970,2285,7,5.25,202004
8,8,283,43,582,658,9,739,5,2319,1574,3893,10,6,202004
8,9,213,56,230,215,72,245,114,1145,644,1789,10,5.2,202004
9,1,89,9,174,161,102,169,9,713,580,1293,5,6,202004
9,2,333,68,790,704,219,642,37,2793,1941,4734,12,6,202004
9,3,102,14,303,266,106,346,16,1153,1260,2413,7,6,202004
9,4,202,22,545,518,156,329,5,1777,875,2652,11,6,202004
9,5,191,9,239,285,75,346,0,1145,970,2115,7,6,202004
9,6,94,22,217,180,109,235,20,877,755,1632,7,6,202004
9,7,85,17,471,264,16,161,27,1041,607,1648,9,6,202004
9,8,85,10,316,325,57,322,26,1141,541,1682,5,6,202004
9,9,137,9,288,319,103,236,4,1096,627,1723,5,6,202004
9,10,108,12,412,311,53,276,9,1181,1125,2306,6,6,202004
9,11,167,18,396,395,167,387,24,1554,1369,2923,7,6,202004
9,12,203,32,585,613,47,437,47,1964,1741,3705,11,6,202004
9,13,97,14,333,290,98,261,11,1104,888,1992,4,6,202004
9,14,85,7,172,239,58,263,14,838,379,1217,5,6,202004
9,15,235,27,979,799,58,619,44,2761,2289,5050,10,6.5,202004
9,16,178,253,500,749,107,293,7,2087,1841,3928,15,6,202004
9,17,139,12,238,233,41,224,2,889,687,1576,6,6,202004
9,18,139,15,320,383,128,450,46,1481,1250,2731,12,6,202004
9,19,193,23,318,334,165,377,24,1434,863,2297,5,6,202004
9,20,80,11,119,168,68,119,10,575,307,882,5,6,202004
9,21,166,6,228,312,70,210,29,1021,751,1772,3,6,202004
9,22,150,15,223,263,95,276,16,1038,891,1929,5,6,202004
9,23,127,19,540,414,109,237,4,1450,1081,2531,6,6,202004
9,24,263,30,613,649,274,595,23,2447,1736,4183,14,6,202004
10,1,257,53,316,346,34,287,90,1383,965,2348,12,4.666666667,202004
10,2,287,26,538,563,38,245,40,1737,1970,3707,9,5.25,202004
10,3,242,58,282,327,51,408,128,1496,836,2332,11,5.4,202004
10,4,325,41,578,743,28,449,9,2173,1387,3560,12,6.5,202004
11,1,220,111,231,321,67,213,11,1174,571,1745,6,5.666666667,202004
11,2,215,61,343,230,207,317,7,1380,754,2134,7,6,202004
11,3,142,35,216,217,30,223,5,868,825,1693,3,6,202004
11,4,186,50,241,265,85,255,1,1083,778,1861,8,6,202004
11,5,285,75,479,659,41,246,46,1831,1254,3085,7,6,202004
11,6,156,41,287,282,53,192,32,1043,896,1939,8,6,202004
11,7,251,51,350,721,36,284,1,1694,1245,2939,9,5.5,202004
11,8,220,54,351,481,106,291,23,1526,982,2508,9,5.75,202004
11,9,245,58,352,514,17,414,10,1610,1009,2619,10,5.666666667,202004
11,10,278,61,255,279,46,432,37,1388,892,2280,10,5.6,202004
11,11,165,46,348,462,23,270,0,1314,583,1897,5,6,202004
11,12,221,91,538,547,27,333,6,1763,1331,3094,7,6,202004
11,13,207,60,275,231,49,307,31,1160,712,1872,8,5.5,202004
11,14,210,58,364,293,99,220,0,1244,723,1967,8,5.5,202004
11,15,186,26,275,326,22,256,26,1117,491,1608,9,6,202004
12,1,186,47,271,178,102,344,3,1131,653,1784,10,5.2,202004
12,2,245,27,301,414,24,488,23,1522,1087,2609,10,5.5,202004
12,3,211,19,281,440,30,140,1,1122,875,1997,11,5.2,202004
12,4,225,31,489,599,49,281,0,1674,923,2597,9,5.666666667,202004
12,5,199,20,197,268,3,94,54,835,727,1562,10,5.25,202004
12,6,129,16,152,204,30,23,23,577,623,1200,10,5.25,202004
12,7,183,19,270,367,16,380,38,1273,1200,2473,6,5.5,202004
12,8,191,23,188,304,3,118,0,827,641,1468,9,5.25,202004
12,9,218,33,417,529,100,162,8,1467,1016,2483,9,5.666666667,202004
13,1,120,18,98,277,52,39,108,712,1027,1739,9,5.333333333,202004
13,2,111,21,92,320,83,62,40,729,803,1532,6,5.333333333,202004
13,3,97,46,173,392,154,26,15,903,859,1762,12,5.25,202004
13,4,159,21,218,588,85,35,5,1111,1107,2218,9,5.666666667,202004
13,5,121,23,190,954,30,91,0,1409,1666,3075,9,5.75,202004
13,6,166,56,334,1188,32,75,2,1853,1745,3598,11,5.666666667,202004
13,7,74,23,128,745,18,33,0,1021,1074,2095,8,5.5,202004
14,1,215,66,216,109,123,107,13,849,718,1567,6,5.5,202004
14,2,175,34,224,107,105,253,0,898,715,1613,5,5.666666667,202004
14,3,270,26,466,142,9,355,2,1270,859,2129,8,5.4,202004
14,4,206,17,359,361,33,441,9,1426,1198,2624,10,6,202004
14,5,194,25,499,222,51,327,2,1320,826,2146,9,5.5,202004
14,6,232,21,779,355,24,243,5,1659,1142,2801,11,6,202004
14,7,116,21,342,181,0,99,0,759,457,1216,6,6,202004
14,8,345,60,1253,811,82,561,3,3115,2516,5631,11,6.25,202004
14,9,151,26,333,355,24,241,27,1157,1068,2225,11,6,202004
14,10,181,70,585,291,11,219,17,1374,1196,2570,7,6,202004
14,11,102,5,180,143,29,270,42,771,463,1234,4,6,202004
14,12,222,28,620,166,53,171,1,1261,1045,2306,9,5.5,202004
14,13,182,26,467,218,12,252,9,1166,1360,2526,6,6,202004
14,14,150,36,320,285,43,436,9,1279,615,1894,7,6,202004
14,15,206,61,308,205,92,431,6,1309,907,2216,10,5.6,202004
14,16,139,29,331,174,54,231,7,965,799,1764,5,6,202004
14,17,241,57,319,137,63,247,9,1073,505,1578,7,5.25,202004
14,18,245,49,357,138,192,302,28,1311,666,1977,9,5.4,202004
14,19,253,39,413,259,52,223,21,1260,818,2078,8,5.25,202004
14,20,281,41,559,379,11,176,0,1447,795,2242,10,5.666666667,202004
15,1,205,23,230,143,372,249,0,1222,830,2052,7,5.333333333,202004
15,2,153,31,365,294,158,179,7,1187,840,2027,6,6,202004
15,3,255,26,239,251,373,342,38,1524,887,2411,10,5.666666667,202004
15,4,161,24,222,380,79,195,9,1070,930,2000,4,6,202004
15,5,220,27,400,320,45,207,8,1227,802,2029,8,5.666666667,202004
15,6,201,8,384,484,51,219,54,1401,909,2310,7,6,202004
15,7,140,11,417,280,61,300,0,1209,842,2051,10,6,202004
15,8,106,16,229,283,26,176,13,849,721,1570,4,6,202004
15,9,269,24,203,139,158,359,0,1152,950,2102,9,5.75,202004
15,10,161,10,251,366,33,264,9,1094,754,1848,6,6,202004
15,11,189,42,334,381,55,203,16,1220,1037,2257,8,6,202004
15,12,239,16,513,551,120,184,3,1626,1499,3125,8,6,202004
15,13,100,23,183,196,124,201,0,827,625,1452,8,6,202004
15,14,83,32,178,223,26,165,10,717,799,1516,4,6,202004
15,15,158,233,288,394,106,145,8,1332,491,1823,6,6,202004
15,16,284,38,530,647,68,387,25,1979,932,2911,8,6,202004
15,17,148,15,260,307,49,279,44,1102,673,1775,8,6,202004
15,18,264,36,423,427,47,303,23,1523,1180,2703,7,5.666666667,202004
15,19,204,40,588,734,42,408,94,2110,1399,3509,10,6,202004
15,20,85,18,360,290,25,107,8,893,618,1511,6,6,202004
15,21,103,7,131,166,44,215,19,685,558,1243,6,5.5,202004
15,22,276,138,665,711,60,343,76,2269,2100,4369,14,6,202004
15,23,214,20,320,387,64,174,8,1187,1074,2261,6,5.333333333,202004
15,24,143,30,289,328,55,151,17,1013,622,1635,4,6,202004
15,25,187,14,317,345,61,242,18,1184,774,1958,6,6,202004
15,26,134,36,173,230,133,228,0,934,814,1748,9,7,202004
15,27,246,24,464,455,35,344,50,1618,1140,2758,9,5.666666667,202004
15,28,247,43,605,422,57,197,41,1612,1308,2920,9,5.666666667,202004
15,29,263,27,501,633,9,440,19,1892,2094,3986,8,6,202004
15,30,317,45,502,463,88,254,45,1714,971,2685,16,6,202004
15,31,155,204,232,314,17,84,0,1006,1037,2043,6,6,202004
15,32,159,17,291,365,51,241,4,1128,998,2126,9,6,202004
15,33,206,25,480,379,38,204,0,1332,968,2300,7,6,202004
15,34,180,19,300,554,21,145,7,1226,1053,2279,8,6,202004
15,35,330,22,327,656,9,247,31,1622,1706,3328,9,5.666666667,202004
15,36,294,25,336,443,96,343,16,1553,1152,2705,9,5.5,202004
15,37,271,28,435,567,119,432,28,1880,1421,3301,7,6,202004
15,38,224,49,333,401,85,201,11,1304,907,2211,6,5.5,202004
15,39,204,21,249,374,58,237,2,1145,852,1997,4,6,202004
15,40,340,102,371,437,213,293,2,1758,1034,2792,9,6,202004
15,41,330,46,696,680,117,339,47,2255,1821,4076,13,6,202004
16,1,194,24,353,222,24,126,2,945,737,1682,7,5.333333333,202004
16,2,143,39,202,193,15,198,9,799,536,1335,9,5.25,202004
16,3,235,31,235,328,48,219,8,1104,786,1890,10,5.25,202004
16,4,244,70,401,217,128,148,0,1208,915,2123,8,5.5,202004
16,5,243,42,276,316,83,280,21,1261,883,2144,10,5.666666667,202004
16,6,237,47,284,275,65,243,1,1152,806,1958,12,5.5,202004
16,7,252,41,284,299,54,136,18,1084,720,1804,9,5.5,202004
16,8,300,58,726,605,17,325,10,2041,1542,3583,12,6,202004
16,9,211,28,327,360,10,290,5,1231,1169,2400,9,6,202004
16,10,179,30,460,455,28,203,3,1358,865,2223,6,6,202004
16,11,244,38,316,216,113,359,4,1290,829,2119,10,5.4,202004
16,12,228,43,269,187,48,304,3,1082,873,1955,10,5.25,202004
17,1,190,23,494,598,59,231,16,1611,1367,2978,9,7,202004
17,2,166,15,341,395,37,236,16,1206,1098,2304,8,5.666666667,202004
17,3,271,31,505,467,47,331,0,1652,1322,2974,8,5.5,202004
17,4,227,35,514,577,38,159,30,1580,1157,2737,10,5.666666667,202004
17,5,113,12,160,150,39,129,0,603,583,1186,5,5.5,202004
18,1,157,27,174,186,43,172,66,825,464,1289,7,5.25,202004
18,2,257,33,452,431,44,505,0,1722,1355,3077,9,6.333333333,202004
18,3,160,14,449,260,13,160,3,1059,702,1761,8,5.5,202004
19,1,177,20,349,358,30,372,49,1355,1049,2404,9,6,202004
19,2,258,34,859,547,31,227,0,1956,1856,3812,9,6,202004
19,3,272,23,615,347,57,303,10,1627,1362,2989,7,6,202004
19,4,88,5,175,157,40,304,55,824,603,1427,5,6,202004
19,5,324,21,616,569,51,614,26,2221,1745,3966,8,7,202004
19,6,92,7,212,224,2,300,0,837,567,1404,5,6,202004
19,7,192,16,560,246,20,168,5,1207,876,2083,10,5.25,202004
19,8,75,8,258,178,3,67,3,592,324,916,7,6,202004
19,9,230,39,352,396,43,345,25,1430,679,2109,9,5.25,202004
19,10,83,11,222,211,11,303,7,848,1014,1862,6,7,202004
19,11,347,31,614,732,15,868,61,2668,2562,5230,13,6,202004
19,12,202,10,745,232,18,200,27,1434,984,2418,13,5.666666667,202004
20,1,165,14,250,232,94,143,52,950,737,1687,7,5.5,202004
20,2,163,45,300,234,54,65,6,867,514,1381,6,5.333333333,202004
20,3,128,16,152,134,215,166,27,838,519,1357,6,5.333333333,202004
20,4,142,12,111,106,35,214,47,667,502,1169,6,5.333333333,202004
20,5,166,20,328,468,34,111,0,1127,837,1964,11,5.25,202004
20,6,158,7,230,200,155,167,163,1080,491,1571,8,5.25,202004
20,7,152,24,235,460,47,125,10,1053,1084,2137,7,5.75,202004
20,8,502,72,803,731,103,778,33,3022,2642,5664,15,9,202004
20,9,301,14,259,191,233,242,20,1260,1120,2380,8,5.666666667,202004
20,10,197,21,412,238,51,135,3,1057,788,1845,9,5.25,202004
21,1,270,24,387,268,67,176,2,1194,735,1929,9,5.4,202004
21,2,194,19,280,184,83,150,0,910,655,1565,9,5.2,202004
21,3,288,14,390,228,100,348,34,1402,1290,2692,8,5.5,202004
21,4,154,9,115,94,61,183,0,616,618,1234,6,5.25,202004
21,5,227,26,556,285,42,174,22,1332,931,2263,8,5.666666667,202004
21,6,239,10,373,317,99,420,17,1475,1069,2544,6,6,202004
21,7,374,13,274,308,86,343,1,1399,1156,2555,9,5.666666667,202004
21,8,236,22,412,191,106,262,47,1276,709,1985,9,5.2,202004
21,9,265,19,636,491,84,288,22,1805,1241,3046,9,6,202004
21,10,224,18,425,325,21,268,40,1321,1040,2361,7,5.5,202004
21,11,86,7,262,145,56,95,8,659,377,1036,4,6,202004
21,12,351,62,928,710,184,381,247,2863,2541,5404,16,6.5,202004
21,13,240,16,408,230,44,376,6,1320,1032,2352,8,5.666666667,202004
21,14,192,13,276,119,97,244,3,944,803,1747,12,5.333333333,202004
21,15,302,11,424,334,65,416,28,1580,1197,2777,7,5.5,202004
22,1,227,72,221,445,33,106,13,1117,1139,2256,11,5.2,202004
22,2,181,40,317,317,157,167,18,1197,1077,2274,7,5.5,202004
22,3,295,67,1062,839,19,338,0,2620,1750,4370,9,5.666666667,202004
22,4,244,43,806,548,32,368,4,2045,1623,3668,9,6.5,202004
22,5,206,46,551,350,96,164,51,1464,1090,2554,10,5.5,202004
23,1,240,11,1381,385,57,275,25,2374,1774,4148,14,5.6,202004
23,2,233,21,705,568,56,77,1,1661,962,2623,9,5.5,202004
23,3,243,13,1260,648,51,165,42,2422,1528,3950,19,6,202004
23,4,141,7,641,286,46,215,36,1372,846,2218,6,5.5,202004
24,1,209,91,177,346,25,197,3,1048,667,1715,10,5.2,202004
24,2,167,44,324,244,32,160,37,1008,473,1481,6,5.5,202004
24,3,214,43,244,297,104,156,10,1068,710,1778,9,5.25,202004
24,4,148,23,212,186,45,277,29,920,855,1775,5,5.5,202004
24,5,264,82,768,708,21,216,23,2082,1467,3549,10,6.333333333,202004
24,6,219,93,550,452,100,245,0,1659,931,2590,6,6,202004
24,7,221,33,241,357,182,41,0,1075,989,2064,9,5.25,202004
25,1,202,19,336,305,95,269,53,1279,1075,2354,13,5.75,202004
25,2,230,47,474,553,17,313,7,1641,1180,2821,7,5.5,202004
25,3,174,9,360,692,53,353,12,1653,1231,2884,8,5.6,202004
25,4,263,46,323,319,153,207,3,1314,1172,2486,8,5.333333333,202004
25,5,203,19,508,525,28,223,67,1573,1011,2584,8,5.666666667,202004
25,6,242,19,436,370,75,301,60,1503,1429,2932,8,5.75,202004
25,7,250,27,782,626,19,163,3,1870,1304,3174,6,6,202004
26,1,235,19,375,382,9,311,0,1331,1302,2633,9,5.5,202004
26,2,268,13,574,482,13,295,108,1753,1051,2804,12,5.4,202004
26,3,271,30,480,519,34,404,23,1761,1333,3094,13,6,202004
26,4,143,22,370,285,74,90,11,995,830,1825,9,5.2,202004
26,5,193,28,326,317,27,346,1,1238,837,2075,15,6,202004
26,6,188,15,239,247,26,380,18,1113,1037,2150,10,5.333333333,202004
26,7,153,25,245,325,107,86,21,962,799,1761,10,5.5,202004
27,1,145,12,252,320,179,151,8,1067,555,1622,8,5.5,202004
27,2,236,8,291,593,26,137,3,1294,1183,2477,8,5.666666667,202004
27,3,210,16,249,572,9,312,12,1380,863,2243,7,5.666666667,202004
27,4,270,19,404,849,40,359,18,1959,1511,3470,8,6,202004
27,5,110,10,174,405,49,169,0,917,574,1491,6,5.333333333,202004
27,6,221,4,241,644,24,228,0,1362,1032,2394,7,5.5,202004
28,1,215,34,693,482,17,242,0,1683,1182,2865,13,6,202004
28,2,242,18,581,298,49,362,199,1749,1288,3037,15,5.666666667,202004
28,3,155,18,287,184,6,124,33,807,544,1351,7,5.333333333,202004
28,4,327,37,650,341,84,380,80,1899,1391,3290,19,8,202004
28,5,190,24,281,431,16,433,49,1424,1236,2660,10,5.5,202004
28,6,200,50,283,766,91,170,10,1570,928,2498,13,5.166666667,202004
28,7,212,35,490,367,126,491,20,1741,1404,3145,13,6,202004
28,8,145,8,273,226,71,353,7,1083,1219,2302,13,7,202004
28,9,181,20,564,276,55,252,49,1397,884,2281,11,5.75,202004
29,1,218,27,343,437,54,331,11,1421,1136,2557,7,5.5,202004
29,2,260,17,313,527,53,411,117,1698,1270,2968,11,6,202004
29,3,155,17,210,406,27,233,5,1053,773,1826,6,5.666666667,202004
30,1,137,15,253,233,158,131,27,954,772,1726,7,5.333333333,202004
30,2,197,16,170,105,92,133,181,894,767,1661,8,5.25,202004
30,3,190,13,294,160,146,290,76,1169,1118,2287,6,5.666666667,202004
30,4,123,12,356,141,35,202,0,869,663,1532,8,6,202004
30,5,162,12,396,225,50,136,9,990,878,1868,7,5.5,202004
30,6,168,12,309,260,53,181,26,1009,1246,2255,9,5.333333333,202004
30,7,202,23,399,269,169,125,88,1275,1028,2303,11,5.25,202004
30,8,246,34,753,297,129,229,12,1700,1440,3140,11,5.4,202004
30,9,240,9,224,204,128,267,38,1110,785,1895,8,5.5,202004
30,10,208,20,540,281,35,358,17,1459,1282,2741,6,6,202004
30,11,176,17,567,422,21,174,10,1387,854,2241,5,5.5,202004
30,12,261,11,876,469,48,464,3,2132,1570,3702,10,6,202004
30,13,292,21,225,264,168,469,64,1503,1050,2553,10,5.4,202004
30,14,149,10,306,161,115,224,24,989,756,1745,8,5.5,202004
30,15,276,19,298,299,151,449,69,1561,1369,2930,11,5.666666667,202004
30,16,209,5,410,402,80,291,169,1566,1621,3187,10,5.333333333,202004
30,17,208,19,332,260,73,286,82,1260,1175,2435,8,5.5,202004
30,18,316,17,171,162,61,205,29,961,738,1699,8,5.25,202004
30,19,163,5,420,219,46,207,23,1083,925,2008,13,5.6,202004
30,20,149,11,224,547,106,250,14,1301,852,2153,10,5.4,202004
31,1,195,19,358,65,291,145,1,1074,920,1994,8,5.5,202004
31,2,128,4,177,15,155,278,0,757,563,1320,6,5.333333333,202004
31,3,465,151,1516,873,204,344,1,3554,3052,6606,21,6.333333333,202004
31,4,117,12,333,177,186,219,63,1107,1316,2423,4,6,202004
31,5,173,8,191,232,83,332,12,1031,959,1990,6,5.333333333,202004
32,1,191,53,194,237,52,284,60,1071,733,1804,12,5.2,202004
32,2,314,46,250,171,130,294,43,1248,750,1998,13,5.142857143,202004
32,3,201,44,239,381,6,370,5,1246,1137,2383,13,5.4,202004
32,4,232,68,348,356,40,265,39,1348,1123,2471,12,5.2,202004
1,1,208,53,367,427,85,130,17,1287,1772,3059,13,5,202005
1,2,289,69,581,460,58,311,9,1777,3357,5134,10,5.333333333,202005
1,3,184,73,540,318,63,317,35,1530,2908,4438,9,5,202005
2,1,214,24,377,295,38,448,48,1444,2244,3688,11,5,202005
2,2,168,9,319,370,9,377,1,1253,1622,2875,7,5,202005
2,3,184,15,352,325,28,415,27,1346,2413,3759,12,5.333333333,202005
2,4,194,16,642,225,77,119,33,1306,1864,3170,9,5,202005
2,5,220,12,599,266,162,449,13,1721,2288,4009,11,5,202005
2,6,176,11,346,246,26,315,3,1123,1869,2992,8,5.5,202005
2,7,217,22,429,282,52,162,78,1242,1958,3200,12,5,202005
2,8,158,11,346,223,20,216,66,1040,1700,2740,6,5,202005
3,1,189,17,370,278,47,208,14,1123,1465,2588,12,5,202005
3,2,154,18,544,228,59,207,0,1210,1372,2582,9,5,202005
4,1,226,33,346,401,114,280,49,1449,2862,4311,11,5,202005
4,2,224,8,435,412,55,283,50,1467,1683,3150,14,5,202005
5,1,59,19,149,566,6,52,0,851,2715,3566,9,5,202005
5,2,30,7,63,384,4,18,0,506,1424,1930,10,5,202005
5,3,35,10,90,484,70,60,6,755,2716,3471,11,5,202005
5,4,33,15,185,795,5,58,1,1092,4454,5546,11,5,202005
5,5,68,16,202,673,5,42,22,1028,2938,3966,10,5,202005
5,6,46,15,184,364,12,23,34,678,2393,3071,10,5,202005
5,7,44,11,83,391,1,34,61,625,1543,2168,11,5.5,202005
6,1,273,11,387,256,10,288,35,1260,2005,3265,12,5.2,202005
6,2,179,15,317,192,41,239,20,1003,1373,2376,9,5,202005
7,1,358,12,208,364,23,65,1,1031,745,1776,9,5,202005
7,2,231,11,171,1345,35,47,0,1840,1185,3025,9,5,202005
7,3,202,8,171,125,163,88,0,757,837,1594,7,5,202005
7,4,219,7,117,222,14,73,28,680,955,1635,11,5,202005
7,5,234,14,185,337,33,150,0,953,1092,2045,11,5,202005
7,6,275,16,469,336,59,257,12,1424,1152,2576,9,5.333333333,202005
7,7,248,16,268,290,112,213,12,1159,1189,2348,8,5,202005
7,8,203,44,174,281,131,157,37,1027,1437,2464,12,5,202005
7,9,202,13,293,362,33,234,9,1146,1585,2731,9,5,202005
7,10,181,6,256,405,11,117,0,976,1025,2001,9,5,202005
7,11,149,4,204,94,36,59,0,546,414,960,6,5,202005
7,12,227,5,336,550,12,69,19,1218,1482,2700,9,5,202005
7,13,77,18,106,1036,1,27,0,1265,453,1718,9,5,202005
8,1,108,10,288,137,32,161,8,744,911,1655,4,5,202005
8,2,247,81,702,579,35,162,12,1818,2734,4552,16,5,202005
8,3,167,36,334,295,43,111,140,1126,1719,2845,4,5,202005
8,4,153,29,496,342,43,281,62,1406,1720,3126,11,5,202005
8,5,191,78,408,409,67,116,1,1270,1296,2566,10,5,202005
8,6,138,58,372,329,42,171,24,1134,2358,3492,9,6,202005
8,7,173,102,233,263,10,204,0,985,1156,2141,7,5,202005
8,8,226,45,531,617,12,546,1,1978,2326,4304,10,5,202005
8,9,164,44,221,186,63,176,79,933,796,1729,10,4.8,202005
9,1,95,10,151,145,80,157,6,644,599,1243,5,5,202005
9,2,310,85,669,540,141,560,36,2341,3009,5350,12,5,202005
9,3,116,16,320,277,131,259,37,1156,1276,2432,7,5,202005
9,4,199,39,428,431,160,260,2,1519,2055,3574,11,5,202005
9,5,155,13,232,258,67,317,0,1042,1476,2518,7,5,202005
9,6,100,33,165,155,145,170,22,790,1120,1910,7,5,202005
9,7,96,13,515,292,3,109,13,1041,996,2037,9,5,202005
9,8,93,18,302,236,46,240,22,957,1067,2024,5,5,202005
9,9,112,5,237,261,91,206,1,913,892,1805,5,5,202005
9,10,113,13,419,275,55,227,19,1121,1158,2279,6,5,202005
9,11,170,21,465,395,151,331,23,1556,1482,3038,7,5,202005
9,12,185,19,526,481,52,339,36,1638,2671,4309,11,5,202005
9,13,114,14,269,228,88,252,8,973,1198,2171,4,5,202005
9,14,103,4,167,179,43,209,13,718,582,1300,5,5,202005
9,15,254,24,946,684,77,481,37,2503,2858,5361,10,5.5,202005
9,16,182,238,399,645,68,222,4,1758,2198,3956,15,5,202005
9,17,107,7,231,213,30,164,6,758,522,1280,6,5,202005
9,18,122,18,342,393,114,341,24,1354,1354,2708,12,5,202005
9,19,175,31,300,310,151,315,13,1295,1155,2450,5,5,202005
9,20,69,10,134,151,57,90,12,523,269,792,5,5,202005
9,21,143,8,208,232,67,183,14,855,695,1550,3,5,202005
9,22,144,14,219,244,124,217,20,982,1145,2127,5,5,202005
9,23,76,8,289,163,54,121,2,713,694,1407,6,5,202005
9,24,272,67,610,585,311,479,14,2338,1532,3870,14,5,202005
10,1,250,24,236,272,24,211,91,1108,1423,2531,12,4.5,202005
10,2,197,29,485,490,30,223,36,1490,1967,3457,9,5,202005
10,3,231,44,270,275,33,298,105,1256,1223,2479,11,5,202005
10,4,229,33,473,574,15,331,2,1657,2596,4253,12,5.5,202005
11,1,198,78,219,310,63,232,11,1111,1209,2320,6,5,202005
11,2,187,51,303,213,153,213,13,1133,853,1986,7,5,202005
11,3,105,38,182,165,33,206,2,731,1055,1786,3,5,202005
11,4,154,57,212,219,70,174,1,887,926,1813,8,5.333333333,202005
11,5,212,75,401,535,24,201,48,1496,1548,3044,7,5,202005
11,6,149,42,288,260,42,166,11,958,1179,2137,8,5,202005
11,7,201,55,334,547,30,206,0,1373,1485,2858,9,5,202005
11,8,190,65,291,397,129,225,21,1318,907,2225,9,5,202005
11,9,189,55,293,386,13,306,5,1247,1119,2366,10,5,202005
11,10,230,49,285,254,39,367,30,1254,1686,2940,10,5,202005
11,11,152,49,321,377,17,161,0,1077,1778,2855,5,5,202005
11,12,193,83,455,441,35,258,5,1470,1727,3197,7,5,202005
11,13,197,46,274,239,57,238,27,1078,942,2020,8,5,202005
11,14,207,47,343,233,91,185,1,1107,1121,2228,8,5,202005
11,15,146,49,237,249,30,207,15,933,892,1825,9,5,202005
12,1,159,26,223,163,71,242,4,888,1072,1960,10,5,202005
12,2,166,13,221,350,23,353,10,1136,1664,2800,10,5,202005
12,3,207,30,317,533,18,113,1,1219,1109,2328,11,5,202005
12,4,184,20,442,501,44,238,1,1430,2135,3565,9,5,202005
12,5,162,21,205,217,12,71,59,747,988,1735,10,5,202005
12,6,131,19,176,234,33,37,5,635,1224,1859,10,5,202005
12,7,200,23,259,325,152,242,4,1205,1750,2955,6,4,202005
12,8,237,26,220,386,2,195,1,1067,1075,2142,9,5,202005
12,9,179,35,343,443,64,113,10,1187,2220,3407,9,5,202005
13,1,147,20,113,323,79,35,103,820,1665,2485,9,5,202005
13,2,126,15,94,349,62,73,28,747,1410,2157,6,5,202005
13,3,140,52,219,506,154,35,8,1114,1702,2816,12,5,202005
13,4,137,23,262,643,77,30,2,1174,2209,3383,9,5,202005
13,5,118,17,267,967,46,68,0,1483,2970,4453,9,5,202005
13,6,140,97,288,1213,34,62,0,1834,3109,4943,11,5,202005
13,7,97,13,176,845,11,22,0,1164,2038,3202,8,5,202005
14,1,147,66,190,81,130,97,17,728,550,1278,6,5,202005
14,2,156,18,181,74,94,196,1,720,612,1332,5,5,202005
14,3,234,27,327,105,16,224,1,934,824,1758,8,5,202005
14,4,181,18,369,302,26,338,19,1253,1113,2366,10,5,202005
14,5,171,24,480,204,33,247,3,1162,632,1794,9,5,202005
14,6,212,17,740,282,25,163,3,1442,549,1991,11,5,202005
14,7,145,16,304,146,0,55,0,666,540,1206,6,5,202005
14,8,357,50,979,724,49,473,5,2637,2760,5397,11,5.25,202005
14,9,154,20,294,347,29,185,12,1041,1798,2839,11,5,202005
14,10,149,56,493,247,9,223,18,1195,1042,2237,7,5,202005
14,11,92,8,142,122,17,221,32,634,643,1277,4,5,202005
14,12,227,29,649,167,43,88,0,1203,955,2158,9,5,202005
14,13,175,18,386,221,13,206,14,1033,1291,2324,6,5,202005
14,14,144,26,294,257,34,366,15,1136,1554,2690,7,5,202005
14,15,259,48,303,158,83,373,2,1226,1438,2664,10,5,202005
14,16,157,25,342,159,38,195,10,926,797,1723,5,5,202005
14,17,216,50,296,85,75,279,8,1009,700,1709,7,5,202005
14,18,279,63,393,157,150,311,36,1389,1149,2538,9,5,202005
14,19,233,28,413,135,73,186,17,1085,1335,2420,8,5,202005
14,20,237,24,466,268,7,127,0,1129,1170,2299,10,5,202005
15,1,215,21,170,119,271,265,0,1061,806,1867,7,5,202005
15,2,164,16,313,258,155,128,21,1055,1306,2361,6,5,202005
15,3,285,36,228,254,353,264,35,1455,1708,3163,10,5,202005
15,4,151,11,184,373,73,182,20,994,1014,2008,4,5,202005
15,5,158,24,330,287,48,127,14,988,1196,2184,8,5,202005
15,6,162,8,322,390,39,192,34,1147,1672,2819,7,5,202005
15,7,150,11,355,221,73,272,0,1082,1637,2719,10,5,202005
15,8,92,17,186,220,24,158,6,703,1244,1947,4,5,202005
15,9,247,8,174,116,164,324,0,1033,927,1960,9,5,202005
15,10,135,6,215,287,15,216,1,875,1166,2041,6,5,202005
15,11,151,38,295,310,49,164,32,1039,1666,2705,8,5,202005
15,12,209,12,493,436,123,165,3,1441,1842,3283,8,5,202005
15,13,76,19,156,155,126,140,0,672,866,1538,8,5,202005
15,14,68,43,143,193,44,114,11,616,664,1280,4,5,202005
15,15,121,188,275,361,88,77,3,1113,965,2078,6,5,202005
15,16,248,31,490,581,31,295,23,1699,935,2634,8,5,202005
15,17,124,10,200,257,29,243,31,894,421,1315,8,5,202005
15,18,267,15,355,415,37,238,20,1347,941,2288,7,5,202005
15,19,184,56,467,684,50,336,32,1809,1815,3624,10,5,202005
15,20,65,14,323,255,26,95,5,783,464,1247,6,5,202005
15,21,89,14,103,166,51,198,13,634,513,1147,6,5,202005
15,22,235,167,589,676,36,264,52,2019,1559,3578,14,5,202005
15,23,231,12,306,379,40,229,1,1198,987,2185,6,5,202005
15,24,135,32,266,271,57,112,17,890,500,1390,4,5,202005
15,25,201,33,283,271,55,196,9,1048,612,1660,6,5,202005
15,26,136,4,163,192,102,164,2,763,556,1319,9,6,202005
15,27,207,24,476,402,29,285,50,1473,1065,2538,9,5,202005
15,28,196,45,544,372,59,151,34,1401,1246,2647,9,5,202005
15,29,222,22,480,617,16,386,15,1758,1622,3380,8,5,202005
15,30,212,35,444,504,70,206,57,1528,918,2446,16,5,202005
15,31,117,188,209,283,17,90,2,906,478,1384,6,5,202005
15,32,164,16,259,336,60,159,2,996,660,1656,9,5,202005
15,33,181,25,461,292,51,139,0,1149,784,1933,7,5,202005
15,34,177,15,307,440,19,126,11,1095,727,1822,8,5,202005
15,35,331,26,308,613,11,209,25,1523,755,2278,9,5,202005
15,36,261,19,312,355,126,254,17,1344,883,2227,9,5,202005
15,37,234,31,394,492,121,356,29,1657,768,2425,7,5,202005
15,38,219,74,359,342,78,175,15,1262,611,1873,6,5,202005
15,39,152,29,277,270,48,176,6,958,1330,2288,4,5,202005
15,40,294,100,239,424,209,278,11,1555,1299,2854,9,5,202005
15,41,282,37,641,557,97,293,32,1939,2056,3995,13,5,202005
16,1,169,26,336,117,35,108,4,795,1125,1920,7,5,202005
16,2,163,34,167,178,16,134,15,707,895,1602,9,5,202005
16,3,225,30,202,303,33,206,3,1002,1163,2165,10,5,202005
16,4,223,47,329,220,84,130,0,1033,756,1789,8,5,202005
16,5,209,28,187,221,68,240,33,986,1365,2351,10,5,202005
16,6,172,52,222,184,61,161,0,852,935,1787,12,5,202005
16,7,195,52,260,275,49,123,14,968,1175,2143,9,5,202005
16,8,278,46,622,522,18,262,10,1758,2081,3839,12,5,202005
16,9,189,21,269,306,8,198,51,1042,1974,3016,9,5,202005
16,10,156,27,416,359,21,168,0,1147,1454,2601,6,5,202005
16,11,206,45,266,165,79,206,7,974,936,1910,10,5,202005
16,12,177,31,259,178,41,283,4,973,912,1885,10,5,202005
17,1,151,31,480,488,55,197,7,1409,2286,3695,9,6,202005
17,2,119,14,325,361,21,209,6,1055,1647,2702,8,5,202005
17,3,264,28,493,510,43,289,0,1627,2281,3908,8,5,202005
17,4,208,26,465,442,36,133,22,1332,2260,3592,10,5,202005
17,5,100,12,192,144,30,137,0,615,688,1303,5,5,202005
18,1,205,21,192,214,55,176,113,976,761,1737,7,5,202005
18,2,254,32,364,340,46,393,0,1429,2797,4226,9,5.333333333,202005
18,3,195,22,457,235,17,138,5,1069,1017,2086,8,5,202005
19,1,150,22,349,336,23,252,50,1182,1996,3178,9,5,202005
19,2,234,33,785,467,39,191,0,1749,2222,3971,9,5,202005
19,3,219,15,522,290,32,312,7,1397,2084,3481,7,5,202005
19,4,94,15,174,102,42,263,44,734,939,1673,5,5,202005
19,5,257,25,593,550,17,486,23,1951,3317,5268,8,5,202005
19,6,66,10,195,231,9,196,6,713,1038,1751,5,5,202005
19,7,217,14,622,217,16,134,1,1221,777,1998,10,5,202005
19,8,67,14,222,158,10,53,1,525,681,1206,7,5,202005
19,9,214,24,344,344,42,229,6,1203,415,1618,9,5,202005
19,10,104,12,228,165,15,245,14,783,530,1313,7,7,202005
19,11,333,47,557,675,16,675,51,2354,1372,3726,13,5,202005
19,12,208,14,692,188,21,161,17,1301,1030,2331,13,5,202005
20,1,223,16,196,237,139,127,35,973,1355,2328,7,5,202005
20,2,109,15,159,129,50,58,9,529,576,1105,6,5,202005
20,3,115,6,163,149,122,127,20,702,925,1627,6,5,202005
20,4,132,9,100,92,34,176,34,577,846,1423,6,5,202005
20,5,185,12,314,387,25,76,1,1000,1435,2435,11,5,202005
20,6,154,11,175,162,154,119,118,893,1009,1902,8,5,202005
20,7,128,11,208,347,28,103,6,831,1066,1897,7,5,202005
20,8,434,63,652,606,61,550,54,2420,3190,5610,15,6.5,202005
20,9,215,16,214,165,174,186,21,991,999,1990,8,5,202005
20,10,177,10,311,188,23,136,16,861,737,1598,9,5,202005
21,1,155,9,302,221,41,131,6,865,1182,2047,9,5,202005
21,2,201,20,314,172,139,158,0,1004,1062,2066,9,5,202005
21,3,290,11,297,186,88,271,24,1167,1842,3009,8,5,202005
21,4,140,4,119,92,87,175,5,622,828,1450,6,5,202005
21,5,241,22,503,266,28,144,18,1222,1200,2422,8,5,202005
21,6,240,12,327,273,72,349,21,1294,1087,2381,6,5,202005
21,7,314,15,202,260,67,297,2,1157,756,1913,9,5,202005
21,8,264,20,356,239,73,259,52,1263,740,2003,9,5,202005
21,9,236,23,546,408,90,237,29,1569,1115,2684,9,5,202005
21,10,228,19,393,320,41,278,45,1324,1245,2569,7,5,202005
21,11,88,8,194,140,42,73,7,552,285,837,4,5,202005
21,12,355,40,1066,603,163,227,244,2698,2075,4773,16,5.5,202005
21,13,219,13,313,194,43,311,2,1095,1505,2600,8,5,202005
21,14,175,8,209,142,72,204,5,815,607,1422,12,5,202005
21,15,268,6,350,272,36,288,26,1246,2037,3283,7,5,202005
22,1,155,63,200,373,28,80,10,909,1272,2181,11,4,202005
22,2,76,27,234,175,124,84,7,727,845,1572,7,4,202005
22,3,210,49,699,518,19,207,5,1707,2742,4449,9,4,202005
22,4,182,32,576,354,22,249,5,1420,2038,3458,9,4.5,202005
22,5,133,15,323,210,66,130,24,901,1259,2160,10,4,202005
23,1,257,10,1069,282,54,175,11,1858,2153,4011,14,5,202005
23,2,168,36,687,445,41,60,0,1437,1367,2804,8,5,202005
23,3,247,17,1161,540,33,134,30,2162,2534,4696,19,0,202005
23,4,131,7,631,308,31,156,23,1287,1689,2976,6,5,202005
24,1,194,104,179,303,24,186,2,992,1187,2179,10,5,202005
24,2,158,49,268,219,17,156,17,884,668,1552,6,5,202005
24,3,198,95,256,345,113,124,11,1142,1241,2383,9,5,202005
24,4,151,19,253,185,62,239,40,949,1328,2277,5,5,202005
24,5,256,53,596,561,14,156,10,1646,2391,4037,10,5.333333333,202005
24,6,184,107,478,378,117,223,1,1488,1032,2520,6,5,202005
24,7,227,40,285,372,120,53,0,1097,1182,2279,9,5,202005
25,1,149,7,249,274,47,164,36,926,1463,2389,13,5,202005
25,2,215,74,440,517,24,263,7,1540,1902,3442,7,5,202005
25,3,191,10,312,477,45,238,10,1283,1793,3076,8,5,202005
25,4,166,23,320,261,134,168,3,1075,1178,2253,8,5,202005
25,5,178,18,466,463,33,166,40,1364,2168,3532,8,5,202005
25,6,167,11,449,287,60,192,21,1187,1639,2826,8,5,202005
25,7,239,20,680,482,19,152,0,1592,1441,3033,6,5,202005
26,1,190,9,346,324,15,256,1,1141,1513,2654,9,5,202005
26,2,216,18,424,445,25,178,44,1350,1510,2860,12,5,202005
26,3,228,34,406,419,30,377,14,1508,1971,3479,13,5,202005
26,4,178,30,337,227,67,72,3,914,1366,2280,9,5,202005
26,5,168,10,235,257,25,272,0,967,1521,2488,15,5.5,202005
26,6,165,8,258,230,34,342,2,1039,1357,2396,10,5,202005
26,7,127,19,250,266,97,70,45,874,1128,2002,10,5,202005
27,1,167,10,241,311,168,136,4,1037,1113,2150,8,5,202005
27,2,220,17,273,573,33,119,1,1236,2017,3253,8,5,202005
27,3,186,7,211,629,14,277,0,1324,1902,3226,7,5,202005
27,4,198,13,370,796,27,289,4,1697,2232,3929,8,5.5,202005
27,5,102,5,141,244,24,127,1,644,1017,1661,6,5,202005
27,6,205,18,265,510,10,266,9,1283,1268,2551,7,5,202005
28,1,160,45,602,417,6,165,0,1395,1873,3268,13,5,202005
28,2,167,24,497,272,34,283,127,1404,2050,3454,15,5,202005
28,3,135,19,309,199,7,93,30,792,828,1620,7,5,202005
28,4,284,35,583,338,78,280,70,1668,1039,2707,18,6.5,202005
28,5,168,16,228,311,15,377,46,1161,2091,3252,10,5.25,202005
28,6,156,33,236,937,148,110,9,1629,1445,3074,13,5,202005
28,7,189,23,467,306,89,426,13,1513,2123,3636,13,5,202005
28,8,111,12,274,209,29,321,15,971,1254,2225,13,6,202005
28,9,158,18,440,219,38,208,46,1127,1084,2211,11,5,202005
29,1,269,21,347,423,38,288,18,1404,2039,3443,7,5,202005
29,2,238,19,272,480,28,359,81,1477,2316,3793,11,5.333333333,202005
29,3,113,21,185,383,23,166,4,895,1457,2352,6,5,202005
30,1,114,18,188,198,116,109,9,752,1133,1885,7,5,202005
30,2,182,12,159,90,43,147,218,851,1274,2125,8,5,202005
30,3,177,10,321,180,130,212,49,1079,1390,2469,6,5,202005
30,4,114,10,327,129,39,168,0,787,1114,1901,8,5,202005
30,5,153,11,344,173,44,99,13,837,1120,1957,7,5,202005
30,6,179,21,325,263,29,126,15,958,1342,2300,9,5,202005
30,7,230,20,344,238,159,114,81,1186,1543,2729,11,5,202005
30,8,187,29,541,273,99,217,35,1381,1246,2627,11,5,202005
30,9,249,5,271,216,114,229,29,1113,1077,2190,8,5,202005
30,10,173,23,457,258,44,293,19,1267,1215,2482,7,5.5,202005
30,11,182,26,625,449,25,163,3,1473,772,2245,5,5,202005
30,12,247,25,776,388,28,357,9,1830,2157,3987,10,5,202005
30,13,291,17,245,259,164,401,74,1451,1549,3000,10,5,202005
30,14,169,16,313,200,133,182,33,1046,1258,2304,8,5,202005
30,15,296,23,276,230,164,342,67,1398,1219,2617,11,5,202005
30,16,158,8,362,404,123,170,113,1338,1551,2889,10,5,202005
30,17,207,24,271,237,26,287,79,1131,1127,2258,8,5,202005
30,18,184,12,115,133,58,162,29,693,572,1265,8,5,202005
30,19,195,10,399,240,37,208,25,1114,1236,2350,13,5,202005
30,20,172,11,161,392,63,216,1,1016,1225,2241,10,3.8,202005
31,1,241,24,362,32,274,125,1,1059,824,1883,8,5,202005
31,2,133,12,148,20,185,317,0,815,624,1439,6,5,202005
31,3,427,137,1167,747,161,242,0,2881,4147,7028,20,5,202005
31,4,116,14,291,142,172,199,60,994,1665,2659,4,5,202005
31,5,149,13,146,192,49,228,21,798,740,1538,6,5,202005
32,1,161,50,234,172,60,233,34,944,971,1915,12,5,202005
32,2,183,39,242,139,117,222,47,989,927,1916,13,5,202005
32,3,188,80,227,420,11,259,3,1188,1386,2574,13,5,202005
32,4,219,58,222,314,15,192,38,1058,1214,2272,12,5,202005
1,1,181,37,311,326,69,132,8,1064,1508,2572,13,4.5,202006
1,2,220,57,564,412,59,301,3,1616,2251,3867,10,5.333333333,202006
1,3,165,63,508,332,47,257,32,1404,2093,3497,9,5,202006
2,1,160,9,355,269,47,362,50,1252,1845,3097,11,5,202006
2,2,114,11,298,347,15,336,0,1121,1494,2615,7,5,202006
2,3,169,9,343,268,11,424,17,1241,2064,3305,12,5,202006
2,4,125,8,603,199,85,121,22,1163,1667,2830,9,5,202006
2,5,174,13,563,271,136,346,8,1511,2630,4141,11,5,202006
2,6,127,13,324,218,29,291,2,1004,1993,2997,8,5.5,202006
2,7,169,18,405,311,47,151,37,1138,1831,2969,12,4.75,202006
2,8,121,9,262,226,28,206,38,890,1436,2326,6,5,202006
3,1,142,10,383,313,48,189,5,1090,1397,2487,12,4.666666667,202006
3,2,108,15,465,203,39,192,0,1022,1281,2303,9,4.666666667,202006
4,1,147,30,275,347,92,186,22,1099,1873,2972,11,4.25,202006
4,2,181,16,367,431,118,191,58,1362,1463,2825,14,4.2,202006
5,1,49,21,143,110,11,69,21,424,1163,1587,9,4.666666667,202006
5,2,51,14,92,191,10,62,3,423,2066,2489,10,4.2,202006
5,3,27,8,97,161,23,53,19,388,1604,1992,11,4.333333333,202006
5,4,43,11,131,317,5,37,12,556,2799,3355,11,4.75,202006
5,5,56,9,176,319,24,92,26,702,1943,2645,10,5,202006
5,6,48,10,131,140,12,44,24,409,1061,1470,10,4.5,202006
5,7,17,6,47,200,5,34,31,340,1646,1986,10,4.5,202006
6,1,168,11,275,200,13,259,29,955,1333,2288,11,4.8,202006
6,2,92,8,250,152,39,193,23,757,1019,1776,9,4.666666667,202006
7,1,208,12,220,321,8,61,0,830,1129,1959,9,4.25,202006
7,2,245,8,102,303,25,26,0,709,1125,1834,9,4.25,202006
7,3,221,5,179,157,161,62,0,785,746,1531,7,4.333333333,202006
7,4,167,7,117,212,26,61,32,622,754,1376,11,4.4,202006
7,5,222,11,164,437,32,112,0,978,1222,2200,11,4.666666667,202006
7,6,205,15,392,277,59,207,7,1162,1420,2582,9,4.666666667,202006
7,7,145,14,223,234,96,172,13,897,1433,2330,8,4.5,202006
7,8,159,41,198,282,44,126,28,878,1388,2266,12,4.25,202006
7,9,157,10,292,386,22,207,8,1082,1768,2850,9,4.666666667,202006
7,10,103,4,133,476,22,102,0,840,1621,2461,9,4.5,202006
7,11,107,0,146,84,22,39,0,398,792,1190,6,4.333333333,202006
7,12,171,6,386,666,12,57,16,1314,1760,3074,9,4.5,202006
7,13,121,23,109,941,0,24,0,1218,900,2118,9,4.25,202006
8,1,80,5,307,144,14,151,7,708,919,1627,4,5,202006
8,2,197,70,561,387,32,124,6,1377,3298,4675,16,4.5,202006
8,3,118,21,342,289,25,96,60,951,1149,2100,4,5,202006
8,4,124,23,385,306,37,194,52,1121,1996,3117,11,5,202006
8,5,164,72,342,380,75,131,4,1168,1323,2491,10,4.25,202006
8,6,122,39,316,318,45,165,16,1021,1694,2715,9,6,202006
8,7,139,52,197,272,9,156,0,825,1238,2063,7,4.25,202006
8,8,170,34,469,524,9,442,2,1650,3405,5055,10,5,202006
8,9,169,29,219,152,49,196,68,882,646,1528,10,4,202006
9,1,83,12,113,125,84,118,7,542,1055,1597,5,5,202006
9,2,213,60,567,477,132,458,36,1943,4019,5962,12,5,202006
9,3,75,21,268,270,100,256,13,1003,1847,2850,7,5,202006
9,4,143,51,437,422,172,287,1,1513,2261,3774,11,5,202006
9,5,168,11,195,220,44,262,1,901,1372,2273,7,5,202006
9,6,62,16,184,149,104,194,9,718,1434,2152,7,5,202006
9,7,64,15,467,261,9,116,22,954,1272,2226,9,5,202006
9,8,76,6,285,303,39,232,26,967,1252,2219,5,5,202006
9,9,78,10,178,259,74,184,2,785,1650,2435,5,5,202006
9,10,88,14,426,320,39,235,17,1139,1070,2209,6,5,202006
9,11,105,10,291,359,98,255,11,1129,2238,3367,7,5,202006
9,12,157,16,551,480,48,313,29,1594,2890,4484,11,5,202006
9,13,72,10,267,233,81,213,4,880,1697,2577,4,5,202006
9,14,77,6,130,199,55,187,23,677,1153,1830,5,5,202006
9,15,167,21,865,691,68,436,32,2280,4173,6453,10,5.5,202006
9,16,162,204,399,590,87,170,9,1621,3037,4658,15,5,202006
9,17,93,8,195,209,39,175,2,721,996,1717,6,5,202006
9,18,117,18,300,378,94,311,21,1239,2334,3573,12,5,202006
9,19,112,22,283,266,116,255,6,1060,2413,3473,5,5,202006
9,20,53,6,133,141,57,90,4,484,550,1034,5,5,202006
9,21,76,9,157,198,56,167,37,700,1702,2402,3,5,202006
9,22,95,15,211,250,103,180,8,862,1695,2557,5,5,202006
9,23,93,18,325,231,75,200,3,945,1878,2823,6,5,202006
9,24,202,46,588,595,267,373,10,2081,3267,5348,14,5,202006
10,1,193,25,215,201,29,230,69,962,1004,1966,12,3.833333333,202006
10,2,135,9,321,383,38,170,29,1085,1370,2455,9,4.25,202006
10,3,141,41,212,230,24,221,66,935,1763,2698,11,4.4,202006
10,4,202,24,414,551,25,281,3,1500,2462,3962,12,5.5,202006
11,1,149,62,188,249,49,157,3,857,1567,2424,6,4.666666667,202006
11,2,149,36,265,193,110,205,8,966,1239,2205,7,5,202006
11,3,92,27,199,180,25,165,4,692,1249,1941,3,5,202006
11,4,115,64,177,211,72,171,0,810,1441,2251,8,5,202006
11,5,183,52,339,457,35,179,39,1284,2794,4078,7,5,202006
11,6,105,27,277,244,43,105,9,810,1644,2454,8,5,202006
11,7,172,56,322,574,32,172,7,1335,1854,3189,9,4.5,202006
11,8,140,53,272,389,135,198,17,1204,2374,3578,9,4.75,202006
11,9,142,43,251,307,14,253,18,1028,2120,3148,10,4.666666667,202006
11,10,156,61,186,215,36,292,41,987,1975,2962,10,4.6,202006
11,11,148,38,268,339,15,155,0,963,1580,2543,5,5,202006
11,12,132,78,376,406,14,225,2,1233,2246,3479,7,5,202006
11,13,127,39,200,185,33,162,16,762,1646,2408,8,4.5,202006
11,14,125,38,255,191,71,137,0,817,1407,2224,8,4.5,202006
11,15,130,29,222,222,8,176,19,806,1279,2085,9,5,202006
12,1,141,33,205,188,59,256,0,882,858,1740,10,4.2,202006
12,2,176,37,223,398,17,294,24,1169,1276,2445,10,4.5,202006
12,3,187,33,255,910,43,103,0,1531,860,2391,11,4.2,202006
12,4,171,29,360,457,42,197,0,1256,1388,2644,9,4.666666667,202006
12,5,185,23,216,287,2,78,47,838,1145,1983,10,4.25,202006
12,6,105,22,163,223,26,28,1,568,823,1391,10,4.25,202006
12,7,222,20,285,384,55,258,77,1301,1395,2696,6,4.5,202006
12,8,168,17,205,262,2,96,0,750,890,1640,9,4.25,202006
12,9,154,21,371,407,58,93,7,1111,1516,2627,9,4.666666667,202006
13,1,79,7,68,113,82,20,106,475,1439,1914,9,4.333333333,202006
13,2,76,12,58,120,57,66,22,411,902,1313,6,4.333333333,202006
13,3,72,15,153,182,105,72,13,612,1382,1994,12,4.25,202006
13,4,82,15,167,237,98,60,17,676,2026,2702,9,4.666666667,202006
13,5,71,8,163,293,62,68,29,694,2255,2949,9,4.75,202006
13,6,138,62,376,679,22,155,121,1553,3187,4740,11,4.666666667,202006
13,7,65,13,175,339,21,80,4,697,1661,2358,8,4.5,202006
14,1,148,48,155,88,120,96,20,675,597,1272,6,4.5,202006
14,2,148,18,183,91,64,154,3,661,993,1654,5,4.666666667,202006
14,3,219,24,268,88,12,197,0,808,1128,1936,8,4.4,202006
14,4,124,14,266,279,32,256,12,983,1935,2918,10,5,202006
14,5,127,19,365,188,33,186,0,918,1254,2172,9,4.5,202006
14,6,172,21,552,274,28,159,0,1206,2079,3285,11,5,202006
14,7,88,16,220,115,0,51,0,490,836,1326,6,5,202006
14,8,297,43,809,628,34,415,1,2227,3466,5693,11,5.25,202006
14,9,105,14,263,298,9,169,10,868,1225,2093,11,5,202006
14,10,150,57,426,194,3,192,8,1030,1498,2528,7,5,202006
14,11,79,14,122,97,14,194,21,541,985,1526,4,5,202006
14,12,151,23,482,146,39,105,0,946,1585,2531,9,4.5,202006
14,13,157,20,403,212,14,201,9,1016,1446,2462,6,5,202006
14,14,109,15,243,212,29,288,4,900,1654,2554,7,5,202006
14,15,157,52,219,146,88,270,2,934,1603,2537,10,4.6,202006
14,16,105,23,303,145,40,153,6,775,1253,2028,5,5,202006
14,17,134,27,243,62,46,201,2,715,938,1653,7,4.25,202006
14,18,172,29,249,117,89,260,18,934,1191,2125,9,4.4,202006
14,19,145,37,313,190,69,186,21,961,1286,2247,8,4.25,202006
14,20,184,34,445,221,3,122,2,1011,1785,2796,10,4.666666667,202006
15,1,150,20,186,86,245,215,0,902,1089,1991,7,4.333333333,202006
15,2,103,15,241,285,119,124,15,902,1281,2183,6,5,202006
15,3,175,27,171,201,301,272,36,1183,2138,3321,10,4.666666667,202006
15,4,122,26,164,297,58,159,10,836,1412,2248,4,5,202006
15,5,106,25,279,241,26,137,10,824,1673,2497,8,4.666666667,202006
15,6,136,14,308,417,22,161,26,1084,1748,2832,7,5,202006
15,7,125,16,276,211,84,191,0,903,1515,2418,10,5,202006
15,8,67,17,203,240,19,128,18,692,1006,1698,4,5,202006
15,9,188,1,142,106,117,273,3,830,1300,2130,9,4.75,202006
15,10,95,5,211,317,23,184,9,844,1844,2688,6,5,202006
15,11,124,31,261,321,51,131,22,941,1849,2790,8,5,202006
15,12,165,12,449,424,93,154,2,1299,1976,3275,8,5,202006
15,13,70,11,172,151,107,135,1,647,936,1583,8,5,202006
15,14,45,17,127,184,39,133,5,550,858,1408,4,5,202006
15,15,107,182,243,287,43,76,1,939,1675,2614,6,5,202006
15,16,174,18,358,486,32,291,15,1374,3645,5019,8,5,202006
15,17,95,11,159,196,30,197,24,712,1684,2396,8,5,202006
15,18,162,20,332,364,43,192,16,1129,1587,2716,7,4.666666667,202006
15,19,145,39,399,630,26,277,21,1537,2706,4243,10,5,202006
15,20,68,16,256,234,28,79,5,686,827,1513,6,5,202006
15,21,66,6,83,139,37,137,7,475,819,1294,6,4.5,202006
15,22,206,135,493,623,32,210,36,1735,2807,4542,14,5,202006
15,23,115,14,228,323,47,98,3,828,944,1772,6,4.333333333,202006
15,24,93,24,225,242,48,106,16,754,1500,2254,4,5,202006
15,25,110,16,254,248,47,170,16,861,926,1787,6,5,202006
15,26,88,6,145,240,119,138,16,752,1033,1785,9,6,202006
15,27,154,18,356,399,22,254,31,1234,1439,2673,9,4.666666667,202006
15,28,145,33,464,295,71,146,17,1171,1274,2445,9,4.666666667,202006
15,29,171,17,425,581,14,327,8,1543,1346,2889,8,5,202006
15,30,176,28,400,436,83,191,40,1354,1326,2680,16,5,202006
15,31,97,170,144,263,16,71,7,768,671,1439,6,5,202006
15,32,133,21,251,307,53,179,6,950,946,1896,9,5,202006
15,33,137,17,356,326,30,165,1,1032,871,1903,7,5,202006
15,34,110,13,243,414,32,110,24,946,1065,2011,8,5,202006
15,35,207,22,293,559,9,169,9,1268,714,1982,9,4.666666667,202006
15,36,173,10,235,311,135,220,8,1092,671,1763,9,4.5,202006
15,37,165,15,323,428,105,309,18,1363,975,2338,7,5,202006
15,38,105,44,282,324,49,139,21,964,1403,2367,6,4.5,202006
15,39,125,18,212,256,39,166,0,816,1426,2242,4,5,202006
15,40,216,47,242,413,134,240,1,1293,1762,3055,9,5,202006
15,41,205,21,562,501,87,231,19,1626,2284,3910,13,5,202006
16,1,136,25,327,153,19,93,0,753,1017,1770,7,4.333333333,202006
16,2,111,51,152,146,9,161,7,637,805,1442,9,4.25,202006
16,3,176,26,157,238,25,165,3,790,1255,2045,10,4.25,202006
16,4,178,32,239,148,73,88,0,758,1176,1934,8,4.5,202006
16,5,164,21,195,211,55,183,24,853,1032,1885,10,4.666666667,202006
16,6,128,41,179,199,50,139,0,736,1180,1916,12,4.5,202006
16,7,186,42,261,227,39,132,16,903,1211,2114,9,4.5,202006
16,8,232,34,518,462,17,204,12,1479,2798,4277,12,5,202006
16,9,175,17,245,283,13,211,14,958,1433,2391,9,5,202006
16,10,137,15,336,322,19,152,1,982,1355,2337,6,5,202006
16,11,156,26,238,187,74,167,3,851,1329,2180,10,4.4,202006
16,12,134,25,158,104,12,171,2,606,827,1433,10,4.25,202006
17,1,120,18,381,451,55,144,6,1175,2058,3233,9,6,202006
17,2,117,8,288,367,23,186,7,996,1309,2305,8,4.666666667,202006
17,3,201,22,422,482,28,241,2,1398,2257,3655,8,4.5,202006
17,4,165,17,389,443,48,117,20,1199,1753,2952,10,4.666666667,202006
17,5,85,9,148,148,27,88,0,505,603,1108,5,4.5,202006
18,1,132,16,131,147,31,124,34,615,807,1422,7,4.25,202006
18,2,206,26,327,318,34,305,1,1217,2076,3293,8,5,202006
18,3,156,14,309,206,13,135,2,835,1347,2182,8,4.5,202006
19,1,138,19,349,329,23,248,24,1130,1482,2612,9,5,202006
19,2,208,22,736,428,27,192,0,1613,2515,4128,9,5,202006
19,3,190,17,482,277,47,257,11,1281,2586,3867,7,5,202006
19,4,80,8,148,110,41,240,32,659,1253,1912,5,5,202006
19,5,221,19,525,471,20,430,25,1711,2679,4390,8,6,202006
19,6,74,8,175,210,8,218,0,693,1145,1838,5,5,202006
19,7,192,15,468,240,13,137,4,1069,1808,2877,10,4.5,202006
19,8,77,11,221,171,6,56,1,543,1071,1614,7,5,202006
19,9,118,7,200,167,23,188,7,710,988,1698,9,4.25,202006
19,10,79,8,186,160,14,214,10,671,1197,1868,6,6,202006
19,11,199,30,503,556,22,587,43,1940,3591,5531,13,5,202006
19,12,153,8,572,177,14,140,16,1080,1525,2605,13,4.666666667,202006
20,1,159,12,196,208,118,81,83,857,1166,2023,7,4.5,202006
20,2,92,27,230,195,61,54,15,674,762,1436,6,4.333333333,202006
20,3,91,3,152,100,118,119,14,597,1181,1778,6,4.333333333,202006
20,4,100,14,89,58,33,176,26,496,765,1261,6,4.333333333,202006
20,5,141,11,313,381,38,92,0,976,947,1923,11,4.25,202006
20,6,102,4,143,116,83,59,93,600,829,1429,8,4.25,202006
20,7,137,13,219,315,32,98,11,825,904,1729,7,4.75,202006
20,8,331,46,587,558,46,488,43,2099,3463,5562,15,6,202006
20,9,179,4,173,149,133,176,8,822,1075,1897,8,4.666666667,202006
20,10,164,18,318,161,27,116,4,808,1088,1896,9,4.25,202006
21,1,146,19,384,250,75,107,0,981,1106,2087,9,4.4,202006
21,2,168,13,255,191,111,111,0,849,1100,1949,9,4.2,202006
21,3,213,20,304,177,62,291,16,1083,1433,2516,8,4.5,202006
21,4,200,7,207,97,68,200,12,791,671,1462,6,4.25,202006
21,5,171,22,450,254,20,130,9,1056,1906,2962,8,4.666666667,202006
21,6,152,15,301,259,73,285,14,1099,2195,3294,6,5,202006
21,7,191,12,196,227,48,240,1,915,1799,2714,9,4.666666667,202006
21,8,128,6,204,130,40,157,37,702,896,1598,9,4.2,202006
21,9,191,22,468,349,77,178,31,1316,3421,4737,9,5,202006
21,10,118,15,306,235,21,203,22,920,2271,3191,7,4.5,202006
21,11,56,4,212,107,49,48,8,484,544,1028,4,5,202006
21,12,246,28,803,555,136,284,214,2266,2648,4914,16,5.5,202006
21,13,182,4,335,200,32,257,1,1011,1851,2862,8,4.666666667,202006
21,14,161,10,209,104,78,139,6,707,1067,1774,12,4.333333333,202006
21,15,180,7,287,242,44,269,14,1043,1553,2596,7,4.5,202006
22,1,181,87,258,461,59,59,14,1119,1428,2547,11,4.2,202006
22,2,124,30,257,234,102,93,2,842,1183,2025,7,4.5,202006
22,3,273,50,823,664,20,269,3,2102,4286,6388,9,4.666666667,202006
22,4,164,43,661,420,26,266,10,1590,2983,4573,9,5.5,202006
22,5,136,27,394,228,47,132,44,1008,1844,2852,10,4.5,202006
23,1,170,8,964,270,37,159,15,1623,2655,4278,14,4.6,202006
23,2,167,28,573,428,28,45,0,1269,2000,3269,8,4.25,202006
23,3,181,12,997,596,39,136,29,1990,2989,4979,19,5,202006
23,4,120,5,518,283,33,148,23,1130,1445,2575,6,4.5,202006
24,1,84,72,165,197,14,135,4,671,953,1624,10,4.2,202006
24,2,97,16,187,149,22,119,16,606,1089,1695,6,4.5,202006
24,3,175,77,199,245,135,60,1,892,987,1879,9,4.25,202006
24,4,109,19,211,182,47,219,32,819,1082,1901,5,4.5,202006
24,5,171,55,533,526,14,143,6,1448,3110,4558,10,5.333333333,202006
24,6,145,94,403,323,57,214,0,1236,2170,3406,6,5,202006
24,7,153,19,208,279,72,54,0,785,1164,1949,9,4.25,202006
25,1,110,8,239,237,23,213,48,878,1269,2147,13,4.75,202006
25,2,186,43,381,377,28,187,0,1202,2129,3331,7,4.5,202006
25,3,133,15,227,471,52,179,8,1085,1672,2757,8,4.6,202006
25,4,146,18,210,249,94,126,0,843,1269,2112,8,4.333333333,202006
25,5,146,14,381,375,29,150,31,1126,2185,3311,8,4.666666667,202006
25,6,147,9,319,288,43,203,19,1028,1487,2515,8,4.75,202006
25,7,204,20,531,418,17,136,0,1326,3017,4343,6,5,202006
26,1,164,14,311,290,7,199,0,985,1398,2383,9,4.5,202006
26,2,182,12,403,383,21,201,47,1249,2225,3474,12,4.4,202006
26,3,168,26,324,358,30,320,26,1252,2445,3697,13,5,202006
26,4,112,11,213,204,80,49,8,677,1077,1754,9,4.2,202006
26,5,155,13,231,264,20,239,0,922,1442,2364,15,5,202006
26,6,134,8,200,172,21,241,0,776,1434,2210,10,4.333333333,202006
26,7,124,35,231,239,115,78,39,861,1000,1861,10,4.5,202006
27,1,128,17,274,362,95,121,5,1002,1342,2344,8,4.5,202006
27,2,164,13,235,508,41,111,3,1075,1438,2513,8,4.666666667,202006
27,3,162,5,231,508,30,197,9,1142,1854,2996,7,4.666666667,202006
27,4,139,15,338,666,35,255,13,1461,2316,3777,8,5,202006
27,5,89,4,131,240,12,102,0,578,884,1462,6,4.333333333,202006
27,6,87,9,163,413,4,141,12,829,1694,2523,7,4.5,202006
28,1,141,23,492,398,12,153,0,1219,2102,3321,13,5,202006
28,2,154,33,419,271,16,286,147,1326,1826,3152,15,4.666666667,202006
28,3,110,13,253,127,13,73,35,624,1068,1692,7,4.333333333,202006
28,4,205,27,503,309,72,229,51,1396,1829,3225,16,7.5,202006
28,5,121,16,223,287,19,288,52,1006,1265,2271,9,4.25,202006
28,6,114,34,190,887,57,93,10,1385,909,2294,13,4.166666667,202006
28,7,157,29,403,261,75,356,17,1298,1687,2985,13,5,202006
28,8,87,14,187,199,50,263,5,805,1138,1943,13,6,202006
28,9,142,8,352,193,40,175,27,937,874,1811,11,4.75,202006
29,1,168,28,281,383,44,249,24,1177,1960,3137,7,4.5,202006
29,2,214,15,271,445,29,310,76,1360,2684,4044,11,5,202006
29,3,102,14,121,299,23,168,1,728,1335,2063,6,4.666666667,202006
30,1,96,9,174,148,113,85,6,631,789,1420,7,4.333333333,202006
30,2,136,9,154,115,49,110,101,674,1134,1808,8,4.25,202006
30,3,126,11,202,149,98,163,39,788,1042,1830,6,4.666666667,202006
30,4,80,11,283,131,31,149,0,685,1351,2036,8,5,202006
30,5,100,9,256,193,40,101,19,718,1281,1999,7,4.5,202006
30,6,148,14,232,196,34,144,20,788,1132,1920,9,4.333333333,202006
30,7,107,16,284,202,112,96,74,891,1300,2191,11,4.25,202006
30,8,166,22,568,265,142,180,5,1348,1244,2592,11,4.4,202006
30,9,172,6,215,174,113,196,14,890,1350,2240,8,4.5,202006
30,10,132,12,402,231,20,247,15,1059,1608,2667,6,5,202006
30,11,104,9,447,319,13,130,1,1023,1154,2177,5,4.5,202006
30,12,158,15,668,377,24,330,6,1578,2346,3924,10,5,202006
30,13,128,9,127,193,84,230,54,825,1349,2174,10,4.4,202006
30,14,149,11,275,122,128,139,20,844,981,1825,8,4.5,202006
30,15,158,14,234,193,115,293,37,1044,1310,2354,11,4.666666667,202006
30,16,138,7,250,296,84,141,110,1026,1935,2961,10,4.333333333,202006
30,17,150,10,336,230,40,247,42,1055,799,1854,8,4.5,202006
30,18,213,19,105,113,31,130,22,633,258,891,8,4.25,202006
30,19,143,13,410,176,154,176,18,1090,536,1626,13,4.6,202006
30,20,143,8,174,393,141,202,14,1075,1410,2485,10,4.4,202006
31,1,147,20,272,48,266,94,0,847,1239,2086,8,4.5,202006
31,2,88,6,123,19,105,126,0,467,619,1086,6,4.333333333,202006
31,3,262,101,1123,633,143,202,0,2464,4630,7094,21,5.333333333,202006
31,4,96,6,324,146,141,184,31,928,1316,2244,4,5,202006
31,5,114,7,164,191,68,209,7,760,1149,1909,6,4.333333333,202006
32,1,137,38,161,157,45,198,20,756,1423,2179,12,4.2,202006
32,2,186,31,178,110,126,197,48,876,1023,1899,13,4.142857143,202006
32,3,130,47,176,320,10,197,3,883,1121,2004,13,4.4,202006
32,4,182,44,210,278,27,191,29,961,1373,2334,12,4.2,202006
1,1,143,47,279,320,86,121,6,1002,1216,2218,13,4.5,202007
1,2,204,47,586,445,56,285,10,1633,1923,3556,10,5.333333333,202007
1,3,161,74,547,328,55,268,29,1462,1729,3191,9,5,202007
2,1,166,16,345,281,37,335,38,1218,1499,2717,11,5,202007
2,2,116,16,238,298,8,350,0,1026,1468,2494,7,5,202007
2,3,161,10,318,284,10,376,20,1179,1610,2789,12,5,202007
2,4,144,14,594,221,83,107,25,1188,1336,2524,9,5,202007
2,5,176,17,534,229,167,356,10,1489,2291,3780,11,5,202007
2,6,118,14,336,203,34,295,1,1001,1357,2358,8,5.5,202007
2,7,154,15,406,264,55,155,54,1103,1225,2328,12,4.75,202007
2,8,95,13,295,186,28,176,42,835,1162,1997,6,5,202007
3,1,133,12,266,227,43,159,8,848,1197,2045,12,4.666666667,202007
3,2,98,14,478,185,32,156,0,963,1242,2205,9,4.666666667,202007
4,1,138,19,307,345,103,150,17,1079,1368,2447,11,4.25,202007
4,2,147,14,344,335,39,151,29,1059,1407,2466,14,4.2,202007
5,1,53,11,172,162,12,79,17,506,794,1300,9,4.666666667,202007
5,2,52,9,95,203,14,31,5,409,1123,1532,10,4.2,202007
5,3,33,8,105,165,51,85,22,469,1087,1556,11,4.333333333,202007
5,4,27,11,165,329,7,36,15,590,1525,2115,11,4.75,202007
5,5,46,19,150,346,11,130,37,739,1203,1942,10,5,202007
5,6,27,11,103,178,5,44,23,391,673,1064,10,4.5,202007
5,7,33,2,58,249,0,22,34,398,1146,1544,10,4.5,202007
6,1,147,17,323,213,11,268,21,1000,1204,2204,12,5,202007
6,2,106,15,265,156,37,191,30,800,1001,1801,9,4.666666667,202007
7,1,223,7,182,184,11,41,1,649,617,1266,9,4.25,202007
7,2,230,6,108,458,16,24,0,842,1705,2547,9,4.25,202007
7,3,240,6,206,147,117,67,0,783,1200,1983,7,4.333333333,202007
7,4,215,5,128,309,16,53,37,763,526,1289,11,4.4,202007
7,5,227,6,175,369,30,125,0,932,1201,2133,11,4.666666667,202007
7,6,191,14,320,254,27,121,7,934,1325,2259,9,4.666666667,202007
7,7,176,16,234,224,75,163,17,905,1107,2012,8,4.5,202007
7,8,188,31,179,302,34,142,34,910,1281,2191,12,4.25,202007
7,9,134,12,270,373,20,204,8,1021,1050,2071,9,4.666666667,202007
7,10,151,6,181,359,13,93,0,803,1400,2203,9,4.5,202007
7,11,138,7,179,109,40,32,0,505,595,1100,6,4.333333333,202007
7,12,198,11,349,588,14,61,12,1233,1374,2607,9,4.5,202007
7,13,123,32,97,848,1,30,0,1131,392,1523,9,4.25,202007
8,1,87,5,275,130,11,113,5,626,896,1522,4,5,202007
8,2,208,46,568,437,29,124,6,1418,1963,3381,16,4.25,202007
8,3,118,25,299,294,27,86,64,913,1208,2121,4,5,202007
8,4,168,54,429,286,18,150,33,1138,1741,2879,11,5,202007
8,5,159,64,252,367,43,100,6,991,1557,2548,10,4.25,202007
8,6,120,43,315,321,37,165,8,1009,1357,2366,9,6,202007
8,7,187,77,213,252,6,173,1,909,861,1770,7,4.25,202007
8,8,182,26,474,502,12,455,8,1659,2788,4447,10,5,202007
8,9,141,29,157,109,45,131,49,661,893,1554,10,4.2,202007
9,1,63,13,136,131,67,133,9,552,689,1241,5,5,202007
9,2,249,68,666,566,127,405,29,2110,2935,5045,12,5,202007
9,3,78,23,278,252,102,191,21,945,1446,2391,7,5,202007
9,4,136,42,441,475,156,258,4,1512,1740,3252,11,5,202007
9,5,151,13,216,217,59,253,0,909,993,1902,7,5,202007
9,6,86,9,193,152,106,212,6,764,1185,1949,7,5,202007
9,7,81,14,403,238,2,98,26,862,1040,1902,9,5,202007
9,8,65,12,239,282,43,191,22,854,1108,1962,5,5,202007
9,9,76,8,231,224,66,168,0,773,1059,1832,5,5,202007
9,10,82,14,429,304,54,214,7,1104,1127,2231,6,5,202007
9,11,90,19,327,371,112,262,9,1190,1776,2966,7,5,202007
9,12,122,22,498,429,51,303,33,1458,2054,3512,11,5,202007
9,13,89,13,290,226,69,184,9,880,1085,1965,4,5,202007
9,14,51,5,124,164,41,125,16,526,521,1047,5,4,202007
9,15,187,24,827,644,66,456,28,2232,3004,5236,10,5.5,202007
9,16,159,199,407,605,91,226,17,1704,2245,3949,15,5,202007
9,17,87,6,212,247,36,156,4,748,1055,1803,6,5,202007
9,18,118,17,276,338,81,308,28,1166,1788,2954,12,5,202007
9,19,119,25,287,285,148,248,15,1127,1835,2962,5,5,202007
9,20,40,6,121,154,66,82,8,477,664,1141,5,5,202007
9,21,97,3,171,235,52,154,14,726,958,1684,3,5,202007
9,22,117,12,240,235,91,168,13,876,1285,2161,5,5,202007
9,23,80,11,427,312,85,123,2,1040,1942,2982,6,5,202007
9,24,204,38,580,573,220,361,10,1986,3020,5006,14,5,202007
10,1,194,26,254,288,55,207,57,1081,915,1996,12,4.333333333,202007
10,2,184,16,370,375,38,201,25,1209,1537,2746,9,4.25,202007
10,3,138,25,211,231,42,228,33,908,1198,2106,11,4.4,202007
10,4,184,21,395,516,22,311,5,1454,1998,3452,12,5.5,202007
11,1,146,64,210,238,54,161,5,878,1439,2317,6,4.666666667,202007
11,2,144,54,238,211,129,220,10,1006,1224,2230,7,5,202007
11,3,97,32,213,209,22,135,6,714,979,1693,3,5,202007
11,4,109,65,197,227,83,191,0,872,1178,2050,7,5,202007
11,5,201,55,362,474,27,234,36,1389,1750,3139,7,5,202007
11,6,132,38,332,274,35,121,16,948,1072,2020,8,5,202007
11,7,175,115,362,540,28,93,4,1317,1462,2779,9,4.25,202007
11,8,141,49,275,426,114,218,15,1238,1654,2892,9,4.75,202007
11,9,173,44,317,367,12,273,20,1206,1567,2773,10,4.666666667,202007
11,10,184,42,251,290,44,305,46,1162,1596,2758,10,4.6,202007
11,11,144,50,306,331,19,186,1,1037,1112,2149,5,5,202007
11,12,156,81,427,429,19,221,4,1337,2074,3411,7,5,202007
11,13,101,51,219,188,33,191,20,803,1352,2155,8,4.5,202007
11,14,123,36,278,219,77,153,0,886,1303,2189,8,4.5,202007
11,15,122,35,231,246,11,191,12,848,1228,2076,9,5,202007
12,1,116,38,226,137,66,202,1,786,805,1591,10,4,202007
12,2,201,22,270,393,33,288,22,1229,1426,2655,10,4.5,202007
12,3,162,26,251,394,19,75,0,927,1072,1999,11,4.2,202007
12,4,159,28,326,388,35,199,0,1135,1353,2488,9,4.666666667,202007
12,5,210,27,198,246,4,91,64,840,573,1413,10,4.25,202007
12,6,143,28,255,310,99,31,12,878,702,1580,10,4.25,202007
12,7,159,23,322,296,15,112,87,1014,1256,2270,6,4.5,202007
12,8,160,18,229,330,2,111,0,850,556,1406,9,4.25,202007
12,9,135,25,342,364,76,90,9,1041,1537,2578,9,4.666666667,202007
13,1,57,8,77,128,70,35,86,461,934,1395,9,4.333333333,202007
13,2,94,16,63,148,70,49,40,480,857,1337,6,4.333333333,202007
13,3,101,34,169,211,72,62,52,701,993,1694,12,4.25,202007
13,4,79,19,147,226,76,85,41,673,1131,1804,9,4.666666667,202007
13,5,84,12,190,301,58,116,66,827,1182,2009,9,4.75,202007
13,6,130,162,328,568,30,113,126,1457,2562,4019,11,4.666666667,202007
13,7,42,2,156,319,17,77,1,614,1205,1819,8,4.5,202007
14,1,144,35,130,90,126,102,21,648,753,1401,6,4.5,202007
14,2,161,19,192,100,80,209,1,762,1120,1882,5,4.666666667,202007
14,3,203,27,360,91,12,219,2,914,1368,2282,8,4.4,202007
14,4,156,28,281,302,25,321,13,1126,2165,3291,10,5,202007
14,5,150,21,374,207,32,200,2,986,1915,2901,9,4.5,202007
14,6,156,20,554,226,34,146,8,1144,3068,4212,11,5,202007
14,7,79,15,209,100,0,53,0,456,1216,1672,6,5,202007
14,8,283,41,914,630,48,383,4,2303,3119,5422,11,5.25,202007
14,9,143,20,309,321,21,183,13,1010,1060,2070,11,5,202007
14,10,124,34,424,183,6,202,5,978,1515,2493,7,5,202007
14,11,88,15,115,103,18,170,26,535,1155,1690,4,5,202007
14,12,191,19,408,132,18,88,1,857,1487,2344,9,4.5,202007
14,13,149,24,490,210,6,122,7,1008,1179,2187,6,5,202007
14,14,136,25,259,227,30,310,12,999,1412,2411,7,5,202007
14,15,183,47,249,139,62,302,3,985,1167,2152,10,4.6,202007
14,16,118,20,269,124,36,166,5,738,1461,2199,5,5,202007
14,17,137,31,216,67,31,150,2,634,830,1464,7,4.25,202007
14,18,174,27,196,85,109,213,28,832,1124,1956,9,3.8,202007
14,19,167,34,352,161,103,190,24,1031,1427,2458,8,4.25,202007
14,20,217,21,406,249,6,172,0,1071,1330,2401,10,4.666666667,202007
15,1,160,19,166,81,261,155,1,843,1299,2142,7,4.333333333,202007
15,2,107,15,262,237,136,111,12,880,1151,2031,6,5,202007
15,3,210,23,222,224,216,206,22,1123,1747,2870,10,4.666666667,202007
15,4,107,18,201,297,48,153,9,833,1373,2206,4,5,202007
15,5,119,28,280,249,41,112,17,846,1360,2206,8,4.666666667,202007
15,6,132,10,280,391,35,157,20,1025,944,1969,7,5,202007
15,7,86,18,286,212,72,265,6,945,1371,2316,10,5,202007
15,8,58,15,177,243,24,105,16,638,950,1588,4,5,202007
15,9,205,11,151,106,114,268,0,855,1112,1967,9,4.75,202007
15,10,103,10,203,315,17,188,4,840,1051,1891,6,5,202007
15,11,152,25,238,326,48,159,14,962,1457,2419,8,5,202007
15,12,176,6,471,420,94,141,0,1308,1737,3045,8,5,202007
15,13,83,15,135,156,98,164,0,651,885,1536,8,5,202007
15,14,66,14,142,174,37,141,4,578,822,1400,4,5,202007
15,15,101,142,289,311,71,91,7,1012,1330,2342,6,5,202007
15,16,182,29,333,525,33,237,21,1360,2491,3851,8,5,202007
15,17,92,11,176,271,43,184,22,799,1584,2383,8,5,202007
15,18,216,27,335,424,28,211,16,1257,1666,2923,7,4.666666667,202007
15,19,146,37,399,594,29,257,33,1495,2135,3630,10,5,202007
15,20,69,15,263,230,20,85,1,683,1084,1767,6,5,202007
15,21,80,8,103,128,29,117,11,476,998,1474,6,4.5,202007
15,22,202,128,523,620,34,231,39,1777,3115,4892,14,5,202007
15,23,161,20,232,331,77,138,2,961,1525,2486,6,4.333333333,202007
15,24,108,34,210,250,34,114,19,769,1524,2293,4,5,202007
15,25,143,19,234,266,38,146,13,859,1356,2215,6,5,202007
15,26,99,10,189,213,95,141,2,749,1077,1826,9,6,202007
15,27,197,34,358,327,43,199,33,1191,2270,3461,9,4.333333333,202007
15,28,191,30,426,248,48,147,29,1119,2089,3208,9,4.666666667,202007
15,29,148,22,404,529,11,334,15,1463,2351,3814,8,5,202007
15,30,188,29,391,472,64,170,26,1340,2899,4239,16,5,202007
15,31,84,173,148,267,14,53,5,744,1676,2420,6,5,202007
15,32,128,15,192,295,65,159,5,859,1814,2673,9,5,202007
15,33,122,14,355,297,23,141,2,954,1808,2762,7,5,202007
15,34,126,11,241,385,22,96,12,893,1799,2692,8,5,202007
15,35,215,21,242,505,11,155,22,1171,2692,3863,9,4.666666667,202007
15,36,176,17,227,339,95,203,9,1066,1947,3013,9,4.5,202007
15,37,185,15,356,363,118,256,15,1308,2891,4199,7,5,202007
15,38,144,35,312,323,64,138,9,1025,2098,3123,6,4.5,202007
15,39,112,21,228,244,33,138,3,779,1380,2159,4,5,202007
15,40,218,76,264,396,151,246,1,1352,1970,3322,9,5,202007
15,41,185,20,587,545,88,222,17,1664,2498,4162,13,5,202007
16,1,157,30,396,128,22,89,2,824,855,1679,7,4.333333333,202007
16,2,83,35,79,115,17,116,1,446,531,977,9,4.25,202007
16,3,201,23,191,245,35,156,1,852,1304,2156,10,4.25,202007
16,4,192,29,276,165,71,100,0,833,1164,1997,8,4.5,202007
16,5,140,21,191,191,55,173,15,786,1091,1877,10,4.666666667,202007
16,6,184,52,210,221,58,142,0,867,1136,2003,12,4.5,202007
16,7,225,35,245,264,52,158,9,988,1374,2362,9,4.5,202007
16,8,231,37,527,479,14,226,3,1517,1975,3492,12,5,202007
16,9,168,21,256,274,21,223,9,972,1210,2182,9,5,202007
16,10,120,26,360,348,19,165,0,1038,1183,2221,6,5,202007
16,11,188,31,227,171,91,229,5,942,1439,2381,10,4.4,202007
16,12,146,35,197,126,47,207,6,764,1008,1772,10,4.25,202007
17,1,140,18,433,422,40,178,9,1240,1462,2702,9,6,202007
17,2,105,13,275,307,13,159,16,888,903,1791,8,4.666666667,202007
17,3,176,17,427,436,23,239,1,1319,1761,3080,8,4.5,202007
17,4,156,21,394,425,44,110,17,1167,1209,2376,10,4.666666667,202007
17,5,88,11,116,132,25,125,0,497,734,1231,5,4.5,202007
18,1,106,21,110,110,41,112,58,558,533,1091,7,4.25,202007
18,2,156,30,353,332,43,339,1,1254,1483,2737,9,5.333333333,202007
18,3,118,17,363,170,17,117,4,806,1053,1859,8,4.5,202007
19,1,132,26,336,320,26,243,38,1121,1151,2272,9,5,202007
19,2,189,29,689,444,28,186,8,1573,1588,3161,9,5,202007
19,3,187,21,494,267,42,277,2,1290,1751,3041,7,5,202007
19,4,88,12,147,119,47,212,21,646,814,1460,5,5,202007
19,5,219,22,465,474,37,444,47,1708,1728,3436,8,5,202007
19,6,44,7,167,236,7,227,0,688,844,1532,5,5,202007
19,7,160,14,552,225,6,116,0,1073,1355,2428,10,4.5,202007
19,8,71,9,203,168,8,52,2,513,706,1219,7,5,202007
19,9,130,23,305,327,25,189,11,1010,1666,2676,9,4.25,202007
19,10,87,16,181,165,13,247,4,713,991,1704,6,6,202007
19,11,250,18,492,614,20,558,37,1989,3185,5174,13,5,202007
19,12,161,19,555,177,24,134,18,1088,1773,2861,13,4.666666667,202007
20,1,129,13,207,165,170,75,34,793,811,1604,7,4.5,202007
20,2,139,27,255,190,84,48,3,746,783,1529,6,4.333333333,202007
20,3,97,11,149,94,128,107,20,606,881,1487,6,4.333333333,202007
20,4,91,9,70,85,31,189,30,505,529,1034,6,4.333333333,202007
20,5,126,11,273,421,51,87,5,974,912,1886,11,4.25,202007
20,6,145,9,131,173,156,99,76,789,1138,1927,8,4.25,202007
20,7,131,16,217,321,39,112,13,849,609,1458,7,4.75,202007
20,8,287,76,742,570,39,264,25,2003,2471,4474,15,6,202007
20,9,216,12,216,172,146,146,13,921,1317,2238,8,4.666666667,202007
20,10,188,14,403,224,37,94,4,964,952,1916,9,4.25,202007
21,1,164,15,234,239,47,87,4,790,1225,2015,9,4.4,202007
21,2,180,15,282,131,97,109,0,814,921,1735,9,4.2,202007
21,3,194,9,205,191,60,270,33,962,1114,2076,8,4.5,202007
21,4,179,10,104,88,94,188,9,672,532,1204,6,4.25,202007
21,5,162,22,488,235,34,97,4,1042,1652,2694,8,4.666666667,202007
21,6,164,10,306,264,57,281,10,1092,1729,2821,6,5,202007
21,7,172,10,194,261,51,239,0,927,1737,2664,9,4.666666667,202007
21,8,149,11,239,132,54,202,43,830,1060,1890,9,4.2,202007
21,9,146,19,546,393,93,179,21,1397,2412,3809,9,5,202007
21,10,129,11,359,248,29,241,28,1045,1591,2636,7,4.5,202007
21,11,60,5,202,110,17,72,3,469,810,1279,4,5,202007
21,12,237,32,799,482,110,278,219,2157,4407,6564,16,5.5,202007
21,13,167,12,360,179,42,226,9,995,1071,2066,8,4.666666667,202007
21,14,154,7,179,114,76,167,14,711,1033,1744,12,4.333333333,202007
21,15,200,7,266,258,43,223,17,1014,1688,2702,7,4.5,202007
22,1,195,61,227,371,38,80,6,978,1025,2003,11,4.2,202007
22,2,129,42,273,256,114,122,5,941,991,1932,7,4.5,202007
22,3,230,64,792,600,26,237,1,1950,2739,4689,9,4.666666667,202007
22,4,177,49,735,476,27,278,6,1748,2112,3860,9,5.5,202007
22,5,129,24,436,266,64,164,21,1104,1396,2500,10,4.5,202007
23,1,169,7,1104,279,40,149,15,1763,1913,3676,14,4.6,202007
23,2,140,25,500,306,15,31,0,1017,1214,2231,8,4.25,202007
23,3,196,11,931,501,37,107,26,1809,2224,4033,19,5,202007
23,4,105,8,470,276,38,161,17,1075,792,1867,6,4.5,202007
24,1,133,71,175,195,13,151,5,743,786,1529,10,4.2,202007
24,2,130,24,216,189,27,124,23,733,977,1710,6,4.5,202007
24,3,151,46,151,226,69,71,8,722,1091,1813,9,4.25,202007
24,4,113,24,188,145,42,184,31,727,971,1698,5,4.5,202007
24,5,191,48,586,559,22,128,11,1545,2053,3598,10,5.333333333,202007
24,6,178,105,383,317,41,179,0,1203,2692,3895,6,5,202007
24,7,169,25,219,282,68,49,0,812,602,1414,9,4.25,202007
25,1,126,10,249,237,25,185,60,892,942,1834,13,4.75,202007
25,2,159,56,362,425,18,212,0,1232,1544,2776,7,4.5,202007
25,3,128,16,299,615,49,201,9,1317,1558,2875,8,4.6,202007
25,4,138,26,179,220,76,112,0,751,1127,1878,8,4.333333333,202007
25,5,148,10,344,424,22,139,22,1109,1645,2754,8,4.666666667,202007
25,6,167,4,301,291,54,214,27,1058,1346,2404,8,4.75,202007
25,7,193,27,523,467,20,106,0,1336,1811,3147,6,5,202007
26,1,146,15,271,251,11,181,0,875,831,1706,9,4.5,202007
26,2,198,15,433,321,25,173,61,1226,1742,2968,12,4.4,202007
26,3,187,25,301,380,20,296,30,1239,1938,3177,13,5,202007
26,4,123,14,231,217,45,57,4,691,850,1541,9,4.2,202007
26,5,113,13,215,234,28,195,0,798,1052,1850,15,5,202007
26,6,158,18,175,184,17,268,0,820,1237,2057,10,4.333333333,202007
26,7,109,11,211,249,64,57,23,724,841,1565,10,4.5,202007
27,1,180,25,317,420,148,131,5,1226,1199,2425,8,4.5,202007
27,2,121,8,220,469,27,96,9,950,766,1716,8,4.666666667,202007
27,3,104,8,196,467,16,179,1,971,1223,2194,7,4.666666667,202007
27,4,133,13,339,611,22,208,12,1338,1595,2933,8,5,202007
27,5,88,4,125,278,21,123,1,640,636,1276,6,4.333333333,202007
27,6,105,13,213,415,6,119,4,875,1209,2084,7,4.5,202007
28,1,144,31,452,310,14,131,1,1083,1355,2438,13,5,202007
28,2,145,23,406,230,20,223,126,1173,1492,2665,15,4.666666667,202007
28,3,93,9,205,125,9,101,16,558,885,1443,7,4.333333333,202007
28,4,205,27,509,257,55,205,42,1300,2507,3807,16,7.5,202007
28,5,110,19,230,339,13,288,50,1049,1121,2170,10,4.5,202007
28,6,110,27,195,783,44,91,8,1258,1390,2648,13,4.166666667,202007
28,7,151,22,396,270,63,313,19,1234,1729,2963,13,5,202007
28,8,65,17,228,160,46,255,4,775,1149,1924,13,6,202007
28,9,111,12,322,202,40,164,27,878,1539,2417,11,4.75,202007
29,1,158,20,323,334,30,225,17,1107,1473,2580,7,4.5,202007
29,2,178,17,289,474,26,320,80,1384,1747,3131,11,5,202007
29,3,97,18,166,369,11,170,6,837,1004,1841,6,4.666666667,202007
30,1,71,16,175,150,94,107,15,628,1010,1638,7,4.333333333,202007
30,2,119,14,90,61,60,79,118,541,966,1507,8,4.25,202007
30,3,139,6,214,131,87,138,52,767,1466,2233,6,4.666666667,202007
30,4,88,11,313,151,28,134,0,725,973,1698,8,5,202007
30,5,118,12,280,173,35,109,11,738,1118,1856,7,4.5,202007
30,6,176,14,244,210,51,133,8,836,1134,1970,9,4.333333333,202007
30,7,110,10,259,132,90,83,52,736,1135,1871,11,4.25,202007
30,8,202,28,476,228,115,224,3,1276,1940,3216,11,4.4,202007
30,9,177,7,173,181,93,209,23,863,1239,2102,8,4.5,202007
30,10,146,13,362,203,19,226,15,984,2162,3146,6,5,202007
30,11,73,10,348,257,16,126,0,830,2162,2992,5,4.5,202007
30,12,175,19,579,394,30,318,1,1516,2459,3975,10,5,202007
30,13,168,15,169,202,115,208,65,942,1551,2493,10,4.4,202007
30,14,141,21,262,147,112,138,50,871,1220,2091,8,4.5,202007
30,15,174,20,202,180,131,235,22,964,2319,3283,11,4.666666667,202007
30,16,148,10,253,270,58,153,112,1004,1532,2536,10,4.333333333,202007
30,17,143,12,238,246,28,182,50,899,1607,2506,8,4.5,202007
30,18,218,16,110,125,67,127,30,693,1301,1994,8,4.25,202007
30,19,138,11,356,188,61,134,7,895,1498,2393,13,4.6,202007
30,20,136,13,186,461,70,192,2,1060,1504,2564,10,4.4,202007
31,1,133,12,292,48,201,116,0,802,1173,1975,8,4.5,202007
31,2,94,10,107,12,129,196,0,548,638,1186,6,4.333333333,202007
31,3,259,68,1171,696,163,197,1,2555,3455,6010,21,5.333333333,202007
31,4,68,12,335,151,138,171,34,909,922,1831,4,5,202007
31,5,141,11,151,164,74,206,18,765,921,1686,6,4.333333333,202007
32,1,129,30,151,162,31,175,24,702,801,1503,12,4.2,202007
32,2,166,34,180,113,98,192,36,819,1023,1842,13,4.142857143,202007
32,3,153,32,194,353,7,265,4,1008,931,1939,13,4.2,202007
32,4,155,72,231,311,22,150,35,976,1031,2007,12,4.2,202007
1,1,181,42,364,359,82,110,5,1143,1325,2468,13,5.5,202008
1,2,243,43,650,492,66,322,10,1826,2186,4012,10,6.333333333,202008
1,3,166,75,627,395,60,310,30,1663,1911,3574,9,6,202008
2,1,227,21,373,355,54,389,67,1486,1636,3122,11,6,202008
2,2,137,27,316,376,7,429,0,1292,1454,2746,7,6,202008
2,3,216,15,382,316,16,410,36,1391,1581,2972,12,6,202008
2,4,176,14,787,235,99,143,35,1489,1602,3091,9,6,202008
2,5,234,23,665,313,191,463,13,1902,1967,3869,11,6,202008
2,6,190,15,436,276,51,302,3,1273,1393,2666,8,6.5,202008
2,7,196,18,480,286,66,200,54,1300,1411,2711,12,5.75,202008
2,8,160,15,413,280,34,237,33,1172,1218,2390,6,6,202008
3,1,151,17,385,366,45,188,12,1164,1231,2395,12,5.666666667,202008
3,2,143,17,511,261,42,185,0,1159,1289,2448,9,5.666666667,202008
4,1,130,14,294,402,89,187,27,1143,1669,2812,11,5.25,202008
4,2,169,10,394,411,61,225,44,1314,1840,3154,14,5.2,202008
5,1,60,5,203,195,12,106,22,603,585,1188,9,5.666666667,202008
5,2,66,19,126,191,20,99,8,529,677,1206,10,5.2,202008
5,3,37,7,182,238,91,85,31,671,711,1382,11,5.333333333,202008
5,4,28,8,151,395,2,39,13,636,951,1587,11,5.75,202008
5,5,79,8,178,443,18,122,58,906,828,1734,10,6,202008
5,6,46,7,143,254,4,52,35,541,580,1121,10,5.5,202008
5,7,26,7,84,227,10,22,46,422,1024,1446,11,6,202008
6,1,201,20,359,266,13,266,42,1167,1282,2449,11,5.8,202008
6,2,139,21,284,204,33,225,31,937,1129,2066,9,5.666666667,202008
7,1,309,8,188,268,11,56,1,841,952,1793,9,5.25,202008
7,2,193,6,74,697,26,27,0,1023,2103,3126,9,5.25,202008
7,3,309,15,286,198,218,83,0,1109,1433,2542,7,5.333333333,202008
7,4,257,19,174,449,11,66,33,1009,758,1767,11,5.4,202008
7,5,275,14,194,469,39,126,0,1117,1205,2322,11,5.666666667,202008
7,6,231,16,490,325,54,225,10,1351,1827,3178,9,5.666666667,202008
7,7,232,27,277,319,146,166,15,1182,1452,2634,8,5.5,202008
7,8,188,32,206,348,89,186,44,1093,1325,2418,12,5.25,202008
7,9,165,13,337,491,32,234,6,1278,1254,2532,9,5.666666667,202008
7,10,176,10,251,462,47,114,0,1060,1237,2297,9,5.5,202008
7,11,136,5,209,133,52,34,0,569,659,1228,6,5.333333333,202008
7,12,199,12,391,632,13,52,31,1330,1589,2919,9,5.5,202008
7,13,171,20,168,659,3,54,0,1075,1184,2259,9,5.25,202008
8,1,109,6,332,156,14,88,0,705,973,1678,4,6,202008
8,2,275,66,855,539,41,165,15,1956,2310,4266,16,5.5,202008
8,3,162,25,410,354,30,111,84,1176,1152,2328,4,6,202008
8,4,160,46,531,345,42,220,45,1389,2345,3734,11,6,202008
8,5,223,90,366,466,47,118,3,1313,1557,2870,10,5.25,202008
8,6,156,68,371,344,48,184,11,1182,1327,2509,9,7,202008
8,7,149,62,247,261,6,174,0,899,1092,1991,7,5.25,202008
8,8,240,39,554,653,15,439,2,1942,2245,4187,10,6,202008
8,9,189,51,216,160,40,184,76,916,1090,2006,10,5,202008
9,1,53,10,100,122,53,92,9,439,516,955,5,4,202008
9,2,257,49,727,775,178,543,53,2582,2491,5073,12,6,202008
9,3,105,10,281,293,109,222,24,1044,1081,2125,7,5,202008
9,4,175,30,454,425,141,271,1,1497,1459,2956,11,6,202008
9,5,151,7,232,247,61,245,0,943,876,1819,7,5,202008
9,6,114,23,212,180,135,214,19,897,917,1814,7,6,202008
9,7,71,14,437,254,8,108,18,910,986,1896,9,5,202008
9,8,74,16,318,275,33,183,20,919,1051,1970,5,6,202008
9,9,79,11,214,256,72,146,0,778,928,1706,5,5,202008
9,10,104,30,460,334,61,227,9,1225,1319,2544,6,6,202008
9,11,150,23,401,498,121,289,14,1496,1691,3187,7,6,202008
9,12,178,24,659,651,43,329,41,1925,1997,3922,11,6,202008
9,13,91,17,334,305,91,235,16,1089,1080,2169,4,6,202008
9,14,79,2,177,222,50,181,8,719,1052,1771,5,5,202008
9,15,230,29,957,856,76,473,51,2672,3169,5841,10,6.5,202008
9,16,143,213,387,514,56,262,1,1576,2253,3829,15,6,202008
9,17,107,14,281,244,27,193,4,870,956,1826,6,6,202008
9,18,126,18,347,470,129,352,33,1475,1529,3004,12,6,202008
9,19,125,34,309,345,133,248,7,1201,1355,2556,5,6,202008
9,20,51,3,128,177,48,76,11,494,638,1132,5,6,202008
9,21,97,9,201,248,88,165,13,821,1055,1876,3,6,202008
9,22,153,16,210,279,109,195,21,983,1327,2310,5,6,202008
9,23,114,19,526,370,96,106,5,1236,1452,2688,6,6,202008
9,24,245,46,654,732,246,471,15,2409,2845,5254,14,6,202008
10,1,228,37,223,240,27,245,43,1043,962,2005,12,4.666666667,202008
10,2,182,33,382,453,41,171,24,1286,1831,3117,9,5.25,202008
10,3,180,41,251,291,27,228,44,1062,1521,2583,11,5.4,202008
10,4,280,40,498,662,17,285,2,1784,1971,3755,12,6.5,202008
11,1,177,83,266,352,83,168,13,1142,1317,2459,6,5.666666667,202008
11,2,190,49,322,216,146,210,9,1142,1691,2833,7,6,202008
11,3,113,44,239,254,28,212,7,897,949,1846,3,6,202008
11,4,128,80,225,289,93,216,0,1031,1147,2178,8,6,202008
11,5,271,91,457,585,35,224,46,1709,1537,3246,7,6,202008
11,6,158,34,340,295,57,160,11,1055,1000,2055,8,6,202008
11,7,209,70,376,563,21,135,2,1376,1519,2895,9,5.25,202008
11,8,188,57,315,393,126,202,16,1297,1430,2727,9,5.75,202008
11,9,184,64,404,390,20,271,12,1345,1044,2389,10,5.666666667,202008
11,10,207,57,296,299,43,306,55,1263,1526,2789,10,5.6,202008
11,11,214,47,352,422,21,158,0,1214,1589,2803,5,6,202008
11,12,176,66,509,481,36,235,5,1508,2032,3540,7,6,202008
11,13,162,62,256,204,55,165,18,922,1169,2091,8,5.5,202008
11,14,155,32,348,251,91,170,0,1047,1420,2467,8,5.5,202008
11,15,139,43,281,257,14,221,19,974,1259,2233,9,6,202008
12,1,132,39,270,247,57,223,1,969,1223,2192,10,5.2,202008
12,2,182,29,233,426,22,299,14,1205,1253,2458,10,5.5,202008
12,3,138,20,227,406,27,86,0,904,1097,2001,11,4.4,202008
12,4,180,23,399,478,43,204,1,1328,1499,2827,9,5.666666667,202008
12,5,248,29,285,336,4,92,63,1057,959,2016,10,5.25,202008
12,6,150,19,253,369,43,44,25,903,828,1731,10,5.25,202008
12,7,178,25,323,416,20,195,92,1249,1188,2437,6,5.5,202008
12,8,144,20,202,306,2,121,0,795,1126,1921,9,4.5,202008
12,9,160,21,390,450,84,95,8,1208,1323,2531,9,5.666666667,202008
13,1,107,11,74,150,84,30,107,563,660,1223,9,5.333333333,202008
13,2,91,15,85,162,56,56,31,496,874,1370,6,5.333333333,202008
13,3,117,25,225,313,125,77,44,926,734,1660,12,5.25,202008
13,4,103,13,211,285,103,102,80,897,928,1825,9,5.666666667,202008
13,5,131,10,300,406,68,135,69,1119,1173,2292,9,5.75,202008
13,6,129,151,330,714,22,115,152,1613,1681,3294,11,5.666666667,202008
13,7,73,12,158,363,33,66,5,710,1075,1785,8,5.5,202008
14,1,166,52,171,97,180,95,27,788,1118,1906,6,5.5,202008
14,2,182,29,217,101,88,212,2,831,944,1775,5,5.666666667,202008
14,3,223,27,359,107,10,255,1,982,1384,2366,8,5.4,202008
14,4,212,16,370,376,24,244,14,1256,1722,2978,10,6,202008
14,5,209,37,505,241,69,268,1,1330,1721,3051,9,5.5,202008
14,6,218,22,696,349,24,188,8,1505,2063,3568,11,6,202008
14,7,100,12,266,141,0,55,0,574,1034,1608,6,6,202008
14,8,339,60,1042,731,37,428,6,2643,3454,6097,11,6.25,202008
14,9,163,20,283,372,30,209,18,1095,1162,2257,11,6,202008
14,10,150,59,575,251,7,201,10,1253,1931,3184,7,6,202008
14,11,103,15,139,147,26,241,26,697,801,1498,4,6,202008
14,12,209,24,598,176,37,117,0,1161,1247,2408,9,5.5,202008
14,13,175,24,518,243,6,250,15,1231,1129,2360,6,6,202008
14,14,174,29,329,291,33,341,5,1202,1304,2506,7,6,202008
14,15,203,43,238,211,104,244,6,1049,1335,2384,10,5.6,202008
14,16,140,24,335,166,42,204,11,922,1275,2197,5,6,202008
14,17,154,42,239,103,37,193,14,782,1149,1931,7,5.25,202008
14,18,202,41,250,115,93,262,66,1029,1443,2472,9,5.4,202008
14,19,180,43,366,235,90,167,12,1093,1393,2486,8,5.25,202008
14,20,213,33,455,297,9,165,0,1172,1381,2553,10,5.666666667,202008
15,1,131,20,157,75,251,186,0,820,973,1793,7,5.333333333,202008
15,2,130,14,282,311,129,136,9,1011,1116,2127,6,6,202008
15,3,233,36,258,263,327,253,37,1407,1369,2776,10,5.666666667,202008
15,4,142,33,195,345,64,184,11,974,987,1961,4,6,202008
15,5,120,23,342,289,46,116,8,944,1156,2100,8,5.666666667,202008
15,6,140,7,362,475,34,209,27,1254,1131,2385,7,6,202008
15,7,106,23,359,260,86,235,8,1077,1120,2197,10,6,202008
15,8,73,15,210,263,25,110,11,707,831,1538,4,6,202008
15,9,257,17,188,139,171,275,2,1049,1210,2259,9,5.75,202008
15,10,98,8,204,331,23,202,4,870,875,1745,6,6,202008
15,11,177,22,386,369,69,158,13,1194,1172,2366,8,6,202008
15,12,197,26,599,514,134,150,2,1622,1547,3169,8,6,202008
15,13,100,19,207,193,107,148,0,774,830,1604,8,6,202008
15,14,64,36,187,189,36,132,7,651,736,1387,4,6,202008
15,15,114,149,294,382,61,102,7,1109,1214,2323,6,6,202008
15,16,169,32,447,594,30,229,11,1512,2151,3663,8,6,202008
15,17,90,14,247,291,35,201,35,913,1082,1995,8,6,202008
15,18,233,33,404,494,48,233,19,1464,1480,2944,7,5.666666667,202008
15,19,174,50,505,777,37,253,48,1844,1933,3777,10,6,202008
15,20,89,18,292,251,26,111,3,790,1082,1872,6,6,202008
15,21,92,8,119,197,31,163,13,623,679,1302,6,5.5,202008
15,22,236,160,646,771,51,269,59,2192,2500,4692,14,6,202008
15,23,174,15,249,397,47,230,25,1137,1436,2573,6,5.333333333,202008
15,24,122,29,266,296,41,122,16,892,971,1863,4,6,202008
15,25,161,34,319,313,59,169,12,1067,784,1851,6,6,202008
15,26,122,5,194,262,112,174,1,870,916,1786,9,7,202008
15,27,223,27,457,463,25,250,43,1488,1694,3182,9,5.666666667,202008
15,28,177,31,473,388,58,145,33,1305,1493,2798,9,5.666666667,202008
15,29,172,15,507,591,16,367,19,1687,1827,3514,8,6,202008
15,30,204,34,452,475,78,217,41,1501,2035,3536,16,6,202008
15,31,112,177,195,305,17,68,4,878,1551,2429,6,6,202008
15,32,146,15,249,318,65,192,2,987,1732,2719,9,6,202008
15,33,147,17,402,364,42,151,4,1127,1567,2694,7,6,202008
15,34,127,16,258,458,48,101,27,1035,1479,2514,8,6,202008
15,35,270,29,394,615,10,216,19,1553,2506,4059,9,5.666666667,202008
15,36,260,24,303,394,104,240,20,1345,1611,2956,9,5.5,202008
15,37,215,30,407,473,137,237,20,1519,2383,3902,7,6,202008
15,38,178,73,370,346,74,152,21,1214,1714,2928,6,5.5,202008
15,39,143,29,294,298,33,160,2,959,1014,1973,4,6,202008
15,40,283,84,296,512,181,301,1,1658,1863,3521,9,6,202008
15,41,227,23,606,594,90,245,25,1810,2488,4298,13,6,202008
16,1,148,34,363,132,12,57,0,746,983,1729,7,5.333333333,202008
16,2,94,27,133,113,20,135,13,535,723,1258,9,5.25,202008
16,3,214,38,203,359,38,199,4,1055,1277,2332,10,5.25,202008
16,4,206,41,318,187,86,119,0,957,1217,2174,8,5.5,202008
16,5,180,33,238,225,49,211,40,976,1280,2256,10,5.666666667,202008
16,6,177,57,296,271,59,149,0,1009,1083,2092,12,5.5,202008
16,7,210,50,330,309,75,126,8,1108,1193,2301,9,5.5,202008
16,8,244,51,703,577,6,247,7,1835,1962,3797,12,6,202008
16,9,194,14,340,351,7,200,5,1111,1261,2372,9,6,202008
16,10,123,22,444,353,28,156,0,1126,1409,2535,6,6,202008
16,11,208,47,290,206,106,243,1,1101,1470,2571,10,5.4,202008
16,12,178,26,263,166,30,212,2,877,1374,2251,10,5.25,202008
17,1,148,23,496,522,54,193,6,1442,1489,2931,9,7,202008
17,2,116,8,294,363,19,189,23,1012,955,1967,8,5.666666667,202008
17,3,196,20,451,466,34,242,0,1409,1678,3087,8,5.5,202008
17,4,182,21,436,441,45,119,21,1265,1349,2614,10,5.666666667,202008
17,5,135,26,150,197,50,122,0,680,622,1302,5,5.5,202008
18,1,172,28,165,184,43,174,63,829,1109,1938,7,5.25,202008
18,2,223,34,376,466,42,380,0,1521,1712,3233,9,6.333333333,202008
18,3,160,18,386,251,14,105,5,939,1154,2093,8,5.5,202008
19,1,146,23,393,367,18,287,56,1290,1009,2299,9,6,202008
19,2,235,25,779,438,49,242,16,1784,1578,3362,9,6,202008
19,3,226,16,654,344,55,325,5,1625,1591,3216,7,6,202008
19,4,99,9,216,150,48,226,38,786,686,1472,5,6,202008
19,5,307,28,642,528,35,432,40,2012,1818,3830,8,6,202008
19,6,64,4,224,215,8,234,6,755,892,1647,5,6,202008
19,7,161,13,593,244,8,131,0,1150,1450,2600,10,5.5,202008
19,8,69,3,224,192,7,55,2,552,714,1266,7,6,202008
19,9,162,19,342,347,42,239,22,1173,1300,2473,9,5.25,202008
19,10,96,10,288,198,13,231,18,854,667,1521,6,7,202008
19,11,283,31,521,713,14,632,53,2247,2506,4753,13,6,202008
19,12,155,15,724,225,15,110,22,1266,1615,2881,13,5.666666667,202008
20,1,183,13,234,233,141,98,52,954,1021,1975,7,5.5,202008
20,2,81,11,161,130,50,44,7,484,706,1190,6,5.333333333,202008
20,3,123,8,143,124,136,138,20,692,1024,1716,6,5.333333333,202008
20,4,130,6,82,115,35,177,37,582,574,1156,6,5.333333333,202008
20,5,108,14,269,504,66,93,1,1055,1126,2181,11,5.25,202008
20,6,115,8,140,187,205,107,96,858,902,1760,8,5.25,202008
20,7,156,11,272,429,45,102,7,1022,885,1907,7,5.75,202008
20,8,393,100,853,631,57,365,23,2422,2465,4887,15,7,202008
20,9,261,12,214,180,152,170,16,1005,1550,2555,8,5.666666667,202008
20,10,174,11,376,155,35,121,2,874,1003,1877,9,5.25,202008
21,1,176,19,247,266,42,114,5,869,940,1809,9,5.4,202008
21,2,179,24,322,212,105,140,0,982,1035,2017,9,5.2,202008
21,3,210,8,263,192,67,276,29,1045,1048,2093,8,5.5,202008
21,4,157,13,134,72,100,146,4,626,681,1307,6,5.25,202008
21,5,192,30,571,296,34,119,17,1259,1201,2460,8,5.666666667,202008
21,6,195,10,379,291,81,300,22,1278,1535,2813,6,6,202008
21,7,238,16,220,304,75,222,0,1075,1492,2567,9,5.666666667,202008
21,8,200,16,309,140,92,207,40,1004,1277,2281,9,5.2,202008
21,9,197,35,606,419,103,182,19,1561,2223,3784,9,6,202008
21,10,211,16,480,380,37,261,34,1419,1107,2526,7,5.5,202008
21,11,78,7,206,131,25,67,5,519,691,1210,4,6,202008
21,12,284,45,939,682,145,294,220,2609,3673,6282,16,6.5,202008
21,13,199,20,427,230,37,260,5,1178,1306,2484,8,5.666666667,202008
21,14,216,19,283,145,116,232,10,1021,1025,2046,12,5.333333333,202008
21,15,217,10,304,297,43,265,32,1168,1458,2626,7,5.5,202008
22,1,193,74,277,487,41,65,15,1152,965,2117,11,5.2,202008
22,2,140,49,335,304,127,125,13,1093,1041,2134,7,5.5,202008
22,3,254,59,970,759,33,264,0,2339,2618,4957,9,5.666666667,202008
22,4,193,49,757,525,30,325,1,1880,1750,3630,9,6.5,202008
22,5,173,48,489,301,66,145,14,1236,1459,2695,10,5.5,202008
23,1,188,8,1064,276,44,164,12,1756,2063,3819,14,5,202008
23,2,161,29,659,335,29,34,0,1247,1281,2528,8,5.25,202008
23,3,219,15,1079,513,42,118,23,2009,2602,4611,19,6,202008
23,4,121,9,581,328,32,177,31,1279,1480,2759,6,5.5,202008
24,1,154,97,181,249,12,151,1,845,823,1668,10,5.2,202008
24,2,124,26,278,198,35,132,24,817,1028,1845,6,5.5,202008
24,3,191,82,261,307,106,86,4,1037,1378,2415,9,5.25,202008
24,4,140,24,209,160,43,212,36,824,1092,1916,5,5.5,202008
24,5,227,64,718,664,21,149,4,1847,2127,3974,10,6.333333333,202008
24,6,175,130,504,360,56,201,0,1426,2004,3430,6,6,202008
24,7,193,32,224,292,74,46,0,861,1358,2219,9,5.25,202008
25,1,163,17,286,306,63,190,66,1091,1325,2416,13,5.75,202008
25,2,199,45,463,469,15,190,5,1386,1494,2880,7,5.5,202008
25,3,201,11,399,528,65,215,8,1427,1817,3244,8,5.6,202008
25,4,190,25,243,295,112,100,1,966,1372,2338,8,5.333333333,202008
25,5,183,23,499,526,31,175,20,1457,1812,3269,8,5.666666667,202008
25,6,151,18,351,325,69,209,14,1137,1449,2586,8,5.75,202008
25,7,241,25,588,520,16,155,0,1545,2118,3663,6,6,202008
26,1,201,9,401,304,12,250,0,1177,1444,2621,9,5.5,202008
26,2,235,18,484,433,11,190,30,1401,1744,3145,12,5.4,202008
26,3,239,28,442,458,32,337,33,1569,1933,3502,13,6,202008
26,4,158,20,313,233,75,72,8,879,1271,2150,9,5.2,202008
26,5,157,12,273,328,25,246,0,1041,1293,2334,15,6,202008
26,6,188,18,235,231,22,327,1,1022,1201,2223,10,5.333333333,202008
26,7,131,21,250,283,84,77,23,869,1006,1875,10,5.5,202008
27,1,134,22,221,401,83,110,7,978,1221,2199,8,5.5,202008
27,2,200,15,284,616,39,127,16,1297,1369,2666,8,5.666666667,202008
27,3,152,12,251,590,9,234,3,1251,1342,2593,7,5.666666667,202008
27,4,202,17,421,829,25,266,27,1787,1801,3588,8,6,202008
27,5,94,2,137,329,12,115,2,691,728,1419,6,5.333333333,202008
27,6,125,9,210,390,16,143,8,901,1299,2200,7,5.5,202008
28,1,174,32,612,428,15,136,0,1397,1466,2863,13,6,202008
28,2,157,18,423,235,33,195,156,1217,1669,2886,15,5.666666667,202008
28,3,74,3,196,118,15,104,14,524,686,1210,7,5.333333333,202008
28,4,249,27,503,305,71,211,44,1410,1869,3279,18,7.5,202008
28,5,174,13,258,306,13,316,53,1133,1109,2242,10,5.5,202008
28,6,145,25,219,885,67,119,13,1473,1611,3084,13,5.166666667,202008
28,7,157,26,426,317,58,386,23,1393,1593,2986,13,6,202008
28,8,92,17,241,214,42,246,11,863,1246,2109,13,7,202008
28,9,146,17,371,227,30,148,31,970,1375,2345,11,5.75,202008
29,1,207,29,430,448,62,288,16,1480,1601,3081,7,5.5,202008
29,2,186,19,291,495,32,354,105,1482,1937,3419,11,6,202008
29,3,101,20,247,408,28,185,0,989,1198,2187,6,5.666666667,202008
30,1,87,11,202,198,148,87,21,754,1064,1818,7,5.333333333,202008
30,2,151,14,159,125,61,117,128,755,1012,1767,8,5.25,202008
30,3,133,6,227,155,101,175,54,851,1239,2090,6,5.666666667,202008
30,4,102,16,375,150,36,154,0,833,897,1730,8,6,202008
30,5,116,19,328,195,40,111,17,826,950,1776,7,5.5,202008
30,6,166,11,335,244,53,131,7,947,1193,2140,9,5.333333333,202008
30,7,175,22,291,251,107,90,60,996,1463,2459,11,5.25,202008
30,8,237,27,657,248,107,197,19,1492,2276,3768,11,5.4,202008
30,9,214,10,249,186,106,224,22,1011,1300,2311,8,5.5,202008
30,10,144,15,423,271,26,257,21,1157,1951,3108,7,6.5,202008
30,11,103,17,406,335,14,108,5,988,1611,2599,5,5.5,202008
30,12,190,10,705,419,36,346,11,1717,2148,3865,10,6,202008
30,13,236,19,211,235,101,320,110,1232,1861,3093,10,5.4,202008
30,14,131,19,255,175,104,146,30,860,1306,2166,8,5.5,202008
30,15,238,12,262,285,140,332,48,1317,1461,2778,11,5.666666667,202008
30,16,169,4,374,396,86,169,169,1367,1770,3137,10,5.333333333,202008
30,17,135,15,279,263,46,209,76,1023,1442,2465,8,5.5,202008
30,18,161,9,83,125,44,125,33,580,1043,1623,8,5.25,202008
30,19,124,10,336,174,39,124,37,844,1550,2394,13,5.6,202008
30,20,160,15,175,595,107,159,6,1217,1432,2649,10,5.4,202008
31,1,169,13,376,61,301,119,0,1039,1398,2437,8,5.5,202008
31,2,91,4,178,11,109,177,0,570,829,1399,6,5.333333333,202008
31,3,314,114,1291,814,162,203,0,2898,3963,6861,21,6.333333333,202008
31,4,99,13,359,168,142,207,38,1026,1422,2448,4,6,202008
31,5,137,9,172,237,65,178,10,808,1053,1861,6,5.333333333,202008
32,1,163,44,246,192,46,254,27,972,1100,2072,12,5.2,202008
32,2,200,28,213,138,78,257,40,954,1004,1958,13,5.142857143,202008
32,3,178,46,216,394,8,275,0,1117,1464,2581,13,5.4,202008
32,4,193,66,314,319,44,209,35,1180,1134,2314,12,5.2,202008
1,1,202,60,388,399,97,183,20,1349,1494,2843,13,5.5,202009
1,2,247,37,596,509,74,304,16,1783,2150,3933,10,6.333333333,202009
1,3,171,71,531,354,59,285,46,1517,2017,3534,9,6,202009
2,1,209,22,390,302,56,368,64,1411,1507,2918,11,6,202009
2,2,141,21,286,312,11,388,0,1159,1301,2460,7,6,202009
2,3,181,4,342,277,7,346,33,1190,1419,2609,12,5,202009
2,4,168,6,724,247,87,140,20,1392,1647,3039,9,6,202009
2,5,247,19,642,260,180,462,11,1821,1905,3726,11,6,202009
2,6,153,9,365,241,30,260,4,1062,1240,2302,8,6,202009
2,7,182,21,481,256,38,198,40,1216,1389,2605,12,5.75,202009
2,8,140,8,335,233,26,204,27,973,821,1794,6,5,202009
3,1,151,18,337,305,45,157,13,1026,1322,2348,12,5.666666667,202009
3,2,122,13,538,210,44,200,0,1127,1130,2257,9,5.666666667,202009
4,1,105,17,201,297,73,133,20,846,1152,1998,11,4.25,202009
4,2,126,10,318,398,47,152,52,1103,1342,2445,14,4.2,202009
5,1,68,13,245,267,27,116,21,757,383,1140,9,5.666666667,202009
5,2,59,20,84,225,18,61,3,470,438,908,10,5.2,202009
5,3,36,15,150,233,66,82,40,622,470,1092,11,5.333333333,202009
5,4,47,23,156,473,8,55,10,772,780,1552,11,5.75,202009
5,5,55,12,212,367,2,115,40,803,602,1405,10,6,202009
5,6,29,6,127,274,5,51,36,528,373,901,10,5.5,202009
5,7,35,7,102,145,2,26,29,346,628,974,11,6,202009
6,1,156,12,340,239,16,247,29,1039,1265,2304,12,6,202009
6,2,166,14,277,194,51,211,29,942,1098,2040,9,5.666666667,202009
7,1,229,6,227,297,12,85,3,859,1232,2091,9,5.25,202009
7,2,163,6,106,627,18,22,0,942,2202,3144,9,5.25,202009
7,3,140,5,149,132,137,69,0,632,788,1420,7,5.333333333,202009
7,4,195,8,106,266,14,57,28,674,1477,2151,11,5.4,202009
7,5,251,17,207,480,21,134,0,1110,1271,2381,11,5.666666667,202009
7,6,194,9,426,315,57,202,9,1212,1672,2884,8,5.333333333,202009
7,7,222,18,217,305,109,157,15,1043,1253,2296,8,5.25,202009
7,8,238,61,214,358,88,172,28,1159,1330,2489,12,5.25,202009
7,9,142,10,294,419,15,217,9,1106,1122,2228,9,5.666666667,202009
7,10,208,5,223,468,17,95,0,1016,1114,2130,9,5.5,202009
7,11,150,3,188,92,33,22,0,488,452,940,6,5.333333333,202009
7,12,177,14,394,580,15,70,18,1268,1586,2854,9,5.5,202009
7,13,108,19,110,662,0,26,0,925,1841,2766,9,5.25,202009
8,1,104,7,325,143,3,74,0,656,828,1484,4,6,202009
8,2,282,74,870,495,34,141,11,1907,1956,3863,16,5.5,202009
8,3,188,36,375,333,37,95,87,1151,1331,2482,4,6,202009
8,4,168,40,477,309,55,255,46,1350,1575,2925,11,6,202009
8,5,145,83,327,375,40,89,2,1061,1445,2506,10,5.25,202009
8,6,143,61,332,314,50,168,22,1090,1123,2213,9,7,202009
8,7,203,93,273,301,8,158,0,1036,1113,2149,7,5.25,202009
8,8,196,27,566,596,11,440,3,1839,2006,3845,10,6,202009
8,9,183,31,243,148,41,172,44,862,1104,1966,10,4.8,202009
9,1,65,11,140,176,79,174,2,647,841,1488,5,6,202009
9,2,240,50,641,667,97,487,36,2218,2747,4965,12,6,202009
9,3,97,13,257,311,125,218,25,1046,1160,2206,7,5,202009
9,4,181,15,500,533,103,308,10,1650,1573,3223,11,6,202009
9,5,161,3,277,351,57,258,0,1107,987,2094,7,6,202009
9,6,93,15,181,175,92,145,20,721,907,1628,7,5,202009
9,7,98,21,448,346,5,164,5,1087,1004,2091,9,6,202009
9,8,81,22,380,316,23,238,14,1074,1141,2215,5,6,202009
9,9,118,9,225,346,59,187,0,944,1079,2023,5,6,202009
9,10,92,14,396,303,35,232,15,1087,1394,2481,6,6,202009
9,11,114,12,302,307,62,222,3,1022,1251,2273,7,5,202009
9,12,147,16,506,536,50,240,23,1518,1684,3202,11,6,202009
9,13,83,15,274,220,79,191,9,871,1064,1935,4,5,202009
9,14,69,7,175,187,46,143,15,642,1094,1736,5,6,202009
9,15,161,24,731,641,52,407,19,2035,2396,4431,11,6.5,202009
9,16,203,194,442,620,57,265,0,1781,2049,3830,15,6,202009
9,17,74,7,213,190,27,178,1,690,791,1481,6,5,202009
9,18,117,23,279,338,94,260,37,1148,1396,2544,12,5,202009
9,19,164,43,390,375,132,281,9,1394,1764,3158,5,6,202009
9,20,44,7,89,112,29,59,5,345,575,920,5,5,202009
9,21,106,5,179,222,55,160,15,742,1046,1788,3,6,202009
9,22,98,12,235,247,85,181,18,876,1107,1983,5,6,202009
9,23,123,25,509,415,114,100,7,1293,1231,2524,6,6,202009
9,24,190,28,516,532,199,331,8,1804,2241,4045,14,5,202009
10,1,191,35,240,288,26,184,67,1031,1138,2169,12,4,202009
10,2,150,21,366,377,53,147,31,1145,1425,2570,9,5.25,202009
10,3,148,34,194,254,37,188,30,885,923,1808,11,5.4,202009
10,4,202,17,431,544,18,288,5,1505,1887,3392,12,6.5,202009
11,1,173,69,232,242,45,155,14,930,1092,2022,6,5.666666667,202009
11,2,196,62,277,225,121,230,8,1119,1598,2717,7,6,202009
11,3,118,41,229,225,35,167,2,817,922,1739,3,6,202009
11,4,148,72,252,237,63,162,4,938,1104,2042,8,6,202009
11,5,208,87,469,551,54,241,43,1653,1437,3090,7,6,202009
11,6,151,33,276,291,47,141,13,952,1152,2104,8,6,202009
11,7,176,59,282,504,13,185,0,1219,1776,2995,9,5.5,202009
11,8,176,44,337,382,95,196,25,1255,1712,2967,9,5.75,202009
11,9,177,51,375,441,11,339,12,1406,1076,2482,10,5.666666667,202009
11,10,190,46,252,310,43,272,51,1164,1452,2616,10,5.6,202009
11,11,151,40,349,400,20,149,0,1109,1070,2179,5,5,202009
11,12,175,58,475,462,32,220,6,1428,1725,3153,7,6,202009
11,13,170,48,238,207,48,184,24,919,1101,2020,8,5.5,202009
11,14,156,47,298,234,78,139,0,952,985,1937,8,5.25,202009
11,15,139,43,288,247,24,244,37,1022,1088,2110,9,6,202009
12,1,169,36,268,170,78,184,2,907,1218,2125,10,5.2,202009
12,2,186,27,243,429,14,276,9,1184,1368,2552,10,5.5,202009
12,3,176,34,307,612,31,96,0,1256,1991,3247,11,5.2,202009
12,4,192,23,328,465,48,156,1,1213,1661,2874,9,5.666666667,202009
12,5,169,22,189,260,2,70,87,799,879,1678,10,5.25,202009
12,6,85,17,171,228,35,19,13,568,997,1565,10,5.25,202009
12,7,248,25,332,347,49,181,43,1225,1542,2767,6,5.5,202009
12,8,165,27,242,401,3,97,0,935,1100,2035,9,5.25,202009
12,9,170,24,337,413,52,108,6,1110,1450,2560,9,5.666666667,202009
13,1,86,9,81,121,51,17,93,458,408,866,9,5.333333333,202009
13,2,55,10,75,78,47,43,35,343,289,632,6,4.666666667,202009
13,3,103,17,162,264,100,76,31,753,342,1095,12,5.25,202009
13,4,84,19,159,249,68,92,39,710,520,1230,9,5.666666667,202009
13,5,103,14,214,362,75,89,61,918,731,1649,9,5.75,202009
13,6,123,87,320,593,18,82,108,1331,1161,2492,11,5,202009
13,7,65,6,157,348,22,80,6,684,649,1333,8,4.75,202009
14,1,142,45,148,91,139,71,16,652,874,1526,6,5,202009
14,2,169,29,210,111,78,183,2,782,833,1615,5,5.666666667,202009
14,3,220,13,330,95,11,199,2,870,1151,2021,8,5.4,202009
14,4,209,15,334,314,34,277,14,1197,1488,2685,10,6,202009
14,5,150,23,424,206,42,204,5,1054,1236,2290,9,5.5,202009
14,6,214,31,615,330,22,154,5,1371,1577,2948,11,6,202009
14,7,111,16,293,162,0,50,0,632,724,1356,6,6,202009
14,8,316,49,986,731,39,389,3,2513,3045,5558,11,6.25,202009
14,9,119,18,273,334,24,174,13,955,1123,2078,11,6,202009
14,10,183,47,494,263,6,173,9,1175,1532,2707,7,5.5,202009
14,11,123,12,169,144,27,228,28,731,757,1488,4,6,202009
14,12,244,24,573,180,55,121,0,1197,1102,2299,9,5.5,202009
14,13,213,29,486,242,14,231,5,1220,1134,2354,6,6,202009
14,14,163,22,302,274,41,325,19,1146,1187,2333,7,6,202009
14,15,222,46,251,185,103,325,12,1144,1301,2445,10,5.6,202009
14,16,151,21,347,192,46,177,6,940,956,1896,5,6,202009
14,17,168,38,279,118,51,184,4,842,942,1784,7,5.25,202009
14,18,233,38,296,144,103,241,30,1085,1570,2655,9,5.4,202009
14,19,187,36,387,203,42,137,16,1008,1016,2024,8,5.25,202009
14,20,226,31,427,235,9,158,1,1087,1388,2475,10,5.666666667,202009
15,1,195,21,210,128,302,193,0,1049,1301,2350,7,5.333333333,202009
15,2,131,18,278,257,142,89,16,931,1141,2072,6,6,202009
15,3,232,28,230,275,321,218,30,1334,1069,2403,10,5.666666667,202009
15,4,131,21,239,351,67,175,8,992,989,1981,4,6,202009
15,5,141,33,314,292,30,113,10,933,1029,1962,8,5.666666667,202009
15,6,123,10,301,454,42,188,23,1141,1314,2455,7,6,202009
15,7,108,24,390,234,70,240,6,1072,1066,2138,10,6,202009
15,8,97,17,163,267,28,88,10,670,809,1479,4,6,202009
15,9,204,14,173,130,120,265,3,909,1010,1919,9,5.75,202009
15,10,121,7,210,329,21,135,8,831,906,1737,6,6,202009
15,11,151,19,380,337,72,117,13,1089,1115,2204,8,6,202009
15,12,206,21,554,506,111,148,2,1548,1472,3020,8,6,202009
15,13,96,17,194,160,129,143,1,740,801,1541,8,6,202009
15,14,81,13,140,218,34,137,14,637,619,1256,4,6,202009
15,15,133,149,287,351,75,105,8,1108,1261,2369,6,6,202009
15,16,205,31,404,588,36,265,21,1550,1788,3338,8,6,202009
15,17,119,22,196,268,31,195,22,853,933,1786,8,6,202009
15,18,210,24,370,498,39,215,20,1376,1159,2535,7,5.666666667,202009
15,19,187,61,446,766,22,269,0,1751,1673,3424,10,6,202009
15,20,83,12,283,260,31,96,4,769,706,1475,6,6,202009
15,21,83,9,132,137,35,108,21,525,552,1077,6,5.5,202009
15,22,233,135,665,749,36,301,47,2166,2308,4474,14,6,202009
15,23,148,12,276,360,41,161,19,1017,1089,2106,6,5.333333333,202009
15,24,99,23,250,268,45,125,17,827,969,1796,4,6,202009
15,25,170,45,304,304,42,183,13,1061,873,1934,6,6,202009
15,26,112,10,217,282,115,163,0,899,842,1741,9,7,202009
15,27,167,25,413,443,28,237,46,1359,1515,2874,9,5.666666667,202009
15,28,179,25,561,343,60,163,22,1353,1711,3064,9,5.666666667,202009
15,29,166,12,457,594,13,304,15,1561,1871,3432,8,6,202009
15,30,232,40,450,465,72,153,29,1441,2238,3679,16,6,202009
15,31,118,203,214,321,10,72,2,940,1003,1943,6,6,202009
15,32,119,14,246,362,54,178,4,977,1445,2422,9,6,202009
15,33,163,36,376,345,62,151,0,1133,1396,2529,7,6,202009
15,34,126,19,197,377,23,70,36,848,1150,1998,8,6,202009
15,35,248,22,327,597,14,167,11,1386,1951,3337,9,5.666666667,202009
15,36,235,17,304,412,76,210,19,1273,1460,2733,9,5.5,202009
15,37,174,24,291,426,115,219,14,1263,1524,2787,7,6,202009
15,38,122,31,277,370,90,138,19,1047,1206,2253,6,5.5,202009
15,39,145,28,230,305,38,141,2,889,807,1696,4,6,202009
15,40,270,84,273,476,185,231,4,1523,1714,3237,9,6,202009
15,41,206,26,631,576,97,212,23,1771,2328,4099,13,6,202009
16,1,158,18,344,98,26,60,1,705,624,1329,7,5.333333333,202009
16,2,105,31,115,144,18,110,6,529,830,1359,9,5.25,202009
16,3,168,18,176,264,25,120,4,775,998,1773,10,5.25,202009
16,4,169,49,279,181,73,115,0,866,992,1858,8,5.5,202009
16,5,173,32,260,262,65,186,20,998,968,1966,10,5.666666667,202009
16,6,185,33,240,287,39,142,0,926,1118,2044,12,5.5,202009
16,7,169,34,187,288,52,94,5,829,1078,1907,9,5.5,202009
16,8,238,43,588,639,20,241,7,1776,2004,3780,12,6,202009
16,9,198,28,291,336,16,195,8,1072,1128,2200,9,6,202009
16,10,120,22,327,369,15,141,1,995,1435,2430,7,6.5,202009
16,11,199,53,245,182,125,200,1,1005,1252,2257,10,5.4,202009
16,12,141,20,220,135,23,164,1,704,809,1513,10,5.25,202009
17,1,142,24,533,501,39,210,9,1458,1436,2894,9,7,202009
17,2,122,12,305,376,18,182,24,1039,1274,2313,8,5.666666667,202009
17,3,210,21,456,447,29,207,0,1370,1611,2981,8,5.5,202009
17,4,194,23,397,453,52,142,17,1278,1358,2636,10,5.666666667,202009
17,5,84,22,154,151,35,119,0,565,679,1244,5,5.5,202009
18,1,132,28,140,155,38,135,35,663,755,1418,7,5.25,202009
18,2,234,36,366,392,45,316,1,1390,1515,2905,9,6.333333333,202009
18,3,192,24,371,254,10,119,3,973,1079,2052,8,5.5,202009
19,1,187,26,398,384,19,292,48,1354,1316,2670,9,6,202009
19,2,280,25,764,432,26,253,9,1789,1321,3110,9,6,202009
19,3,273,19,705,360,56,302,7,1722,1584,3306,7,6,202009
19,4,106,8,177,151,45,230,39,756,724,1480,5,6,202009
19,5,303,28,603,606,26,465,34,2065,1704,3769,8,6,202009
19,6,82,9,232,237,10,197,6,773,942,1715,5,6,202009
19,7,177,9,588,253,12,128,1,1168,1426,2594,10,5.5,202009
19,8,99,23,238,204,2,45,2,613,650,1263,7,6,202009
19,9,163,24,347,322,56,183,11,1106,1564,2670,9,5.25,202009
19,10,115,13,227,219,13,257,18,862,561,1423,6,7,202009
19,11,333,37,592,717,28,643,53,2403,2271,4674,13,6,202009
19,12,174,14,595,203,14,134,12,1146,1108,2254,13,5.666666667,202009
20,1,139,8,212,202,135,86,47,829,953,1782,7,5.5,202009
20,2,108,32,230,176,78,43,12,679,560,1239,6,5.333333333,202009
20,3,117,8,149,118,175,93,21,681,949,1630,6,5.333333333,202009
20,4,114,6,87,128,37,173,33,578,623,1201,6,5.333333333,202009
20,5,144,16,303,472,49,80,1,1065,1419,2484,11,5.25,202009
20,6,131,7,152,147,110,87,101,735,1125,1860,8,5.25,202009
20,7,110,9,184,341,23,61,14,742,1010,1752,7,5.75,202009
20,8,360,25,825,619,77,395,24,2325,2590,4915,15,7,202009
20,9,222,14,250,225,109,148,13,981,990,1971,8,5.666666667,202009
20,10,139,14,316,186,26,72,1,754,1067,1821,9,5.25,202009
21,1,145,18,275,282,47,83,4,854,1264,2118,9,5.4,202009
21,2,146,20,270,174,121,104,0,835,1052,1887,9,5.2,202009
21,3,193,8,256,172,51,211,14,905,1213,2118,8,5.5,202009
21,4,154,4,96,70,65,156,1,546,893,1439,6,5.25,202009
21,5,153,16,425,231,22,102,21,970,1019,1989,8,5.666666667,202009
21,6,181,12,326,316,71,294,26,1226,1493,2719,6,6,202009
21,7,272,25,239,289,111,269,0,1205,1487,2692,9,5.666666667,202009
21,8,197,15,306,166,67,176,33,960,1550,2510,9,5.2,202009
21,9,191,14,555,403,78,156,16,1413,1822,3235,9,6,202009
21,10,194,17,401,355,36,212,39,1254,822,2076,7,5.5,202009
21,11,72,4,182,123,48,63,9,501,664,1165,4,6,202009
21,12,284,21,931,575,153,252,242,2458,4006,6464,16,6.5,202009
21,13,189,12,316,224,30,236,12,1019,1238,2257,8,5.666666667,202009
21,14,168,18,221,129,67,169,7,779,1006,1785,12,5.333333333,202009
21,15,229,10,304,304,42,230,27,1146,1562,2708,7,5.5,202009
22,1,227,85,289,418,51,82,16,1168,1322,2490,11,5.2,202009
22,2,161,46,328,271,103,112,13,1034,1086,2120,7,5.5,202009
22,3,236,68,926,653,26,209,4,2122,2331,4453,9,5.666666667,202009
22,4,200,45,700,529,30,304,5,1813,1906,3719,9,6.5,202009
22,5,174,28,420,305,74,146,16,1163,1381,2544,10,5.5,202009
23,1,210,3,1177,323,45,169,13,1940,1769,3709,14,5.6,202009
23,2,148,18,462,328,40,30,0,1026,1562,2588,8,5.25,202009
23,3,218,13,1063,476,47,71,21,1909,2782,4691,19,6,202009
23,4,142,6,641,309,45,157,25,1325,1274,2599,6,5.5,202009
24,1,154,47,149,200,18,150,3,721,1093,1814,10,5.2,202009
24,2,125,28,271,196,27,110,15,772,571,1343,6,5.5,202009
24,3,132,53,183,230,93,64,1,756,936,1692,9,5.25,202009
24,4,155,25,194,173,40,172,41,800,1084,1884,5,5.5,202009
24,5,236,71,675,619,16,134,7,1758,1805,3563,10,6.333333333,202009
24,6,172,119,387,366,90,183,0,1317,1606,2923,6,6,202009
24,7,167,22,184,316,73,39,0,801,1427,2228,9,5.25,202009
25,1,162,12,246,275,43,158,58,954,1160,2114,13,5.75,202009
25,2,250,60,413,485,13,202,1,1424,1563,2987,7,5.5,202009
25,3,217,15,296,566,46,208,24,1372,1602,2974,8,5.6,202009
25,4,188,24,236,293,84,137,0,962,1104,2066,8,5.333333333,202009
25,5,229,14,427,541,35,154,27,1427,1514,2941,8,5.666666667,202009
25,6,167,8,261,320,43,172,11,982,1254,2236,8,5.75,202009
25,7,289,23,586,548,23,168,0,1637,1877,3514,6,6,202009
26,1,199,19,384,347,7,180,0,1136,1076,2212,9,5.5,202009
26,2,252,26,474,489,19,207,51,1518,1665,3183,12,5.4,202009
26,3,202,23,352,449,33,328,29,1416,1563,2979,13,6,202009
26,4,136,10,238,210,51,57,7,709,855,1564,9,5.2,202009
26,5,167,13,241,279,22,263,0,985,953,1938,15,6,202009
26,6,205,18,268,290,25,298,0,1104,1066,2170,10,5.333333333,202009
26,7,145,24,258,256,85,60,34,862,912,1774,10,5.5,202009
27,1,122,14,224,329,87,120,0,896,1286,2182,8,5.5,202009
27,2,156,18,240,495,47,89,13,1058,1386,2444,8,5.666666667,202009
27,3,192,9,181,535,2,170,1,1090,1292,2382,7,5.666666667,202009
27,4,194,13,413,946,24,262,8,1860,1541,3401,8,6,202009
27,5,112,5,119,277,18,110,1,642,891,1533,6,5.333333333,202009
27,6,167,8,224,455,10,163,5,1032,1411,2443,7,5.5,202009
28,1,167,23,625,434,8,125,4,1386,1341,2727,13,6,202009
28,2,181,28,499,262,37,243,165,1415,1655,3070,15,5.666666667,202009
28,3,108,16,282,163,13,110,6,698,1226,1924,7,5.333333333,202009
28,4,247,32,550,281,63,186,46,1405,1649,3054,18,7,202009
28,5,147,20,254,346,16,287,56,1126,1226,2352,10,5.5,202009
28,6,149,32,243,864,57,108,6,1459,1345,2804,13,5.166666667,202009
28,7,174,28,442,304,69,327,34,1378,1858,3236,13,6,202009
28,8,95,18,234,227,35,227,5,841,1077,1918,13,7,202009
28,9,148,9,429,254,35,179,28,1082,1093,2175,11,5.75,202009
29,1,210,27,372,428,58,219,12,1326,1466,2792,7,5.5,202009
29,2,204,13,265,523,35,308,115,1463,1703,3166,11,6,202009
29,3,147,22,170,479,13,191,3,1025,1243,2268,6,5.666666667,202009
30,1,87,11,180,149,62,74,9,572,871,1443,7,5.333333333,202009
30,2,143,9,108,101,44,114,77,596,969,1565,8,5.25,202009
30,3,144,9,208,156,74,138,33,762,925,1687,6,5.666666667,202009
30,4,88,6,251,157,26,96,0,624,972,1596,8,6,202009
30,5,129,14,334,232,46,88,13,856,996,1852,7,5.5,202009
30,6,120,8,248,272,60,117,18,843,1015,1858,9,5.333333333,202009
30,7,164,41,276,229,97,86,23,916,1366,2282,11,5.25,202009
30,8,165,23,521,217,278,140,1,1345,1905,3250,11,5.4,202009
30,9,217,7,217,165,133,196,33,968,1155,2123,8,5.5,202009
30,10,119,16,358,202,13,198,16,922,1593,2515,7,6.5,202009
30,11,118,13,434,381,19,88,4,1057,1492,2549,5,5.5,202009
30,12,163,15,537,344,31,206,5,1301,1888,3189,10,6,202009
30,13,169,11,175,226,84,236,79,980,1227,2207,10,5.4,202009
30,14,124,10,235,142,100,129,14,754,1209,1963,8,5.5,202009
30,15,221,15,249,259,106,298,52,1200,1364,2564,11,5.666666667,202009
30,16,171,7,280,332,71,168,118,1147,1705,2852,10,5.333333333,202009
30,17,170,18,225,270,49,210,48,990,1610,2600,8,5.5,202009
30,18,188,15,72,163,43,106,28,615,1048,1663,8,5.25,202009
30,19,106,11,328,170,34,127,13,789,1388,2177,13,5.6,202009
30,20,126,14,169,383,119,145,12,968,1700,2668,10,5.4,202009
31,1,150,24,231,46,238,95,0,784,1107,1891,8,5.5,202009
31,2,85,3,154,23,139,152,0,556,710,1266,6,5.333333333,202009
31,3,334,90,1197,648,160,224,0,2653,3289,5942,21,6.333333333,202009
31,4,98,12,305,162,121,155,25,878,955,1833,4,6,202009
31,5,181,10,192,211,51,175,3,823,1038,1861,6,5.333333333,202009
32,1,193,45,226,208,45,225,33,975,1228,2203,12,5.2,202009
32,2,188,35,180,105,105,163,25,801,1124,1925,13,5.142857143,202009
32,3,159,26,196,311,13,240,2,947,1265,2212,13,5.4,202009
32,4,199,67,260,308,30,267,29,1160,1211,2371,12,5.2,202009
1,1,173,57,300,326,63,182,4,1105,1208,2313,13,5.5,202010
1,2,229,56,653,422,59,284,4,1707,1772,3479,10,6.333333333,202010
1,3,137,65,568,381,38,321,25,1535,1533,3068,9,6,202010
2,1,186,23,321,259,34,274,34,1131,1311,2442,11,6,202010
2,2,152,17,270,328,11,319,0,1097,1192,2289,7,6,202010
2,3,195,16,423,307,21,401,22,1385,1431,2816,12,6,202010
2,4,178,15,609,187,58,174,23,1244,1451,2695,9,5,202010
2,5,268,28,691,303,129,390,10,1819,1928,3747,11,5.5,202010
2,6,191,21,352,267,28,300,1,1160,1212,2372,7,5.5,202010
2,7,161,14,408,256,16,298,8,1161,1369,2530,12,5.5,202010
2,8,155,16,348,272,23,239,32,1085,1268,2353,6,6,202010
3,1,144,13,352,331,54,189,10,1093,1056,2149,12,5.666666667,202010
3,2,147,8,565,225,61,165,0,1171,996,2167,9,5.666666667,202010
4,1,148,23,298,413,101,174,23,1180,1110,2290,11,5,202010
4,2,145,11,338,338,40,162,42,1076,1266,2342,14,5.2,202010
5,1,60,13,176,211,31,49,28,568,205,773,9,5.333333333,202010
5,2,50,11,107,193,5,47,3,416,233,649,10,5,202010
5,3,30,11,109,223,42,75,21,511,300,811,11,5.333333333,202010
5,4,37,9,176,428,5,52,10,717,419,1136,11,5.75,202010
5,5,42,16,120,305,9,76,40,608,467,1075,10,4.5,202010
5,6,45,9,112,259,9,58,29,521,272,793,10,5.5,202010
5,7,37,8,141,220,14,63,56,539,444,983,10,5.5,202010
6,1,157,12,312,269,13,197,28,988,1201,2189,12,6,202010
6,2,168,15,330,219,43,195,24,994,993,1987,9,5.666666667,202010
7,1,240,12,201,381,35,34,3,906,557,1463,9,5.25,202010
7,2,205,10,139,991,22,27,0,1394,1304,2698,9,5.25,202010
7,3,248,9,261,130,243,47,0,938,802,1740,7,5.333333333,202010
7,4,129,8,82,220,7,38,22,506,889,1395,11,5.4,202010
7,5,267,27,187,396,19,114,0,1010,1047,2057,11,5.666666667,202010
7,6,207,16,384,333,42,162,7,1151,1284,2435,9,5.666666667,202010
7,7,210,24,241,381,163,177,30,1226,1038,2264,8,5.5,202010
7,8,206,43,186,385,110,121,30,1081,1121,2202,12,5.25,202010
7,9,176,12,259,428,38,195,7,1115,1257,2372,10,6,202010
7,10,178,4,217,441,12,95,4,951,685,1636,9,5.5,202010
7,11,104,2,150,90,42,17,0,405,588,993,6,5.333333333,202010
7,12,151,7,311,543,10,46,14,1082,1694,2776,9,5.5,202010
7,13,114,27,120,811,0,35,1,1108,1052,2160,9,5.25,202010
8,1,102,7,397,144,16,99,0,765,787,1552,4,6,202010
8,2,249,73,745,499,24,116,9,1715,1457,3172,16,5.5,202010
8,3,186,39,408,345,44,109,68,1199,1080,2279,4,6,202010
8,4,161,34,477,347,20,225,36,1300,1114,2414,11,6,202010
8,5,190,64,362,390,54,81,3,1144,1118,2262,10,5.25,202010
8,6,155,49,344,312,48,129,12,1049,1212,2261,9,7,202010
8,7,156,80,220,278,8,112,0,854,1278,2132,7,5.25,202010
8,8,218,44,535,633,15,375,3,1823,1893,3716,10,6,202010
8,9,104,29,163,144,32,86,58,616,801,1417,10,5.2,202010
9,1,78,9,167,174,57,159,7,651,563,1214,5,6,202010
9,2,245,59,811,826,104,459,23,2527,2409,4936,12,6,202010
9,3,125,22,343,395,74,269,20,1248,1294,2542,7,6,202010
9,4,154,17,465,580,77,246,3,1542,1432,2974,11,6,202010
9,5,140,6,256,393,51,204,0,1050,1057,2107,7,6,202010
9,6,90,19,228,220,119,175,24,875,890,1765,7,6,202010
9,7,92,10,423,333,3,154,1,1016,1791,2807,9,6,202010
9,8,86,29,331,322,29,184,26,1007,1192,2199,5,6,202010
9,9,93,5,228,316,56,161,5,864,862,1726,5,6,202010
9,10,91,27,443,373,34,229,7,1204,1415,2619,6,6,202010
9,11,142,17,412,425,89,269,12,1366,1308,2674,7,6,202010
9,12,165,23,642,733,30,343,26,1962,2081,4043,11,6,202010
9,13,72,25,321,339,60,183,12,1012,1036,2048,4,6,202010
9,14,91,10,191,258,52,190,10,802,736,1538,5,6,202010
9,15,218,23,944,926,51,516,31,2709,2675,5384,10,6.5,202010
9,16,204,220,405,563,49,242,0,1683,1602,3285,15,6,202010
9,17,94,14,288,237,24,193,2,852,832,1684,6,6,202010
9,18,142,21,349,451,117,276,24,1380,1395,2775,12,6,202010
9,19,140,39,362,409,124,251,11,1336,1336,2672,5,6,202010
9,20,60,4,148,150,42,104,7,515,655,1170,5,6,202010
9,21,114,7,211,271,36,182,11,832,1079,1911,3,6,202010
9,22,121,19,261,346,113,192,24,1076,1020,2096,5,6,202010
9,23,125,17,426,490,91,134,9,1292,1098,2390,6,6,202010
9,24,247,38,681,667,224,395,5,2257,2342,4599,14,6,202010
10,1,166,14,188,264,32,252,31,947,1153,2100,12,4.833333333,202010
10,2,218,30,341,308,25,271,8,1201,1414,2615,9,5.25,202010
10,3,159,21,197,217,25,168,31,818,1165,1983,11,5.4,202010
10,4,232,34,369,488,21,343,3,1490,1553,3043,12,6.5,202010
11,1,156,76,238,269,48,150,8,945,983,1928,6,5.666666667,202010
11,2,156,59,277,214,130,185,18,1039,1386,2425,7,6,202010
11,3,129,42,268,280,21,162,4,906,761,1667,3,6,202010
11,4,137,58,262,267,76,178,2,980,923,1903,8,6,202010
11,5,217,87,490,542,39,199,40,1614,1377,2991,7,6,202010
11,6,157,32,298,252,35,147,14,935,1327,2262,8,6,202010
11,7,180,45,319,438,17,163,0,1162,1696,2858,9,5.5,202010
11,8,147,45,315,382,94,170,18,1171,1632,2803,9,5.75,202010
11,9,184,59,347,413,23,261,12,1299,1424,2723,10,5.666666667,202010
11,10,197,44,290,269,41,267,25,1133,1245,2378,10,5.6,202010
11,11,157,39,289,365,21,142,0,1013,1183,2196,5,6,202010
11,12,227,68,467,414,24,215,2,1417,1505,2922,7,6,202010
11,13,164,48,216,189,37,160,16,830,914,1744,8,5.5,202010
11,14,182,47,344,277,66,133,0,1049,1001,2050,8,5.5,202010
11,15,155,32,294,296,17,195,36,1025,981,2006,9,6,202010
12,1,100,38,214,117,111,105,0,685,932,1617,10,5,202010
12,2,156,22,212,413,24,244,14,1085,1323,2408,10,5.5,202010
12,3,145,20,275,481,9,92,0,1022,922,1944,11,5.2,202010
12,4,172,26,368,471,32,191,2,1262,1511,2773,9,5.666666667,202010
12,5,224,27,214,272,6,66,52,861,1112,1973,10,4.75,202010
12,6,117,17,240,252,25,27,18,696,961,1657,10,5.25,202010
12,7,176,16,241,395,13,225,27,1093,1233,2326,6,5.5,202010
12,8,168,11,209,311,1,98,0,798,923,1721,9,5.25,202010
12,9,170,26,371,436,68,105,6,1182,1260,2442,9,5.666666667,202010
13,1,50,10,49,136,44,12,53,354,215,569,9,5.333333333,202010
13,2,64,6,90,120,38,49,37,404,230,634,6,4.666666667,202010
13,3,83,30,133,209,94,38,28,615,209,824,12,5.25,202010
13,4,85,13,125,243,30,58,36,590,404,994,9,5,202010
13,5,80,10,126,305,38,75,62,696,377,1073,9,5,202010
13,6,139,46,382,780,22,159,92,1620,892,2512,11,5.333333333,202010
13,7,42,9,97,375,20,56,5,604,567,1171,8,5.25,202010
14,1,144,40,162,108,94,56,21,625,742,1367,6,5.25,202010
14,2,161,38,228,121,77,236,4,865,881,1746,5,5.666666667,202010
14,3,217,23,330,99,9,188,0,866,955,1821,8,5.4,202010
14,4,207,25,330,301,27,233,12,1135,1261,2396,10,6,202010
14,5,128,28,432,232,49,162,3,1034,1044,2078,9,5.5,202010
14,6,223,34,608,319,14,162,2,1362,1630,2992,11,6,202010
14,7,123,14,301,168,0,51,0,657,632,1289,6,6,202010
14,8,324,56,944,748,37,339,8,2456,2675,5131,11,6,202010
14,9,157,15,259,316,21,147,8,923,1258,2181,11,6,202010
14,10,176,39,496,283,6,192,6,1198,1174,2372,7,6,202010
14,11,107,17,199,180,31,222,29,785,741,1526,4,6,202010
14,12,259,30,566,179,27,119,0,1180,1140,2320,9,5.5,202010
14,13,184,26,509,269,12,242,5,1247,996,2243,6,6,202010
14,14,141,24,294,276,33,285,10,1063,1191,2254,7,6,202010
14,15,210,41,254,184,93,254,4,1040,1155,2195,10,5.6,202010
14,16,152,29,306,196,57,178,3,921,952,1873,5,6,202010
14,17,147,42,272,91,55,179,8,794,1038,1832,7,5.25,202010
14,18,262,49,303,166,108,269,38,1195,1281,2476,9,5.4,202010
14,19,173,41,322,207,50,140,22,955,1295,2250,8,5.25,202010
14,20,233,31,444,234,16,143,1,1102,1223,2325,10,5.666666667,202010
15,1,178,21,180,114,254,189,0,936,979,1915,7,5.333333333,202010
15,2,94,20,270,274,126,119,7,910,878,1788,6,6,202010
15,3,217,24,216,251,264,248,30,1250,1920,3170,10,5.666666667,202010
15,4,166,13,204,373,66,175,14,1011,1121,2132,4,6,202010
15,5,125,21,282,290,53,99,12,882,976,1858,8,5.666666667,202010
15,6,124,4,324,457,25,165,22,1121,1170,2291,7,6,202010
15,7,124,14,391,262,81,220,7,1099,950,2049,10,6,202010
15,8,80,18,188,286,24,91,13,700,726,1426,4,6,202010
15,9,233,14,168,123,126,237,2,903,1062,1965,9,5.75,202010
15,10,103,8,213,294,29,135,9,791,791,1582,6,6,202010
15,11,167,23,323,456,54,144,12,1179,1166,2345,8,6,202010
15,12,192,11,547,504,115,122,0,1491,1671,3162,8,6,202010
15,13,66,19,196,216,117,129,1,744,750,1494,8,6,202010
15,14,74,17,155,223,32,141,7,649,648,1297,4,6,202010
15,15,137,174,306,377,87,93,11,1185,1040,2225,6,6,202010
15,16,201,29,455,607,31,265,18,1606,1640,3246,8,6,202010
15,17,115,8,196,268,28,174,24,813,837,1650,8,6,202010
15,18,207,24,324,452,46,193,26,1272,1865,3137,7,5.666666667,202010
15,19,75,20,166,252,13,86,6,618,1627,2245,10,6,202010
15,20,89,15,285,279,22,66,7,763,799,1562,6,6,202010
15,21,113,11,112,183,30,122,27,598,788,1386,6,5.5,202010
15,22,260,100,665,741,46,234,68,2114,2418,4532,14,6,202010
15,23,136,16,217,319,66,134,29,917,1033,1950,6,5.333333333,202010
15,24,92,34,241,278,41,82,9,777,910,1687,4,6,202010
15,25,129,32,293,295,63,129,12,953,1352,2305,6,6,202010
15,26,139,15,207,280,110,156,0,907,1082,1989,9,7,202010
15,27,202,35,415,462,37,242,61,1454,1321,2775,9,5.666666667,202010
15,28,192,29,521,348,29,124,26,1269,1644,2913,9,5.666666667,202010
15,29,169,20,417,599,10,270,17,1502,2549,4051,8,6,202010
15,30,214,31,426,463,71,156,37,1398,2018,3416,16,6,202010
15,31,104,166,235,337,20,64,3,929,1039,1968,6,6,202010
15,32,103,17,231,335,60,165,8,919,1384,2303,9,6,202010
15,33,142,21,399,359,41,135,3,1100,1601,2701,7,6,202010
15,34,61,8,124,209,21,28,6,457,652,1109,8,6,202010
15,35,293,29,325,616,15,167,12,1457,1911,3368,9,5.666666667,202010
15,36,194,14,249,324,75,199,5,1060,1557,2617,9,5.5,202010
15,37,173,24,356,430,104,237,27,1351,2024,3375,7,6,202010
15,38,143,30,307,342,56,126,12,1016,1320,2336,6,5.5,202010
15,39,125,27,231,285,43,131,1,843,957,1800,4,6,202010
15,40,288,91,270,474,152,209,0,1484,2426,3910,9,6,202010
15,41,240,23,593,630,72,212,17,1787,681,2468,13,6,202010
16,1,163,20,351,159,12,68,3,776,823,1599,7,5.333333333,202010
16,2,120,58,164,159,19,168,13,701,720,1421,9,5.25,202010
16,3,170,31,164,252,27,148,6,798,957,1755,10,5.25,202010
16,4,181,48,298,198,51,112,0,888,916,1804,8,5.5,202010
16,5,181,25,239,213,59,173,29,919,1096,2015,10,5.666666667,202010
16,6,159,38,197,267,52,112,0,825,801,1626,12,5.5,202010
16,7,199,36,287,296,41,93,4,956,1085,2041,9,5.5,202010
16,8,237,37,628,600,12,189,6,1709,2016,3725,12,6,202010
16,9,180,18,302,338,12,193,5,1048,1355,2403,9,6,202010
16,10,121,23,367,307,12,126,0,956,1399,2355,7,6.5,202010
16,11,175,38,223,207,66,209,2,920,1038,1958,10,5.4,202010
16,12,141,24,232,159,39,177,1,773,989,1762,10,5.25,202010
17,1,159,24,481,516,32,133,10,1355,1342,2697,9,7,202010
17,2,130,12,287,387,18,148,26,1008,1178,2186,8,5.666666667,202010
17,3,227,23,409,488,25,219,1,1392,1798,3190,8,5.5,202010
17,4,165,17,379,408,52,112,8,1141,1336,2477,10,5.666666667,202010
17,5,67,5,156,150,21,84,0,483,499,982,5,5.5,202010
18,1,99,15,110,154,25,105,54,562,850,1412,7,5.25,202010
18,2,221,27,350,394,49,310,0,1351,1521,2872,9,6.333333333,202010
18,3,145,11,405,260,15,101,3,940,991,1931,8,5.5,202010
19,1,182,22,434,364,21,247,40,1310,1197,2507,9,6,202010
19,2,232,27,777,462,34,238,16,1786,1311,3097,9,6,202010
19,3,242,23,657,378,63,301,5,1669,1359,3028,7,6,202010
19,4,99,14,180,171,51,234,34,783,732,1515,5,6,202010
19,5,290,34,651,549,30,445,39,2038,1769,3807,8,6,202010
19,6,67,12,244,258,13,210,6,810,840,1650,5,6,202010
19,7,200,19,607,303,9,145,0,1283,1623,2906,10,5.5,202010
19,8,75,12,236,185,4,55,0,567,490,1057,7,6,202010
19,9,112,12,235,194,36,151,5,745,887,1632,9,5.25,202010
19,10,116,8,262,221,20,241,10,878,604,1482,6,7,202010
19,11,339,47,611,769,14,616,58,2454,2186,4640,13,6,202010
19,12,194,13,652,215,18,136,20,1248,1208,2456,13,5.666666667,202010
20,1,128,8,221,198,137,96,45,833,912,1745,7,5.5,202010
20,2,154,29,307,217,72,29,7,815,705,1520,6,5.333333333,202010
20,3,147,10,186,135,228,112,17,835,509,1344,6,5.333333333,202010
20,4,96,14,119,186,39,183,22,659,628,1287,6,5.333333333,202010
20,5,131,10,356,679,82,63,3,1324,806,2130,11,5.25,202010
20,6,190,10,173,156,166,114,115,924,853,1777,8,5.25,202010
20,7,112,10,194,333,40,89,13,791,1017,1808,7,5.75,202010
20,8,315,76,764,568,74,337,28,2162,2242,4404,15,7,202010
20,9,194,13,226,212,116,180,14,955,1147,2102,8,5.666666667,202010
20,10,216,8,375,143,47,127,1,917,794,1711,9,5.25,202010
21,1,138,12,228,226,28,83,5,720,894,1614,9,5.4,202010
21,2,177,36,223,134,108,92,1,771,998,1769,9,5.2,202010
21,3,174,13,241,190,59,206,23,906,1324,2230,8,5.5,202010
21,4,101,8,75,58,43,115,0,400,932,1332,6,5.25,202010
21,5,193,24,491,271,22,107,20,1128,1150,2278,8,5.666666667,202010
21,6,182,16,365,343,84,278,27,1295,1101,2396,6,6,202010
21,7,270,13,241,329,79,264,3,1199,1102,2301,9,5.666666667,202010
21,8,147,22,229,157,67,144,26,792,811,1603,9,5.2,202010
21,9,175,22,522,409,87,164,33,1412,1599,3011,9,6,202010
21,10,206,22,410,323,25,196,31,1213,1059,2272,7,5.5,202010
21,11,76,11,187,128,40,71,8,521,1091,1612,4,6,202010
21,12,258,25,869,638,140,234,236,2400,2551,4951,16,6.5,202010
21,13,201,20,322,203,32,211,5,994,1375,2369,8,5.666666667,202010
21,14,154,9,156,128,82,180,13,722,810,1532,12,5.333333333,202010
21,15,181,4,296,322,36,224,21,1084,1224,2308,7,5.5,202010
22,1,146,46,198,373,41,63,8,875,1030,1905,11,5.2,202010
22,2,120,54,334,303,109,114,9,1043,1128,2171,7,5.5,202010
22,3,261,83,987,754,27,257,3,2372,2458,4830,9,5.666666667,202010
22,4,139,33,662,476,30,222,5,1567,1704,3271,9,6.5,202010
22,5,126,26,387,285,68,102,17,1011,1311,2322,10,5.5,202010
23,1,199,8,1141,342,65,167,13,1935,1526,3461,14,5.6,202010
23,2,144,29,445,302,15,47,0,982,1044,2026,8,5.25,202010
23,3,196,14,1180,605,45,142,29,2211,1185,3396,19,6,202010
23,4,131,6,637,322,43,155,45,1339,1277,2616,6,5.5,202010
24,1,122,57,141,197,14,122,0,653,660,1313,10,5.2,202010
24,2,122,31,258,157,26,117,13,724,691,1415,6,5.5,202010
24,3,147,64,173,247,90,70,1,792,908,1700,9,5.25,202010
24,4,139,37,216,192,52,175,49,860,905,1765,5,5.5,202010
24,5,262,55,633,597,22,126,8,1703,1251,2954,9,6,202010
24,6,175,82,441,379,105,181,0,1363,1474,2837,6,6,202010
24,7,141,24,202,264,69,30,0,730,1054,1784,9,5.25,202010
25,1,176,10,241,314,22,142,72,977,1153,2130,13,5.75,202010
25,2,276,69,381,506,29,182,1,1444,1441,2885,7,5.5,202010
25,3,168,15,330,522,69,175,9,1288,1427,2715,8,5.6,202010
25,4,195,34,203,236,63,149,0,880,1017,1897,8,5.333333333,202010
25,5,140,15,367,445,26,121,30,1144,1325,2469,8,5.666666667,202010
25,6,216,12,362,321,54,211,21,1197,1335,2532,8,5.75,202010
25,7,249,29,603,511,10,90,2,1494,1565,3059,6,6,202010
26,1,186,12,339,298,10,166,0,1011,1005,2016,9,5.5,202010
26,2,195,17,483,452,7,165,29,1348,1049,2397,12,5.4,202010
26,3,238,25,389,498,27,274,31,1482,1327,2809,13,6,202010
26,4,117,15,282,213,61,59,21,768,760,1528,9,5.2,202010
26,5,135,7,218,244,51,222,1,878,933,1811,15,6,202010
26,6,207,14,258,353,30,337,0,1199,1075,2274,10,5.333333333,202010
26,7,181,24,209,292,99,50,8,863,938,1801,10,5.5,202010
27,1,126,14,250,389,90,103,4,976,1091,2067,8,5.5,202010
27,2,127,12,219,531,21,87,15,1012,1044,2056,8,5.666666667,202010
27,3,141,12,174,561,18,162,4,1072,1284,2356,7,5.666666667,202010
27,4,198,14,422,809,17,254,18,1732,1914,3646,8,6,202010
27,5,77,4,110,301,36,74,0,602,515,1117,6,5.333333333,202010
27,6,137,14,236,443,17,160,15,1022,881,1903,7,5.5,202010
28,1,173,22,593,382,17,128,0,1315,1103,2418,13,6,202010
28,2,180,26,448,252,31,179,181,1297,1337,2634,15,5.666666667,202010
28,3,100,12,305,150,19,108,15,709,698,1407,7,5.333333333,202010
28,4,239,29,505,294,73,179,48,1367,1703,3070,18,6.5,202010
28,5,161,28,278,407,20,243,37,1174,1108,2282,9,5.25,202010
28,6,113,42,231,1082,100,105,7,1680,1749,3429,13,5.166666667,202010
28,7,180,19,497,309,72,330,22,1429,1627,3056,13,6,202010
28,8,101,17,258,230,33,248,4,891,941,1832,13,7,202010
28,9,169,15,438,238,40,155,32,1087,1359,2446,11,5.75,202010
29,1,199,26,358,437,45,214,7,1286,1606,2892,7,5.5,202010
29,2,205,19,290,520,40,260,112,1446,1558,3004,11,6,202010
29,3,137,27,230,422,19,169,2,1006,925,1931,6,5.666666667,202010
30,1,67,8,138,128,72,73,6,492,749,1241,7,5.333333333,202010
30,2,127,10,115,109,56,72,101,590,528,1118,8,5.25,202010
30,3,124,10,207,165,73,134,35,748,923,1671,6,5.666666667,202010
30,4,88,11,313,165,33,113,0,723,831,1554,8,6,202010
30,5,126,12,300,225,33,109,12,817,886,1703,7,5.5,202010
30,6,166,17,260,206,42,135,7,833,1025,1858,9,5.333333333,202010
30,7,147,30,243,191,143,65,32,851,832,1683,11,5.25,202010
30,8,165,23,496,233,252,125,7,1301,1745,3046,11,5.4,202010
30,9,199,5,187,168,88,162,41,850,974,1824,8,5.5,202010
30,10,126,8,354,228,32,195,24,967,1043,2010,7,6.5,202010
30,11,140,13,462,376,17,105,7,1120,1391,2511,5,5.5,202010
30,12,175,13,708,415,27,279,8,1625,2122,3747,10,6,202010
30,13,182,10,147,216,101,215,54,925,1250,2175,10,5.4,202010
30,14,117,13,234,141,100,122,9,736,1042,1778,8,5.5,202010
30,15,235,16,238,270,107,223,60,1149,1184,2333,11,5.666666667,202010
30,16,136,6,282,357,127,146,100,1154,1174,2328,10,5.333333333,202010
30,17,165,30,300,288,37,191,65,1076,1294,2370,8,5.5,202010
30,18,148,11,125,131,34,93,22,564,740,1304,8,5.25,202010
30,19,168,8,353,195,18,115,11,868,825,1693,13,5.6,202010
30,20,109,9,181,432,82,145,1,959,1298,2257,10,5.4,202010
31,1,169,17,285,75,221,90,0,857,941,1798,8,5.5,202010
31,2,81,4,113,16,144,136,0,494,693,1187,6,5.333333333,202010
31,3,379,75,1346,800,189,207,0,2996,3009,6005,21,6.333333333,202010
31,4,93,13,372,169,154,177,24,1002,1153,2155,4,6,202010
31,5,171,15,187,207,77,201,11,869,735,1604,6,5.333333333,202010
32,1,189,32,196,199,30,200,21,867,865,1732,12,5.2,202010
32,2,185,36,190,152,102,163,37,865,947,1812,13,5.142857143,202010
32,3,146,39,220,288,9,208,1,911,1211,2122,13,5.4,202010
32,4,181,45,258,326,20,182,20,1032,780,1812,12,5.2,202010
1,1,147,40,236,248,34,133,4,842,1182,2024,13,5.166666667,202011
1,2,235,39,569,428,47,247,10,1575,1938,3513,10,6.333333333,202011
1,3,187,38,462,360,32,271,13,1363,1684,3047,9,6,202011
2,1,178,9,333,299,29,255,30,1133,1525,2658,11,6,202011
2,2,128,14,232,264,10,241,0,889,1535,2424,7,5.5,202011
2,3,193,5,318,277,7,290,13,1103,1413,2516,11,4.666666667,202011
2,4,148,9,564,228,56,162,12,1179,1580,2759,9,6,202011
2,5,261,11,665,303,148,396,14,1798,2501,4299,11,6,202011
2,6,142,11,317,232,18,291,1,1012,1357,2369,8,5.5,202011
2,7,142,15,330,220,5,211,7,930,1448,2378,12,5,202011
2,8,165,7,348,282,17,206,29,1054,991,2045,6,6,202011
3,1,146,17,280,282,32,134,11,902,1510,2412,12,5.5,202011
3,2,153,12,450,227,44,153,0,1039,1730,2769,9,5.666666667,202011
4,1,162,16,261,364,93,145,38,1079,1300,2379,11,5,202011
4,2,179,8,325,376,53,163,23,1127,1222,2349,14,5,202011
5,1,86,10,173,213,14,68,19,583,244,827,9,5.666666667,202011
5,2,38,15,85,152,21,60,9,380,201,581,10,5,202011
5,3,39,13,121,202,23,59,33,490,290,780,11,5.333333333,202011
5,4,32,26,179,413,3,38,16,707,535,1242,11,5.75,202011
5,5,67,13,173,365,8,105,29,760,365,1125,10,5,202011
5,6,44,7,99,253,5,42,37,487,312,799,10,5.5,202011
5,7,34,15,106,196,1,38,32,422,289,711,10,5.5,202011
6,1,184,19,255,239,13,185,27,922,1180,2102,12,6,202011
6,2,136,11,310,210,31,180,22,900,1121,2021,9,5.666666667,202011
7,1,203,7,184,193,40,51,3,681,983,1664,9,5.25,202011
7,2,190,11,138,1358,21,35,0,1753,1074,2827,9,5.25,202011
7,3,200,9,243,136,284,56,0,928,861,1789,7,5.333333333,202011
7,4,161,9,129,460,17,36,18,830,1177,2007,11,5.4,202011
7,5,249,27,174,377,33,98,0,958,1267,2225,11,5.333333333,202011
7,6,196,14,420,283,85,151,6,1155,1531,2686,9,5.666666667,202011
7,7,191,10,229,328,103,147,15,1023,1352,2375,8,5.25,202011
7,8,184,54,188,359,74,123,29,1011,1296,2307,12,5.25,202011
7,9,183,9,323,391,28,170,4,1108,1749,2857,9,5.666666667,202011
7,10,175,4,223,467,35,92,0,996,948,1944,9,5.5,202011
7,11,83,2,81,93,38,17,0,314,556,870,6,5.333333333,202011
7,12,180,8,308,516,13,51,17,1093,1894,2987,9,5.5,202011
7,13,108,11,134,604,2,21,0,880,790,1670,9,5.25,202011
8,1,93,6,348,150,6,82,0,685,812,1497,4,6,202011
8,2,301,68,695,517,36,103,9,1729,1840,3569,16,5.5,202011
8,3,133,25,327,247,58,68,55,913,1252,2165,4,5,202011
8,4,149,36,381,294,48,217,43,1168,1247,2415,11,6,202011
8,5,193,48,281,368,31,75,2,998,1356,2354,10,5.25,202011
8,6,161,50,307,291,31,111,10,961,1596,2557,9,7,202011
8,7,175,52,218,239,9,129,0,822,1171,1993,7,5.25,202011
8,8,219,36,474,495,18,290,0,1532,2598,4130,10,6,202011
8,9,122,25,180,131,35,126,49,668,830,1498,10,5.2,202011
9,1,75,8,139,144,45,81,4,496,768,1264,5,5,202011
9,2,244,58,732,799,78,422,16,2349,2675,5024,12,6,202011
9,3,122,11,315,317,59,234,16,1074,1297,2371,7,6,202011
9,4,139,20,390,526,50,190,5,1320,2228,3548,11,6,202011
9,5,124,4,231,342,32,184,0,917,1593,2510,7,6,202011
9,6,85,18,218,192,98,155,12,778,864,1642,7,6,202011
9,7,77,17,316,291,0,114,2,817,1265,2082,9,6,202011
9,8,77,21,303,263,21,151,10,846,1169,2015,5,6,202011
9,9,87,11,210,255,58,135,3,759,1179,1938,5,6,202011
9,10,74,15,386,336,27,199,3,1040,1492,2532,6,6,202011
9,11,142,11,377,381,79,258,11,1259,1809,3068,7,6,202011
9,12,119,22,497,602,23,263,23,1549,2119,3668,11,5.5,202011
9,13,92,11,297,299,65,178,15,957,1478,2435,4,6,202011
9,14,67,3,187,187,30,117,12,603,1012,1615,5,5,202011
9,15,183,21,770,769,68,404,27,2242,3169,5411,10,6,202011
9,16,171,185,390,518,63,236,0,1563,2212,3775,15,6,202011
9,17,105,11,255,246,26,166,4,813,1178,1991,6,6,202011
9,18,116,12,319,445,85,232,21,1230,1792,3022,12,6,202011
9,19,151,26,324,319,108,205,7,1140,1385,2525,5,6,202011
9,20,42,12,120,139,37,86,4,440,675,1115,5,6,202011
9,21,101,6,170,235,34,134,2,682,930,1612,3,5,202011
9,22,114,9,210,258,88,139,12,830,1081,1911,5,5,202011
9,23,132,17,403,405,77,138,10,1182,1774,2956,6,6,202011
9,24,261,32,565,592,183,348,9,1990,3070,5060,14,6,202011
10,1,276,35,308,332,65,305,43,1364,1318,2682,12,5.166666667,202011
10,2,188,24,279,283,19,224,13,1030,1456,2486,9,5,202011
10,3,186,24,185,231,21,192,38,877,1277,2154,11,5.2,202011
10,4,258,31,331,487,19,312,7,1445,2126,3571,12,6.5,202011
11,1,137,70,167,290,58,133,4,859,1252,2111,6,5.666666667,202011
11,2,138,32,246,172,99,158,10,855,1529,2384,7,6,202011
11,3,117,32,226,208,26,136,11,756,1139,1895,3,6,202011
11,4,112,53,182,215,46,123,1,732,1224,1956,8,6,202011
11,5,217,61,394,493,35,162,23,1385,2017,3402,7,6,202011
11,6,109,26,265,246,37,139,7,829,1430,2259,8,6,202011
11,7,188,44,278,520,22,120,1,1173,1597,2770,9,5.5,202011
11,8,130,62,253,387,104,159,21,1116,1719,2835,9,5.75,202011
11,9,180,50,267,364,12,212,6,1091,2495,3586,10,5.333333333,202011
11,10,177,47,203,249,31,220,27,954,1336,2290,10,5.2,202011
11,11,157,46,329,364,20,141,0,1057,1288,2345,5,6,202011
11,12,150,48,343,401,21,173,2,1138,2278,3416,7,6,202011
11,13,144,43,184,186,31,129,14,731,1186,1917,8,5.5,202011
11,14,159,36,301,249,54,127,0,926,1339,2265,8,5.5,202011
11,15,110,37,205,213,8,154,16,743,1450,2193,9,6,202011
12,1,122,22,204,155,59,145,0,707,924,1631,10,5.2,202011
12,2,161,15,214,419,11,208,3,1031,1518,2549,10,5.5,202011
12,3,167,21,285,486,20,91,0,1070,1384,2454,11,5.2,202011
12,4,141,32,368,410,32,141,2,1126,1406,2532,9,5.666666667,202011
12,5,166,26,157,221,2,57,50,679,940,1619,10,5.25,202011
12,6,104,10,196,334,29,20,11,704,1029,1733,10,5.25,202011
12,7,186,13,189,333,12,179,22,934,1670,2604,6,5.5,202011
12,8,195,12,230,383,0,100,0,920,858,1778,9,5.25,202011
12,9,162,20,302,404,36,76,7,1007,1425,2432,9,5.666666667,202011
13,1,68,10,59,132,28,23,58,378,218,596,9,5.333333333,202011
13,2,66,7,60,96,36,38,23,326,141,467,6,4.666666667,202011
13,3,83,11,156,237,83,43,22,635,222,857,12,5.25,202011
13,4,78,9,121,294,43,56,46,647,373,1020,9,5,202011
13,5,101,27,223,376,50,72,49,898,392,1290,9,5.5,202011
13,6,164,22,375,668,26,98,87,1440,844,2284,11,5.666666667,202011
13,7,58,6,116,337,10,44,1,572,410,982,8,5.5,202011
14,1,140,46,118,57,102,37,17,517,760,1277,6,5.5,202011
14,2,147,21,196,77,61,204,1,707,1020,1727,5,5.333333333,202011
14,3,199,18,309,79,9,139,3,756,1110,1866,8,5.4,202011
14,4,177,16,260,291,14,190,11,959,1239,2198,10,5.5,202011
14,5,170,35,451,247,31,130,2,1066,1715,2781,9,5.5,202011
14,6,182,21,517,277,28,131,2,1158,1809,2967,11,6,202011
14,7,103,15,213,123,1,34,0,489,763,1252,6,5,202011
14,8,263,26,808,630,32,291,3,2053,3423,5476,11,6,202011
14,9,117,12,225,271,14,113,4,756,1239,1995,11,6,202011
14,10,142,35,432,223,5,129,13,979,1360,2339,7,5.5,202011
14,11,98,9,188,144,22,147,19,627,889,1516,4,5,202011
14,12,216,21,534,163,13,71,1,1019,1723,2742,9,5.25,202011
14,13,197,25,415,265,14,213,4,1133,801,1934,6,6,202011
14,14,139,22,211,228,28,221,11,860,1413,2273,7,5,202011
14,15,190,42,257,179,70,216,11,965,1390,2355,10,5.6,202011
14,16,138,27,263,160,47,137,8,780,1008,1788,5,6,202011
14,17,166,29,198,81,32,112,5,623,692,1315,7,5.25,202011
14,18,198,29,190,128,96,167,48,856,1131,1987,9,5.4,202011
14,19,161,30,316,172,65,131,23,898,1328,2226,8,5.25,202011
14,20,202,20,381,216,7,116,4,946,1146,2092,10,5.666666667,202011
15,1,106,7,110,60,136,85,0,504,948,1452,7,5.333333333,202011
15,2,115,11,244,230,94,77,4,775,1260,2035,6,6,202011
15,3,234,23,250,233,228,182,20,1170,1895,3065,10,5.666666667,202011
15,4,129,16,170,247,54,124,8,748,1275,2023,4,5,202011
15,5,161,23,249,284,40,74,13,844,1267,2111,8,5.666666667,202011
15,6,132,8,226,392,31,133,22,944,1909,2853,7,6,202011
15,7,117,14,312,209,87,165,6,910,1441,2351,10,6,202011
15,8,69,9,149,238,19,85,17,586,1026,1612,4,6,202011
15,9,214,14,131,120,150,189,0,818,1214,2032,9,5.5,202011
15,10,91,5,176,285,16,119,5,697,1184,1881,6,6,202011
15,11,154,36,259,322,54,109,7,941,1596,2537,8,6,202011
15,12,195,10,476,436,88,112,2,1319,2098,3417,8,6,202011
15,13,91,8,151,179,84,112,0,625,856,1481,8,6,202011
15,14,62,19,136,208,32,103,1,561,909,1470,4,6,202011
15,15,97,154,227,310,65,57,5,915,1748,2663,6,6,202011
15,16,190,24,339,474,34,226,16,1303,1979,3282,8,6,202011
15,17,100,9,200,249,25,148,23,754,842,1596,8,6,202011
15,18,209,22,335,441,28,180,16,1231,2396,3627,7,5.666666667,202011
15,19,198,45,488,756,28,234,27,1776,2493,4269,10,6,202011
15,20,70,15,235,241,14,70,1,646,1031,1677,6,6,202011
15,21,91,6,116,187,39,102,12,553,748,1301,6,5.5,202011
15,22,182,93,515,641,55,205,38,1729,2938,4667,14,6,202011
15,23,185,16,212,316,39,161,24,953,1212,2165,6,5.333333333,202011
15,24,97,18,200,226,32,94,6,673,839,1512,4,6,202011
15,25,146,24,255,275,48,143,7,898,1694,2592,6,6,202011
15,26,118,11,162,237,92,110,0,730,1598,2328,9,7,202011
15,27,192,29,389,447,21,195,43,1316,1823,3139,9,5.666666667,202011
15,28,171,39,444,329,55,99,28,1165,1906,3071,9,5,202011
15,29,182,11,366,489,11,233,14,1306,2519,3825,8,6,202011
15,30,203,25,408,422,58,133,30,1279,1736,3015,16,6,202011
15,31,125,153,190,305,16,54,6,849,1399,2248,6,6,202011
15,32,123,12,195,351,56,122,4,863,1221,2084,9,6,202011
15,33,147,24,382,342,36,121,2,1054,2120,3174,7,6,202011
15,34,52,13,115,245,17,32,6,480,1025,1505,8,6,202011
15,35,236,24,301,527,7,144,13,1252,1655,2907,9,5.666666667,202011
15,36,226,13,266,381,85,168,10,1149,1531,2680,9,5.5,202011
15,37,180,20,336,382,125,197,24,1264,2174,3438,7,6,202011
15,38,131,27,226,284,56,93,10,827,1657,2484,6,5.5,202011
15,39,122,14,231,247,39,95,3,751,1388,2139,4,6,202011
15,40,270,61,228,416,166,203,1,1345,2232,3577,9,6,202011
15,41,210,14,626,555,88,201,45,1739,4134,5873,13,6,202011
16,1,150,37,344,177,12,63,2,785,1103,1888,7,5.333333333,202011
16,2,101,34,112,112,24,71,1,455,565,1020,9,4.75,202011
16,3,185,29,184,244,35,112,2,791,1265,2056,10,5.25,202011
16,4,175,29,224,167,55,73,0,723,1091,1814,8,5,202011
16,5,192,21,193,224,57,136,10,833,1079,1912,10,5.666666667,202011
16,6,145,47,186,174,38,122,0,712,1122,1834,12,5.25,202011
16,7,220,45,259,293,55,81,4,957,1106,2063,9,5.5,202011
16,8,202,25,547,529,11,213,4,1531,2616,4147,12,6,202011
16,9,183,17,253,287,5,136,8,889,1522,2411,9,6,202011
16,10,130,15,313,313,19,108,0,898,1603,2501,6,6,202011
16,11,195,24,238,184,60,153,0,854,999,1853,10,5.4,202011
16,12,155,25,222,139,24,177,3,745,983,1728,10,5.25,202011
17,1,166,11,390,405,26,122,5,1125,2018,3143,9,7,202011
17,2,119,8,294,275,15,124,19,854,1329,2183,8,5.666666667,202011
17,3,186,17,387,467,18,186,1,1262,1692,2954,8,5.5,202011
17,4,162,10,328,380,32,77,3,992,1747,2739,10,5.333333333,202011
17,5,99,10,128,182,24,99,0,542,648,1190,5,5.5,202011
18,1,150,16,132,146,45,96,47,632,867,1499,7,4.75,202011
18,2,209,25,310,353,40,238,0,1175,1910,3085,8,5.666666667,202011
18,3,109,12,308,194,6,82,3,714,1132,1846,8,4.75,202011
19,1,145,19,326,308,10,179,37,1024,1860,2884,9,5,202011
19,2,240,21,699,392,21,219,20,1612,2551,4163,9,6,202011
19,3,211,20,601,320,53,210,7,1422,2165,3587,7,5.5,202011
19,4,95,7,171,133,33,202,24,665,1016,1681,5,6,202011
19,5,259,19,639,504,29,361,29,1840,3070,4910,8,6,202011
19,6,76,8,225,219,7,176,1,712,838,1550,5,6,202011
19,7,154,9,505,248,7,122,0,1045,1332,2377,10,5.25,202011
19,8,72,6,157,177,7,50,0,469,859,1328,7,6,202011
19,9,149,16,276,261,31,151,3,887,1146,2033,9,5.25,202011
19,10,82,2,191,160,9,197,16,657,1076,1733,6,6,202011
19,11,250,28,522,628,18,548,49,2043,3152,5195,13,5.333333333,202011
19,12,166,7,618,174,11,89,12,1077,1080,2157,13,5.333333333,202011
20,1,133,19,198,197,66,80,36,729,1224,1953,7,5.5,202011
20,2,214,22,297,210,98,36,10,887,735,1622,6,5.333333333,202011
20,3,97,11,146,121,124,111,20,630,671,1301,6,5.333333333,202011
20,4,91,10,95,197,74,152,43,662,520,1182,6,5,202011
20,5,121,14,229,596,46,70,2,1078,889,1967,11,5.25,202011
20,6,180,15,222,150,196,147,93,1003,860,1863,8,5,202011
20,7,145,14,236,355,31,84,12,877,1299,2176,7,5.5,202011
20,8,369,70,700,550,43,284,21,2037,2617,4654,15,7,202011
20,9,226,25,253,250,122,143,16,1035,1156,2191,8,5.666666667,202011
20,10,164,8,292,149,64,78,0,755,926,1681,9,5.25,202011
21,1,128,9,169,168,20,59,5,558,867,1425,9,3.4,202011
21,2,93,23,156,122,51,56,0,501,760,1261,9,3.2,202011
21,3,168,6,135,125,42,116,13,605,1315,1920,8,3.25,202011
21,4,81,2,41,58,41,79,3,305,675,980,6,3,202011
21,5,148,11,312,164,21,79,8,743,1416,2159,8,3.666666667,202011
21,6,118,8,202,200,49,149,12,738,1385,2123,6,4,202011
21,7,257,11,183,212,67,192,1,923,1229,2152,9,3.666666667,202011
21,8,131,15,159,108,34,138,28,613,1050,1663,9,3.2,202011
21,9,153,16,342,272,42,85,11,921,1666,2587,9,4,202011
21,10,131,6,204,149,14,104,16,624,1834,2458,7,3.5,202011
21,11,63,0,126,82,16,37,2,326,543,869,4,3,202011
21,12,226,14,505,377,68,140,163,1493,3262,4755,16,4.5,202011
21,13,142,3,157,116,26,123,1,568,1282,1850,8,3,202011
21,14,131,12,117,95,56,107,4,522,1026,1548,12,3.333333333,202011
21,15,124,7,177,170,31,130,10,649,1123,1772,7,3.5,202011
22,1,172,71,208,448,43,70,7,1019,1271,2290,11,5,202011
22,2,128,35,286,242,77,66,7,841,1619,2460,7,5.5,202011
22,3,221,45,802,601,23,168,4,1864,3002,4866,9,5.666666667,202011
22,4,163,37,574,468,18,200,1,1461,2849,4310,9,6.5,202011
22,5,120,20,366,221,53,103,18,901,1280,2181,10,5.5,202011
23,1,189,5,899,257,40,140,13,1543,2643,4186,14,5.4,202011
23,2,134,22,420,336,27,42,1,982,1722,2704,8,5.25,202011
23,3,195,20,927,490,44,86,18,1780,2376,4156,19,6,202011
23,4,125,8,483,272,28,132,18,1066,2218,3284,6,5.5,202011
24,1,120,50,188,224,19,144,2,747,1179,1926,10,5.2,202011
24,2,125,27,253,166,29,113,20,733,784,1517,6,5.5,202011
24,3,143,45,178,245,81,44,3,739,806,1545,9,5.25,202011
24,4,127,20,242,156,44,152,37,778,929,1707,5,5.5,202011
24,5,236,57,561,541,16,123,1,1535,2362,3897,9,6,202011
24,6,176,85,361,338,66,141,0,1167,2004,3171,6,6,202011
24,7,198,22,183,262,58,40,0,763,655,1418,9,5.25,202011
25,1,149,10,212,272,35,173,57,908,1065,1973,13,5.75,202011
25,2,199,39,321,389,26,163,0,1137,2059,3196,7,5.5,202011
25,3,244,17,324,501,30,168,13,1297,1464,2761,8,5.6,202011
25,4,181,21,244,222,76,86,0,830,934,1764,8,5.333333333,202011
25,5,170,16,350,426,19,133,19,1133,1697,2830,8,5.666666667,202011
25,6,162,13,265,279,44,172,17,952,1288,2240,8,5.75,202011
25,7,209,23,491,451,10,93,0,1277,1713,2990,6,6,202011
26,1,183,15,313,253,3,165,0,932,1437,2369,9,5,202011
26,2,226,9,422,392,10,136,20,1215,1655,2870,12,5.2,202011
26,3,205,20,322,416,19,246,32,1260,1797,3057,13,6,202011
26,4,136,16,281,200,52,61,22,768,841,1609,9,5.2,202011
26,5,129,23,206,268,17,195,0,838,1293,2131,15,6,202011
26,6,188,12,241,237,24,249,0,951,1281,2232,10,5,202011
26,7,143,33,173,226,100,60,23,758,1117,1875,10,5.5,202011
27,1,134,13,178,303,111,87,8,834,1318,2152,8,5.5,202011
27,2,142,16,217,428,29,76,13,921,1575,2496,8,5.333333333,202011
27,3,129,6,117,398,9,137,1,797,1341,2138,7,5.666666667,202011
27,4,192,14,386,678,31,202,7,1510,2955,4465,8,6,202011
27,5,94,8,149,293,37,98,0,679,846,1525,6,5.333333333,202011
27,6,145,13,238,556,9,100,9,1070,1463,2533,7,5.5,202011
28,1,160,33,511,384,12,116,2,1218,1794,3012,13,5.8,202011
28,2,163,29,441,235,43,192,131,1234,1838,3072,15,5.666666667,202011
28,3,119,10,254,121,16,92,13,625,829,1454,7,5.333333333,202011
28,4,241,34,489,274,59,164,49,1310,2396,3706,18,6.5,202011
28,5,182,14,211,302,22,231,24,986,1643,2629,10,5.5,202011
28,6,134,31,212,911,65,86,20,1459,1745,3204,13,5,202011
28,7,178,20,411,325,59,266,21,1280,2278,3558,13,6,202011
28,8,94,7,236,217,28,182,3,767,1189,1956,13,7,202011
28,9,157,9,375,226,28,161,36,992,1415,2407,11,5.5,202011
29,1,171,29,351,380,46,182,12,1171,1437,2608,7,4.75,202011
29,2,199,26,278,477,27,244,115,1366,1804,3170,11,5.666666667,202011
29,3,128,16,170,374,18,170,0,876,1064,1940,6,5.333333333,202011
30,1,126,13,206,183,90,72,10,700,662,1362,7,5.333333333,202011
30,2,149,5,107,96,44,79,99,579,769,1348,8,5,202011
30,3,177,11,196,117,75,130,46,752,853,1605,6,5,202011
30,4,68,16,308,113,30,90,0,625,967,1592,8,5,202011
30,5,114,15,276,185,27,70,5,692,1155,1847,7,4.5,202011
30,6,159,9,238,187,47,81,12,733,871,1604,9,4.666666667,202011
30,7,173,40,219,209,82,95,40,858,1193,2051,11,5,202011
30,8,141,25,420,208,83,136,5,1018,1651,2669,11,5.2,202011
30,9,222,8,240,169,67,165,30,901,1176,2077,8,5.25,202011
30,10,120,13,332,207,24,174,17,887,1110,1997,6,5,202011
30,11,112,10,333,306,25,90,8,884,1346,2230,5,4.5,202011
30,12,170,16,540,347,26,217,3,1319,2057,3376,10,5,202011
30,13,202,27,181,238,69,221,75,1013,1497,2510,10,5.2,202011
30,14,119,10,165,151,97,100,18,660,972,1632,8,4.75,202011
30,15,194,25,244,232,130,239,46,1110,2082,3192,11,5.333333333,202011
30,16,136,7,249,332,37,97,92,950,1689,2639,10,5,202011
30,17,152,13,202,240,26,177,61,871,1568,2439,8,5.25,202011
30,18,114,19,76,107,41,81,25,463,597,1060,8,4.75,202011
30,19,167,16,337,187,13,137,28,885,1092,1977,13,4.8,202011
30,20,125,6,130,491,73,125,2,952,1230,2182,10,5,202011
31,1,207,20,250,42,215,82,0,816,1037,1853,8,5.25,202011
31,2,76,7,92,13,125,110,0,423,563,986,6,5,202011
31,3,329,87,1193,683,130,178,3,2603,3470,6073,21,6,202011
31,4,70,11,335,151,116,123,17,823,878,1701,4,6,202011
31,5,104,6,165,157,58,112,3,605,784,1389,6,5,202011
32,1,149,23,195,173,31,142,19,732,1010,1742,12,4.6,202011
32,2,206,21,153,148,89,154,29,800,929,1729,13,5,202011
32,3,149,51,185,298,10,167,1,861,1077,1938,13,5,202011
32,4,243,39,275,310,21,143,26,1057,1430,2487,12,5.2,202011
1,1,168,37,175,210,54,114,0,758,993,1751,13,4.5,202012
1,2,132,30,373,291,23,111,11,971,1475,2446,10,5.333333333,202012
1,3,115,23,265,251,19,149,9,831,1420,2251,9,5,202012
2,1,133,8,208,244,18,169,18,798,1380,2178,11,5,202012
2,2,86,10,194,251,3,190,0,734,930,1664,8,5.5,202012
2,3,155,9,238,193,11,237,17,860,1171,2031,12,5,202012
2,4,105,6,448,165,42,133,13,912,1212,2124,9,5,202012
2,5,173,18,469,203,82,228,8,1181,1994,3175,11,5,202012
2,6,108,14,267,195,22,157,0,763,1076,1839,8,5.5,202012
2,7,117,14,301,211,12,188,4,847,1260,2107,12,4.75,202012
2,8,105,6,258,215,12,142,15,753,1062,1815,6,5,202012
3,1,120,15,259,248,21,139,7,809,1226,2035,12,4.666666667,202012
3,2,97,8,358,140,45,104,0,752,1445,2197,9,4.666666667,202012
4,1,113,11,194,257,57,111,11,754,1109,1863,11,4.25,202012
4,2,136,13,272,315,77,99,44,956,1227,2183,14,4.2,202012
5,1,44,10,120,134,12,40,8,368,168,536,9,5.666666667,202012
5,2,51,7,105,160,13,26,4,366,428,794,10,5.2,202012
5,3,44,10,86,160,29,35,17,381,259,640,11,5.333333333,202012
5,4,28,10,130,320,0,23,2,513,410,923,11,5.75,202012
5,5,36,5,94,289,1,81,16,522,360,882,10,6,202012
5,6,36,5,112,196,3,28,31,411,298,709,10,5.5,202012
5,7,27,6,81,198,6,21,21,360,229,589,10,5.5,202012
6,1,115,12,133,112,3,92,13,480,892,1372,11,4.8,202012
6,2,91,4,198,141,19,90,7,550,851,1401,9,4.666666667,202012
7,1,138,2,80,97,8,27,2,354,1560,1914,9,4.25,202012
7,2,135,8,298,259,15,18,0,733,972,1705,9,4.25,202012
7,3,167,4,188,149,188,51,0,747,470,1217,7,4.333333333,202012
7,4,110,6,98,321,4,32,12,583,384,967,11,4.4,202012
7,5,209,14,132,286,31,81,1,754,1375,2129,11,4.666666667,202012
7,6,128,10,310,218,30,83,2,781,1298,2079,9,4.666666667,202012
7,7,149,10,171,229,112,115,9,795,1139,1934,8,4.5,202012
7,8,122,17,101,113,25,66,17,461,752,1213,12,4.25,202012
7,9,122,2,171,272,9,119,7,702,1695,2397,9,4.666666667,202012
7,10,105,6,135,392,14,48,3,703,883,1586,9,4.5,202012
7,11,106,2,110,70,35,17,0,340,813,1153,6,4.333333333,202012
7,12,148,7,232,346,10,30,8,781,1359,2140,9,4.5,202012
7,13,93,16,238,368,1,27,0,743,572,1315,9,4.25,202012
8,1,85,3,214,127,10,57,0,496,734,1230,4,5,202012
8,2,177,48,382,295,25,87,4,1018,1685,2703,16,4.5,202012
8,3,120,25,286,221,31,80,46,809,1285,2094,4,5,202012
8,4,107,18,257,207,26,123,21,759,1384,2143,11,5,202012
8,5,138,39,171,195,22,67,0,632,1321,1953,10,4.25,202012
8,6,114,36,217,224,24,76,12,703,1002,1705,8,5,202012
8,7,108,38,156,191,6,102,0,601,913,1514,7,4.25,202012
8,8,177,21,296,363,10,226,1,1094,1624,2718,10,5,202012
8,9,134,21,153,127,31,84,31,581,848,1429,10,4,202012
9,1,48,1,101,109,44,86,7,396,628,1024,5,5,202012
9,2,227,48,570,620,106,324,21,1916,3120,5036,12,5,202012
9,3,64,8,201,184,36,131,8,632,1095,1727,7,5,202012
9,4,90,16,253,423,41,154,5,982,2202,3184,11,5,202012
9,5,84,4,145,218,41,127,0,619,1246,1865,7,5,202012
9,6,63,9,138,151,66,104,7,538,839,1377,7,5,202012
9,7,61,5,241,241,1,104,3,656,881,1537,9,5,202012
9,8,65,10,269,227,24,113,4,712,1011,1723,5,5,202012
9,9,72,9,142,188,33,94,3,541,870,1411,5,5,202012
9,10,65,17,252,248,8,133,1,724,1109,1833,6,5,202012
9,11,102,11,296,294,64,194,8,969,1585,2554,7,5,202012
9,12,105,22,382,439,14,194,17,1173,1755,2928,11,5,202012
9,13,70,11,235,254,58,132,7,767,1193,1960,4,5,202012
9,14,53,6,129,156,9,87,5,445,1069,1514,5,5,202012
9,15,147,19,652,629,39,291,11,1788,2682,4470,10,5.5,202012
9,16,137,149,254,421,54,155,0,1170,1749,2919,15,5,202012
9,17,72,5,220,176,22,137,1,633,1231,1864,6,5,202012
9,18,102,21,254,322,55,177,19,950,1466,2416,12,5,202012
9,19,134,24,254,294,102,179,7,994,1237,2231,5,5,202012
9,20,20,3,97,121,36,47,1,325,625,950,5,5,202012
9,21,111,8,151,202,31,104,7,614,805,1419,3,5,202012
9,22,91,17,174,238,96,128,10,754,944,1698,5,5,202012
9,23,69,13,223,277,58,97,0,737,1737,2474,6,5,202012
9,24,162,18,454,548,157,273,6,1618,2691,4309,14,5,202012
10,1,148,14,133,196,14,118,9,632,1110,1742,12,3.833333333,202012
10,2,127,19,209,230,9,144,2,740,942,1682,9,4.25,202012
10,3,114,18,116,174,9,129,12,572,958,1530,11,4.4,202012
10,4,152,18,259,340,9,200,3,981,1672,2653,12,5.5,202012
11,1,133,42,130,202,24,105,3,639,941,1580,6,4.666666667,202012
11,2,113,37,186,158,84,102,10,690,1709,2399,7,5,202012
11,3,119,27,174,166,13,104,3,606,876,1482,3,5,202012
11,4,94,39,147,184,28,95,1,588,1024,1612,8,5,202012
11,5,180,52,275,344,27,101,22,1001,2533,3534,7,5,202012
11,6,105,22,194,212,24,90,2,649,904,1553,8,5,202012
11,7,163,33,231,477,20,123,0,1047,1448,2495,9,4.5,202012
11,8,169,22,216,270,58,112,13,860,1255,2115,9,4.75,202012
11,9,151,32,235,286,8,144,9,865,1670,2535,10,4.666666667,202012
11,10,166,19,167,170,34,175,23,754,1116,1870,10,4.6,202012
11,11,106,29,241,267,8,98,0,749,1277,2026,5,5,202012
11,12,145,48,301,327,15,123,1,960,1641,2601,7,5,202012
11,13,129,36,147,140,20,87,26,585,940,1525,8,4.5,202012
11,14,137,27,213,198,42,92,0,709,1121,1830,8,4.5,202012
11,15,100,19,186,178,15,90,11,599,870,1469,9,5,202012
12,1,78,17,109,98,41,103,0,446,788,1234,10,4,202012
12,2,123,10,176,267,8,153,0,737,1040,1777,10,4.25,202012
12,3,138,22,246,475,28,58,0,967,956,1923,11,4.2,202012
12,4,104,16,226,334,18,109,0,807,1145,1952,9,4.666666667,202012
12,5,149,22,115,208,1,51,34,580,813,1393,10,4.25,202012
12,6,126,17,181,379,29,34,9,775,541,1316,10,4.25,202012
12,7,146,13,131,263,4,155,44,756,1029,1785,6,4.5,202012
12,8,122,15,208,330,1,50,0,726,697,1423,9,4.25,202012
12,9,118,29,231,318,45,68,4,813,1037,1850,9,4.666666667,202012
13,1,70,9,41,96,25,7,66,314,168,482,9,4.333333333,202012
13,2,57,14,37,93,22,39,25,287,112,399,6,4.333333333,202012
13,3,70,9,110,211,75,31,11,517,200,717,12,4.25,202012
13,4,74,16,114,243,48,51,70,616,533,1149,9,4.666666667,202012
13,5,52,11,101,293,35,37,36,565,351,916,9,4.75,202012
13,6,92,21,217,565,21,59,51,1026,919,1945,11,4.666666667,202012
13,7,48,4,87,277,4,43,0,463,442,905,8,4.5,202012
14,1,0,0,0,0,0,0,0,0,0,0,0,0,202012
14,2,0,0,0,0,0,0,0,0,0,0,0,0,202012
14,3,0,0,0,0,0,0,0,0,0,0,0,0,202012
14,4,0,0,0,0,0,0,0,0,0,0,0,0,202012
14,5,0,0,0,0,0,0,0,0,0,0,0,0,202012
14,6,0,0,0,0,0,0,0,0,0,0,0,0,202012
14,7,0,0,0,0,0,0,0,0,0,0,0,0,202012
14,8,0,0,0,0,0,0,0,0,0,0,0,0,202012
14,9,0,0,0,0,0,0,0,0,0,0,0,0,202012
14,10,0,0,0,0,0,0,0,0,0,0,0,0,202012
14,11,0,0,0,0,0,0,0,0,0,0,0,0,202012
14,12,0,0,0,0,0,0,0,0,0,0,0,0,202012
14,13,0,0,0,0,0,0,0,0,0,0,0,0,202012
14,14,0,0,0,0,0,0,0,0,0,0,0,0,202012
14,15,0,0,0,0,0,0,0,0,0,0,0,0,202012
14,16,0,0,0,0,0,0,0,0,0,0,0,0,202012
14,17,0,0,0,0,0,0,0,0,0,0,0,0,202012
14,18,0,0,0,0,0,0,0,0,0,0,0,0,202012
14,19,0,0,0,0,0,0,0,0,0,0,0,0,202012
14,20,0,0,0,0,0,0,0,0,0,0,0,0,202012
15,1,143,15,110,83,194,110,0,655,959,1614,7,4.333333333,202012
15,2,106,7,180,216,83,78,3,673,1064,1737,6,5,202012
15,3,172,12,154,189,198,165,19,909,1479,2388,10,4.666666667,202012
15,4,114,17,176,270,41,122,11,751,1067,1818,4,5,202012
15,5,115,20,213,198,35,73,6,660,1137,1797,8,4.666666667,202012
15,6,117,6,222,322,26,99,16,808,1643,2451,7,5,202012
15,7,52,12,199,165,59,136,4,627,1116,1743,10,5,202012
15,8,52,15,125,168,13,62,6,441,719,1160,4,5,202012
15,9,116,5,98,93,60,157,0,529,984,1513,9,4.75,202012
15,10,78,12,177,252,11,102,7,639,1150,1789,6,5,202012
15,11,123,15,252,251,54,73,9,777,1221,1998,8,5,202012
15,12,98,14,267,260,55,61,1,756,1884,2640,8,5,202012
15,13,70,7,134,173,84,106,0,574,753,1327,8,5,202012
15,14,49,19,86,143,21,66,3,387,689,1076,4,5,202012
15,15,89,99,202,291,48,60,7,796,1232,2028,6,5,202012
15,16,168,22,321,418,23,177,17,1146,1813,2959,8,5,202012
15,17,94,4,154,213,24,104,21,614,954,1568,8,5,202012
15,18,154,20,260,329,38,136,14,951,1548,2499,7,4.666666667,202012
15,19,138,34,421,580,28,172,14,1387,2256,3643,10,5,202012
15,20,56,5,214,166,13,41,2,497,1376,1873,6,5,202012
15,21,28,2,37,60,15,35,4,181,618,799,6,4.5,202012
15,22,177,80,479,466,40,126,30,1398,2467,3865,14,5,202012
15,23,85,4,142,205,21,80,6,543,953,1496,6,4.333333333,202012
15,24,74,26,182,199,24,55,5,565,904,1469,4,5,202012
15,25,92,13,196,228,31,110,11,681,1577,2258,6,5,202012
15,26,101,10,141,236,85,108,0,681,1022,1703,9,6,202012
15,27,138,30,284,336,24,166,30,1008,2263,3271,9,4.666666667,202012
15,28,151,29,369,265,24,88,5,931,1407,2338,9,4.666666667,202012
15,29,157,18,313,447,9,204,9,1157,1767,2924,8,5,202012
15,30,143,33,326,385,55,107,21,1070,1397,2467,16,5,202012
15,31,85,92,148,215,12,38,0,590,995,1585,6,5,202012
15,32,93,9,149,287,42,99,1,680,887,1567,9,5,202012
15,33,138,15,279,293,28,104,2,859,1430,2289,7,5,202012
15,34,47,13,95,183,17,25,6,386,1208,1594,8,5,202012
15,35,146,16,215,396,8,92,8,881,1421,2302,9,4.666666667,202012
15,36,140,13,201,274,54,137,6,825,1402,2227,9,4.5,202012
15,37,164,17,311,378,85,172,11,1138,1669,2807,7,5,202012
15,38,129,46,185,272,52,66,6,756,1202,1958,6,4.5,202012
15,39,125,18,181,219,28,88,2,661,1198,1859,4,5,202012
15,40,188,46,185,337,120,152,0,1028,1552,2580,9,5,202012
15,41,179,16,370,443,77,149,18,1252,1841,3093,13,5,202012
16,1,74,23,254,104,10,44,1,510,838,1348,7,4.333333333,202012
16,2,93,23,66,92,8,72,3,357,359,716,9,4.25,202012
16,3,114,12,102,170,22,103,2,525,688,1213,10,4.25,202012
16,4,136,26,209,129,51,62,0,613,986,1599,8,4.5,202012
16,5,120,22,135,154,56,118,16,621,911,1532,10,4.666666667,202012
16,6,134,38,159,165,45,81,0,622,822,1444,12,4.5,202012
16,7,167,26,200,216,37,68,1,715,1010,1725,9,4.5,202012
16,8,207,25,441,434,10,123,2,1242,1942,3184,12,5,202012
16,9,145,13,216,267,6,106,2,755,972,1727,9,5,202012
16,10,109,18,247,245,15,83,1,718,1070,1788,6,5,202012
16,11,161,32,169,133,51,111,3,660,1093,1753,10,4.4,202012
16,12,95,20,144,116,19,99,0,493,655,1148,10,4.25,202012
17,1,146,13,309,330,30,86,6,920,1598,2518,9,6,202012
17,2,103,5,182,253,16,105,9,673,1018,1691,8,4.666666667,202012
17,3,172,13,268,344,18,150,0,965,1445,2410,8,4.5,202012
17,4,134,16,274,285,27,71,4,811,1449,2260,10,4.666666667,202012
17,5,85,10,91,132,29,56,0,403,522,925,5,4.5,202012
18,1,69,8,65,80,18,75,11,326,706,1032,7,4,202012
18,2,160,17,211,207,31,194,0,820,1319,2139,9,5.333333333,202012
18,3,114,17,230,160,8,83,1,613,954,1567,8,4,202012
19,1,69,8,194,186,4,86,14,561,1588,2149,9,5,202012
19,2,119,15,372,235,6,93,3,843,2709,3552,9,5,202012
19,3,127,11,340,204,28,118,6,834,1953,2787,7,5,202012
19,4,65,3,93,109,22,116,9,417,870,1287,5,5,202012
19,5,180,32,388,334,21,219,19,1193,2987,4180,8,5,202012
19,6,33,6,98,106,5,75,3,326,591,917,5,5,202012
19,7,80,9,281,143,3,54,0,570,977,1547,10,4.5,202012
19,8,38,3,119,140,0,26,0,326,529,855,7,5,202012
19,9,107,8,152,128,26,86,10,517,1237,1754,9,4.25,202012
19,10,57,5,134,111,8,115,6,436,1255,1691,5,5,202012
19,11,182,28,364,421,9,341,17,1362,3262,4624,13,5,202012
19,12,95,9,314,147,6,55,2,628,1515,2143,11,3.333333333,202012
20,1,111,7,133,134,95,46,35,561,1015,1576,7,4.5,202012
20,2,137,20,215,163,47,12,4,598,627,1225,6,4.333333333,202012
20,3,91,9,109,85,127,64,6,491,552,1043,6,4,202012
20,4,79,5,47,120,30,139,13,433,529,962,6,4.333333333,202012
20,5,95,18,228,416,39,53,3,852,546,1398,11,4.25,202012
20,6,183,8,171,140,98,102,91,793,659,1452,8,4.25,202012
20,7,134,11,140,224,40,38,9,596,1452,2048,7,4.75,202012
20,8,272,22,487,409,37,215,22,1464,2917,4381,15,6,202012
20,9,162,12,192,197,97,108,7,775,965,1740,8,4.666666667,202012
20,10,130,14,290,125,26,61,0,646,958,1604,9,4.25,202012
21,1,149,16,270,213,33,55,2,738,853,1591,9,4.4,202012
21,2,124,16,211,144,74,72,0,641,975,1616,9,4.2,202012
21,3,195,4,206,165,52,162,7,791,941,1732,8,4.5,202012
21,4,132,3,112,68,94,123,2,534,490,1024,6,4.25,202012
21,5,146,20,397,233,27,86,14,923,1751,2674,8,4.666666667,202012
21,6,151,12,216,226,49,167,14,835,1709,2544,6,4,202012
21,7,276,10,163,198,70,207,1,925,1088,2013,9,4.666666667,202012
21,8,158,10,179,147,44,124,43,705,1111,1816,9,4.2,202012
21,9,159,16,354,292,65,108,27,1021,1375,2396,9,5,202012
21,10,99,11,245,232,14,143,23,767,1606,2373,7,4,202012
21,11,62,4,130,105,31,51,3,386,566,952,4,5,202012
21,12,221,20,567,397,54,181,190,1630,2431,4061,16,5,202012
21,13,169,10,221,163,21,155,3,742,1165,1907,8,4.666666667,202012
21,14,186,14,248,134,70,137,11,800,1003,1803,12,4.333333333,202012
21,15,243,9,268,321,29,192,11,1073,1183,2256,7,4.5,202012
22,1,167,51,210,320,32,40,10,830,1197,2027,11,4.2,202012
22,2,113,29,201,179,41,56,3,622,1079,1701,7,4.5,202012
22,3,180,39,604,445,17,115,2,1402,2108,3510,9,4.333333333,202012
22,4,113,35,486,364,21,158,2,1179,1994,3173,9,5.5,202012
22,5,102,22,255,185,22,51,4,641,1008,1649,10,4.5,202012
23,1,112,6,544,166,34,74,7,943,2562,3505,14,4.6,202012
23,2,119,13,388,247,20,28,0,815,1426,2241,8,4.25,202012
23,3,131,6,670,363,27,61,11,1269,2867,4136,19,5,202012
23,4,69,3,314,213,12,108,13,732,1245,1977,6,4.5,202012
24,1,92,40,109,157,8,97,0,503,645,1148,10,4.2,202012
24,2,77,12,160,148,12,55,8,472,939,1411,6,4.5,202012
24,3,135,51,135,226,85,51,1,684,936,1620,9,4.25,202012
24,4,112,14,118,124,23,133,30,554,838,1392,5,4.5,202012
24,5,177,47,463,444,6,77,0,1214,1790,3004,10,5.333333333,202012
24,6,133,60,275,259,51,90,2,870,1348,2218,6,5,202012
24,7,128,18,147,255,51,22,0,621,819,1440,9,4.25,202012
25,1,114,3,182,224,21,113,53,710,1049,1759,13,4.75,202012
25,2,137,22,229,264,22,129,0,803,1672,2475,7,4.5,202012
25,3,144,8,190,407,39,122,13,923,1248,2171,8,4.6,202012
25,4,141,10,184,194,57,87,0,673,902,1575,8,4.333333333,202012
25,5,132,8,213,313,15,61,10,752,1161,1913,8,4.666666667,202012
25,6,112,3,214,237,35,153,11,765,1035,1800,8,4.75,202012
25,7,169,13,339,338,5,79,0,943,1441,2384,6,5,202012
26,1,107,9,233,233,8,111,0,701,1257,1958,9,4.5,202012
26,2,74,3,146,184,0,61,3,471,1151,1622,12,3.2,202012
26,3,101,7,166,218,18,119,10,639,1423,2062,13,5,202012
26,4,78,4,129,119,29,30,21,410,683,1093,9,3.8,202012
26,5,44,12,60,131,8,73,0,328,584,912,15,5,202012
26,6,131,10,176,232,13,170,1,733,944,1677,10,4.333333333,202012
26,7,63,18,94,114,41,26,8,364,824,1188,10,4.5,202012
27,1,94,5,218,313,90,66,1,787,731,1518,8,4.5,202012
27,2,101,14,129,386,19,47,5,701,1419,2120,8,4.666666667,202012
27,3,102,5,111,361,8,98,0,685,1085,1770,7,4.666666667,202012
27,4,140,18,298,546,15,141,1,1159,1797,2956,8,5,202012
27,5,114,8,141,260,23,107,1,654,755,1409,6,4.333333333,202012
27,6,139,5,213,531,27,102,4,1021,928,1949,7,4.5,202012
28,1,77,17,290,242,3,75,2,706,1403,2109,13,5,202012
28,2,108,7,257,193,18,126,90,799,1253,2052,15,4.666666667,202012
28,3,80,8,179,86,5,57,11,426,550,976,7,4.333333333,202012
28,4,171,22,347,225,51,138,30,984,1710,2694,18,5.5,202012
28,5,123,5,152,225,12,159,17,693,1453,2146,10,4.5,202012
28,6,62,12,111,347,27,66,6,631,1116,1747,13,3.833333333,202012
28,7,90,11,229,197,36,160,22,745,1269,2014,13,5,202012
28,8,65,4,174,188,31,105,2,569,806,1375,13,6,202012
28,9,89,7,232,156,20,98,24,626,1151,1777,11,4.75,202012
29,1,190,25,258,332,31,133,4,973,1212,2185,7,4.5,202012
29,2,180,10,174,385,29,170,50,998,1439,2437,11,5,202012
29,3,133,18,124,325,13,148,0,761,853,1614,6,4.666666667,202012
30,1,54,7,81,78,43,49,3,315,499,814,7,4.333333333,202012
30,2,129,4,77,75,98,63,60,506,694,1200,8,4.25,202012
30,3,91,10,166,121,53,93,23,557,941,1498,6,4.666666667,202012
30,4,67,9,150,60,18,49,0,353,702,1055,8,5,202012
30,5,97,5,236,177,34,49,7,605,673,1278,7,4.5,202012
30,6,147,7,215,192,40,75,14,690,731,1421,9,4.333333333,202012
30,7,100,22,180,177,77,47,25,628,847,1475,11,4.25,202012
30,8,164,14,318,227,67,123,6,919,1513,2432,11,4.4,202012
30,9,141,9,153,148,76,107,23,657,1024,1681,8,4.5,202012
30,10,135,7,305,227,16,141,14,845,912,1757,6,5,202012
30,11,82,5,295,256,9,58,2,707,877,1584,5,4.5,202012
30,12,133,10,366,243,16,117,4,889,1666,2555,10,5,202012
30,13,105,6,110,158,50,124,52,605,702,1307,10,4.4,202012
30,14,117,9,177,139,84,102,18,646,842,1488,8,4.5,202012
30,15,140,9,145,198,53,174,51,770,1332,2102,11,4.666666667,202012
30,16,103,4,218,295,36,106,64,826,1300,2126,10,4.333333333,202012
30,17,163,23,214,249,30,154,48,881,922,1803,8,4.5,202012
30,18,117,14,79,156,24,63,43,496,703,1199,8,4.25,202012
30,19,112,8,324,139,106,101,6,796,1216,2012,13,4.6,202012
30,20,133,7,139,363,76,152,0,870,920,1790,10,4.4,202012
31,1,106,13,126,32,138,68,0,483,822,1305,8,4.25,202012
31,2,38,3,84,7,72,49,0,253,311,564,6,3,202012
31,3,178,41,618,373,87,95,0,1392,2991,4383,21,5.333333333,202012
31,4,49,5,150,103,67,74,19,467,661,1128,4,5,202012
31,5,78,5,83,117,28,75,3,389,850,1239,6,4.333333333,202012
32,1,127,31,158,144,39,124,20,643,929,1572,12,4.2,202012
32,2,150,20,120,84,54,105,13,546,847,1393,13,4.142857143,202012
32,3,117,37,124,262,6,145,3,694,849,1543,13,4.4,202012
32,4,133,33,181,195,15,130,10,697,1386,2083,12,4.2,202012
1,1,14,0,11,16,1,1,1,44,700,744,10,5,202032
1,2,18,0,15,20,2,3,1,59,655,714,9,5,202032
1,3,0,0,0,0,0,0,0,0,625,625,8,5,202032
2,1,0,0,0,0,0,0,0,0,462,462,4,3.333333333,202032
2,2,0,0,0,0,0,0,0,0,0,0,0,0,202032
2,3,0,0,0,0,0,0,0,0,922,922,8,5,202032
2,4,0,0,0,0,0,0,0,0,949,949,7,5,202032
2,5,0,0,0,0,0,0,0,0,1149,1149,5,5,202032
2,6,0,0,0,0,0,0,0,0,718,718,6,5,202032
2,7,0,0,0,0,0,0,0,0,607,607,5,3.333333333,202032
2,8,0,0,0,0,0,0,0,0,830,830,3,5,202032
3,1,0,0,0,0,0,0,0,0,551,551,8,5,202032
3,2,19,1,36,37,5,3,0,101,586,687,7,5,202032
4,1,0,0,0,0,0,0,0,0,423,423,6,5,202032
4,2,0,0,0,0,0,0,0,0,336,336,7,5,202032
5,1,0,0,0,0,0,0,0,0,159,159,7,5,202032
5,2,0,0,0,0,0,0,0,0,118,118,6,5,202032
5,3,0,0,0,0,0,0,0,0,173,173,8,5,202032
5,4,0,0,0,0,0,0,0,0,268,268,7,5,202032
5,5,0,0,0,0,0,0,0,0,298,298,10,5,202032
5,6,0,0,0,0,0,0,0,0,140,140,3,5,202032
5,7,0,0,0,0,0,0,0,0,159,159,6,5,202032
6,1,0,0,0,0,0,0,0,0,414,414,8,5,202032
6,2,0,0,0,0,0,0,0,0,189,189,3,2.5,202032
7,1,0,0,0,0,0,0,0,0,168,168,6,5,202032
7,2,0,0,0,0,0,0,0,0,333,333,6,5,202032
7,3,0,0,0,0,0,0,0,0,378,378,4,5,202032
7,4,0,0,0,0,0,0,0,0,291,291,8,5,202032
7,5,0,0,0,0,0,0,0,0,543,543,10,5,202032
7,6,0,1,0,0,0,0,0,1,0,1,1,0,202032
7,7,0,0,0,0,0,0,0,0,534,534,6,5,202032
7,8,0,0,0,0,0,0,0,0,450,450,7,5,202032
7,9,0,0,0,0,0,0,0,0,0,0,0,0,202032
7,10,0,0,0,0,0,0,0,0,380,380,6,5,202032
7,11,0,0,0,0,0,0,0,0,158,158,4,5,202032
7,12,0,0,0,0,0,0,0,0,0,0,0,0,202032
7,13,0,0,0,0,0,0,0,0,88,88,3,5,202032
8,1,0,0,0,0,0,0,0,0,0,0,0,0,202032
8,2,0,0,0,0,0,0,0,0,208,208,3,2.5,202032
8,3,0,0,0,0,0,0,0,0,0,0,0,0,202032
8,4,0,0,0,0,0,0,0,0,0,0,0,0,202032
8,5,0,0,0,0,0,0,0,0,354,354,6,5,202032
8,6,0,0,0,0,0,0,0,0,653,653,5,5,202032
8,7,0,0,0,0,0,0,0,0,272,272,5,5,202032
8,8,0,0,0,0,0,1,0,1,959,960,8,5,202032
8,9,0,0,0,0,0,0,0,0,276,276,7,5,202032
9,1,0,0,0,0,0,0,0,0,527,527,4,5,202032
9,2,0,0,0,0,1,0,0,1,1673,1674,10,5,202032
9,3,0,0,0,0,0,0,0,0,724,724,4,5,202032
9,4,0,0,0,0,0,0,0,0,711,711,7,5,202032
9,5,0,0,0,1,0,0,0,1,558,559,6,5,202032
9,6,0,0,0,0,0,0,0,0,703,703,7,5,202032
9,7,0,0,0,0,0,0,0,0,630,630,4,5,202032
9,8,0,0,0,0,0,0,0,0,620,620,3,5,202032
9,9,0,0,0,0,0,0,0,0,601,601,3,5,202032
9,10,0,0,0,0,0,0,0,0,670,670,3,5,202032
9,11,0,0,0,0,0,0,0,0,784,784,7,5,202032
9,12,0,0,0,0,0,0,0,0,1108,1108,7,5,202032
9,13,0,0,0,0,0,0,0,0,579,579,3,5,202032
9,14,0,0,0,0,0,0,0,0,800,800,5,5,202032
9,15,0,0,1,0,0,0,0,1,1446,1447,6,5,202032
9,16,0,0,0,0,0,0,0,0,960,960,11,5,202032
9,17,0,0,0,1,0,1,0,2,639,641,5,5,202032
9,18,0,0,0,0,0,0,0,0,894,894,8,5,202032
9,19,0,0,0,0,0,0,0,0,839,839,3,5,202032
9,20,0,0,0,0,0,0,0,0,443,443,2,5,202032
9,21,0,0,0,0,0,0,0,0,462,462,3,5,202032
9,22,0,0,0,0,0,0,0,0,543,543,4,5,202032
9,23,0,0,0,1,0,0,0,1,952,953,6,5,202032
9,24,0,0,0,0,0,0,0,0,1476,1476,11,5,202032
10,1,0,0,0,0,0,0,0,0,403,403,9,5,202032
10,2,0,0,0,0,0,0,0,0,536,536,5,5,202032
10,3,0,0,0,0,0,0,0,0,375,375,9,5,202032
10,4,0,0,0,0,0,0,0,0,780,780,11,5,202032
11,1,0,0,0,0,0,0,0,0,319,319,6,5,202032
11,2,0,0,0,0,0,0,0,0,654,654,6,5,202032
11,3,0,0,0,0,0,0,0,0,364,364,3,5,202032
11,4,0,0,0,2,0,0,0,2,407,409,5,5,202032
11,5,0,0,0,0,0,0,0,0,1073,1073,7,5,202032
11,6,0,0,0,0,0,0,0,0,436,436,5,5,202032
11,7,0,0,0,0,0,0,0,0,575,575,7,5,202032
11,8,0,0,0,0,0,0,0,0,637,637,9,5,202032
11,9,0,0,0,0,0,0,0,0,721,721,7,5,202032
11,10,0,0,0,0,0,0,0,0,394,394,9,5,202032
11,11,5,2,8,10,0,4,0,29,608,637,5,5,202032
11,12,0,0,0,0,0,0,0,0,705,705,7,5,202032
11,13,0,0,0,0,0,0,0,0,310,310,7,5,202032
11,14,0,0,0,0,0,0,0,0,340,340,6,5,202032
11,15,0,0,0,0,0,0,0,0,700,700,4,5,202032
12,1,0,0,0,0,0,0,0,0,273,273,6,5,202032
12,2,0,0,0,0,0,0,0,0,586,586,8,5,202032
12,3,0,0,0,0,0,0,0,0,316,316,7,5,202032
12,4,0,0,1,1,0,1,0,3,887,890,8,5,202032
12,5,0,0,0,0,0,0,0,0,415,415,7,5,202032
12,6,0,0,0,0,0,0,0,0,279,279,7,5,202032
12,7,0,0,0,0,0,0,0,0,488,488,5,5,202032
12,8,0,0,0,0,0,0,0,0,219,219,6,5,202032
12,9,0,0,0,0,0,0,0,0,599,599,8,5,202032
13,1,0,0,0,0,0,0,0,0,86,86,7,5,202032
13,2,0,0,0,0,0,0,0,0,95,95,4,5,202032
13,3,0,0,0,0,0,0,0,0,119,119,8,5,202032
13,4,0,0,0,0,0,0,0,0,253,253,7,5,202032
13,5,0,0,0,0,0,0,0,0,158,158,8,5,202032
13,6,0,0,0,0,0,0,0,0,574,574,10,5,202032
13,7,0,0,0,0,0,0,0,0,213,213,7,5,202032
14,1,0,0,0,0,0,0,0,0,309,309,5,5,202032
14,2,0,0,0,0,0,0,0,0,504,504,4,5,202032
14,3,0,0,0,0,0,0,0,0,454,454,7,5,202032
14,4,0,0,0,0,0,0,0,0,0,0,0,0,202032
14,5,0,0,0,0,0,0,0,0,0,0,0,0,202032
14,6,0,0,0,0,0,0,0,0,0,0,0,0,202032
14,7,0,0,0,0,0,0,0,0,0,0,0,0,202032
14,8,0,0,0,0,0,0,0,0,1554,1554,9,5,202032
14,9,0,0,0,0,0,0,0,0,553,553,5,5,202032
14,10,0,0,0,0,0,0,0,0,0,0,0,0,202032
14,11,0,0,0,0,0,0,0,0,504,504,3,5,202032
14,12,0,0,0,0,0,0,0,0,0,0,0,0,202032
14,13,0,0,0,0,0,0,0,0,0,0,0,0,202032
14,14,0,0,0,0,0,0,0,0,718,718,5,5,202032
14,15,0,0,0,0,0,0,0,0,742,742,6,5,202032
14,16,0,0,0,0,0,0,0,0,0,0,0,0,202032
14,17,0,0,0,0,0,0,0,0,409,409,5,5,202032
14,18,0,0,0,0,0,0,0,0,714,714,7,5,202032
14,19,0,0,0,0,0,0,0,0,429,429,5,5,202032
14,20,0,0,0,1,0,0,0,1,222,223,2,2.5,202032
15,1,0,0,0,0,0,0,0,0,446,446,5,5,202032
15,2,0,0,0,0,0,0,0,0,0,0,0,0,202032
15,3,0,0,0,0,0,0,0,0,661,661,9,5,202032
15,4,0,0,0,0,0,0,0,0,580,580,4,5,202032
15,5,0,0,0,0,0,0,0,0,439,439,7,5,202032
15,6,0,0,0,0,0,0,0,0,0,0,0,0,202032
15,7,0,0,0,0,0,0,0,0,0,0,0,0,202032
15,8,0,0,0,0,0,0,0,0,0,0,0,0,202032
15,9,0,0,0,0,0,0,0,0,567,567,8,5,202032
15,10,0,0,0,0,0,0,0,0,0,0,0,0,202032
15,11,0,0,0,0,0,0,0,0,0,0,0,0,202032
15,12,0,0,0,0,0,0,0,0,0,0,0,0,202032
15,13,0,0,0,0,0,0,0,0,0,0,0,0,202032
15,14,0,0,0,0,0,0,0,0,0,0,0,0,202032
15,15,0,0,0,0,0,0,0,0,0,0,0,0,202032
15,16,0,0,0,0,0,0,0,0,396,396,4,2.5,202032
15,17,0,0,0,0,0,0,0,0,0,0,0,0,202032
15,18,0,0,0,0,0,0,0,0,694,694,6,5,202032
15,19,0,0,0,0,0,0,0,0,1297,1297,10,5,202032
15,20,0,0,0,0,0,0,0,0,0,0,0,0,202032
15,21,0,0,0,0,0,0,0,0,292,292,5,5,202032
15,22,0,0,0,0,0,0,0,0,1183,1183,14,5,202032
15,23,0,0,0,0,0,0,0,0,527,527,5,5,202032
15,24,0,0,0,0,0,0,0,0,637,637,4,5,202032
15,25,0,0,0,0,0,0,0,0,0,0,0,0,202032
15,26,1,0,2,5,0,0,0,8,580,588,8,5,202032
15,27,0,0,0,0,0,0,0,0,1059,1059,8,5,202032
15,28,0,0,0,0,0,0,0,0,802,802,8,5,202032
15,29,0,0,0,0,0,0,0,0,0,0,0,0,202032
15,30,0,0,0,0,0,0,0,0,0,0,0,0,202032
15,31,0,0,0,0,0,0,0,0,0,0,0,0,202032
15,32,0,0,0,0,0,0,0,0,0,0,0,0,202032
15,33,0,0,0,0,0,0,0,0,664,664,7,5,202032
15,34,0,0,0,0,0,0,0,0,448,448,8,5,202032
15,35,0,0,0,0,0,0,0,0,600,600,8,5,202032
15,36,0,0,0,0,0,0,0,0,482,482,7,5,202032
15,37,0,0,0,0,0,0,0,0,890,890,7,5,202032
15,38,0,0,0,0,0,0,0,0,0,0,0,0,202032
15,39,0,0,0,0,0,0,0,0,0,0,0,0,202032
15,40,0,0,0,0,0,0,0,0,820,820,9,5,202032
15,41,0,0,0,0,0,0,0,0,904,904,13,5,202032
16,1,0,0,0,0,0,0,0,0,317,317,4,5,202032
16,2,0,0,0,0,0,0,0,0,359,359,6,5,202032
16,3,0,0,0,0,0,0,0,0,649,649,7,5,202032
16,4,0,0,0,0,0,0,0,0,601,601,7,5,202032
16,5,0,0,0,0,0,0,0,0,525,525,5,5,202032
16,6,0,0,0,0,0,0,0,0,420,420,10,5,202032
16,7,0,0,0,0,0,0,0,0,426,426,7,5,202032
16,8,0,0,0,0,0,0,0,0,948,948,11,5,202032
16,9,0,0,0,0,0,0,0,0,776,776,8,5,202032
16,10,0,0,0,0,0,0,0,0,714,714,5,5,202032
16,11,0,0,0,0,0,0,0,0,487,487,9,5,202032
16,12,0,0,0,0,0,0,0,0,288,288,5,5,202032
17,1,0,0,0,0,0,0,0,0,0,0,0,0,202032
17,2,0,0,0,0,0,0,0,0,175,175,3,2.5,202032
17,3,0,0,0,0,0,0,0,0,0,0,0,0,202032
17,4,0,0,0,0,0,0,0,0,629,629,5,5,202032
17,5,0,0,0,0,0,0,0,0,439,439,4,5,202032
18,1,0,0,0,0,0,0,0,0,204,204,5,5,202032
18,2,0,0,0,0,0,0,0,0,0,0,0,0,202032
18,3,0,0,0,0,0,0,0,0,95,95,4,5,202032
19,1,0,0,0,0,0,0,0,0,764,764,7,5,202032
19,2,0,0,0,0,0,0,0,0,0,0,0,0,202032
19,3,0,0,0,0,0,0,0,0,0,0,0,0,202032
19,4,0,0,0,0,0,0,0,0,569,569,5,5,202032
19,5,0,0,0,0,0,0,0,0,0,0,0,0,202032
19,6,0,0,0,0,0,0,0,0,0,0,0,0,202032
19,7,0,0,0,0,0,0,0,0,417,417,8,5,202032
19,8,0,0,0,0,0,0,0,0,324,324,6,5,202032
19,9,0,0,0,0,0,0,0,0,370,370,5,5,202032
19,10,0,0,0,0,0,0,0,0,0,0,0,0,202032
19,11,0,0,0,0,0,0,0,0,1632,1632,12,5,202032
19,12,0,0,1,0,0,0,0,1,257,258,2,2.5,202032
20,1,0,0,0,0,0,0,0,0,407,407,4,5,202032
20,2,0,0,0,0,0,0,0,0,181,181,4,5,202032
20,3,0,0,0,0,0,0,0,0,365,365,3,5,202032
20,4,0,0,0,0,0,0,0,0,148,148,4,5,202032
20,5,0,0,0,0,0,0,0,0,460,460,6,5,202032
20,6,0,0,0,0,0,0,0,0,202,202,5,5,202032
20,7,0,0,0,0,0,0,0,0,481,481,4,5,202032
20,8,0,0,0,0,0,0,0,0,2631,2631,14,5,202032
20,9,0,0,0,0,0,0,0,0,597,597,7,5,202032
20,10,0,0,0,0,0,0,0,0,260,260,5,5,202032
21,1,0,0,0,0,0,0,0,0,192,192,2,2.5,202032
21,2,0,0,0,0,0,0,0,0,267,267,6,5,202032
21,3,0,0,0,0,0,0,0,0,188,188,2,2.5,202032
21,4,0,0,0,0,0,0,0,0,138,138,4,5,202032
21,5,0,0,0,0,0,0,0,0,192,192,2,2.5,202032
21,6,0,0,0,0,0,0,0,0,0,0,0,0,202032
21,7,0,0,0,0,0,0,0,0,434,434,8,5,202032
21,8,0,0,0,0,0,0,0,0,307,307,7,5,202032
21,9,0,0,0,0,0,0,0,0,0,0,0,0,202032
21,10,0,0,0,0,0,0,0,0,0,0,0,0,202032
21,11,0,0,0,0,0,0,0,0,0,0,0,0,202032
21,12,0,0,0,0,0,0,0,0,0,0,0,0,202032
21,13,0,0,0,0,0,0,0,0,135,135,3,2.5,202032
21,14,0,0,0,0,0,0,0,0,345,345,5,5,202032
21,15,0,0,0,0,0,0,0,0,0,0,0,0,202032
22,1,0,0,0,0,0,0,0,0,298,298,7,5,202032
22,2,0,0,0,0,0,0,0,0,532,532,6,5,202032
22,3,0,0,0,0,0,0,0,0,0,0,0,0,202032
22,4,0,0,0,0,0,0,0,0,0,0,0,0,202032
22,5,0,0,0,0,0,0,0,0,477,477,8,5,202032
23,1,0,0,0,0,0,0,0,0,584,584,10,5,202032
23,2,0,0,0,0,0,0,0,0,0,0,0,0,202032
23,3,0,0,0,0,0,0,0,0,949,949,16,5,202032
23,4,0,0,0,0,0,0,0,0,563,563,3,5,202032
24,1,0,0,0,0,0,0,0,0,235,235,5,5,202032
24,2,0,0,0,0,0,0,0,0,496,496,5,5,202032
24,3,0,0,0,0,0,0,0,0,513,513,6,5,202032
24,4,0,0,0,0,0,0,0,0,450,450,4,5,202032
24,5,1,0,0,0,0,1,0,2,881,883,9,5,202032
24,6,0,0,0,0,0,0,0,0,730,730,6,5,202032
24,7,0,0,0,0,0,0,0,0,246,246,6,5,202032
25,1,0,0,0,0,0,0,0,0,80,80,3,2.5,202032
25,2,0,0,0,0,0,0,0,0,733,733,4,5,202032
25,3,0,0,0,0,0,0,0,0,493,493,7,5,202032
25,4,0,0,0,0,0,0,0,0,398,398,6,5,202032
25,5,0,0,0,0,0,0,0,0,684,684,7,5,202032
25,6,0,0,0,0,0,0,0,0,101,101,1,2.5,202032
25,7,0,0,0,0,0,0,0,0,1048,1048,5,5,202032
26,1,0,0,0,0,0,0,0,0,443,443,7,5,202032
26,2,0,0,0,0,0,0,0,0,642,642,7,5,202032
26,3,0,0,0,0,0,0,0,0,798,798,9,5,202032
26,4,0,0,0,0,0,0,0,0,309,309,7,5,202032
26,5,0,0,0,0,0,0,0,0,499,499,9,5,202032
26,6,0,0,0,0,0,0,0,0,864,864,5,5,202032
26,7,0,0,0,0,0,0,0,0,265,265,6,5,202032
27,1,0,0,0,0,0,0,0,0,491,491,6,5,202032
27,2,0,0,0,0,0,0,0,0,460,460,7,5,202032
27,3,0,0,0,0,0,0,0,0,149,149,2,2.5,202032
27,4,0,0,0,0,0,0,0,0,949,949,6,5,202032
27,5,0,0,0,0,0,0,0,0,229,229,4,5,202032
27,6,0,0,0,0,0,0,0,0,491,491,6,5,202032
28,1,0,0,0,0,0,0,0,0,762,762,7,5,202032
28,2,0,0,0,0,0,0,0,0,757,757,11,5,202032
28,3,0,0,0,0,0,0,0,0,148,148,4,5,202032
28,4,0,0,0,0,0,0,0,0,1081,1081,14,5,202032
28,5,0,0,0,0,0,0,0,0,675,675,6,5,202032
28,6,0,0,0,0,0,0,0,0,394,394,9,5,202032
28,7,0,0,0,0,0,0,0,0,689,689,9,5,202032
28,8,0,0,0,0,0,0,0,0,483,483,12,5,202032
28,9,0,0,0,0,0,0,0,0,472,472,6,5,202032
29,1,0,0,0,0,0,0,0,0,829,829,6,5,202032
29,2,0,0,0,0,0,0,0,0,628,628,5,5,202032
29,3,0,0,0,0,0,0,0,0,398,398,4,5,202032
30,1,0,0,0,0,0,0,0,0,175,175,5,5,202032
30,2,0,0,0,0,0,0,0,0,182,182,5,5,202032
30,3,0,0,0,0,0,0,0,0,169,169,2,2.5,202032
30,4,0,0,0,0,0,0,0,0,0,0,0,0,202032
30,5,0,0,0,0,0,0,0,0,0,0,0,0,202032
30,6,0,0,0,0,0,0,0,0,326,326,7,5,202032
30,7,0,0,0,0,0,0,0,0,0,0,0,0,202032
30,8,0,0,0,0,0,0,0,0,103,103,3,2.5,202032
30,9,0,0,0,0,0,0,0,0,124,124,2,2.5,202032
30,10,0,0,0,0,0,0,0,0,0,0,0,0,202032
30,11,0,0,0,0,0,0,0,0,0,0,0,0,202032
30,12,0,0,0,0,0,0,0,0,0,0,0,0,202032
30,13,0,0,0,0,0,0,0,0,235,235,7,5,202032
30,14,0,0,0,0,0,0,0,0,307,307,6,5,202032
30,15,0,0,0,0,0,0,0,0,43,43,2,2.5,202032
30,16,0,0,0,0,0,0,0,0,686,686,8,5,202032
30,17,0,0,0,0,0,0,0,0,770,770,6,5,202032
30,18,0,0,0,0,0,0,0,0,119,119,5,5,202032
30,19,0,0,0,0,0,0,0,0,386,386,8,5,202032
30,20,0,0,0,0,0,0,0,0,155,155,3,2.5,202032
31,1,0,0,0,0,0,0,0,0,314,314,6,5,202032
31,2,14,0,9,2,11,4,0,40,127,167,3,5,202032
31,3,0,0,0,0,0,0,0,0,1188,1188,12,5,202032
31,4,0,0,0,0,0,0,0,0,657,657,4,5,202032
31,5,0,0,0,0,0,0,0,0,404,404,4,5,202032
32,1,1,1,0,1,0,0,0,3,292,295,8,5,202032
32,2,2,0,2,0,0,0,0,4,170,174,8,5,202032
32,3,24,5,30,81,1,7,2,150,482,632,9,5,202032
32,4,40,2,26,36,2,7,0,113,522,635,8,5,202032
1,1,16,2,13,26,1,4,0,62,292,354,10,5,202033
1,2,67,5,89,91,10,16,3,281,299,580,9,5,202033
1,3,0,0,0,0,0,0,0,0,304,304,8,5,202033
2,1,0,0,0,0,0,0,0,0,180,180,4,3.333333333,202033
2,2,0,0,0,0,0,0,0,0,0,0,0,0,202033
2,3,0,0,0,0,0,0,0,0,421,421,9,5,202033
2,4,0,0,0,0,0,0,0,0,557,557,7,5,202033
2,5,0,0,0,0,0,0,0,0,483,483,5,5,202033
2,6,0,0,0,0,0,0,0,0,281,281,6,5,202033
2,7,0,0,0,0,0,0,0,0,212,212,5,3.333333333,202033
2,8,0,0,0,0,0,0,0,0,370,370,3,5,202033
3,1,0,0,0,0,0,0,0,0,309,309,8,5,202033
3,2,0,17,0,22,27,3,1,70,473,543,7,5,202033
4,1,0,0,0,0,0,0,0,0,213,213,6,5,202033
4,2,0,0,0,0,0,0,0,0,130,130,6,5,202033
5,1,0,0,0,0,0,0,0,0,146,146,7,5,202033
5,2,0,0,0,0,0,0,0,0,79,79,5,5,202033
5,3,0,0,0,0,0,0,0,0,65,65,8,5,202033
5,4,0,0,0,0,0,0,0,0,178,178,7,5,202033
5,5,0,0,0,0,0,0,0,0,161,161,10,5,202033
5,6,0,0,0,0,0,0,0,0,76,76,3,5,202033
5,7,0,0,0,0,0,0,0,0,71,71,6,5,202033
6,1,0,0,0,0,0,0,0,0,333,333,8,5,202033
6,2,0,0,0,0,0,0,0,0,250,250,3,2.5,202033
7,1,0,0,0,0,0,0,0,0,162,162,6,5,202033
7,2,0,0,0,0,0,0,0,0,150,150,6,5,202033
7,3,0,0,0,0,0,0,0,0,363,363,4,5,202033
7,4,0,0,0,0,0,0,0,0,219,219,8,5,202033
7,5,0,0,0,0,0,0,0,0,381,381,10,5,202033
7,6,0,0,0,0,0,0,0,0,0,0,0,0,202033
7,7,0,0,0,0,0,0,0,0,587,587,6,5,202033
7,8,0,0,0,0,0,0,0,0,447,447,7,5,202033
7,9,0,0,0,0,0,0,0,0,0,0,0,0,202033
7,10,0,0,0,0,0,0,0,0,238,238,6,5,202033
7,11,0,0,0,0,0,0,0,0,93,93,4,5,202033
7,12,0,0,0,0,0,0,0,0,0,0,0,0,202033
7,13,0,0,0,0,0,0,0,0,37,37,3,5,202033
8,1,0,0,0,0,0,0,0,0,0,0,0,0,202033
8,2,0,0,0,0,0,0,0,0,82,82,3,2.5,202033
8,3,0,0,0,0,0,0,0,0,0,0,0,0,202033
8,4,0,0,0,0,0,0,0,0,0,0,0,0,202033
8,5,0,0,0,0,0,0,0,0,204,204,6,5,202033
8,6,0,0,0,0,0,0,0,0,161,161,5,5,202033
8,7,0,0,0,0,0,0,0,0,158,158,5,5,202033
8,8,0,0,0,0,0,0,0,0,436,436,8,5,202033
8,9,0,0,0,0,0,0,0,0,279,279,6,5,202033
9,1,0,0,0,0,0,0,0,0,300,300,4,5,202033
9,2,0,0,0,0,0,0,0,0,1063,1063,10,5,202033
9,3,0,0,0,0,0,0,0,0,333,333,4,5,202033
9,4,0,0,0,0,0,0,0,0,287,287,7,5,202033
9,5,0,0,0,0,0,0,0,0,329,329,6,5,202033
9,6,0,0,0,0,0,0,0,0,342,342,7,5,202033
9,7,0,0,0,0,0,0,0,0,318,318,4,5,202033
9,8,0,0,0,0,0,0,0,0,315,315,3,5,202033
9,9,0,0,0,0,0,0,0,0,289,289,3,5,202033
9,10,0,0,0,0,0,0,0,0,442,442,3,5,202033
9,11,0,0,0,0,0,0,0,0,532,532,7,5,202033
9,12,0,0,0,0,0,0,0,0,583,583,7,5,202033
9,13,0,0,0,0,0,0,0,0,361,361,3,5,202033
9,14,0,0,0,0,0,0,0,0,423,423,5,5,202033
9,15,0,0,0,0,0,0,0,0,618,618,6,5,202033
9,16,0,0,0,0,0,0,0,0,471,471,11,5,202033
9,17,0,0,0,0,0,0,0,0,441,441,5,5,202033
9,18,0,0,0,0,0,0,0,0,340,340,8,5,202033
9,19,0,0,0,0,0,0,0,0,370,370,3,5,202033
9,20,0,0,0,0,0,0,0,0,271,271,2,5,202033
9,21,0,0,0,0,0,0,0,0,240,240,3,5,202033
9,22,0,0,0,0,0,0,0,0,316,316,4,5,202033
9,23,0,0,0,0,0,0,0,0,417,417,6,5,202033
9,24,0,0,0,0,0,0,0,0,996,996,11,5,202033
10,1,0,0,0,0,0,0,0,0,362,362,11,5,202033
10,2,0,0,0,0,0,0,0,0,322,322,5,5,202033
10,3,0,0,0,0,0,0,0,0,217,217,9,5,202033
10,4,0,0,0,0,0,0,0,0,430,430,11,5,202033
11,1,0,0,0,0,0,0,0,0,229,229,6,5,202033
11,2,0,0,0,0,0,0,0,0,344,344,6,5,202033
11,3,0,0,0,0,0,0,0,0,223,223,3,5,202033
11,4,0,0,0,0,0,0,0,0,262,262,5,5,202033
11,5,0,0,0,0,0,0,0,0,580,580,7,5,202033
11,6,0,0,0,0,0,0,0,0,231,231,5,5,202033
11,7,0,0,0,0,0,0,0,0,418,418,7,5,202033
11,8,0,0,0,0,0,0,0,0,352,352,9,5,202033
11,9,0,0,0,0,0,0,0,0,337,337,7,5,202033
11,10,0,0,0,0,0,0,0,0,253,253,9,5,202033
11,11,0,0,2,2,0,1,0,5,329,334,5,5,202033
11,12,0,0,0,0,0,0,0,0,371,371,7,5,202033
11,13,0,0,0,0,0,0,0,0,208,208,7,5,202033
11,14,0,0,0,0,0,0,0,0,229,229,6,5,202033
11,15,0,0,0,0,0,0,0,0,244,244,5,5,202033
12,1,0,0,0,0,0,0,0,0,177,177,6,5,202033
12,2,0,0,0,0,0,0,0,0,255,255,8,5,202033
12,3,0,0,0,0,0,0,0,0,119,119,7,5,202033
12,4,0,0,0,0,0,0,0,0,333,333,8,5,202033
12,5,0,0,0,0,0,0,0,0,278,278,7,5,202033
12,6,0,0,0,0,0,0,0,0,179,179,7,5,202033
12,7,0,0,0,0,0,0,0,0,243,243,5,5,202033
12,8,0,0,0,0,0,0,0,0,125,125,6,5,202033
12,9,0,0,0,0,0,0,0,0,360,360,8,5,202033
13,1,0,0,0,0,0,0,0,0,83,83,7,5,202033
13,2,0,0,0,0,0,0,0,0,70,70,4,5,202033
13,3,0,0,0,0,0,0,0,0,58,58,7,5,202033
13,4,0,0,0,0,0,0,0,0,193,193,7,5,202033
13,5,0,0,0,0,0,0,0,0,108,108,8,5,202033
13,6,0,0,0,0,0,0,0,0,323,323,10,5,202033
13,7,0,0,0,0,0,0,0,0,181,181,7,5,202033
14,1,0,0,0,0,0,0,0,0,295,295,5,5,202033
14,2,0,0,0,0,0,0,0,0,354,354,4,5,202033
14,3,0,0,0,0,0,0,0,0,344,344,7,5,202033
14,4,0,0,0,0,0,0,0,0,0,0,0,0,202033
14,5,0,0,0,0,0,0,0,0,0,0,0,0,202033
14,6,0,0,0,0,0,0,0,0,0,0,0,0,202033
14,7,0,0,0,0,0,0,0,0,0,0,0,0,202033
14,8,0,0,0,0,0,0,0,0,962,962,9,5,202033
14,9,0,0,0,0,0,0,0,0,386,386,5,5,202033
14,10,0,0,0,0,0,0,0,0,0,0,0,0,202033
14,11,0,0,0,0,0,0,0,0,240,240,3,5,202033
14,12,0,0,0,0,0,0,0,0,0,0,0,0,202033
14,13,0,0,0,0,0,0,0,0,0,0,0,0,202033
14,14,0,0,0,0,0,0,0,0,373,373,5,5,202033
14,15,0,0,0,0,0,0,0,0,475,475,6,5,202033
14,16,0,0,0,0,0,0,0,0,0,0,0,0,202033
14,17,0,0,0,0,0,0,0,0,279,279,5,5,202033
14,18,0,0,0,0,0,0,0,0,460,460,7,5,202033
14,19,0,0,0,0,0,0,0,0,201,201,5,5,202033
14,20,0,0,0,0,0,0,0,0,103,103,2,2.5,202033
15,1,0,0,0,0,0,0,0,0,249,249,5,5,202033
15,2,0,0,0,0,0,0,0,0,0,0,0,0,202033
15,3,0,0,0,0,0,0,0,0,462,462,9,5,202033
15,4,0,0,0,0,0,0,0,0,321,321,4,5,202033
15,5,0,0,0,0,0,0,0,0,252,252,7,5,202033
15,6,0,0,0,0,0,0,0,0,0,0,0,0,202033
15,7,0,0,0,0,0,0,0,0,0,0,0,0,202033
15,8,0,0,0,0,0,0,0,0,0,0,0,0,202033
15,9,0,0,0,0,0,0,0,0,346,346,8,5,202033
15,10,0,0,0,0,0,0,0,0,0,0,0,0,202033
15,11,0,0,0,0,0,0,0,0,0,0,0,0,202033
15,12,0,0,0,0,0,0,0,0,0,0,0,0,202033
15,13,0,0,0,0,0,0,0,0,0,0,0,0,202033
15,14,0,0,0,0,0,0,0,0,0,0,0,0,202033
15,15,0,0,0,0,0,0,0,0,0,0,0,0,202033
15,16,0,0,0,0,0,0,0,0,201,201,4,2.5,202033
15,17,0,0,0,0,0,0,0,0,0,0,0,0,202033
15,18,0,0,0,0,0,0,0,0,440,440,6,5,202033
15,19,0,0,0,0,0,0,0,0,860,860,10,5,202033
15,20,0,0,0,0,0,0,0,0,0,0,0,0,202033
15,21,0,0,0,0,0,0,0,0,187,187,5,5,202033
15,22,0,0,0,0,0,0,0,0,564,564,14,5,202033
15,23,0,0,0,0,0,0,0,0,254,254,5,5,202033
15,24,0,0,0,0,0,0,0,0,295,295,4,5,202033
15,25,0,0,0,0,0,0,0,0,0,0,0,0,202033
15,26,0,0,0,0,0,0,0,0,235,235,8,5,202033
15,27,0,0,0,0,0,0,0,0,430,430,8,5,202033
15,28,0,0,0,0,0,0,0,0,466,466,8,5,202033
15,29,0,0,0,0,0,0,0,0,0,0,0,0,202033
15,30,0,0,0,0,0,0,0,0,0,0,0,0,202033
15,31,0,0,0,0,0,0,0,0,0,0,0,0,202033
15,32,0,0,0,0,0,0,0,0,0,0,0,0,202033
15,33,0,0,0,0,0,0,0,0,375,375,7,5,202033
15,34,0,0,0,0,0,0,0,0,225,225,8,5,202033
15,35,0,0,0,0,0,0,0,0,277,277,8,5,202033
15,36,0,0,0,0,0,0,0,0,448,448,7,5,202033
15,37,0,0,0,0,0,0,0,0,568,568,7,5,202033
15,38,0,0,0,0,0,0,0,0,0,0,0,0,202033
15,39,0,0,0,0,0,0,0,0,0,0,0,0,202033
15,40,0,0,0,0,0,0,0,0,398,398,9,5,202033
15,41,0,0,0,0,0,0,0,0,511,511,13,5,202033
16,1,0,0,0,0,0,0,0,0,228,228,4,5,202033
16,2,0,0,0,0,0,0,0,0,89,89,6,5,202033
16,3,0,0,0,0,0,0,0,0,305,305,7,5,202033
16,4,0,0,0,0,0,0,0,0,382,382,7,5,202033
16,5,0,0,0,0,0,0,0,0,278,278,5,5,202033
16,6,0,0,0,0,0,0,0,0,195,195,10,5,202033
16,7,0,0,0,0,0,0,0,0,333,333,7,5,202033
16,8,0,0,0,0,0,0,0,0,514,514,11,5,202033
16,9,0,0,0,0,0,0,0,0,340,340,8,5,202033
16,10,0,0,0,0,0,0,0,0,413,413,6,5,202033
16,11,0,0,0,0,0,0,0,0,270,270,9,5,202033
16,12,0,0,0,0,0,0,0,0,162,162,5,5,202033
17,1,0,0,0,0,0,0,0,0,0,0,0,0,202033
17,2,0,0,0,0,0,0,0,0,56,56,3,2.5,202033
17,3,0,0,0,0,0,0,0,0,0,0,0,0,202033
17,4,0,0,0,0,0,0,0,0,357,357,5,5,202033
17,5,0,0,0,0,0,0,0,0,93,93,4,5,202033
18,1,0,0,0,0,0,0,0,0,142,142,5,5,202033
18,2,0,0,0,0,0,0,0,0,0,0,0,0,202033
18,3,0,0,0,0,0,0,0,0,75,75,4,5,202033
19,1,0,0,0,0,0,0,0,0,321,321,7,5,202033
19,2,0,0,0,0,0,0,0,0,0,0,0,0,202033
19,3,0,0,0,0,0,0,0,0,0,0,0,0,202033
19,4,0,0,0,0,0,0,0,0,209,209,5,5,202033
19,5,0,0,0,0,0,0,0,0,0,0,0,0,202033
19,6,0,0,0,0,0,0,0,0,0,0,0,0,202033
19,7,0,0,0,0,0,0,0,0,210,210,8,5,202033
19,8,36,3,58,59,2,8,0,166,159,325,6,5,202033
19,9,0,0,0,0,0,0,0,0,169,169,5,5,202033
19,10,0,0,0,0,0,0,0,0,0,0,0,0,202033
19,11,101,5,102,236,5,48,36,533,624,1157,12,5,202033
19,12,8,1,38,11,0,0,0,58,126,184,2,2.5,202033
20,1,0,0,0,0,0,0,0,0,204,204,4,5,202033
20,2,0,0,0,0,0,0,0,0,155,155,4,5,202033
20,3,0,0,0,0,0,0,0,0,186,186,4,5,202033
20,4,0,0,0,0,0,0,0,0,116,116,4,5,202033
20,5,0,0,0,0,0,0,0,0,287,287,6,5,202033
20,6,0,0,0,0,0,0,0,0,148,148,5,5,202033
20,7,0,0,0,0,0,0,0,0,374,374,4,5,202033
20,8,0,0,0,0,0,0,0,0,1224,1224,14,5,202033
20,9,0,0,0,0,0,0,0,0,267,267,7,5,202033
20,10,0,0,0,0,0,0,0,0,119,119,5,5,202033
21,1,0,0,0,0,0,0,0,0,84,84,2,2.5,202033
21,2,0,0,0,0,0,0,0,0,165,165,6,5,202033
21,3,0,0,0,0,0,0,0,0,112,112,2,2.5,202033
21,4,0,0,0,0,0,0,0,0,106,106,4,5,202033
21,5,0,0,0,0,0,0,0,0,104,104,2,2.5,202033
21,6,0,0,0,0,0,0,0,0,0,0,0,0,202033
21,7,0,0,0,0,0,0,0,0,255,255,8,5,202033
21,8,0,0,0,0,0,0,0,0,194,194,7,5,202033
21,9,0,0,0,0,0,0,0,0,0,0,0,0,202033
21,10,0,0,0,0,0,0,0,0,0,0,0,0,202033
21,11,0,0,0,0,0,0,0,0,0,0,0,0,202033
21,12,0,0,0,0,0,0,0,0,0,0,0,0,202033
21,13,0,0,0,0,0,0,0,0,82,82,3,2.5,202033
21,14,0,0,0,0,0,0,0,0,272,272,6,5,202033
21,15,0,0,0,0,0,0,0,0,0,0,0,0,202033
22,1,0,0,0,0,0,0,0,0,155,155,7,5,202033
22,2,0,0,0,0,0,0,0,0,219,219,6,5,202033
22,3,0,0,0,0,0,0,0,0,0,0,0,0,202033
22,4,0,0,0,0,0,0,0,0,0,0,0,0,202033
22,5,0,0,0,0,0,0,0,0,386,386,8,5,202033
23,1,0,0,0,0,0,0,0,0,300,300,10,5,202033
23,2,0,0,0,0,0,0,0,0,0,0,0,0,202033
23,3,0,0,0,0,0,0,0,0,423,423,16,5,202033
23,4,0,0,0,0,0,0,0,0,346,346,3,5,202033
24,1,0,0,0,0,0,0,0,0,96,96,7,5,202033
24,2,0,0,0,0,0,0,0,0,430,430,5,5,202033
24,3,0,0,0,0,0,0,0,0,264,264,6,5,202033
24,4,0,0,0,0,0,0,0,0,308,308,4,5,202033
24,5,0,0,0,0,0,0,0,0,493,493,9,5,202033
24,6,0,0,0,0,0,0,0,0,489,489,6,5,202033
24,7,0,0,0,0,0,0,0,0,152,152,6,5,202033
25,1,0,0,0,0,0,0,0,0,64,64,3,2.5,202033
25,2,0,0,0,0,0,0,0,0,437,437,4,5,202033
25,3,0,0,0,0,0,0,0,0,314,314,7,5,202033
25,4,0,0,0,0,0,0,0,0,222,222,6,5,202033
25,5,0,0,0,0,0,0,0,0,541,541,7,5,202033
25,6,0,0,0,0,0,0,0,0,76,76,1,2.5,202033
25,7,0,0,0,0,0,0,0,0,480,480,5,5,202033
26,1,0,0,0,0,0,0,0,0,379,379,7,5,202033
26,2,0,0,0,0,0,0,0,0,295,295,7,5,202033
26,3,0,0,0,0,0,0,0,0,467,467,9,5,202033
26,4,0,0,0,0,0,0,0,0,145,145,7,5,202033
26,5,0,0,0,0,0,0,0,0,291,291,8,5,202033
26,6,0,0,0,0,0,0,0,0,339,339,5,5,202033
26,7,0,0,0,0,0,0,0,0,176,176,6,5,202033
27,1,0,0,0,0,0,0,0,0,275,275,6,5,202033
27,2,0,0,0,0,0,0,0,0,259,259,7,5,202033
27,3,0,0,0,0,0,0,0,0,97,97,2,2.5,202033
27,4,0,0,0,0,0,0,0,0,522,522,6,5,202033
27,5,0,0,0,0,0,0,0,0,193,193,4,5,202033
27,6,0,0,0,0,0,0,0,0,287,287,6,5,202033
28,1,0,0,0,0,0,0,0,0,396,396,7,5,202033
28,2,0,0,0,0,0,0,0,0,320,320,11,5,202033
28,3,0,0,0,0,0,0,0,0,164,164,4,5,202033
28,4,0,0,0,0,0,0,0,0,386,386,14,5,202033
28,5,0,0,0,0,0,0,0,0,375,375,6,5,202033
28,6,0,0,0,0,0,0,0,0,246,246,9,5,202033
28,7,0,0,0,0,0,0,0,0,303,303,9,4.5,202033
28,8,0,0,0,0,0,0,0,0,202,202,12,5,202033
28,9,0,0,0,0,0,0,0,0,282,282,6,5,202033
29,1,0,0,0,0,0,0,0,0,506,506,6,5,202033
29,2,0,0,0,0,0,0,0,0,356,356,5,5,202033
29,3,0,0,0,0,0,0,0,0,190,190,4,5,202033
30,1,0,0,0,0,0,0,0,0,88,88,5,5,202033
30,2,0,0,0,0,0,0,0,0,131,131,4,5,202033
30,3,0,0,0,0,0,0,0,0,106,106,2,2.5,202033
30,4,0,0,0,0,0,0,0,0,0,0,0,0,202033
30,5,0,0,0,0,0,0,0,0,0,0,0,0,202033
30,6,0,0,0,0,0,0,0,0,221,221,7,5,202033
30,7,0,0,0,0,0,0,0,0,0,0,0,0,202033
30,8,0,0,0,0,0,0,0,0,68,68,3,2.5,202033
30,9,0,0,0,0,0,0,0,0,92,92,2,2.5,202033
30,10,0,0,0,0,0,0,0,0,0,0,0,0,202033
30,11,0,0,0,0,0,0,0,0,0,0,0,0,202033
30,12,0,0,0,0,0,0,0,0,0,0,0,0,202033
30,13,0,0,0,0,0,0,0,0,178,178,7,5,202033
30,14,0,0,0,0,0,0,0,0,154,154,6,5,202033
30,15,0,0,0,0,0,0,0,0,45,45,2,2.5,202033
30,16,0,0,0,0,0,0,0,0,298,298,8,5,202033
30,17,0,0,0,0,0,0,0,0,392,392,6,5,202033
30,18,0,0,0,0,0,0,0,0,195,195,4,5,202033
30,19,0,0,0,0,0,0,0,0,258,258,9,5,202033
30,20,0,0,0,0,0,0,0,0,179,179,3,2.5,202033
31,1,0,0,0,0,0,0,0,0,257,257,6,5,202033
31,2,9,0,2,5,1,3,0,20,68,88,3,5,202033
31,3,0,0,0,0,0,0,0,0,601,601,12,5,202033
31,4,0,0,0,0,0,0,0,0,442,442,4,5,202033
31,5,0,0,0,0,0,0,0,0,291,291,4,5,202033
32,1,3,0,3,5,0,1,4,16,164,180,8,5,202033
32,2,5,0,0,1,0,1,0,7,73,80,7,5,202033
32,3,15,3,13,26,0,5,2,64,227,291,10,5,202033
32,4,25,1,10,16,0,6,0,58,279,337,8,5,202033
1,1,339,20,204,217,23,44,6,853,137,990,10,5,202034
1,2,285,24,249,294,28,73,3,956,163,1119,10,5,202034
1,3,308,36,308,336,21,93,19,1121,143,1264,8,5,202034
2,1,257,11,182,218,22,89,43,822,167,989,6,5,202034
2,2,110,5,93,143,4,46,4,405,193,598,3,5,202034
2,3,271,8,230,235,5,81,21,851,6,857,7,5,202034
2,4,296,9,252,129,34,18,18,756,7,763,7,5,202034
2,5,288,6,261,186,67,61,5,874,35,909,5,5,202034
2,6,174,8,213,172,35,82,10,694,1,695,6,5,202034
2,7,210,1,154,180,15,43,22,625,53,678,8,5,202034
2,8,162,6,138,146,13,33,14,512,8,520,3,5,202034
3,1,225,19,157,236,15,78,5,735,118,853,8,5,202034
3,2,98,2,138,75,20,18,0,351,137,488,7,3,202034
4,1,266,7,148,292,29,61,6,809,28,837,5,5,202034
4,2,131,1,97,154,10,37,22,452,23,475,6,5,202034
5,1,0,0,0,439,0,0,0,439,90,529,7,5,202034
5,2,0,0,2,116,0,0,0,118,56,174,5,5,202034
5,3,0,0,0,329,0,0,0,329,35,364,8,5,202034
5,4,0,0,2,902,0,0,0,904,94,998,7,5,202034
5,5,0,0,4,867,0,0,0,871,88,959,10,5,202034
5,6,0,0,0,202,0,0,0,202,48,250,3,5,202034
5,7,0,0,0,188,0,0,0,188,40,228,6,5,202034
6,1,283,13,182,189,9,77,18,771,20,791,8,5,202034
6,2,184,10,147,134,24,27,14,540,82,622,7,5,202034
7,1,97,3,71,66,3,24,1,265,10,275,6,5,202034
7,2,163,6,50,159,7,8,0,393,162,555,6,5,202034
7,3,72,1,45,33,21,7,0,179,0,179,2,5,202034
7,4,218,5,86,169,4,19,5,506,181,687,9,5,202034
7,5,241,8,107,235,14,26,2,633,86,719,8,5,202034
7,6,127,2,114,102,9,35,5,394,168,562,6,5,202034
7,7,190,5,98,117,34,55,3,502,203,705,6,5,202034
7,8,139,5,53,108,24,20,5,354,222,576,6,5,202034
7,9,173,7,109,212,12,38,2,553,395,948,8,5,202034
7,10,189,0,95,132,10,20,0,446,92,538,6,5,202034
7,11,102,0,30,40,34,9,0,215,7,222,3,5,202034
7,12,176,6,124,204,5,27,5,547,244,791,6,5,202034
7,13,104,3,66,127,0,8,0,308,61,369,6,5,202034
8,1,75,0,52,28,2,12,3,172,24,196,2,5,202034
8,2,489,42,311,202,9,24,1,1078,367,1445,12,5,202034
8,3,178,9,79,105,8,21,8,408,69,477,4,5,202034
8,4,323,25,369,304,33,107,35,1196,669,1865,8,5,202034
8,5,114,13,72,123,4,21,0,347,65,412,5,5,202034
8,6,312,26,147,251,22,61,14,833,106,939,5,5,202034
8,7,117,5,78,117,6,35,0,358,17,375,5,5,202034
8,8,409,24,290,393,8,73,0,1197,125,1322,8,5,202034
8,9,132,6,74,94,16,28,16,366,37,403,4,5,202034
9,1,106,3,98,162,39,29,8,445,28,473,4,5,202034
9,2,389,24,407,570,81,106,15,1592,11,1603,10,5,202034
9,3,206,9,187,314,38,63,18,835,14,849,4,5,202034
9,4,282,8,297,591,62,88,14,1342,22,1364,7,5,202034
9,5,190,8,147,249,43,48,2,687,1,688,6,5,202034
9,6,165,5,153,221,92,52,17,705,26,731,7,5,202034
9,7,153,10,236,276,1,26,0,702,111,813,6,5,202034
9,8,102,9,154,234,7,43,7,556,3,559,3,5,202034
9,9,160,3,119,249,34,37,9,611,25,636,3,5,202034
9,10,127,7,144,173,19,34,5,509,5,514,3,5,202034
9,11,215,11,263,339,40,71,15,954,94,1048,7,5,202034
9,12,180,12,272,390,22,82,10,968,21,989,7,5,202034
9,13,119,4,111,190,29,31,9,493,5,498,3,5,202034
9,14,134,3,152,187,32,36,9,553,8,561,5,5,202034
9,15,230,17,471,441,29,107,24,1319,244,1563,6,5,202034
9,16,359,57,304,535,53,80,3,1391,126,1517,11,5,202034
9,17,162,6,139,187,14,44,4,556,17,573,5,5,202034
9,18,203,7,225,363,74,93,31,996,13,1009,8,5,202034
9,19,161,11,114,211,66,57,5,625,4,629,3,5,202034
9,20,80,7,84,88,29,17,2,307,46,353,3,5,202034
9,21,109,6,103,148,39,32,8,445,16,461,3,5,202034
9,22,102,11,138,211,47,40,9,558,1,559,4,5,202034
9,23,235,10,274,372,73,50,5,1019,14,1033,6,5,202034
9,24,421,16,398,604,91,110,16,1656,176,1832,11,5,202034
10,1,254,11,154,250,26,61,26,782,77,859,10,5,202034
10,2,126,8,69,154,4,42,3,406,84,490,6,5,202034
10,3,198,17,137,177,17,72,14,632,29,661,9,4.5,202034
10,4,359,21,234,410,11,86,2,1123,80,1203,11,5,202034
11,1,213,26,109,166,13,42,0,569,31,600,6,5,202034
11,2,247,16,124,132,54,42,6,621,128,749,6,5,202034
11,3,99,17,65,86,10,45,3,325,80,405,3,5,202034
11,4,200,33,72,137,10,39,0,491,114,605,5,5,202034
11,5,257,52,186,289,12,80,11,887,160,1047,7,5,202034
11,6,189,31,187,199,30,52,10,698,68,766,5,5,202034
11,7,232,22,151,178,18,36,4,641,171,812,7,5,202034
11,8,306,55,238,345,38,77,11,1070,152,1222,9,5,202034
11,9,285,27,191,304,15,48,19,889,150,1039,8,5,202034
11,10,248,29,139,203,25,71,35,750,24,774,9,5,202034
11,11,182,26,147,175,6,43,0,579,132,711,5,5,202034
11,12,221,38,266,292,11,42,2,872,120,992,7,5,202034
11,13,142,11,88,130,21,26,12,430,69,499,6,5,202034
11,14,144,12,113,137,19,23,0,448,66,514,6,5,202034
11,15,228,20,149,191,15,66,20,689,59,748,5,5,202034
12,1,80,10,63,47,11,16,1,228,103,331,5,5,202034
12,2,202,14,155,272,5,51,1,700,118,818,8,5,202034
12,3,95,14,116,149,10,25,0,409,53,462,4,5,202034
12,4,275,18,277,355,38,53,5,1021,24,1045,8,5,202034
12,5,147,13,114,114,3,13,28,432,153,585,7,5,202034
12,6,189,3,83,134,24,5,9,447,114,561,7,5,202034
12,7,169,11,115,205,3,31,3,537,80,617,5,5,202034
12,8,149,7,77,102,0,11,1,347,89,436,6,5,202034
12,9,335,16,330,472,36,57,2,1248,142,1390,8,5,202034
13,1,0,0,0,184,1,0,0,185,45,230,7,5,202034
13,2,0,0,0,262,0,0,0,262,46,308,4,5,202034
13,3,0,0,0,226,0,0,0,226,39,265,8,5,202034
13,4,2,0,2,359,0,0,0,363,72,435,7,5,202034
13,5,0,0,0,553,0,1,1,555,89,644,7,5,202034
13,6,0,0,0,1042,0,0,0,1042,218,1260,10,5,202034
13,7,2,0,0,470,0,1,0,473,100,573,7,5,202034
14,1,111,11,55,44,46,34,14,315,69,384,5,5,202034
14,2,173,9,56,52,18,28,2,338,103,441,4,5,202034
14,3,163,6,150,60,2,41,2,424,93,517,6,5,202034
14,4,275,14,190,273,26,76,8,862,425,1287,8,5,202034
14,5,180,13,192,162,15,43,6,611,376,987,9,5,202034
14,6,292,11,242,166,12,44,1,768,349,1117,7,5,202034
14,7,206,9,234,139,0,17,0,605,246,851,6,5,202034
14,8,404,25,445,457,13,92,5,1441,342,1783,9,5,202034
14,9,174,20,181,294,20,64,8,761,48,809,5,5,202034
14,10,187,5,226,170,14,74,2,678,411,1089,6,5,202034
14,11,130,7,63,104,21,37,2,364,103,467,3,5,202034
14,12,209,10,162,84,18,30,0,513,364,877,8,5,202034
14,13,174,10,137,125,1,40,3,490,560,1050,5,5,202034
14,14,214,14,157,211,35,82,10,723,75,798,5,5,202034
14,15,223,31,176,131,40,86,8,695,148,843,7,5,202034
14,16,195,14,142,134,28,52,3,568,276,844,5,5,202034
14,17,82,10,44,39,12,30,8,225,137,362,5,5,202034
14,18,143,10,108,96,25,33,18,433,105,538,7,5,202034
14,19,99,7,134,93,8,17,1,359,68,427,5,5,202034
14,20,221,23,264,207,3,41,0,759,395,1154,8,5,202034
15,1,127,4,45,51,74,18,1,320,77,397,5,5,202034
15,2,138,9,104,130,30,31,3,445,294,739,6,5,202034
15,3,258,6,149,192,145,56,14,820,157,977,9,5,202034
15,4,160,5,82,131,13,30,3,424,109,533,4,5,202034
15,5,122,13,110,127,16,21,7,416,85,501,7,5,202034
15,6,91,3,66,165,9,27,6,367,273,640,5,5,202034
15,7,204,12,210,175,45,50,8,704,345,1049,10,5,202034
15,8,117,10,93,165,12,27,4,428,167,595,4,5,202034
15,9,216,5,70,102,116,88,2,599,224,823,8,5,202034
15,10,175,3,88,258,15,43,7,589,163,752,6,5,202034
15,11,170,12,135,214,24,30,0,585,232,817,8,5,202034
15,12,204,6,210,233,36,35,0,724,532,1256,8,5,202034
15,13,113,6,83,141,57,43,0,443,195,638,8,5,202034
15,14,99,6,88,195,20,32,6,446,194,640,4,5,202034
15,15,82,21,107,141,21,22,10,404,409,813,6,5,202034
15,16,292,19,250,533,21,90,24,1229,315,1544,8,5,202034
15,17,126,9,77,155,31,47,15,460,397,857,8,5,202034
15,18,194,8,160,241,27,41,1,672,141,813,5,5,202034
15,19,328,34,349,603,31,85,13,1443,264,1707,10,5,202034
15,20,108,8,180,195,20,25,6,542,395,937,6,5,202034
15,21,106,5,70,119,33,45,9,387,56,443,5,5,202034
15,22,320,39,291,520,31,81,25,1307,202,1509,14,5,202034
15,23,101,8,96,194,7,18,1,425,84,509,5,5,202034
15,24,102,12,55,151,19,20,2,361,52,413,4,5,202034
15,25,154,16,133,195,15,50,6,569,382,951,6,5,202034
15,26,156,8,108,200,45,30,1,548,82,630,8,5,202034
15,27,245,8,212,327,15,68,35,910,117,1027,8,5,202034
15,28,155,6,182,150,17,30,4,544,172,716,8,5,202034
15,29,217,14,208,419,13,67,29,967,635,1602,8,5,202034
15,30,289,33,300,462,61,56,17,1218,502,1720,16,5,202034
15,31,139,71,78,192,14,27,2,523,123,646,6,5,202034
15,32,196,7,97,260,31,51,3,645,394,1039,9,5,202034
15,33,250,6,209,260,34,36,1,796,20,816,7,5,202034
15,34,180,7,169,331,19,43,7,756,82,838,8,5,202034
15,35,162,7,142,262,4,64,6,647,146,793,8,5,202034
15,36,194,14,162,242,1,33,0,646,175,821,7,5,202034
15,37,213,18,177,374,59,74,17,932,160,1092,7,5,202034
15,38,135,11,120,198,40,34,10,548,349,897,5,5,202034
15,39,100,16,72,133,19,31,0,371,296,667,4,5,202034
15,40,303,33,150,358,78,62,1,985,143,1128,9,5,202034
15,41,314,22,372,400,66,40,18,1232,133,1365,13,5,202034
16,1,86,4,97,60,10,5,0,262,44,306,4,5,202034
16,2,135,10,48,100,18,25,0,336,51,387,6,5,202034
16,3,169,10,117,184,13,35,0,528,42,570,7,5,202034
16,4,192,16,179,122,24,28,0,561,98,659,7,5,202034
16,5,174,10,104,123,22,47,17,497,105,602,5,5,202034
16,6,260,45,172,209,56,43,0,785,60,845,10,5,202034
16,7,224,17,174,275,25,44,2,761,80,841,7,5,202034
16,8,342,24,411,409,12,57,3,1258,233,1491,11,5,202034
16,9,265,14,242,353,12,89,6,981,95,1076,8,5,202034
16,10,142,12,256,215,7,27,1,660,74,734,5,5,202034
16,11,200,21,111,165,38,56,6,597,144,741,9,5,202034
16,12,81,6,84,67,1,35,1,275,80,355,5,5,202034
17,1,80,1,102,121,8,14,4,330,230,560,4,5,202034
17,2,122,5,144,187,4,16,3,481,304,785,5,5,202034
17,3,153,5,115,103,15,19,4,414,471,885,6,5,202034
17,4,108,8,152,197,6,18,16,505,188,693,6,5,202034
17,5,76,3,78,109,9,19,0,294,31,325,4,5,202034
18,1,32,3,20,33,0,6,1,95,50,145,5,5,202034
18,2,286,14,222,268,40,87,1,918,248,1166,8,5,202034
18,3,141,10,169,97,6,23,1,447,89,536,6,5,202034
19,1,234,9,205,267,20,106,47,888,158,1046,7,5,202034
19,2,168,6,173,146,5,46,2,546,284,830,6,5,202034
19,3,201,11,215,217,36,55,2,737,427,1164,6,5,202034
19,4,192,2,113,97,39,76,31,550,70,620,5,5,202034
19,5,293,18,242,349,19,118,27,1066,735,1801,8,5,202034
19,6,96,10,129,213,6,76,6,536,336,872,5,5,202034
19,7,244,7,291,168,4,52,0,766,87,853,8,5,202034
19,8,202,4,193,216,6,40,0,661,43,704,6,5,202034
19,9,99,7,71,61,8,30,5,281,74,355,5,5,202034
19,10,108,3,77,93,5,42,15,343,324,667,4,5,202034
19,11,501,25,381,591,15,224,50,1787,392,2179,12,5,202034
19,12,228,6,256,129,8,30,6,663,465,1128,10,5,202034
20,1,140,6,76,89,28,16,21,376,71,447,4,5,202034
20,2,80,6,65,79,27,11,1,269,157,426,4,5,202034
20,3,77,2,84,69,30,36,12,310,54,364,4,5,202034
20,4,115,2,94,54,18,37,7,327,48,375,4,5,202034
20,5,112,3,104,121,26,5,0,371,43,414,5,5,202034
20,6,142,3,71,74,29,20,16,355,52,407,5,5,202034
20,7,95,2,67,135,5,18,0,322,87,409,4,5,202034
20,8,448,22,455,691,80,121,44,1861,148,2009,13,5,202034
20,9,296,5,125,124,102,47,10,709,89,798,7,5,202034
20,10,116,3,114,85,11,12,0,341,47,388,5,5,202034
21,1,185,11,161,185,15,21,0,578,225,803,7,5,202034
21,2,120,7,81,62,32,11,1,314,64,378,4,5,202034
21,3,183,4,113,161,21,45,5,532,289,821,6,5,202034
21,4,60,3,26,37,20,14,2,162,14,176,4,5,202034
21,5,179,11,207,185,26,46,6,660,194,854,7,5,202034
21,6,153,3,141,200,39,58,6,600,268,868,5,5,202034
21,7,181,6,100,203,42,62,9,603,29,632,8,5,202034
21,8,118,8,65,89,17,30,21,348,71,419,6,5,202034
21,9,224,11,256,335,53,57,8,944,456,1400,8,5,202034
21,10,136,7,94,126,9,26,17,415,373,788,4,5,202034
21,11,88,7,101,99,19,27,1,342,182,524,3,5,202034
21,12,272,15,314,316,44,77,119,1157,731,1888,8,5,202034
21,13,129,3,138,139,22,68,2,501,96,597,6,5,202034
21,14,90,2,62,67,17,23,12,273,52,325,5,5,202034
21,15,140,1,104,206,9,44,16,520,294,814,5,5,202034
22,1,166,18,75,158,6,17,5,445,89,534,6,5,202034
22,2,184,17,162,125,53,23,2,566,100,666,6,5,202034
22,3,259,18,346,297,16,47,0,983,599,1582,8,5,202034
22,4,217,16,416,385,8,63,5,1110,501,1611,8,5,202034
22,5,217,15,321,181,33,57,10,834,93,927,8,5,202034
23,1,210,2,365,128,21,52,7,785,9,794,8,5,202034
23,2,174,7,197,153,9,20,0,560,298,858,7,5,202034
23,3,382,6,658,520,33,54,11,1664,25,1689,16,5,202034
23,4,120,2,176,137,13,30,9,487,61,548,5,5,202034
24,1,108,15,66,106,6,29,1,331,55,386,5,5,202034
24,2,84,6,61,72,7,19,2,251,102,353,3,5,202034
24,3,161,13,116,113,34,29,2,468,69,537,6,5,202034
24,4,148,9,92,97,14,48,12,420,64,484,4,5,202034
24,5,293,22,314,419,10,48,0,1106,199,1305,8,5,202034
24,6,143,38,169,220,27,40,0,637,111,748,3,5,202034
24,7,140,7,55,77,18,7,0,304,88,392,6,5,202034
25,1,264,9,218,254,14,73,32,864,227,1091,10,5,202034
25,2,247,21,219,249,17,40,1,794,128,922,4,5,202034
25,3,286,11,188,277,46,51,17,876,178,1054,7,5,202034
25,4,203,19,154,246,50,48,1,721,104,825,6,5,202034
25,5,311,14,263,378,19,66,5,1056,107,1163,7,5,202034
25,6,164,4,139,204,17,51,14,593,262,855,5,5,202034
25,7,308,15,259,314,1,34,0,931,203,1134,5,5,202034
26,1,215,7,127,138,1,46,0,534,92,626,7,5,202034
26,2,280,6,165,206,2,52,2,713,16,729,4,5,202034
26,3,302,7,182,253,6,95,24,869,136,1005,9,5,202034
26,4,87,2,70,77,1,17,2,256,18,274,5,5,202034
26,5,218,3,110,187,4,80,1,603,91,694,8,5,202034
26,6,155,7,113,155,9,71,1,511,77,588,5,5,202034
26,7,113,3,79,125,29,18,2,369,75,444,6,5,202034
27,1,300,7,101,166,27,25,0,626,79,705,6,5,202034
27,2,263,7,131,279,17,42,10,749,119,868,7,5,202034
27,3,225,6,89,277,10,29,0,636,262,898,6,5,202034
27,4,283,11,209,441,15,49,7,1015,135,1150,6,5,202034
27,5,81,0,38,70,4,22,0,215,55,270,4,5,202034
27,6,209,7,135,371,4,36,0,762,87,849,6,5,202034
28,1,416,33,443,382,11,51,0,1336,97,1433,7,5,202034
28,2,343,13,254,264,18,93,94,1079,115,1194,11,4.5,202034
28,3,77,2,34,40,1,16,5,175,23,198,3,5,202034
28,4,578,24,395,355,73,104,25,1554,198,1752,14,5,202034
28,5,209,7,106,164,5,41,6,538,68,606,6,5,202034
28,6,184,9,92,148,14,22,10,479,110,589,9,5,202034
28,7,214,10,241,224,48,65,26,828,78,906,9,5,202034
28,8,242,9,224,288,47,92,15,917,14,931,12,5,202034
28,9,189,4,166,116,7,42,8,532,72,604,6,5,202034
29,1,197,12,126,172,20,30,1,558,24,582,6,5,202034
29,2,200,5,119,251,16,39,30,660,105,765,6,5,202034
29,3,107,9,60,158,7,36,2,379,0,379,3,5,202034
30,1,114,6,87,104,6,15,10,342,7,349,4,5,202034
30,2,101,10,28,47,12,4,23,225,54,279,5,5,202034
30,3,208,8,112,108,40,38,29,543,73,616,5,5,202034
30,4,187,3,211,143,32,59,0,635,164,799,8,5,202034
30,5,143,8,135,134,19,23,0,462,254,716,6,5,202034
30,6,190,5,133,135,21,17,3,504,9,513,5,5,202034
30,7,143,3,69,86,20,19,21,361,127,488,8,5,202034
30,8,201,7,164,132,30,40,0,574,178,752,7,5,202034
30,9,215,5,73,96,32,25,18,464,62,526,6,5,202034
30,10,198,8,207,181,21,65,22,702,351,1053,6,5,202034
30,11,133,4,89,126,3,18,0,373,137,510,4,5,202034
30,12,284,11,293,244,14,59,0,905,275,1180,10,5,202034
30,13,201,6,76,120,31,65,30,529,30,559,7,5,202034
30,14,201,6,126,127,26,35,2,523,8,531,5,5,202034
30,15,281,6,158,199,37,97,35,813,202,1015,10,5,202034
30,16,302,10,184,270,35,63,41,905,42,947,8,5,202034
30,17,201,6,119,158,15,48,12,559,14,573,6,5,202034
30,18,95,3,44,61,8,7,0,218,26,244,4,5,202034
30,19,262,5,208,153,24,59,0,711,48,759,9,5,202034
30,20,159,9,104,143,33,30,1,479,184,663,7,5,202034
31,1,147,6,148,13,54,15,0,383,88,471,5,5,202034
31,2,41,1,25,3,30,9,0,109,39,148,3,5,202034
31,3,388,20,521,327,64,51,0,1371,90,1461,12,5,202034
31,4,146,4,181,147,56,32,12,578,56,634,4,5,202034
31,5,93,7,80,58,9,12,0,259,28,287,2,5,202034
32,1,133,9,57,105,11,24,19,358,41,399,7,5,202034
32,2,103,4,44,33,22,15,12,233,55,288,7,5,202034
32,3,297,32,174,247,7,59,10,826,197,1023,9,5,202034
32,4,165,11,101,111,5,33,4,430,229,659,8,5,202034
1,1,285,22,219,216,27,45,5,819,212,1031,10,5,202035
1,2,278,26,285,252,43,57,10,951,365,1316,9,5,202035
1,3,303,56,335,333,25,78,24,1154,281,1435,8,5,202035
2,1,255,5,208,195,20,48,46,777,112,889,6,5,202035
2,2,100,3,82,140,2,48,0,375,247,622,3,5,202035
2,3,269,11,231,240,10,81,16,858,10,868,7,5,202035
2,4,269,9,251,125,29,23,13,719,4,723,7,5,202035
2,5,241,8,299,190,73,70,13,894,33,927,5,5,202035
2,6,164,4,194,149,31,60,22,624,5,629,6,5,202035
2,7,222,6,160,159,20,50,15,632,68,700,8,5,202035
2,8,144,2,133,138,12,47,21,497,13,510,3,5,202035
3,1,211,15,227,224,27,62,5,771,262,1033,8,5,202035
3,2,172,4,253,164,33,22,0,648,203,851,6,5,202035
4,1,191,3,113,195,15,30,13,560,182,742,6,5,202035
4,2,107,3,90,132,11,28,14,385,68,453,6,5,202035
5,1,0,0,0,361,0,0,0,361,163,524,7,5,202035
5,2,0,0,0,123,0,0,0,123,96,219,5,5,202035
5,3,0,0,0,295,0,0,0,295,153,448,8,5,202035
5,4,3,0,2,685,0,0,0,690,400,1090,7,5,202035
5,5,1,0,1,621,0,0,1,624,532,1156,10,5,202035
5,6,0,0,0,267,0,0,0,267,80,347,3,5,202035
5,7,0,0,0,333,0,0,0,333,52,385,6,5,202035
6,1,274,8,196,192,9,56,24,759,82,841,8,5,202035
6,2,143,7,97,119,25,23,5,419,65,484,7,4.5,202035
7,1,130,2,41,49,2,9,0,233,65,298,5,5,202035
7,2,187,11,62,144,3,6,0,413,143,556,6,5,202035
7,3,83,1,31,29,17,8,1,170,3,173,3,5,202035
7,4,211,6,89,128,4,26,4,468,172,640,9,5,202035
7,5,260,5,97,260,16,24,3,665,130,795,8,5,202035
7,6,161,1,108,110,4,30,6,420,277,697,6,5,202035
7,7,206,9,90,118,38,32,4,497,186,683,6,5,202035
7,8,119,4,58,77,16,14,29,317,197,514,6,5,202035
7,9,210,5,117,192,21,38,2,585,485,1070,8,5,202035
7,10,188,4,99,142,6,12,0,451,138,589,6,5,202035
7,11,107,0,43,23,17,8,0,198,49,247,4,5,202035
7,12,223,1,118,200,4,16,0,562,355,917,6,5,202035
7,13,90,2,53,96,0,5,0,246,134,380,5,5,202035
8,1,90,0,70,35,0,5,0,200,21,221,2,5,202035
8,2,450,16,275,213,20,29,2,1005,298,1303,13,5,202035
8,3,185,16,88,110,8,28,11,446,63,509,4,5,202035
8,4,345,29,416,385,27,84,23,1309,619,1928,8,5,202035
8,5,133,4,83,124,3,19,0,366,92,458,5,5,202035
8,6,289,41,196,241,22,43,3,835,122,957,5,5,202035
8,7,102,5,88,94,3,28,0,320,54,374,5,5,202035
8,8,403,29,283,444,9,79,0,1247,189,1436,8,5,202035
8,9,110,5,75,76,26,18,10,320,101,421,4,5,202035
9,1,109,3,102,157,41,24,5,441,60,501,4,5,202035
9,2,373,29,405,596,79,98,15,1595,34,1629,10,5,202035
9,3,179,3,192,302,42,45,23,786,78,864,4,5,202035
9,4,249,6,277,420,76,46,4,1078,45,1123,7,5,202035
9,5,193,1,149,222,45,46,0,656,8,664,6,5,202035
9,6,175,17,136,201,126,62,21,738,4,742,7,5,202035
9,7,157,6,257,223,1,28,0,672,176,848,6,5,202035
9,8,75,5,158,204,7,32,4,485,9,494,3,5,202035
9,9,140,3,110,177,37,32,13,512,83,595,3,5,202035
9,10,94,7,180,174,11,37,10,513,9,522,3,5,202035
9,11,189,13,240,332,87,75,11,947,160,1107,7,5,202035
9,12,165,17,253,391,12,71,22,931,26,957,7,5,202035
9,13,101,5,136,165,40,24,7,478,14,492,3,5,202035
9,14,146,6,143,174,37,33,14,553,13,566,5,5,202035
9,15,176,16,417,434,20,51,18,1132,382,1514,6,5,202035
9,16,309,55,272,510,52,56,4,1258,254,1512,11,5,202035
9,17,143,7,148,197,17,47,1,560,31,591,5,5,202035
9,18,175,11,212,328,73,79,10,888,21,909,8,5,202035
9,19,164,15,134,185,72,41,5,616,16,632,3,5,202035
9,20,83,5,75,133,30,16,3,345,100,445,3,5,202035
9,21,120,8,102,168,31,20,3,452,23,475,3,5,202035
9,22,126,4,131,219,54,24,15,573,14,587,4,5,202035
9,23,203,11,281,353,86,34,4,972,8,980,6,5,202035
9,24,391,21,424,611,130,125,21,1723,179,1902,11,5,202035
10,1,234,8,149,210,17,40,18,676,158,834,11,5,202035
10,2,124,7,82,133,4,39,4,393,180,573,5,5,202035
10,3,219,12,105,150,21,60,15,582,122,704,9,5,202035
10,4,404,15,226,399,13,42,8,1107,320,1427,11,5,202035
11,1,210,26,87,168,14,28,0,533,131,664,6,5,202035
11,2,233,20,142,127,66,55,7,650,180,830,6,5,202035
11,3,110,11,67,98,16,29,5,336,96,432,3,5,202035
11,4,166,20,110,100,16,39,0,451,201,652,5,5,202035
11,5,243,53,192,294,18,71,23,894,186,1080,7,5,202035
11,6,173,20,202,216,21,65,4,701,206,907,8,5,202035
11,7,258,19,182,192,16,29,0,696,268,964,7,5,202035
11,8,323,31,236,369,46,94,11,1110,262,1372,9,5,202035
11,9,248,36,183,255,20,36,9,787,314,1101,8,5,202035
11,10,247,27,163,176,29,68,23,733,64,797,9,5,202035
11,11,203,21,127,169,4,34,0,558,176,734,5,5,202035
11,12,242,40,223,302,17,46,1,871,221,1092,7,5,202035
11,13,143,14,99,108,20,26,19,429,140,569,6,5,202035
11,14,157,25,106,125,34,24,2,473,152,625,6,5,202035
11,15,174,17,158,187,15,64,37,652,108,760,5,5,202035
12,1,85,9,49,74,15,16,0,248,105,353,5,5,202035
12,2,201,10,168,265,9,45,0,698,300,998,8,5,202035
12,3,112,10,146,148,9,12,0,437,129,566,5,5,202035
12,4,281,26,346,362,61,59,3,1138,343,1481,8,5,202035
12,5,144,20,94,93,4,11,24,390,178,568,7,5,202035
12,6,195,10,90,83,23,3,6,410,231,641,7,5,202035
12,7,169,8,84,224,3,25,2,515,176,691,5,5,202035
12,8,147,8,73,94,0,10,0,332,137,469,6,5,202035
12,9,399,23,329,487,32,46,3,1319,615,1934,8,5,202035
13,1,1,0,0,119,0,0,0,120,133,253,7,5,202035
13,2,0,0,0,164,0,0,0,164,42,206,4,5,202035
13,3,0,0,1,173,0,0,0,174,106,280,6,5,202035
13,4,0,0,2,382,0,0,0,384,189,573,7,5,202035
13,5,2,0,1,410,1,1,2,417,390,807,8,5,202035
13,6,0,0,0,820,0,0,0,820,262,1082,10,5,202035
13,7,3,0,2,368,0,1,0,374,178,552,7,5,202035
14,1,97,25,57,40,43,28,3,293,105,398,5,5,202035
14,2,152,7,84,52,19,31,3,348,167,515,4,5,202035
14,3,173,8,157,42,4,42,3,429,73,502,7,5,202035
14,4,300,16,300,311,10,67,14,1018,405,1423,8,5,202035
14,5,193,8,211,164,16,25,3,620,327,947,9,5,202035
14,6,238,15,280,175,6,46,2,762,403,1165,7,5,202035
14,7,211,19,188,158,0,17,0,593,267,860,6,5,202035
14,8,359,26,511,496,12,89,0,1493,513,2006,9,5,202035
14,9,189,19,199,279,15,54,13,768,155,923,5,5,202035
14,10,222,15,231,161,8,51,6,694,433,1127,6,5,202035
14,11,108,6,69,98,22,36,10,349,130,479,3,5,202035
14,12,219,7,189,118,8,16,0,557,441,998,8,5,202035
14,13,149,15,147,157,8,34,8,518,446,964,5,5,202035
14,14,226,12,188,250,30,62,8,776,169,945,5,5,202035
14,15,217,20,161,171,38,75,14,696,284,980,7,5,202035
14,16,184,8,173,133,28,47,4,577,565,1142,5,5,202035
14,17,78,7,60,37,13,21,13,229,156,385,5,5,202035
14,18,141,16,118,88,34,44,15,456,111,567,7,5,202035
14,19,109,8,175,84,12,22,1,411,149,560,5,5,202035
14,20,294,24,282,195,3,25,1,824,482,1306,8,5,202035
15,1,118,5,68,53,65,17,0,326,165,491,5,5,202035
15,2,149,7,84,144,37,29,4,454,284,738,5,5,202035
15,3,197,9,115,126,130,27,31,635,149,784,9,5,202035
15,4,138,8,85,155,22,25,3,436,218,654,3,5,202035
15,5,133,11,94,123,10,20,9,400,132,532,5,5,202035
15,6,104,4,123,144,7,28,5,415,263,678,5,5,202035
15,7,221,11,198,151,73,60,6,720,326,1046,8,5,202035
15,8,115,5,108,220,19,30,9,506,270,776,3,5,202035
15,9,199,8,65,98,115,79,0,564,196,760,7,5,202035
15,10,175,5,100,246,11,31,6,574,154,728,6,5,202035
15,11,167,17,170,224,35,27,1,641,293,934,5,5,202035
15,12,215,12,205,254,47,31,0,764,433,1197,7,5,202035
15,13,108,7,82,117,63,23,1,401,187,588,5,5,202035
15,14,124,6,99,154,16,29,3,431,174,605,4,5,202035
15,15,93,20,96,136,23,17,12,397,277,674,2,5,202035
15,16,276,18,234,571,26,69,39,1233,458,1691,8,5,202035
15,17,127,10,87,196,20,37,20,497,382,879,5,5,202035
15,18,188,9,205,239,28,49,5,723,173,896,6,5,202035
15,19,319,29,321,558,21,94,9,1351,325,1676,8,5,202035
15,20,122,21,187,199,23,17,1,570,361,931,5,5,202035
15,21,55,0,24,76,19,26,9,209,96,305,3,5,202035
15,22,253,46,257,433,17,65,30,1101,317,1418,7,5,202035
15,23,116,3,73,199,14,35,0,440,62,502,5,5,202035
15,24,102,14,88,142,19,19,3,387,48,435,3,5,202035
15,25,159,23,123,217,21,37,8,588,386,974,4,5,202035
15,26,149,5,122,202,92,23,1,594,110,704,5,5,202035
15,27,255,12,251,307,14,81,40,960,153,1113,8,5,202035
15,28,168,26,160,130,15,19,4,522,166,688,7,5,202035
15,29,197,12,200,348,4,47,0,808,576,1384,6,5,202035
15,30,392,39,278,399,75,54,17,1254,485,1739,12,5,202035
15,31,126,85,76,170,12,12,0,481,214,695,4,5,202035
15,32,203,10,117,271,32,43,4,680,291,971,7,5,202035
15,33,229,8,240,260,28,22,2,789,145,934,6,5,202035
15,34,149,7,117,300,22,38,0,633,224,857,6,5,202035
15,35,207,11,135,253,7,40,9,662,216,878,7,5,202035
15,36,191,4,156,240,2,28,1,622,217,839,7,5,202035
15,37,239,18,189,336,58,71,12,923,414,1337,4,5,202035
15,38,155,24,107,172,36,25,11,530,376,906,4,5,202035
15,39,122,13,64,134,10,8,1,352,266,618,4,5,202035
15,40,310,45,154,321,86,53,3,972,237,1209,9,5,202035
15,41,308,17,372,374,60,64,19,1214,199,1413,11,5,202035
16,1,87,6,91,72,15,6,0,277,95,372,4,5,202035
16,2,124,16,49,92,18,27,5,331,63,394,6,5,202035
16,3,191,2,104,174,14,26,1,512,95,607,7,5,202035
16,4,200,18,145,120,37,35,1,556,123,679,7,5,202035
16,5,155,13,86,155,23,47,6,485,238,723,5,5,202035
16,6,264,54,129,162,44,25,0,678,189,867,10,5,202035
16,7,264,22,176,250,15,38,1,766,304,1070,7,5,202035
16,8,328,22,419,398,9,45,5,1226,412,1638,11,5,202035
16,9,289,18,255,320,10,57,2,951,139,1090,8,5,202035
16,10,154,9,191,223,17,33,0,627,130,757,5,5,202035
16,11,234,13,122,130,46,36,1,582,220,802,9,5,202035
16,12,111,12,142,96,1,32,1,395,120,515,5,5,202035
17,1,76,4,95,123,11,19,7,335,346,681,4,5,202035
17,2,111,3,116,146,6,21,4,407,427,834,5,5,202035
17,3,117,6,133,103,13,15,0,387,472,859,6,5,202035
17,4,149,7,191,226,11,37,14,635,332,967,6,5,202035
17,5,67,3,79,96,7,20,0,272,68,340,4,5,202035
18,1,26,6,23,38,2,10,0,105,49,154,4,5,202035
18,2,319,8,178,279,28,64,0,876,182,1058,8,5,202035
18,3,134,9,212,96,7,20,0,478,89,567,6,5,202035
19,1,250,21,237,250,24,94,50,926,215,1141,7,5,202035
19,2,248,4,232,150,10,34,0,678,272,950,6,5,202035
19,3,229,2,188,165,28,57,3,672,411,1083,6,5,202035
19,4,171,5,125,103,45,70,41,560,101,661,5,5,202035
19,5,353,47,303,374,22,102,20,1221,680,1901,8,5,202035
19,6,122,10,145,224,3,45,11,560,337,897,5,5,202035
19,7,254,3,267,181,5,43,1,754,213,967,8,5,202035
19,8,182,9,220,199,5,46,0,661,166,827,6,5,202035
19,9,86,6,118,50,6,16,0,282,111,393,5,5,202035
19,10,92,5,110,137,6,42,13,405,237,642,4,5,202035
19,11,496,30,363,627,7,194,72,1789,729,2518,12,5,202035
19,12,276,6,291,109,12,31,1,726,393,1119,10,5,202035
20,1,118,2,78,117,43,12,16,386,78,464,4,5,202035
20,2,69,5,66,75,42,9,0,266,114,380,4,5,202035
20,3,83,4,43,79,25,18,2,254,72,326,4,5,202035
20,4,111,2,73,58,15,33,7,299,117,416,4,5,202035
20,5,114,7,88,138,25,10,0,382,136,518,6,5,202035
20,6,114,2,66,79,32,18,6,317,157,474,5,5,202035
20,7,109,5,81,134,4,16,1,350,197,547,4,5,202035
20,8,515,18,530,672,82,109,38,1964,334,2298,13,5,202035
20,9,294,7,137,119,75,45,12,689,132,821,7,5,202035
20,10,109,3,101,62,7,8,0,290,108,398,5,5,202035
21,1,208,7,144,152,22,19,0,552,340,892,7,5,202035
21,2,135,8,69,56,39,14,0,321,104,425,6,5,202035
21,3,211,7,153,127,37,37,6,578,304,882,6,5,202035
21,4,53,2,28,30,19,9,2,143,38,181,4,5,202035
21,5,235,5,236,149,25,35,13,698,198,896,7,5,202035
21,6,172,6,111,173,34,34,11,541,336,877,5,5,202035
21,7,228,2,105,163,43,45,2,588,87,675,8,5,202035
21,8,118,2,69,76,12,20,25,322,148,470,7,5,202035
21,9,237,12,343,313,54,68,16,1043,423,1466,8,5,202035
21,10,105,9,120,122,8,27,14,405,447,852,4,5,202035
21,11,96,4,95,107,36,16,2,356,191,547,3,5,202035
21,12,276,17,323,288,55,52,142,1153,782,1935,8,5,202035
21,13,132,8,120,120,20,44,2,446,191,637,6,5,202035
21,14,91,3,40,49,28,29,4,244,120,364,6,5,202035
21,15,156,7,122,150,16,38,14,503,242,745,5,5,202035
22,1,168,17,79,141,7,18,2,432,112,544,7,5,202035
22,2,150,21,150,127,33,25,4,510,219,729,6,5,202035
22,3,269,19,418,321,9,40,0,1076,640,1716,8,5,202035
22,4,229,21,397,341,8,46,0,1042,651,1693,8,5,202035
22,5,199,13,358,200,51,39,18,878,242,1120,8,5,202035
23,1,208,5,399,143,24,29,17,825,36,861,9,5,202035
23,2,185,11,236,177,7,15,0,631,329,960,7,5,202035
23,3,332,9,623,459,26,39,7,1495,113,1608,16,5,202035
23,4,117,2,184,149,21,30,15,518,136,654,5,5,202035
24,1,109,16,73,100,13,31,0,342,162,504,5,5,202035
24,2,106,7,81,78,7,19,2,300,98,398,3,5,202035
24,3,186,28,109,90,47,21,0,481,106,587,6,5,202035
24,4,144,18,74,111,10,36,25,418,83,501,4,5,202035
24,5,325,38,389,432,9,48,0,1241,420,1661,8,5,202035
24,6,177,30,192,202,16,27,0,644,188,832,3,5,202035
24,7,111,10,51,82,22,4,0,280,61,341,6,5,202035
25,1,280,10,243,272,11,51,36,903,177,1080,11,5,202035
25,2,230,33,225,282,10,27,2,809,127,936,4,5,202035
25,3,270,11,181,291,41,43,20,857,340,1197,7,5,202035
25,4,233,8,144,270,47,34,4,740,164,904,6,5,202035
25,5,278,14,251,369,18,74,5,1009,228,1237,7,5,202035
25,6,176,2,156,192,20,37,8,591,272,863,6,5,202035
25,7,257,8,286,311,2,15,0,879,292,1171,5,5,202035
26,1,167,4,136,137,1,51,0,496,139,635,7,5,202035
26,2,229,9,160,228,2,24,0,652,272,924,6,5,202035
26,3,334,9,175,302,24,89,26,959,269,1228,9,5,202035
26,4,76,3,70,84,0,10,11,254,61,315,5,5,202035
26,5,205,9,131,181,13,59,0,598,252,850,8,5,202035
26,6,121,7,100,148,13,30,4,423,145,568,7,5,202035
26,7,141,7,112,168,35,24,2,489,174,663,8,5,202035
27,1,276,3,87,199,32,20,1,618,198,816,6,5,202035
27,2,326,8,134,326,22,31,8,855,166,1021,7,5,202035
27,3,242,6,80,252,7,20,0,607,320,927,5,5,202035
27,4,304,3,194,462,19,49,3,1034,329,1363,6,5,202035
27,5,87,0,51,81,5,5,5,234,74,308,4,5,202035
27,6,236,5,172,355,3,26,0,797,213,1010,6,5,202035
28,1,394,29,363,382,5,41,0,1214,341,1555,7,5,202035
28,2,448,31,321,271,31,81,122,1305,366,1671,11,5,202035
28,3,75,4,45,63,7,17,5,216,43,259,3,5,202035
28,4,560,32,380,335,87,128,49,1571,321,1892,14,5,202035
28,5,160,4,103,171,3,20,17,478,151,629,6,5,202035
28,6,133,6,81,129,20,17,4,390,223,613,9,5,202035
28,7,248,15,223,221,49,47,20,823,222,1045,9,5,202035
28,8,215,11,207,242,49,67,41,832,146,978,12,5,202035
28,9,225,8,230,155,11,35,19,683,117,800,5,5,202035
29,1,236,10,118,177,23,30,0,594,62,656,6,5,202035
29,2,185,10,137,264,19,62,38,715,243,958,6,5,202035
29,3,121,13,56,146,10,24,0,370,36,406,4,5,202035
30,1,97,6,75,75,19,9,16,297,188,485,5,5,202035
30,2,96,7,47,37,7,9,30,233,124,357,5,5,202035
30,3,245,7,110,91,52,38,27,570,153,723,5,5,202035
30,4,227,5,195,156,40,50,0,673,165,838,8,5,202035
30,5,181,2,143,114,16,24,0,480,422,902,6,5,202035
30,6,196,2,128,130,11,20,3,490,131,621,7,5,202035
30,7,143,3,73,78,26,28,18,369,229,598,8,5,202035
30,8,161,6,199,122,50,19,1,558,233,791,8,5,202035
30,9,183,0,84,87,41,26,18,439,276,715,6,5,202035
30,10,222,10,267,166,23,57,13,758,366,1124,6,5,202035
30,11,137,4,121,112,2,24,2,402,321,723,4,5,202035
30,12,298,9,323,260,11,46,0,947,532,1479,10,5,202035
30,13,200,3,73,104,39,41,31,491,295,786,7,5,202035
30,14,173,7,151,122,26,25,4,508,130,638,6,5,202035
30,15,316,5,153,173,43,67,37,794,215,1009,10,5,202035
30,16,291,5,192,226,26,53,61,854,419,1273,8,5,202035
30,17,189,7,103,157,16,45,19,536,79,615,6,5,202035
30,18,78,7,31,68,9,15,0,208,118,326,5,5,202035
30,19,243,5,227,174,9,38,2,698,85,783,9,5,202035
30,20,171,6,74,147,38,26,1,463,363,826,7,5,202035
31,1,132,7,198,27,58,10,0,432,103,535,4,5,202035
31,2,34,1,31,5,19,7,0,97,23,120,3,5,202035
31,3,375,17,409,267,67,42,0,1177,230,1407,13,5,202035
31,4,121,7,141,104,46,37,13,469,100,569,4,5,202035
31,5,96,1,72,67,3,9,0,248,83,331,4,5,202035
32,1,169,11,67,87,23,28,36,421,105,526,8,5,202035
32,2,95,11,42,61,23,14,17,263,136,399,7,5,202035
32,3,266,31,171,257,8,50,15,798,257,1055,10,5,202035
32,4,164,13,95,156,13,33,7,481,159,640,8,5,202035
1,1,261,33,196,220,17,57,11,795,354,1149,11,5,202036
1,2,290,20,299,272,23,83,9,996,591,1587,12,5,202036
1,3,311,44,349,402,22,92,29,1249,693,1942,12,5,202036
2,1,185,4,167,195,11,93,28,683,72,755,6,5,202036
2,2,106,0,64,152,2,42,2,368,316,684,3,5,202036
2,3,249,15,250,238,9,104,21,886,20,906,8,5,202036
2,4,270,8,233,163,35,44,17,770,20,790,7,5,202036
2,5,249,10,332,184,60,100,22,957,38,995,5,5,202036
2,6,138,7,188,163,28,91,27,642,12,654,6,5,202036
2,7,215,8,241,169,20,71,25,749,126,875,8,5,202036
2,8,120,5,168,146,12,41,30,522,9,531,3,5,202036
3,1,206,13,207,260,31,75,13,805,529,1334,8,5,202036
3,2,202,3,236,123,16,38,1,619,366,985,7,5,202036
4,1,216,9,113,185,15,48,4,590,370,960,5,5,202036
4,2,90,2,80,94,15,33,19,333,204,537,7,5,202036
5,1,0,0,0,346,0,0,0,346,216,562,6,5,202036
5,2,0,0,2,137,0,0,0,139,68,207,3,5,202036
5,3,0,0,0,262,0,0,0,262,261,523,7,5,202036
5,4,1,1,2,638,0,1,0,643,668,1311,6,5,202036
5,5,1,1,1,755,0,0,1,759,459,1218,10,5,202036
5,6,0,0,0,252,0,0,0,252,164,416,3,5,202036
5,7,0,0,0,260,0,0,0,260,140,400,5,5,202036
6,1,234,11,175,183,12,82,34,731,279,1010,9,5,202036
6,2,114,11,91,92,10,28,11,357,320,677,7,5,202036
7,1,141,3,50,56,4,17,0,271,145,416,6,5,202036
7,2,187,0,43,166,7,15,0,418,273,691,6,5,202036
7,3,100,0,54,46,24,10,1,235,25,260,5,5,202036
7,4,198,5,68,130,5,22,3,431,274,705,9,5,202036
7,5,277,10,118,248,11,19,7,690,253,943,8,5,202036
7,6,127,4,142,125,13,40,7,458,252,710,7,5,202036
7,7,247,10,134,145,31,43,11,621,382,1003,6,5,202036
7,8,96,5,47,79,24,29,21,301,298,599,7,5,202036
7,9,203,8,131,258,22,41,10,673,443,1116,8,5,202036
7,10,207,4,76,141,10,24,0,462,289,751,6,5,202036
7,11,87,1,38,46,21,5,0,198,102,300,4,5,202036
7,12,186,7,137,213,5,24,1,573,457,1030,6,5,202036
7,13,95,7,54,80,1,9,0,246,299,545,6,5,202036
8,1,103,3,92,42,0,8,0,248,225,473,4,5,202036
8,2,423,28,349,259,12,21,1,1093,598,1691,13,5,202036
8,3,201,16,169,192,12,39,16,645,304,949,4,5,202036
8,4,363,33,405,425,42,127,30,1425,954,2379,8,5,202036
8,5,128,14,79,133,7,28,0,389,236,625,6,5,202036
8,6,307,38,175,244,25,56,7,852,591,1443,5,5,202036
8,7,104,8,79,79,4,31,0,305,156,461,5,5,202036
8,8,315,21,287,379,12,106,0,1120,569,1689,8,5,202036
8,9,106,8,72,56,15,24,17,298,192,490,5,5,202036
9,1,96,5,93,125,42,41,15,417,159,576,4,5,202036
9,2,340,25,402,624,90,120,18,1619,528,2147,10,5,202036
9,3,109,5,161,257,35,47,17,631,197,828,4,5,202036
9,4,270,8,216,369,39,76,10,988,389,1377,7,5,202036
9,5,199,6,183,301,40,72,0,801,507,1308,7,5,202036
9,6,151,11,107,233,95,47,19,663,279,942,7,5,202036
9,7,158,2,225,216,5,45,0,651,453,1104,6,5,202036
9,8,54,9,129,167,4,25,1,389,144,533,3,5,202036
9,9,114,1,103,174,32,40,3,467,256,723,3,5,202036
9,10,95,4,156,171,15,45,6,492,155,647,3,5,202036
9,11,207,9,264,370,71,97,16,1034,416,1450,7,5,202036
9,12,140,14,280,349,13,86,20,902,475,1377,7,5,202036
9,13,90,7,122,172,38,46,8,483,142,625,3,5,202036
9,14,189,7,135,220,53,68,16,688,339,1027,5,5,202036
9,15,126,11,377,353,18,83,16,984,1064,2048,6,5,202036
9,16,258,92,277,506,34,78,5,1250,689,1939,11,5,202036
9,17,153,9,202,234,16,70,5,689,336,1025,6,5,202036
9,18,164,9,201,289,54,74,12,803,541,1344,8,5,202036
9,19,133,8,99,196,54,44,6,540,211,751,3,5,202036
9,20,69,1,84,119,42,15,4,334,205,539,3,5,202036
9,21,131,4,98,146,27,29,9,444,275,719,3,5,202036
9,22,129,2,132,193,61,40,22,579,203,782,4,5,202036
9,23,212,9,247,362,49,68,1,948,275,1223,6,5,202036
9,24,358,13,383,590,140,138,10,1632,519,2151,11,5,202036
10,1,198,10,116,178,7,36,26,571,572,1143,10,5,202036
10,2,133,7,93,171,1,37,4,446,248,694,5,5,202036
10,3,175,14,82,152,17,33,9,482,309,791,9,5,202036
10,4,395,27,197,351,12,49,1,1032,581,1613,11,5,202036
11,1,182,24,86,126,13,32,0,463,285,748,6,5,202036
11,2,248,18,161,117,43,60,7,654,275,929,7,5,202036
11,3,95,15,78,111,18,46,9,372,249,621,3,5,202036
11,4,203,29,113,157,24,47,0,573,342,915,5,5,202036
11,5,317,68,295,419,33,83,14,1229,400,1629,7,5,202036
11,6,163,20,193,225,30,55,2,688,125,813,8,5,202036
11,7,230,31,192,246,25,60,11,795,648,1443,7,5,202036
11,8,280,35,307,359,35,87,15,1118,753,1871,9,5,202036
11,9,293,36,200,309,7,55,9,909,508,1417,8,5,202036
11,10,263,32,217,203,22,68,41,846,225,1071,9,5,202036
11,11,151,26,122,213,2,41,0,555,236,791,5,5,202036
11,12,202,38,216,259,17,54,9,795,414,1209,7,5,202036
11,13,151,15,67,109,18,24,15,399,196,595,7,5,202036
11,14,178,18,124,168,37,30,0,555,258,813,6,5,202036
11,15,206,16,131,174,12,48,23,610,407,1017,5,5,202036
12,1,115,8,74,68,15,25,0,305,194,499,5,5,202036
12,2,224,21,177,361,10,73,0,866,503,1369,8,5,202036
12,3,157,13,183,165,14,27,0,559,355,914,7,5,202036
12,4,301,24,278,402,36,69,2,1112,536,1648,8,5,202036
12,5,131,10,97,75,0,20,17,350,304,654,6,5,202036
12,6,121,15,95,86,17,9,13,356,330,686,7,5,202036
12,7,162,9,101,210,3,49,0,534,289,823,5,5,202036
12,8,159,7,88,72,0,16,0,342,323,665,6,5,202036
12,9,371,26,327,480,30,62,2,1298,1221,2519,8,5,202036
13,1,1,0,1,117,0,1,0,120,128,248,7,5,202036
13,2,1,0,0,174,0,0,0,175,103,278,4,5,202036
13,3,0,0,0,136,0,0,0,136,234,370,6,5,202036
13,4,2,0,2,358,0,1,0,363,288,651,6,5,202036
13,5,2,0,1,449,0,1,0,453,397,850,8,5,202036
13,6,1,0,1,781,0,1,0,784,463,1247,10,5,202036
13,7,1,0,3,301,0,1,0,306,325,631,7,5,202036
14,1,102,17,60,44,28,44,7,302,162,464,5,5,202036
14,2,137,13,92,66,26,38,3,375,248,623,4,5,202036
14,3,209,6,148,62,9,54,8,496,161,657,6,5,202036
14,4,260,21,318,331,21,95,11,1057,586,1643,8,5,202036
14,5,193,13,191,206,12,48,2,665,416,1081,9,5,202036
14,6,238,11,269,190,10,49,2,769,743,1512,7,5,202036
14,7,175,23,197,183,0,27,0,605,490,1095,6,5,202036
14,8,390,30,514,515,13,114,1,1577,929,2506,9,5,202036
14,9,201,9,161,293,14,51,10,739,455,1194,5,5,202036
14,10,177,11,212,140,11,67,3,621,470,1091,6,5,202036
14,11,131,11,164,141,28,57,12,544,325,869,4,5,202036
14,12,219,10,207,113,17,31,0,597,488,1085,8,5,202036
14,13,145,9,152,144,5,44,8,507,672,1179,5,5,202036
14,14,209,17,152,210,41,95,8,732,272,1004,5,5,202036
14,15,280,31,178,170,47,86,7,799,590,1389,8,5,202036
14,16,177,7,150,149,43,51,3,580,524,1104,5,5,202036
14,17,85,4,66,47,7,18,15,242,190,432,5,5,202036
14,18,192,26,170,119,69,51,25,652,254,906,7,5,202036
14,19,156,13,136,111,6,26,0,448,226,674,5,5,202036
14,20,300,15,299,224,8,50,0,896,798,1694,8,5,202036
15,1,150,8,80,84,63,20,1,406,293,699,5,5,202036
15,2,154,2,112,189,54,29,2,542,370,912,5,5,202036
15,3,155,5,108,139,112,47,19,585,307,892,9,5,202036
15,4,142,4,75,177,22,38,6,464,383,847,3,5,202036
15,5,141,17,154,172,10,28,5,527,268,795,5,5,202036
15,6,107,5,102,173,10,34,14,445,370,815,5,5,202036
15,7,192,7,250,153,76,57,9,744,565,1309,8,5,202036
15,8,126,11,134,248,14,25,11,569,375,944,3,5,202036
15,9,182,8,71,92,96,79,0,528,289,817,7,5,202036
15,10,187,3,121,243,15,44,6,619,128,747,6,5,202036
15,11,169,9,168,201,30,21,2,600,435,1035,5,5,202036
15,12,234,5,309,262,33,46,0,889,705,1594,7,5,202036
15,13,102,2,103,138,44,40,0,429,291,720,5,5,202036
15,14,117,9,75,158,19,31,4,413,196,609,4,5,202036
15,15,93,17,86,140,24,23,9,392,457,849,2,5,202036
15,16,319,29,264,544,19,93,22,1290,680,1970,8,5,202036
15,17,137,9,121,191,19,63,24,564,314,878,5,5,202036
15,18,226,9,219,255,30,64,16,819,416,1235,6,5,202036
15,19,330,17,317,619,16,96,9,1404,774,2178,8,5,202036
15,20,110,14,206,207,40,32,3,612,455,1067,5,5,202036
15,21,66,0,55,54,12,19,6,212,194,406,3,5,202036
15,22,255,60,300,501,18,59,21,1214,575,1789,7,5,202036
15,23,122,2,82,161,14,29,0,410,232,642,5,5,202036
15,24,122,8,88,146,21,24,4,413,116,529,3,5,202036
15,25,183,8,131,215,24,52,10,623,568,1191,4,5,202036
15,26,198,6,191,226,79,36,0,736,243,979,5,5,202036
15,27,239,12,244,283,24,97,27,926,377,1303,8,5,202036
15,28,168,7,321,176,17,28,9,726,307,1033,7,5,202036
15,29,237,16,212,391,6,93,33,988,697,1685,6,5,202036
15,30,354,37,311,395,62,78,11,1248,663,1911,12,5,202036
15,31,189,104,139,218,18,29,2,699,320,1019,4,5,202036
15,32,183,8,121,254,43,57,7,673,416,1089,7,5,202036
15,33,205,11,210,254,24,31,2,737,337,1074,6,5,202036
15,34,171,13,117,299,18,37,2,657,498,1155,6,5,202036
15,35,212,7,134,261,2,62,6,684,463,1147,7,5,202036
15,36,224,8,158,242,3,65,1,701,471,1172,7,5,202036
15,37,206,20,200,346,88,64,5,929,771,1700,4,5,202036
15,38,131,27,94,172,28,29,6,487,471,958,4,5,202036
15,39,124,13,83,140,18,28,1,407,304,711,4,5,202036
15,40,371,29,189,349,103,94,8,1143,455,1598,9,5,202036
15,41,304,19,355,356,39,57,11,1141,340,1481,11,5,202036
16,1,99,5,137,88,2,12,0,343,268,611,5,5,202036
16,2,110,5,114,95,11,23,0,358,365,723,6,5,202036
16,3,229,11,125,225,31,55,1,677,496,1173,7,5,202036
16,4,170,17,131,111,30,27,0,486,263,749,7,5,202036
16,5,156,11,92,156,24,46,19,504,412,916,5,5,202036
16,6,207,28,132,157,41,36,1,602,352,954,10,5,202036
16,7,330,36,207,314,22,51,1,961,489,1450,7,5,202036
16,8,369,19,421,481,9,61,6,1366,903,2269,11,5,202036
16,9,276,14,233,284,8,59,8,882,407,1289,9,5,202036
16,10,157,15,212,205,8,34,0,631,321,952,5,5,202036
16,11,194,14,128,113,31,55,0,535,279,814,9,5,202036
16,12,105,5,114,83,2,38,1,348,189,537,5,5,202036
17,1,116,1,115,137,10,20,4,403,473,876,4,5,202036
17,2,208,4,185,264,7,47,5,720,437,1157,8,5,202036
17,3,161,8,175,190,11,45,0,590,255,845,6,5,202036
17,4,249,11,258,347,27,50,8,950,541,1491,9,5,202036
17,5,70,3,58,96,7,15,0,249,122,371,4,5,202036
18,1,48,3,38,27,6,16,5,143,67,210,4,5,202036
18,2,293,20,183,249,42,94,0,881,216,1097,9,5,202036
18,3,143,10,176,87,6,16,0,438,118,556,6,5,202036
19,1,227,9,258,297,21,117,39,968,628,1596,8,5,202036
19,2,211,11,213,183,10,43,3,674,400,1074,6,5,202036
19,3,257,13,224,213,27,73,1,808,580,1388,7,5,202036
19,4,229,10,150,148,65,96,51,749,210,959,5,5,202036
19,5,331,37,258,338,11,111,24,1110,1195,2305,8,5,202036
19,6,148,10,194,333,4,107,1,797,492,1289,5,5,202036
19,7,242,2,274,205,2,56,3,784,514,1298,8,5,202036
19,8,195,8,192,220,6,44,0,665,330,995,6,5,202036
19,9,92,8,98,60,10,30,2,300,199,499,5,5,202036
19,10,135,3,123,159,3,77,16,516,364,880,5,5,202036
19,11,462,33,394,591,8,215,52,1755,1337,3092,12,5,202036
19,12,271,8,325,136,8,35,4,787,503,1290,10,5,202036
20,1,112,11,89,103,34,16,19,384,232,616,4,5,202036
20,2,64,2,45,70,20,4,0,205,187,392,4,5,202036
20,3,90,2,47,61,26,19,13,258,217,475,4,5,202036
20,4,77,2,70,58,16,26,8,257,166,423,4,5,202036
20,5,115,4,103,143,19,12,1,397,206,603,6,5,202036
20,6,119,2,67,68,26,5,14,301,261,562,5,5,202036
20,7,129,4,107,130,4,18,0,392,213,605,4,5,202036
20,8,400,35,383,526,74,115,17,1550,1940,3490,14,5,202036
20,9,254,6,111,107,102,41,12,633,346,979,7,5,202036
20,10,108,2,88,57,10,17,0,282,209,491,5,5,202036
21,1,226,8,191,166,36,35,0,662,558,1220,7,5,202036
21,2,115,6,76,58,19,24,1,299,203,502,6,5,202036
21,3,256,3,129,119,35,69,8,619,447,1066,7,5,202036
21,4,61,1,24,34,15,18,4,157,72,229,4,5,202036
21,5,310,13,228,144,26,41,5,767,412,1179,7,5,202036
21,6,156,3,129,194,35,46,7,570,438,1008,5,5,202036
21,7,214,7,96,152,33,75,2,579,269,848,8,5,202036
21,8,115,3,71,81,14,22,12,318,254,572,7,5,202036
21,9,273,10,320,297,71,86,15,1072,544,1616,8,5,202036
21,10,117,3,128,131,11,54,11,455,449,904,4,5,202036
21,11,89,7,129,131,16,19,0,391,371,762,3,5,202036
21,12,258,10,277,298,70,69,114,1096,670,1766,8,5,202036
21,13,132,7,105,100,23,48,6,421,279,700,6,5,202036
21,14,93,2,49,51,29,19,17,260,206,466,5,5,202036
21,15,163,4,142,164,16,44,18,551,454,1005,5,5,202036
22,1,182,15,103,154,10,20,1,485,334,819,7,5,202036
22,2,183,17,189,152,60,13,1,615,326,941,6,5,202036
22,3,293,29,393,366,11,54,0,1146,845,1991,8,5,202036
22,4,221,27,390,391,20,62,4,1115,903,2018,8,5,202036
22,5,215,8,363,201,39,51,36,913,505,1418,8,5,202036
23,1,204,3,385,127,14,34,8,775,122,897,10,5,202036
23,2,183,5,227,166,9,23,0,613,443,1056,7,5,202036
23,3,388,8,574,398,20,49,6,1443,309,1752,16,5,202036
23,4,130,5,188,131,29,35,25,543,208,751,5,5,202036
24,1,89,17,70,103,2,38,0,319,293,612,6,5,202036
24,2,119,9,91,100,12,28,5,364,152,516,5,5,202036
24,3,130,20,90,108,42,21,0,411,229,640,6,5,202036
24,4,141,13,84,93,7,32,15,385,170,555,4,5,202036
24,5,376,35,376,466,12,61,0,1326,871,2197,9,5,202036
24,6,156,36,197,247,20,42,1,699,325,1024,3,5,202036
24,7,88,4,41,73,16,5,0,227,181,408,6,5,202036
25,1,298,11,244,278,17,64,42,954,383,1337,11,5,202036
25,2,199,19,186,251,24,45,0,724,313,1037,4,5,202036
25,3,252,7,153,271,41,81,9,814,750,1564,8,5,202036
25,4,173,8,113,242,53,28,1,618,432,1050,6,5,202036
25,5,285,10,234,335,22,80,9,975,519,1494,7,5,202036
25,6,188,4,150,209,18,68,16,653,415,1068,6,5,202036
25,7,254,7,255,288,0,32,0,836,490,1326,5,5,202036
26,1,186,4,155,172,2,51,0,570,288,858,8,5,202036
26,2,198,3,164,232,2,49,1,649,559,1208,6,5,202036
26,3,313,9,214,332,12,111,14,1005,746,1751,10,5,202036
26,4,80,2,67,89,5,8,3,254,204,458,6,5,202036
26,5,161,8,118,158,7,74,0,526,378,904,8,5,202036
26,6,71,6,88,141,6,63,5,380,290,670,7,5,202036
26,7,138,5,112,200,35,30,2,522,342,864,8,5,202036
27,1,285,7,120,158,21,42,5,638,479,1117,6,5,202036
27,2,334,11,148,348,14,41,11,907,444,1351,7,5,202036
27,3,266,5,109,257,1,39,1,678,498,1176,5,5,202036
27,4,323,10,170,427,22,58,2,1012,803,1815,7,5,202036
27,5,93,1,49,98,5,15,1,262,120,382,4,5,202036
27,6,236,9,113,339,9,25,0,731,595,1326,6,5,202036
28,1,367,21,352,337,7,52,0,1136,757,1893,7,5,202036
28,2,348,18,310,210,29,88,127,1130,565,1695,11,5,202036
28,3,62,4,42,79,10,21,12,230,112,342,5,5,202036
28,4,434,27,310,299,69,126,73,1338,691,2029,14,5,202036
28,5,154,7,116,175,6,53,4,515,275,790,7,5,202036
28,6,112,7,98,105,15,33,11,381,495,876,9,5,202036
28,7,199,8,201,179,31,64,37,719,496,1215,9,5,202036
28,8,208,4,138,228,32,68,27,705,376,1081,12,5,202036
28,9,203,13,206,151,11,60,24,668,334,1002,8,5,202036
29,1,258,20,169,205,27,56,0,735,86,821,8,5,202036
29,2,250,9,120,246,13,53,36,727,397,1124,7,5,202036
29,3,155,6,55,107,9,30,0,362,114,476,5,5,202036
30,1,99,4,78,90,12,24,16,323,313,636,5,5,202036
30,2,104,2,41,36,11,20,18,232,227,459,7,5,202036
30,3,205,4,128,95,63,44,26,565,191,756,5,5,202036
30,4,236,7,230,172,37,52,0,734,255,989,8,5,202036
30,5,235,6,199,198,16,37,2,693,631,1324,6,5,202036
30,6,197,3,121,118,18,24,1,482,340,822,7,5,202036
30,7,169,2,67,94,18,27,32,409,219,628,8,5,202036
30,8,183,5,199,122,52,34,1,596,453,1049,8,5,202036
30,9,196,4,110,121,43,52,27,553,345,898,6,5,202036
30,10,261,8,302,177,24,69,15,856,502,1358,6,5,202036
30,11,129,5,114,113,3,16,0,380,401,781,4,5,202036
30,12,273,3,312,266,8,75,1,938,468,1406,10,5,202036
30,13,209,7,81,121,20,40,27,505,542,1047,7,5,202036
30,14,188,8,178,139,23,28,10,574,181,755,6,5,202036
30,15,298,4,169,181,41,85,44,822,834,1656,10,5,202036
30,16,273,6,162,252,31,67,77,868,638,1506,8,5,202036
30,17,200,10,134,153,23,71,14,605,506,1111,6,5,202036
30,18,80,10,38,53,5,23,3,212,223,435,5,5,202036
30,19,219,7,205,160,18,60,0,669,546,1215,9,5,202036
30,20,174,6,78,160,43,35,0,496,503,999,7,5,202036
31,1,162,5,162,31,87,24,0,471,269,740,6,5,202036
31,2,36,0,27,11,36,13,0,123,73,196,4,5,202036
31,3,428,24,530,358,78,52,0,1470,464,1934,16,5,202036
31,4,146,2,127,93,59,35,17,479,208,687,4,5,202036
31,5,107,3,77,71,13,24,0,295,165,460,4,5,202036
32,1,155,9,65,89,8,34,36,396,226,622,8,5,202036
32,2,84,9,52,54,18,20,15,252,203,455,7,5,202036
32,3,209,20,177,224,3,82,15,730,516,1246,10,5,202036
32,4,186,13,119,194,8,57,6,583,320,903,8,5,202036
1,1,265,30,194,203,14,52,7,765,609,1374,11,5,202038
1,2,342,32,350,304,29,88,9,1154,756,1910,12,5,202038
1,3,316,44,395,367,35,94,44,1295,976,2271,12,5,202038
2,1,166,5,123,156,13,78,27,568,503,1071,6,5,202038
2,2,117,2,80,164,3,33,0,399,582,981,4,5,202038
2,3,244,12,242,221,3,120,24,866,405,1271,8,5,202038
2,4,207,6,241,129,38,32,18,671,409,1080,7,5,202038
2,5,170,8,262,165,79,62,13,759,537,1296,5,5,202038
2,6,134,5,154,176,22,83,37,611,383,994,6,5,202038
2,7,226,8,202,167,18,71,24,716,588,1304,8,5,202038
2,8,118,4,133,128,3,32,27,445,239,684,3,5,202038
3,1,193,8,236,224,24,79,13,777,777,1554,8,5,202038
3,2,172,3,267,101,22,32,9,606,593,1199,7,5,202038
4,1,233,12,105,185,25,38,17,615,442,1057,6,5,202038
4,2,147,1,71,122,5,34,17,397,265,662,7,5,202038
5,1,0,0,0,323,0,0,0,323,450,773,6,5,202038
5,2,0,0,0,109,0,0,0,109,93,202,5,5,202038
5,3,0,0,0,263,0,0,0,263,322,585,6,5,202038
5,4,4,0,1,742,0,3,1,751,654,1405,6,5,202038
5,5,2,0,2,772,0,1,0,777,545,1322,10,5,202038
5,6,0,0,1,276,0,0,0,277,316,593,3,5,202038
5,7,0,0,0,270,0,0,0,270,226,496,5,5,202038
6,1,257,9,238,167,9,47,33,760,341,1101,9,5,202038
6,2,195,9,138,106,32,28,11,519,220,739,7,5,202038
7,1,118,5,55,48,8,16,2,252,181,433,6,5,202038
7,2,158,2,49,143,6,10,0,368,374,742,6,5,202038
7,3,86,0,73,25,36,6,0,226,59,285,5,5,202038
7,4,159,5,81,118,8,16,2,389,374,763,7,5,202038
7,5,257,8,90,236,15,15,0,621,415,1036,8,5,202038
7,6,176,9,138,159,11,43,3,539,503,1042,6,5,202038
7,7,260,5,167,168,42,40,5,687,475,1162,6,5,202038
7,8,107,4,58,69,28,24,11,301,332,633,7,5,202038
7,9,249,8,150,237,24,40,3,711,508,1219,8,5,202038
7,10,181,2,98,116,7,19,0,423,568,991,6,5,202038
7,11,73,1,96,22,23,4,0,219,120,339,4,5,202038
7,12,222,2,136,262,5,18,3,648,470,1118,6,5,202038
7,13,101,7,63,79,0,9,0,259,246,505,6,5,202038
8,1,100,6,80,49,1,12,0,248,391,639,4,5,202038
8,2,435,44,354,333,15,36,0,1217,688,1905,11,5,202038
8,3,192,17,156,217,14,26,8,630,385,1015,4,5,202038
8,4,450,32,410,391,40,115,58,1496,910,2406,8,5,202038
8,5,110,8,92,158,7,19,0,394,336,730,6,5,202038
8,6,282,22,190,285,25,51,13,868,794,1662,5,5,202038
8,7,94,2,81,94,4,21,0,296,285,581,5,5,202038
8,8,315,21,272,401,8,87,0,1104,817,1921,7,5,202038
8,9,85,5,90,66,27,15,31,319,236,555,6,5,202038
9,1,80,8,87,138,44,19,7,383,220,603,4,5,202038
9,2,347,18,382,526,104,117,2,1496,795,2291,10,5,202038
9,3,88,1,133,230,30,28,19,529,382,911,4,5,202038
9,4,264,12,203,331,34,70,10,924,686,1610,7,5,202038
9,5,214,7,190,281,38,70,1,801,706,1507,7,5,202038
9,6,165,21,151,193,74,42,24,670,322,992,7,5,202038
9,7,148,6,250,221,4,28,1,658,457,1115,6,5,202038
9,8,81,3,120,167,12,23,1,407,245,652,3,5,202038
9,9,137,5,81,161,32,32,6,454,392,846,3,5,202038
9,10,79,14,172,159,17,33,10,484,250,734,3,5,202038
9,11,233,8,248,368,63,86,16,1022,406,1428,7,5,202038
9,12,168,30,258,354,19,73,23,925,626,1551,7,5,202038
9,13,93,8,140,172,35,33,8,489,539,1028,3,5,202038
9,14,149,6,162,227,52,58,24,678,403,1081,5,5,202038
9,15,158,11,349,292,28,80,33,951,1018,1969,6,5,202038
9,16,286,82,256,442,66,50,1,1183,704,1887,11,5,202038
9,17,147,11,254,195,19,58,5,689,532,1221,6,5,202038
9,18,193,8,174,280,77,70,17,819,745,1564,8,5,202038
9,19,104,19,121,139,53,40,2,478,416,894,3,5,202038
9,20,79,4,94,94,27,10,8,316,385,701,3,5,202038
9,21,118,1,111,138,22,23,2,415,253,668,3,5,202038
9,22,179,11,98,188,37,31,9,553,267,820,2,5,202038
9,23,177,10,257,311,48,32,9,844,544,1388,6,5,202038
9,24,343,20,350,578,118,130,15,1554,1041,2595,11,5,202038
10,1,190,9,114,203,8,59,27,610,415,1025,11,5,202038
10,2,140,15,96,181,4,37,4,477,322,799,5,5,202038
10,3,136,8,96,140,26,43,12,461,445,906,9,5,202038
10,4,381,12,193,329,12,24,7,958,1048,2006,11,5,202038
11,1,173,35,83,103,8,28,0,430,354,784,6,5,202038
11,2,221,16,131,133,46,46,11,604,460,1064,7,5,202038
11,3,105,22,81,121,23,39,4,395,338,733,3,5,202038
11,4,195,31,121,137,35,59,1,579,359,938,5,5,202038
11,5,351,72,326,425,27,88,26,1315,572,1887,7,5,202038
11,6,211,26,155,203,23,71,7,696,673,1369,8,5,202038
11,7,284,25,251,294,31,55,5,945,845,1790,7,5,202038
11,8,325,51,261,407,63,90,20,1217,939,2156,9,5,202038
11,9,291,33,186,303,8,57,10,888,606,1494,8,5,202038
11,10,222,40,197,204,24,72,25,784,333,1117,9,5,202038
11,11,163,19,146,184,8,44,0,564,336,900,5,5,202038
11,12,233,44,220,276,15,41,5,834,465,1299,7,5,202038
11,13,131,19,93,115,16,23,20,417,254,671,7,5,202038
11,14,155,30,142,131,32,28,0,518,417,935,6,5,202038
11,15,203,18,160,215,9,68,13,686,420,1106,6,5,202038
12,1,99,8,64,79,18,33,1,302,273,575,5,5,202038
12,2,271,16,202,303,15,50,0,857,649,1506,8,5,202038
12,3,156,11,221,186,7,32,1,614,532,1146,7,5,202038
12,4,256,27,268,396,32,59,2,1040,1162,2202,8,5,202038
12,5,143,23,126,108,2,12,30,444,310,754,7,5,202038
12,6,159,12,102,112,25,12,9,431,357,788,7,5,202038
12,7,171,8,84,177,5,44,4,493,392,885,5,5,202038
12,8,137,3,76,92,15,0,0,323,327,650,6,5,202038
12,9,385,21,327,508,34,61,3,1339,1220,2559,8,5,202038
13,1,1,0,1,121,0,0,0,123,113,236,7,5,202038
13,2,0,1,0,157,0,0,0,158,127,285,3,5,202038
13,3,0,0,1,187,0,0,0,188,136,324,6,5,202038
13,4,0,1,1,350,0,0,0,352,323,675,7,5,202038
13,5,4,0,12,0,0,1,0,17,419,436,7,5,202038
13,6,0,0,1,310,0,1,0,312,892,1204,10,5,202038
13,7,1,0,6,314,0,0,0,321,390,711,6,5,202038
14,1,84,22,49,38,38,28,3,262,240,502,5,5,202038
14,2,129,5,78,61,25,44,0,342,362,704,4,5,202038
14,3,176,12,184,54,8,47,4,485,260,745,7,5,202038
14,4,283,15,369,270,20,77,9,1043,742,1785,8,5,202038
14,5,169,14,229,177,19,41,2,651,524,1175,9,5,202038
14,6,257,12,341,166,11,42,2,831,763,1594,6,5,202038
14,7,175,9,225,157,0,21,0,587,547,1134,6,5,202038
14,8,332,30,574,540,16,112,3,1607,1368,2975,9,5,202038
14,9,198,12,181,252,15,38,15,711,592,1303,5,5,202038
14,10,188,19,200,127,19,67,9,629,570,1199,6,5,202038
14,11,161,9,154,191,24,47,10,596,437,1033,4,5,202038
14,12,259,6,223,93,23,18,1,623,536,1159,8,5,202038
14,13,151,11,187,144,2,40,6,541,671,1212,5,5,202038
14,14,213,7,173,191,34,76,20,714,437,1151,5,5,202038
14,15,289,33,211,150,59,99,13,854,762,1616,8,5,202038
14,16,170,14,173,135,35,46,6,579,559,1138,5,5,202038
14,17,71,12,65,46,12,19,10,235,256,491,5,5,202038
14,18,223,29,182,105,57,52,22,670,442,1112,7,5,202038
14,19,129,15,133,91,10,28,1,407,357,764,5,5,202038
14,20,262,25,324,245,5,32,2,895,1124,2019,8,5,202038
15,1,136,5,82,104,110,19,2,458,355,813,5,5,202038
15,2,136,10,134,189,47,27,11,554,488,1042,5,5,202038
15,3,172,4,137,167,184,43,23,730,362,1092,9,5,202038
15,4,113,6,97,176,26,28,8,454,481,935,3,5,202038
15,5,169,23,130,180,14,18,4,538,364,902,5,5,202038
15,6,108,6,106,202,14,42,8,486,400,886,5,5,202038
15,7,201,16,213,205,68,66,11,780,668,1448,8,5,202038
15,8,124,11,139,252,15,24,15,580,501,1081,3,5,202038
15,9,190,5,58,74,100,79,2,508,447,955,7,5,202038
15,10,187,11,118,238,16,46,6,622,193,815,6,5,202038
15,11,177,9,152,223,26,29,1,617,487,1104,5,5,202038
15,12,292,6,320,346,32,56,3,1055,719,1774,7,5,202038
15,13,104,7,99,141,67,32,0,450,318,768,5,5,202038
15,14,98,8,117,169,24,46,7,469,236,705,4,5,202038
15,15,87,29,80,147,20,20,17,400,485,885,2,5,202038
15,16,331,25,239,498,19,83,32,1227,841,2068,8,5,202038
15,17,160,7,104,186,19,57,17,550,389,939,5,5,202038
15,18,242,15,224,255,39,62,20,857,652,1509,6,5,202038
15,19,349,30,295,583,13,102,7,1379,1234,2613,8,5,202038
15,20,131,15,222,223,21,31,6,649,545,1194,5,5,202038
15,21,83,4,45,71,21,26,6,256,261,517,3,5,202038
15,22,274,67,276,499,22,79,18,1235,776,2011,7,5,202038
15,23,116,6,46,171,15,31,0,385,541,926,5,5,202038
15,24,127,17,98,144,21,19,8,434,184,618,3,5,202038
15,25,214,22,141,176,26,72,6,657,567,1224,4,5,202038
15,26,206,2,177,239,100,52,9,785,421,1206,5,5,202038
15,27,239,17,226,279,15,85,55,916,684,1600,8,5,202038
15,28,223,22,306,195,18,33,9,806,450,1256,7,5,202038
15,29,258,4,206,329,1,78,0,876,721,1597,6,5,202038
15,30,372,35,303,404,51,75,20,1260,923,2183,12,5,202038
15,31,159,113,166,260,14,40,0,752,437,1189,4,5,202038
15,32,239,6,111,219,39,49,9,672,603,1275,7,5,202038
15,33,246,12,183,253,31,22,0,747,494,1241,6,5,202038
15,34,172,7,149,258,26,24,11,647,526,1173,6,5,202038
15,35,243,8,112,273,9,54,5,704,730,1434,7,5,202038
15,36,227,6,131,325,1,72,0,762,591,1353,7,5,202038
15,37,247,15,218,422,80,72,10,1064,923,1987,4,5,202038
15,38,117,18,125,158,37,21,5,481,494,975,4,5,202038
15,39,88,33,79,120,18,22,1,361,486,847,4,5,202038
15,40,353,31,204,374,93,66,2,1123,757,1880,9,5,202038
15,41,379,16,291,347,50,48,23,1154,570,1724,11,5,202038
16,1,107,10,190,80,1,7,0,395,341,736,5,5,202038
16,2,105,13,124,134,15,24,0,415,339,754,6,5,202038
16,3,201,6,153,213,18,48,1,640,477,1117,7,5,202038
16,4,125,7,133,83,32,29,0,409,451,860,7,5,202038
16,5,182,15,100,143,39,28,8,515,415,930,6,5,202038
16,6,197,35,111,155,47,38,0,583,528,1111,10,5,202038
16,7,297,46,250,319,31,45,0,988,777,1765,7,5,202038
16,8,358,16,465,461,9,65,10,1384,1209,2593,12,5,202038
16,9,251,23,209,262,7,60,10,822,729,1551,9,5,202038
16,10,146,15,219,259,6,42,0,687,467,1154,5,5,202038
16,11,174,8,120,127,48,46,0,523,355,878,9,5,202038
16,12,112,17,134,109,1,39,0,412,290,702,5,5,202038
17,1,137,7,139,172,15,17,7,494,468,962,4,5,202038
17,2,230,9,225,328,4,51,2,849,592,1441,8,5,202038
17,3,197,14,215,215,9,44,0,694,347,1041,6,5,202038
17,4,287,7,288,414,29,52,3,1080,722,1802,9,5,202038
17,5,71,5,80,68,13,20,0,257,141,398,4,5,202038
18,1,52,6,34,34,3,8,11,148,121,269,5,5,202038
18,2,249,15,180,216,27,88,3,778,343,1121,8,5,202038
18,3,105,8,159,108,2,24,0,406,168,574,6,5,202038
19,1,258,25,337,313,18,129,74,1154,750,1904,8,5,202038
19,2,227,8,229,189,14,53,5,725,448,1173,5,5,202038
19,3,286,11,249,199,35,67,3,850,624,1474,7,5,202038
19,4,218,7,151,140,69,89,53,727,327,1054,5,5,202038
19,5,330,25,327,406,18,123,37,1266,1198,2464,8,5,202038
19,6,172,8,254,374,8,114,18,948,596,1544,5,5,202038
19,7,239,8,343,233,4,49,0,876,835,1711,8,5,202038
19,8,218,5,199,233,4,51,0,710,356,1066,6,5,202038
19,9,99,6,71,62,15,40,11,304,359,663,5,5,202038
19,10,145,7,130,144,3,60,18,507,384,891,5,5,202038
19,11,424,18,361,593,11,184,59,1650,1761,3411,12,5,202038
19,12,330,7,334,138,14,27,3,853,604,1457,10,5,202038
20,1,135,1,98,94,34,20,21,403,447,850,4,5,202038
20,2,47,4,43,57,19,4,0,174,247,421,4,5,202038
20,3,72,1,61,54,16,14,5,223,187,410,4,5,202038
20,4,79,1,57,30,15,27,13,222,234,456,4,5,202038
20,5,125,5,77,125,22,6,0,360,487,847,6,5,202038
20,6,128,0,57,69,25,13,13,305,325,630,5,5,202038
20,7,132,4,120,146,10,31,0,443,491,934,4,5,202038
20,8,482,13,434,525,46,114,31,1645,1766,3411,13,5,202038
20,9,249,4,129,114,70,41,18,625,534,1159,7,5,202038
20,10,111,2,95,47,3,9,0,267,270,537,5,5,202038
21,1,263,7,221,180,35,27,1,734,612,1346,7,5,202038
21,2,116,7,61,56,27,13,0,280,211,491,4,5,202038
21,3,230,3,177,172,39,51,9,681,526,1207,7,5,202038
21,4,52,3,21,31,15,14,8,144,141,285,4,5,202038
21,5,216,8,220,162,31,36,6,679,594,1273,7,5,202038
21,6,201,7,123,182,38,43,11,605,455,1060,5,5,202038
21,7,232,9,128,172,37,63,2,643,392,1035,8,5,202038
21,8,126,6,51,77,11,21,12,304,242,546,7,5,202038
21,9,295,17,283,275,53,72,22,1017,677,1694,8,5,202038
21,10,134,3,109,133,8,59,16,462,471,933,4,5,202038
21,11,143,1,146,166,25,23,5,509,407,916,3,5,202038
21,12,367,15,316,296,69,64,129,1256,736,1992,5,5,202038
21,13,126,2,122,106,23,38,0,417,206,623,6,5,202038
21,14,67,2,29,42,28,30,10,208,225,433,6,5,202038
21,15,196,1,141,162,11,43,15,569,495,1064,5,5,202038
22,1,154,28,119,156,14,23,0,494,485,979,7,5,202038
22,2,181,21,222,152,59,31,1,667,499,1166,6,5,202038
22,3,318,21,354,328,4,42,1,1068,1064,2132,8,5,202038
22,4,289,30,404,381,14,65,8,1191,1024,2215,7,5,202038
22,5,201,19,386,230,37,67,26,966,753,1719,8,5,202038
23,1,203,3,347,119,17,28,10,727,227,954,10,5,202038
23,2,170,6,234,162,6,13,1,592,611,1203,7,5,202038
23,3,345,13,516,361,30,34,9,1308,523,1831,14,5,202038
23,4,105,3,203,135,23,31,30,530,327,857,4,5,202038
24,1,114,5,46,104,11,20,2,302,380,682,6,5,202038
24,2,137,5,107,133,19,33,7,441,257,698,5,5,202038
24,3,114,17,79,77,41,26,2,356,314,670,6,5,202038
24,4,147,5,56,69,14,33,27,351,219,570,4,5,202038
24,5,351,40,412,432,11,46,0,1292,1165,2457,9,5,202038
24,6,150,26,168,168,27,37,1,577,638,1215,3,5,202038
24,7,78,10,52,71,11,9,0,231,234,465,5,5,202038
25,1,213,9,226,281,21,57,43,850,592,1442,11,5,202038
25,2,224,20,177,233,15,34,3,706,554,1260,4,5,202038
25,3,248,7,202,310,27,47,9,850,856,1706,8,5,202038
25,4,155,8,92,235,48,31,1,570,631,1201,6,5,202038
25,5,271,7,236,329,20,65,8,936,722,1658,7,5,202038
25,6,207,5,199,209,26,49,24,719,583,1302,6,5,202038
25,7,250,13,286,289,2,19,0,859,702,1561,5,5,202038
26,1,240,6,246,204,7,58,0,761,567,1328,8,5,202038
26,2,204,5,197,216,0,38,21,681,798,1479,6,5,202038
26,3,341,9,235,267,17,119,30,1018,946,1964,9,5,202038
26,4,71,4,59,76,5,17,10,242,256,498,6,5,202038
26,5,170,4,117,156,12,52,3,514,681,1195,8,5,202038
26,6,105,2,92,137,7,47,0,390,335,725,7,5,202038
26,7,174,7,120,167,37,19,1,525,489,1014,8,5,202038
27,1,262,6,111,190,24,39,5,637,580,1217,6,5,202038
27,2,349,9,152,369,12,39,3,933,774,1707,7,5,202038
27,3,283,4,109,325,8,49,0,778,690,1468,5,5,202038
27,4,284,7,169,353,22,64,7,906,892,1798,6,5,202038
27,5,116,0,54,97,1,15,2,285,198,483,4,5,202038
27,6,238,6,126,351,4,33,0,758,563,1321,6,5,202038
28,1,293,18,397,348,8,46,0,1110,1077,2187,8,5,202038
28,2,306,29,281,221,21,69,133,1060,915,1975,11,5,202038
28,3,57,5,41,87,11,22,20,243,208,451,5,5,202038
28,4,381,26,265,212,64,83,42,1073,945,2018,14,5,202038
28,5,176,3,114,224,9,41,10,577,348,925,7,5,202038
28,6,78,3,69,121,21,20,12,324,344,668,9,4,202038
28,7,196,10,145,164,50,57,42,664,655,1319,9,5,202038
28,8,188,5,167,222,30,57,33,702,486,1188,12,5,202038
28,9,217,8,195,128,23,43,15,629,712,1341,6,5,202038
29,1,270,17,187,254,23,42,4,797,395,1192,8,5,202038
29,2,251,5,140,247,12,61,46,762,566,1328,8,5,202038
29,3,146,4,69,150,4,24,0,397,201,598,5,5,202038
30,1,97,7,82,91,11,14,11,313,316,629,5,5,202038
30,2,137,8,90,64,15,10,41,365,254,619,7,5,202038
30,3,198,6,129,99,71,44,27,574,654,1228,5,5,202038
30,4,232,7,240,154,45,45,0,723,249,972,8,5,202038
30,5,220,9,226,181,24,40,1,701,694,1395,6,5,202038
30,6,153,8,143,94,18,19,7,442,253,695,7,5,202038
30,7,155,3,65,90,20,17,35,385,102,487,8,5,202038
30,8,203,7,218,126,45,21,3,623,533,1156,8,5,202038
30,9,228,3,135,127,25,34,25,577,470,1047,6,5,202038
30,10,277,9,271,202,19,55,32,865,773,1638,6,5,202038
30,11,143,2,139,130,2,17,1,434,329,763,4,5,202038
30,12,277,7,320,249,12,56,2,923,314,1237,10,5,202038
30,13,194,6,73,113,37,47,26,496,536,1032,7,5,202038
30,14,182,6,156,102,23,28,5,502,213,715,5,5,202038
30,15,289,5,171,160,62,77,45,809,887,1696,10,5,202038
30,16,271,5,166,217,41,46,78,824,1134,1958,8,5,202038
30,17,228,8,137,165,26,45,22,631,541,1172,6,5,202038
30,18,82,7,35,49,7,20,7,207,230,437,5,5,202038
30,19,172,7,219,166,15,35,0,614,416,1030,9,5,202038
30,20,170,3,86,154,38,34,0,485,703,1188,7,5,202038
31,1,150,4,139,47,90,16,0,446,358,804,6,5,202038
31,2,45,1,61,6,33,13,0,159,66,225,4,5,202038
31,3,465,31,477,259,64,39,0,1335,752,2087,16,5,202038
31,4,139,2,121,95,76,42,27,502,276,778,4,5,202038
31,5,102,3,84,57,5,18,0,269,219,488,4,5,202038
32,1,124,18,61,78,14,34,20,349,294,643,8,5,202038
32,2,74,7,50,36,19,33,18,237,299,536,8,5,202038
32,3,206,35,148,229,8,56,11,693,734,1427,9,5,202038
32,4,203,13,155,178,8,42,2,601,513,1114,8,5,202038
1,1,196,27,156,148,15,18,5,565,679,1244,11,4,202039
1,2,264,16,254,236,38,47,8,863,878,1741,12,4,202039
1,3,252,33,304,259,21,61,39,969,905,1874,12,4,202039
2,1,169,2,116,141,7,86,10,531,469,1000,8,4,202039
2,2,92,1,67,155,0,19,0,334,376,710,5,4,202039
2,3,229,13,167,154,5,69,16,653,410,1063,8,4,202039
2,4,215,6,186,107,26,30,10,580,378,958,7,4,202039
2,5,164,5,205,121,35,39,14,583,474,1057,7,4,202039
2,6,100,7,128,104,11,64,21,435,329,764,7,4,202039
2,7,178,8,161,120,10,47,28,552,478,1030,8,4,202039
2,8,86,3,79,91,8,17,12,296,237,533,4,4,202039
3,1,200,14,171,173,17,27,7,609,768,1377,8,4,202039
3,2,163,7,219,113,13,17,1,533,580,1113,7,4,202039
4,1,176,6,107,133,17,38,6,483,337,820,5,4,202039
4,2,89,4,73,105,1,11,29,312,248,560,6,4,202039
5,1,0,0,0,270,0,0,0,270,340,610,6,4,202039
5,2,0,0,0,85,0,0,0,85,102,187,3,4,202039
5,3,0,0,0,210,0,0,0,210,265,475,7,4,202039
5,4,1,0,2,541,0,2,0,546,631,1177,6,4,202039
5,5,1,0,2,593,0,1,1,598,753,1351,10,4,202039
5,6,0,0,0,210,0,0,0,210,204,414,3,4,202039
5,7,0,0,0,202,0,0,0,202,261,463,6,4,202039
6,1,172,12,152,117,4,40,21,518,467,985,9,4,202039
6,2,151,8,108,77,25,34,9,412,223,635,7,4,202039
7,1,95,1,49,35,3,11,0,194,166,360,5,4,202039
7,2,124,0,40,85,0,7,0,256,670,926,6,4,202039
7,3,84,2,39,34,27,5,1,192,148,340,5,4,202039
7,4,139,3,41,101,0,13,5,302,356,658,8,4,202039
7,5,171,1,56,175,8,12,0,423,598,1021,10,4,202039
7,6,145,5,109,113,4,31,12,419,465,884,6,4,202039
7,7,193,13,147,151,34,38,3,579,549,1128,6,4,202039
7,8,98,3,41,50,14,22,4,232,427,659,8,4,202039
7,9,190,6,142,167,19,40,1,565,515,1080,7,4,202039
7,10,137,2,68,81,2,12,0,302,453,755,7,4,202039
7,11,38,2,25,28,22,9,0,124,103,227,3,4,202039
7,12,174,2,114,170,3,15,2,480,480,960,5,4,202039
7,13,71,6,66,54,0,8,0,205,269,474,6,4,202039
8,1,98,2,80,38,0,4,0,222,406,628,4,4,202039
8,2,402,44,328,246,6,21,1,1048,939,1987,12,4,202039
8,3,165,11,146,143,10,23,17,515,613,1128,4,4,202039
8,4,360,23,353,324,46,78,60,1244,1207,2451,8,4,202039
8,5,111,5,70,128,5,27,0,346,354,700,6,4,202039
8,6,203,28,171,234,14,43,17,710,818,1528,5,4,202039
8,7,65,8,78,84,1,11,0,247,303,550,5,4,202039
8,8,238,16,234,365,8,48,0,909,812,1721,7,4,202039
8,9,61,3,58,54,21,15,27,239,239,478,7,4,202039
9,1,91,9,66,81,27,11,4,289,261,550,4,4,202039
9,2,307,14,270,432,66,77,5,1171,653,1824,10,4,202039
9,3,101,3,92,160,18,19,15,408,354,762,4,4,202039
9,4,176,12,152,261,36,34,37,708,847,1555,7,4,202039
9,5,181,2,146,246,35,47,4,661,529,1190,7,4,202039
9,6,123,5,117,153,43,24,29,494,304,798,7,4,202039
9,7,114,3,159,180,3,25,0,484,425,909,6,4,202039
9,8,37,5,99,128,8,23,4,304,236,540,3,4,202039
9,9,104,1,67,117,26,17,1,333,443,776,3,4,202039
9,10,82,5,108,118,8,40,8,369,230,599,3,4,202039
9,11,166,8,204,236,54,70,9,747,374,1121,7,4,202039
9,12,149,18,198,250,13,42,25,695,561,1256,7,4,202039
9,13,82,7,87,123,19,15,3,336,454,790,3,4,202039
9,14,137,1,115,166,42,30,27,518,306,824,5,4,202039
9,15,98,4,276,220,20,47,38,703,763,1466,6,4,202039
9,16,215,72,219,329,46,40,5,926,732,1658,11,4,202039
9,17,128,19,186,177,17,28,4,559,414,973,6,4,202039
9,18,150,6,144,184,53,51,4,592,509,1101,8,4,202039
9,19,95,10,64,114,38,17,2,340,367,707,3,4,202039
9,20,73,2,70,72,25,8,5,255,141,396,3,4,202039
9,21,86,5,74,108,24,13,8,318,268,586,3,4,202039
9,22,134,3,62,133,43,19,6,400,265,665,2,4,202039
9,23,148,6,182,233,36,43,4,652,477,1129,6,4,202039
9,24,254,3,277,376,97,66,11,1084,874,1958,11,4,202039
10,1,148,9,97,153,11,35,14,467,505,972,11,4,202039
10,2,103,5,76,120,2,19,3,328,413,741,6,4,202039
10,3,120,11,62,120,20,31,8,372,344,716,9,4,202039
10,4,309,15,164,239,2,3,1,733,996,1729,11,4,202039
11,1,136,17,77,86,8,18,1,343,313,656,6,4,202039
11,2,152,24,141,99,24,48,2,490,428,918,7,4,202039
11,3,82,20,58,75,12,20,9,276,357,633,3,4,202039
11,4,175,25,85,110,17,39,3,454,383,837,5,4,202039
11,5,243,74,236,318,18,55,22,966,797,1763,7,4,202039
11,6,134,22,126,144,15,34,20,495,709,1204,8,4,202039
11,7,243,21,202,199,32,31,1,729,879,1608,7,4,202039
11,8,270,29,202,272,35,65,15,888,948,1836,9,4,202039
11,9,232,28,168,252,12,46,16,754,592,1346,8,4,202039
11,10,173,21,133,147,16,50,27,567,429,996,8,4,202039
11,11,130,14,109,142,8,15,1,419,605,1024,5,4,202039
11,12,195,30,156,205,14,35,2,637,537,1174,7,4,202039
11,13,95,19,73,90,19,11,26,333,265,598,7,4,202039
11,14,138,20,95,99,25,14,0,391,446,837,6,4,202039
11,15,191,14,93,154,6,56,20,534,672,1206,6,4,202039
12,1,82,7,65,49,5,11,0,219,251,470,5,4,202039
12,2,191,22,119,255,13,27,0,627,770,1397,8,4,202039
12,3,120,9,187,125,7,22,0,470,506,976,7,4,202039
12,4,212,15,193,302,24,31,2,779,1117,1896,8,4,202039
12,5,113,14,92,67,4,9,27,326,305,631,6,4,202039
12,6,136,12,77,101,11,8,10,355,348,703,7,4,202039
12,7,118,5,71,136,4,22,4,360,362,722,5,4,202039
12,8,98,6,64,79,0,9,0,256,361,617,6,4,202039
12,9,306,19,268,388,38,56,2,1077,1185,2262,8,4,202039
13,1,0,0,0,110,0,0,0,110,76,186,6,4,202039
13,2,0,0,1,110,0,0,0,111,132,243,3,4,202039
13,3,0,0,0,150,0,0,0,150,144,294,6,4,202039
13,4,0,0,5,237,0,0,0,242,307,549,7,4,202039
13,5,3,0,2,301,1,0,0,307,383,690,8,4,202039
13,6,0,1,1,496,0,1,0,499,827,1326,10,4,202039
13,7,2,0,5,219,0,1,0,227,326,553,7,4,202039
14,1,70,13,53,37,23,17,1,214,260,474,5,4,202039
14,2,122,7,57,45,11,37,1,280,318,598,4,4,202039
14,3,147,2,110,48,3,36,3,349,302,651,6,4,202039
14,4,230,14,251,229,24,47,16,811,655,1466,8,4,202039
14,5,136,11,174,142,11,31,0,505,438,943,8,4,202039
14,6,199,16,258,125,6,35,4,643,830,1473,7,4,202039
14,7,138,6,159,113,0,17,0,433,448,881,6,4,202039
14,8,304,27,421,370,8,72,3,1205,1512,2717,9,4,202039
14,9,153,15,121,230,5,32,9,565,547,1112,5,4,202039
14,10,151,25,184,107,13,51,17,548,382,930,6,4,202039
14,11,119,9,86,107,14,49,9,393,598,991,4,4,202039
14,12,220,6,180,100,17,25,0,548,470,1018,8,4,202039
14,13,139,8,140,129,3,36,5,460,607,1067,5,4,202039
14,14,134,6,106,143,21,60,14,484,408,892,5,4,202039
14,15,235,22,146,169,43,57,12,684,741,1425,8,4,202039
14,16,178,8,135,95,32,32,2,482,445,927,5,4,202039
14,17,54,9,63,43,11,24,11,215,223,438,5,4,202039
14,18,169,8,148,73,49,32,18,497,596,1093,7,4,202039
14,19,103,13,125,75,5,14,1,336,342,678,5,4,202039
14,20,206,20,299,205,11,28,0,769,908,1677,8,4,202039
15,1,131,5,80,58,83,19,3,379,410,789,5,4,202039
15,2,136,7,104,139,48,18,6,458,564,1022,5,4,202039
15,3,156,7,100,127,94,34,29,547,455,1002,9,4,202039
15,4,123,6,63,133,29,14,3,371,415,786,3,4,202039
15,5,159,20,112,129,7,24,6,457,345,802,5,4,202039
15,6,98,3,79,112,16,17,10,335,387,722,5,4,202039
15,7,195,10,188,160,58,39,11,661,610,1271,8,4,202039
15,8,134,7,85,198,13,36,8,481,503,984,3,4,202039
15,9,158,3,40,72,61,58,2,394,482,876,7,4,202039
15,10,148,5,93,191,7,37,9,490,178,668,6,4,202039
15,11,141,13,130,159,22,26,1,492,506,998,5,4,202039
15,12,221,8,259,231,22,26,0,767,809,1576,7,4,202039
15,13,88,2,51,91,54,22,0,308,305,613,5,4,202039
15,14,113,5,83,154,11,27,7,400,221,621,4,4,202039
15,15,112,15,57,128,23,18,6,359,319,678,2,4,202039
15,16,228,19,159,325,11,45,15,802,795,1597,8,4,202039
15,17,116,8,93,143,23,38,23,444,361,805,5,4,202039
15,18,167,9,169,187,28,55,14,629,759,1388,6,4,202039
15,19,235,26,234,400,15,57,14,981,1357,2338,8,4,202039
15,20,102,5,183,164,24,29,3,510,442,952,5,4,202039
15,21,72,2,47,75,16,21,4,237,248,485,3,4,202039
15,22,221,54,199,357,18,35,23,907,756,1663,7,4,202039
15,23,102,2,81,96,5,18,0,304,375,679,5,4,202039
15,24,125,20,53,117,11,14,2,342,169,511,3,4,202039
15,25,189,5,109,163,23,23,20,532,509,1041,4,4,202039
15,26,179,3,125,189,64,28,9,597,484,1081,5,4,202039
15,27,178,10,189,244,19,48,39,727,731,1458,8,4,202039
15,28,200,9,208,141,22,24,6,610,618,1228,7,4,202039
15,29,238,8,179,287,7,64,37,820,765,1585,6,4,202039
15,30,282,25,229,274,55,48,25,938,815,1753,12,4,202039
15,31,147,75,130,223,14,15,1,605,382,987,4,4,202039
15,32,165,4,84,179,35,47,14,528,578,1106,7,4,202039
15,33,178,5,133,166,27,19,2,530,753,1283,6,4,202039
15,34,139,6,97,191,12,22,7,474,567,1041,6,4,202039
15,35,186,8,109,179,1,36,9,528,707,1235,7,4,202039
15,36,186,4,136,237,0,28,3,594,598,1192,7,4,202039
15,37,210,16,154,293,56,48,11,788,970,1758,4,4,202039
15,38,111,8,82,127,29,15,3,375,390,765,4,4,202039
15,39,175,20,87,155,21,26,0,484,461,945,4,4,202039
15,40,301,29,192,310,74,56,4,966,643,1609,9,4,202039
15,41,251,10,259,278,39,34,12,883,632,1515,11,4,202039
16,1,100,4,111,60,12,7,0,294,381,675,5,4,202039
16,2,129,9,97,111,11,17,1,375,348,723,6,4,202039
16,3,189,4,136,162,17,35,1,544,642,1186,7,4,202039
16,4,119,7,108,64,22,25,0,345,438,783,7,4,202039
16,5,124,10,95,118,19,27,21,414,426,840,6,4,202039
16,6,159,27,117,129,28,12,1,473,471,944,10,4,202039
16,7,268,32,178,236,26,38,0,778,856,1634,7,4,202039
16,8,256,20,358,345,8,27,9,1023,1274,2297,12,4,202039
16,9,185,16,167,210,10,59,13,660,699,1359,9,4,202039
16,10,135,7,189,152,4,29,1,517,524,1041,5,4,202039
16,11,137,12,97,93,32,14,1,386,367,753,9,4,202039
16,12,94,8,104,81,2,26,0,315,343,658,6,4,202039
17,1,108,6,141,182,5,17,5,464,303,767,4,4,202039
17,2,182,4,193,266,5,33,5,688,522,1210,8,4,202039
17,3,174,3,147,160,10,52,0,546,410,956,6,4,202039
17,4,260,10,250,253,8,36,5,822,694,1516,9,4,202039
17,5,67,3,48,69,11,11,0,209,121,330,4,4,202039
18,1,39,2,31,39,2,5,3,121,77,198,5,4,202039
18,2,202,11,136,195,31,61,1,637,372,1009,8,4,202039
18,3,110,5,108,74,5,8,3,313,134,447,6,4,202039
19,1,218,6,282,247,15,90,61,919,689,1608,8,4,202039
19,2,202,6,202,160,4,41,5,620,498,1118,5,4,202039
19,3,253,8,230,166,22,42,4,725,505,1230,7,4,202039
19,4,173,7,109,107,53,68,56,573,266,839,5,4,202039
19,5,298,22,281,298,15,93,28,1035,1103,2138,8,4,202039
19,6,132,7,185,283,8,92,28,735,707,1442,5,4,202039
19,7,188,6,259,188,3,51,1,696,744,1440,8,4,202039
19,8,148,8,169,204,6,26,1,562,538,1100,6,4,202039
19,9,88,6,60,42,10,32,16,254,296,550,5,4,202039
19,10,109,8,118,134,3,56,47,475,331,806,5,4,202039
19,11,361,16,287,443,13,123,36,1279,1576,2855,12,4,202039
19,12,241,7,271,101,9,21,2,652,497,1149,10,4,202039
20,1,127,6,75,73,20,21,18,340,350,690,4,4,202039
20,2,40,1,35,40,24,3,0,143,180,323,3,4,202039
20,3,66,5,47,47,22,20,9,216,247,463,4,4,202039
20,4,54,3,62,30,12,16,10,187,183,370,4,4,202039
20,5,110,3,70,79,18,8,0,288,391,679,6,4,202039
20,6,87,0,62,56,26,9,11,251,244,495,5,4,202039
20,7,124,6,85,100,9,11,0,335,362,697,4,4,202039
20,8,421,15,371,411,52,78,29,1377,1357,2734,14,4,202039
20,9,190,6,84,78,88,33,14,493,499,992,7,4,202039
20,10,81,1,75,44,5,13,1,220,225,445,5,4,202039
21,1,238,7,145,162,30,13,0,595,817,1412,7,4,202039
21,2,85,0,2,61,44,28,7,227,202,429,6,4,202039
21,3,193,3,130,121,41,44,3,535,532,1067,7,4,202039
21,4,49,2,25,22,10,10,1,119,120,239,3,4,202039
21,5,161,7,178,105,30,28,6,515,548,1063,7,4,202039
21,6,156,7,106,136,35,39,7,486,394,880,4,4,202039
21,7,213,8,91,132,51,42,3,540,340,880,8,4,202039
21,8,86,3,52,46,7,14,19,227,228,455,7,4,202039
21,9,233,7,263,245,39,52,19,858,522,1380,8,4,202039
21,10,109,5,90,100,10,38,15,367,379,746,4,4,202039
21,11,117,4,117,117,24,16,3,398,291,689,3,4,202039
21,12,285,6,267,253,55,60,107,1033,672,1705,7,4,202039
21,13,96,2,99,76,9,32,3,317,164,481,6,4,202039
21,14,78,2,27,29,16,13,1,166,193,359,6,4,202039
21,15,147,1,87,125,13,26,21,420,466,886,5,4,202039
22,1,146,24,90,119,17,8,2,406,468,874,7,4,202039
22,2,192,20,152,114,51,17,0,546,598,1144,6,4,202039
22,3,251,13,329,275,11,28,0,907,1028,1935,8,4,202039
22,4,231,24,327,293,15,45,7,942,974,1916,7,4,202039
22,5,160,10,304,185,48,37,29,773,699,1472,8,4,202039
23,1,156,2,277,111,14,11,5,576,348,924,10,4,202039
23,2,148,7,165,109,12,11,0,452,516,968,7,4,202039
23,3,262,6,394,280,22,24,2,990,442,1432,14,4,202039
23,4,89,4,157,104,22,36,26,438,442,880,4,4,202039
24,1,77,15,55,68,2,18,0,235,280,515,7,4,202039
24,2,96,15,96,92,11,16,6,332,255,587,5,4,202039
24,3,91,16,54,56,38,18,1,274,356,630,6,4,202039
24,4,91,7,65,68,12,14,20,277,223,500,4,4,202039
24,5,253,29,309,310,8,40,0,949,1065,2014,9,4,202039
24,6,55,15,67,54,13,8,0,212,301,513,3,2,202039
24,7,77,8,41,58,10,6,0,200,220,420,6,4,202039
25,1,180,4,160,183,14,34,30,605,589,1194,11,4,202039
25,2,199,10,127,207,6,17,1,567,829,1396,4,4,202039
25,3,194,8,153,242,20,33,17,667,944,1611,8,4,202039
25,4,115,4,92,144,37,9,0,401,487,888,6,4,202039
25,5,190,6,177,217,16,48,7,661,677,1338,7,4,202039
25,6,133,3,123,161,10,37,28,495,761,1256,6,4,202039
25,7,209,5,208,224,3,13,0,662,767,1429,5,4,202039
26,1,183,5,190,157,3,49,1,588,528,1116,8,4,202039
26,2,178,5,163,200,4,43,4,597,426,1023,6,4,202039
26,3,256,9,183,210,10,75,20,763,979,1742,9,4,202039
26,4,58,2,45,60,3,9,4,181,206,387,6,4,202039
26,5,134,2,73,120,7,56,0,392,484,876,8,4,202039
26,6,97,2,74,92,5,17,0,287,328,615,7,4,202039
26,7,145,13,103,148,22,11,0,442,432,874,8,4,202039
27,1,188,5,99,124,32,27,5,480,631,1111,6,4,202039
27,2,257,6,108,285,10,32,5,703,915,1618,7,4,202039
27,3,217,5,87,210,1,17,2,539,725,1264,5,4,202039
27,4,260,3,127,308,4,54,13,769,838,1607,6,4,202039
27,5,74,1,39,89,2,19,1,225,211,436,4,4,202039
27,6,198,7,83,225,1,26,0,540,753,1293,6,4,202039
28,1,244,14,276,286,2,23,1,846,1024,1870,8,4,202039
28,2,233,23,208,150,14,52,101,781,882,1663,11,4,202039
28,3,40,4,38,63,5,19,30,199,197,396,4,4,202039
28,4,305,15,205,176,43,63,39,846,874,1720,14,4,202039
28,5,166,11,94,130,7,45,14,467,430,897,7,4,202039
28,6,118,8,93,131,16,22,12,400,476,876,9,4,202039
28,7,193,15,136,109,35,31,39,558,722,1280,9,4,202039
28,8,201,13,151,139,33,59,44,640,408,1048,12,4,202039
28,9,158,6,177,105,11,60,12,529,736,1265,5,4,202039
29,1,217,18,111,199,20,23,1,589,593,1182,8,4,202039
29,2,177,8,107,209,10,54,25,590,612,1202,8,4,202039
29,3,102,6,42,117,6,20,3,296,339,635,5,4,202039
30,1,70,5,58,68,15,10,17,243,299,542,5,4,202039
30,2,161,1,61,62,14,10,47,356,321,677,7,4,202039
30,3,159,4,105,72,65,28,30,463,760,1223,5,4,202039
30,4,204,2,169,125,22,44,1,567,262,829,8,4,202039
30,5,261,4,168,151,8,21,0,613,694,1307,6,4,202039
30,6,105,2,77,74,8,15,1,282,330,612,7,4,202039
30,7,128,0,45,61,15,21,28,298,109,407,8,4,202039
30,8,184,3,157,88,37,13,0,482,452,934,8,4,202039
30,9,144,2,117,88,27,22,23,423,572,995,6,4,202039
30,10,198,8,259,140,11,40,34,690,730,1420,6,4,202039
30,11,148,0,94,99,8,16,3,368,316,684,4,4,202039
30,12,207,3,302,235,15,49,0,811,254,1065,10,4,202039
30,13,165,5,47,89,25,27,37,395,538,933,7,4,202039
30,14,144,2,122,92,9,13,5,387,235,622,6,4,202039
30,15,265,5,125,136,41,63,57,692,624,1316,10,4,202039
30,16,221,3,136,161,16,29,78,644,791,1435,8,4,202039
30,17,184,10,94,157,17,51,10,523,543,1066,6,4,202039
30,18,57,1,23,52,6,15,5,159,243,402,4,4,202039
30,19,140,1,118,117,8,31,21,436,447,883,9,4,202039
30,20,142,5,49,112,29,19,0,356,514,870,7,4,202039
31,1,132,2,119,25,51,9,0,338,341,679,6,4,202039
31,2,35,1,58,1,28,9,0,132,88,220,4,4,202039
31,3,378,23,342,218,70,34,0,1065,660,1725,16,4,202039
31,4,88,3,109,63,66,28,27,384,237,621,4,4,202039
31,5,67,1,67,29,2,13,0,179,235,414,5,4,202039
32,1,109,9,68,61,15,28,16,306,292,598,8,4,202039
32,2,59,6,47,52,23,15,10,212,161,373,7,4,202039
32,3,170,19,106,172,7,36,8,518,535,1053,9,4,202039
32,4,125,11,104,127,5,29,10,411,563,974,8,4,202039
1,1,407,53,258,317,42,47,15,1139,826,1965,13,5,202040
1,2,406,36,379,381,38,66,20,1326,1165,2491,16,5,202040
1,3,289,36,359,313,45,65,54,1161,1191,2352,15,5,202040
2,1,218,9,163,202,16,111,9,728,800,1528,8,5,202040
2,2,124,12,99,228,11,45,0,519,516,1035,5,5,202040
2,3,214,9,180,175,2,92,25,697,692,1389,8,5,202040
2,4,243,3,213,109,35,23,14,640,649,1289,7,5,202040
2,5,242,15,245,145,65,53,24,789,797,1586,7,5,202040
2,6,155,5,196,148,19,71,29,623,675,1298,7,5,202040
2,7,215,11,199,146,20,67,19,677,692,1369,8,5,202040
2,8,162,8,154,123,4,40,17,508,375,883,4,5,202040
3,1,222,6,216,272,25,57,5,803,776,1579,8,5,202040
3,2,199,13,379,205,25,27,1,849,805,1654,7,5,202040
4,1,230,8,126,216,26,50,6,662,531,1193,6,5,202040
4,2,117,1,92,130,17,23,44,424,436,860,7,5,202040
5,1,0,0,0,321,0,0,0,321,414,735,6,5,202040
5,2,1,0,0,113,0,0,0,114,130,244,4,5,202040
5,3,0,0,0,246,0,0,0,246,264,510,8,5,202040
5,4,2,0,4,681,0,0,0,687,730,1417,6,5,202040
5,5,3,1,3,783,0,1,0,791,822,1613,10,5,202040
5,6,0,0,0,290,0,0,0,290,328,618,3,5,202040
5,7,0,0,0,189,0,0,0,189,348,537,5,5,202040
6,1,214,6,203,179,13,54,31,700,628,1328,9,5,202040
6,2,173,6,132,101,29,29,12,482,415,897,7,5,202040
7,1,126,1,52,57,2,8,1,247,207,454,5,5,202040
7,2,198,4,65,126,3,8,0,404,661,1065,6,5,202040
7,3,138,1,73,50,43,16,1,322,446,768,5,5,202040
7,4,186,0,65,104,7,22,10,394,292,686,8,5,202040
7,5,230,3,97,192,11,12,1,546,670,1216,10,5,202040
7,6,196,7,135,149,11,48,26,572,754,1326,6,5,202040
7,7,283,13,176,197,38,53,7,767,745,1512,6,5,202040
7,8,125,4,48,81,26,31,3,318,417,735,8,5,202040
7,9,258,7,178,259,26,50,7,785,1114,1899,8,5,202040
7,10,175,2,77,114,6,17,0,391,467,858,7,5,202040
7,11,91,4,22,46,26,12,0,201,192,393,4,5,202040
7,12,224,3,141,246,4,13,2,633,665,1298,7,5,202040
7,13,84,11,66,93,0,7,0,261,343,604,6,5,202040
8,1,164,2,109,56,0,5,1,337,332,669,4,5,202040
8,2,437,55,396,301,11,25,0,1225,1302,2527,12,5,202040
8,3,245,19,207,218,26,44,17,776,875,1651,4,5,202040
8,4,461,40,475,461,38,106,86,1667,1836,3503,8,5,202040
8,5,115,9,81,175,6,20,0,406,517,923,6,5,202040
8,6,254,36,262,277,25,70,15,939,1037,1976,5,5,202040
8,7,100,6,84,128,5,22,0,345,373,718,5,5,202040
8,8,279,19,267,394,9,47,6,1021,1330,2351,7,5,202040
8,9,88,8,95,64,25,24,25,329,378,707,6,5,202040
9,1,111,6,66,96,35,19,8,341,343,684,4,5,202040
9,2,275,16,333,466,62,60,7,1219,1509,2728,10,5,202040
9,3,141,5,118,148,34,25,31,502,659,1161,4,5,202040
9,4,212,16,205,277,34,42,21,807,1335,2142,7,5,202040
9,5,212,4,205,295,31,38,5,790,721,1511,7,5,202040
9,6,157,21,113,157,63,29,34,574,518,1092,7,5,202040
9,7,116,6,183,218,4,18,2,547,802,1349,6,5,202040
9,8,62,4,112,128,7,16,4,333,543,876,3,5,202040
9,9,110,7,63,131,33,25,4,373,721,1094,3,5,202040
9,10,78,7,129,133,18,40,4,409,421,830,3,5,202040
9,11,193,6,207,294,61,95,9,865,899,1764,7,5,202040
9,12,123,32,214,297,13,57,21,757,946,1703,7,5,202040
9,13,113,5,113,189,37,22,17,496,687,1183,3,5,202040
9,14,168,9,161,199,53,47,46,683,645,1328,5,5,202040
9,15,143,8,371,299,43,63,68,995,1108,2103,6,5,202040
9,16,244,75,226,423,49,51,5,1073,940,2013,11,5,202040
9,17,152,21,266,193,18,50,4,704,729,1433,6,5,202040
9,18,149,7,129,243,58,56,10,652,783,1435,8,5,202040
9,19,125,11,72,130,48,19,2,407,543,950,3,5,202040
9,20,76,4,78,100,21,9,7,295,333,628,3,5,202040
9,21,102,9,102,119,23,18,10,383,499,882,3,5,202040
9,22,147,3,95,153,49,34,14,495,471,966,2,5,202040
9,23,151,5,228,300,46,41,9,780,827,1607,6,5,202040
9,24,314,21,359,500,136,79,23,1432,1903,3335,11,5,202040
10,1,193,10,133,173,7,61,20,597,889,1486,12,5,202040
10,2,175,7,83,189,1,32,2,489,509,998,7,5,202040
10,3,153,14,105,146,24,44,17,503,388,891,8,5,202040
10,4,391,51,215,318,11,2,7,995,1255,2250,11,5,202040
11,1,213,28,110,166,14,37,9,577,438,1015,6,5,202040
11,2,221,19,165,110,47,44,10,616,542,1158,7,4.666666667,202040
11,3,104,19,100,134,15,42,17,431,478,909,3,5,202040
11,4,206,35,139,184,27,47,0,638,574,1212,5,5,202040
11,5,351,67,345,466,35,106,33,1403,1208,2611,7,5,202040
11,6,230,21,217,206,30,68,16,788,643,1431,8,5,202040
11,7,354,32,321,284,37,47,4,1079,1030,2109,7,5,202040
11,8,331,32,296,456,38,85,15,1253,1201,2454,9,5,202040
11,9,345,34,255,372,10,55,26,1097,901,1998,8,5,202040
11,10,217,25,183,194,27,73,32,751,677,1428,9,5,202040
11,11,188,9,134,182,2,37,0,552,732,1284,5,5,202040
11,12,222,29,214,248,24,42,12,791,852,1643,7,5,202040
11,13,132,22,89,107,31,16,32,429,491,920,7,5,202040
11,14,189,24,163,153,41,21,0,591,562,1153,6,5,202040
11,15,196,18,160,206,12,74,21,687,743,1430,6,5,202040
12,1,108,7,83,83,21,33,1,336,337,673,6,5,202040
12,2,256,13,184,370,14,45,0,882,857,1739,8,5,202040
12,3,213,10,190,192,16,29,1,651,683,1334,7,5,202040
12,4,285,24,274,410,43,44,0,1080,1596,2676,8,5,202040
12,5,169,26,119,82,2,14,36,448,341,789,7,5,202040
12,6,202,13,117,128,24,5,7,496,580,1076,7,5,202040
12,7,156,4,114,200,3,21,1,499,466,965,5,5,202040
12,8,157,8,55,105,0,11,0,336,313,649,6,5,202040
12,9,420,24,400,506,45,61,7,1463,1346,2809,8,5,202040
13,1,1,0,1,129,0,0,0,131,96,227,7,5,202040
13,2,0,0,0,180,0,0,0,180,194,374,3,5,202040
13,3,0,0,0,206,0,0,0,206,223,429,6,5,202040
13,4,3,0,1,302,0,0,0,306,347,653,7,5,202040
13,5,0,0,9,361,1,1,0,372,394,766,8,5,202040
13,6,0,0,3,666,0,0,0,669,854,1523,10,5,202040
13,7,1,1,1,344,1,1,0,349,349,698,7,5,202040
14,1,98,27,73,45,37,31,3,314,369,683,5,5,202040
14,2,134,3,106,67,34,46,2,392,354,746,4,5,202040
14,3,166,7,171,60,7,59,4,474,444,918,7,5,202040
14,4,288,25,351,349,23,76,20,1132,1175,2307,8,5,202040
14,5,169,10,209,144,19,25,0,576,674,1250,9,5,202040
14,6,235,15,352,195,22,42,5,866,1381,2247,7,5,202040
14,7,185,11,237,160,0,19,0,612,580,1192,6,5,202040
14,8,372,24,612,603,25,104,4,1744,2084,3828,9,5,202040
14,9,174,18,229,318,16,40,14,809,866,1675,5,5,202040
14,10,165,19,274,147,10,73,27,715,745,1460,6,5,202040
14,11,153,11,135,175,29,64,21,588,569,1157,4,5,202040
14,12,262,7,244,107,22,12,0,654,961,1615,8,5,202040
14,13,143,17,186,137,13,34,12,542,1035,1577,5,5,202040
14,14,151,11,127,198,17,61,15,580,607,1187,5,5,202040
14,15,276,33,250,231,66,76,13,945,1068,2013,8,5,202040
14,16,201,14,172,159,40,49,4,639,765,1404,5,5,202040
14,17,85,11,107,39,13,29,13,297,296,593,5,5,202040
14,18,217,27,202,139,73,45,33,736,744,1480,7,5,202040
14,19,155,11,173,102,11,25,0,477,602,1079,5,5,202040
14,20,301,26,369,260,9,34,1,1000,1056,2056,8,5,202040
15,1,151,12,95,85,99,25,0,467,571,1038,5,5,202040
15,2,161,8,140,218,63,34,9,633,688,1321,5,5,202040
15,3,243,15,125,171,171,43,35,803,745,1548,9,5,202040
15,4,182,6,116,232,36,35,8,615,490,1105,3,5,202040
15,5,207,29,182,182,12,29,6,647,544,1191,5,5,202040
15,6,132,5,118,191,14,27,20,507,540,1047,5,5,202040
15,7,268,12,283,222,72,48,17,922,863,1785,8,5,202040
15,8,151,11,181,220,13,28,10,614,588,1202,3,5,202040
15,9,187,10,75,70,106,78,0,526,564,1090,7,5,202040
15,10,188,12,129,251,12,29,9,630,458,1088,6,5,202040
15,11,211,9,166,267,25,13,8,699,805,1504,5,5,202040
15,12,324,10,316,342,29,44,0,1065,1200,2265,7,5,202040
15,13,92,6,75,109,45,24,0,351,601,952,5,5,202040
15,14,126,7,103,251,14,29,0,530,488,1018,4,5,202040
15,15,111,28,108,153,19,27,26,472,414,886,2,5,202040
15,16,358,28,246,488,30,75,36,1261,1177,2438,8,5,202040
15,17,150,6,141,235,20,48,33,633,550,1183,5,5,202040
15,18,254,15,243,259,41,64,22,898,1035,1933,6,5,202040
15,19,292,27,276,552,24,59,24,1254,1602,2856,8,5,202040
15,20,131,9,261,243,29,22,1,696,932,1628,5,5,202040
15,21,94,6,67,105,21,43,9,345,398,743,3,5,202040
15,22,328,62,295,516,20,86,44,1351,1246,2597,7,5,202040
15,23,138,7,90,158,12,22,0,427,553,980,5,5,202040
15,24,140,19,114,175,28,19,12,507,399,906,3,5,202040
15,25,226,12,175,243,35,31,28,750,729,1479,4,5,202040
15,26,251,6,169,235,106,34,5,806,861,1667,5,5,202040
15,27,251,7,232,273,23,59,55,900,1345,2245,8,5,202040
15,28,313,17,350,253,22,26,16,997,1216,2213,7,5,202040
15,29,245,16,222,411,2,77,9,982,890,1872,6,5,202040
15,30,386,23,332,396,71,61,34,1303,1185,2488,12,5,202040
15,31,234,126,188,280,17,40,0,885,621,1506,4,5,202040
15,32,248,11,177,290,45,47,19,837,686,1523,7,5,202040
15,33,246,13,179,251,32,36,1,758,993,1751,6,5,202040
15,34,157,21,118,242,21,17,13,589,769,1358,6,5,202040
15,35,220,14,160,308,3,41,4,750,817,1567,7,5,202040
15,36,275,7,219,320,4,35,1,861,965,1826,7,5,202040
15,37,287,10,231,411,80,57,16,1092,1035,2127,4,5,202040
15,38,175,13,127,196,38,29,0,578,492,1070,3,5,202040
15,39,173,25,111,174,20,36,0,539,584,1123,4,5,202040
15,40,390,23,242,401,94,66,12,1228,1308,2536,9,5,202040
15,41,306,18,307,331,59,50,30,1101,1021,2122,11,5,202040
16,1,109,11,146,84,2,14,0,366,375,741,5,5,202040
16,2,144,10,119,172,20,32,2,499,407,906,6,5,202040
16,3,187,11,126,220,33,29,1,607,743,1350,7,5,202040
16,4,121,10,117,41,34,56,0,379,609,988,7,5,202040
16,5,150,18,142,141,38,52,31,572,686,1258,6,5,202040
16,6,184,31,173,159,60,23,0,630,721,1351,10,5,202040
16,7,327,42,236,328,32,43,1,1009,1038,2047,7,5,202040
16,8,364,34,451,488,13,65,7,1422,1404,2826,12,5,202040
16,9,226,17,189,234,11,43,9,729,824,1553,9,5,202040
16,10,164,9,231,224,10,33,0,671,876,1547,5,5,202040
16,11,175,16,128,108,44,36,1,508,530,1038,9,5,202040
16,12,123,8,133,110,0,43,1,418,352,770,6,5,202040
17,1,145,14,182,264,14,22,6,647,531,1178,4,5,202040
17,2,237,8,224,302,9,41,9,830,1253,2083,8,5,202040
17,3,217,14,222,269,23,70,0,815,1100,1915,6,5,202040
17,4,324,11,358,414,21,43,16,1187,965,2152,9,5,202040
17,5,59,3,67,70,15,12,0,226,247,473,4,5,202040
18,1,53,5,36,47,2,8,4,155,167,322,5,5,202040
18,2,256,25,196,277,31,100,7,892,694,1586,8,5,202040
18,3,118,9,133,94,5,23,0,382,404,786,6,5,202040
19,1,292,10,334,313,10,148,93,1200,1182,2382,8,5,202040
19,2,324,6,251,219,11,42,3,856,1153,2009,5,5,202040
19,3,371,12,314,237,31,45,4,1014,1092,2106,7,5,202040
19,4,286,7,149,148,65,72,70,797,423,1220,5,5,202040
19,5,344,40,353,433,28,82,44,1324,1303,2627,8,5,202040
19,6,205,11,285,386,9,109,23,1028,969,1997,5,5,202040
19,7,282,8,358,237,8,38,0,931,891,1822,8,5,202040
19,8,207,13,203,250,7,36,0,716,904,1620,6,5,202040
19,9,125,8,94,38,8,48,19,340,390,730,5,5,202040
19,10,192,4,208,194,11,74,30,713,568,1281,5,5,202040
19,11,435,28,365,505,2,146,41,1522,2140,3662,12,5,202040
19,12,262,13,365,150,20,21,4,835,886,1721,10,5,202040
20,1,148,8,125,103,25,25,19,453,472,925,4,5,202040
20,2,49,10,55,61,34,3,0,212,218,430,4,5,202040
20,3,87,4,62,74,15,19,4,265,369,634,4,5,202040
20,4,80,10,54,50,9,28,13,244,245,489,4,5,202040
20,5,128,2,127,83,8,12,1,361,394,755,6,5,202040
20,6,125,3,66,78,40,11,12,335,401,736,5,5,202040
20,7,161,3,143,186,9,28,3,533,506,1039,4,5,202040
20,8,460,29,503,697,72,114,32,1907,1553,3460,13,5,202040
20,9,281,5,127,143,120,47,15,738,682,1420,7,5,202040
20,10,106,2,82,56,15,13,2,276,286,562,5,5,202040
21,1,282,9,206,208,45,17,0,767,800,1567,7,5,202040
21,2,92,11,73,55,36,10,0,277,256,533,6,5,202040
21,3,274,5,181,158,36,49,14,717,635,1352,7,5,202040
21,4,55,3,24,18,10,12,1,123,251,374,4,5,202040
21,5,206,13,211,138,23,28,16,635,844,1479,7,5,202040
21,6,170,5,139,172,50,49,12,597,738,1335,4,5,202040
21,7,280,16,104,165,72,64,3,704,628,1332,8,5,202040
21,8,120,0,71,71,19,30,13,324,353,677,7,5,202040
21,9,280,16,309,301,53,67,33,1059,773,1832,8,5,202040
21,10,141,3,111,152,12,46,22,487,476,963,4,5,202040
21,11,149,8,134,154,35,17,4,501,628,1129,3,5,202040
21,12,276,20,393,324,64,53,136,1266,1291,2557,7,5,202040
21,13,105,5,131,85,11,37,1,375,482,857,6,5,202040
21,14,87,3,30,40,29,22,9,220,227,447,6,5,202040
21,15,203,4,139,163,15,42,18,584,790,1374,5,5,202040
22,1,179,37,113,171,13,12,0,525,541,1066,7,5,202040
22,2,216,23,250,201,64,25,0,779,687,1466,6,5,202040
22,3,302,23,412,356,12,38,2,1145,1358,2503,8,5,202040
22,4,256,27,421,349,24,71,6,1154,1387,2541,7,5,202040
22,5,257,17,378,264,53,51,31,1051,980,2031,8,5,202040
23,1,153,6,358,126,25,19,14,701,783,1484,10,5,202040
23,2,194,7,247,189,14,21,0,672,678,1350,7,5,202040
23,3,314,12,544,330,21,31,3,1255,1026,2281,14,5,202040
23,4,120,10,225,155,26,54,37,627,619,1246,4,5,202040
24,1,124,10,48,92,15,15,2,306,325,631,7,5,202040
24,2,122,7,122,114,10,26,2,403,446,849,5,5,202040
24,3,135,12,66,63,52,20,0,348,442,790,6,5,202040
24,4,121,8,76,100,16,26,32,379,628,1007,4,5,202040
24,5,353,43,484,473,10,57,0,1420,1288,2708,9,5,202040
24,6,0,0,0,0,0,0,0,0,0,0,0,0,202040
24,7,125,4,53,78,18,3,0,281,250,531,6,5,202040
25,1,196,7,231,242,29,41,25,771,1088,1859,11,5,202040
25,2,261,26,173,291,12,38,0,801,1094,1895,4,5,202040
25,3,295,7,192,343,39,30,25,931,1014,1945,8,5,202040
25,4,284,10,189,275,67,32,1,858,927,1785,6,5,202040
25,5,274,16,274,416,28,76,15,1099,966,2065,7,5,202040
25,6,161,9,216,251,33,52,37,759,844,1603,6,5,202040
25,7,297,7,322,353,5,17,0,1001,482,1483,5,5,202040
26,1,211,7,170,203,8,44,0,643,746,1389,7,5,202040
26,2,310,11,294,342,10,85,16,1068,873,1941,6,5,202040
26,3,339,9,192,279,20,120,26,985,1054,2039,9,5,202040
26,4,64,2,71,104,0,18,7,266,218,484,5,5,202040
26,5,151,4,98,143,9,84,0,489,634,1123,8,5,202040
26,6,157,5,91,144,14,37,8,456,425,881,7,5,202040
26,7,186,12,114,215,36,17,0,580,674,1254,8,5,202040
27,1,269,6,109,168,32,37,5,626,727,1353,6,5,202040
27,2,340,9,180,324,20,40,19,932,938,1870,7,5,202040
27,3,264,5,117,374,8,26,5,799,878,1677,5,5,202040
27,4,331,9,193,412,11,75,8,1039,1041,2080,6,5,202040
27,5,94,0,60,89,0,17,0,260,294,554,4,5,202040
27,6,214,7,129,350,5,46,0,751,753,1504,6,5,202040
28,1,346,27,423,381,4,36,0,1217,1311,2528,8,5,202040
28,2,345,35,315,237,23,56,142,1153,1136,2289,11,5,202040
28,3,73,8,49,89,7,33,12,271,258,529,5,5,202040
28,4,453,19,329,273,49,94,78,1295,1113,2408,14,5,202040
28,5,219,13,131,222,4,76,31,696,836,1532,7,5,202040
28,6,169,9,100,190,18,18,9,513,466,979,9,5,202040
28,7,252,9,183,173,48,36,56,757,944,1701,9,5,202040
28,8,266,18,200,179,42,67,66,838,591,1429,12,5,202040
28,9,234,9,252,157,22,67,24,765,733,1498,6,5,202040
29,1,272,16,186,247,27,27,1,776,1054,1830,8,5,202040
29,2,232,14,161,265,20,77,35,804,914,1718,9,5,202040
29,3,139,5,65,173,11,17,0,410,564,974,5,5,202040
30,1,99,6,93,95,9,17,25,344,341,685,5,5,202040
30,2,181,11,100,75,23,14,60,464,419,883,6,5,202040
30,3,220,6,138,92,74,38,54,622,778,1400,5,5,202040
30,4,184,8,175,113,26,43,0,549,756,1305,8,5,202040
30,5,264,5,256,199,9,34,1,768,697,1465,6,5,202040
30,6,135,5,117,60,15,11,3,346,389,735,7,5,202040
30,7,129,1,64,72,25,31,42,364,264,628,8,5,202040
30,8,181,7,232,147,46,19,3,635,754,1389,8,5,202040
30,9,206,4,130,114,60,34,37,585,595,1180,6,5,202040
30,10,301,18,407,207,32,59,45,1069,1199,2268,6,5,202040
30,11,153,4,126,132,7,12,0,434,929,1363,4,5,202040
30,12,251,6,316,257,13,58,0,901,1094,1995,10,5,202040
30,13,203,3,77,104,40,44,53,524,483,1007,7,5,202040
30,14,141,3,132,93,28,20,8,425,446,871,6,5,202040
30,15,330,8,203,201,57,77,69,945,855,1800,10,5,202040
30,16,267,5,202,195,39,58,97,863,933,1796,8,5,202040
30,17,203,14,149,196,27,54,28,671,520,1191,5,5,202040
30,18,88,3,37,80,20,13,12,253,221,474,5,5,202040
30,19,138,2,95,95,3,32,3,368,441,809,7,5,202040
30,20,168,7,72,173,37,23,0,480,534,1014,7,5,202040
31,1,179,4,167,34,72,8,1,465,456,921,4,5,202040
31,2,37,0,55,9,39,6,0,146,190,336,4,5,202040
31,3,400,21,442,250,65,43,0,1221,1410,2631,16,5,202040
31,4,104,6,141,99,86,45,32,513,599,1112,4,5,202040
31,5,99,2,80,35,1,12,1,230,280,510,5,5,202040
32,1,129,17,84,105,23,39,25,422,370,792,8,5,202040
32,2,99,8,45,52,25,19,23,271,273,544,8,5,202040
32,3,240,25,134,264,3,52,5,723,776,1499,10,5,202040
32,4,147,14,115,188,7,44,12,527,605,1132,7,5,202040
1,1,421,55,276,313,37,54,14,1170,1073,2243,10,5,202041
1,2,522,49,436,452,47,73,26,1605,1320,2925,15,5,202041
1,3,351,47,455,374,43,76,66,1412,1231,2643,13,5,202041
2,1,307,14,196,236,17,117,19,906,888,1794,8,5,202041
2,2,179,3,135,243,6,53,0,619,599,1218,5,5,202041
2,3,284,8,219,190,1,102,18,822,904,1726,7,5,202041
2,4,350,8,230,174,44,30,22,858,874,1732,8,5,202041
2,5,298,10,320,195,79,65,12,979,1170,2149,7,5,202041
2,6,241,13,207,203,31,85,34,814,811,1625,7,5,202041
2,7,272,19,224,180,31,79,36,841,896,1737,7,5,202041
2,8,195,4,200,151,7,30,13,600,484,1084,4,5,202041
3,1,241,9,246,253,27,55,10,841,763,1604,6,5,202041
3,2,254,7,471,223,40,30,1,1026,808,1834,6,5,202041
4,1,274,8,156,250,26,67,14,795,706,1501,4,5,202041
4,2,130,3,84,110,9,20,29,385,331,716,4,5,202041
5,1,0,0,0,432,0,0,0,432,287,719,6,5,202041
5,2,0,0,1,151,0,0,0,152,120,272,2,5,202041
5,3,0,0,0,408,0,0,0,408,269,677,6,5,202041
5,4,1,0,1,818,0,3,0,823,750,1573,6,5,202041
5,5,2,0,1,844,0,1,2,850,696,1546,10,5,202041
5,6,1,0,0,321,0,1,0,323,260,583,2,5,202041
5,7,0,0,0,303,0,0,0,303,275,578,5,5,202041
6,1,185,16,237,162,19,50,36,705,789,1494,8,5,202041
6,2,151,10,143,95,28,23,11,461,445,906,6,5,202041
7,1,136,4,67,51,7,14,0,279,260,539,3,5,202041
7,2,217,2,71,150,6,11,0,457,443,900,3,5,202041
7,3,170,2,88,57,55,9,2,383,381,764,3,5,202041
7,4,159,4,65,111,5,26,18,388,377,765,5,5,202041
7,5,246,10,113,204,17,23,1,614,793,1407,9,5,202041
7,6,220,2,183,200,14,37,17,673,845,1518,4,5,202041
7,7,371,10,231,237,52,81,5,987,833,1820,4,5,202041
7,8,196,7,61,110,35,29,16,454,422,876,5,5,202041
7,9,317,9,172,271,20,78,9,876,1027,1903,7,5,202041
7,10,174,6,114,128,8,15,0,445,445,890,5,5,202041
7,11,65,1,52,37,9,10,0,174,213,387,2,5,202041
7,12,288,3,162,265,2,15,2,737,737,1474,5,5,202041
7,13,118,11,79,104,1,18,0,331,369,700,3,5,202041
8,1,225,6,180,118,0,6,0,535,428,963,4,5,202041
8,2,507,71,448,328,13,23,3,1393,1517,2910,10,5,202041
8,3,323,17,254,273,12,45,25,949,841,1790,4,5,202041
8,4,442,43,486,447,47,119,55,1639,1630,3269,8,5,202041
8,5,145,15,75,144,5,13,0,397,633,1030,3,5,202041
8,6,379,53,324,367,37,59,19,1238,935,2173,5,5,202041
8,7,132,13,87,132,4,26,0,394,453,847,2,5,202041
8,8,373,26,331,505,9,72,7,1323,1336,2659,7,5,202041
8,9,103,12,87,74,24,26,39,365,406,771,3,5,202041
9,1,137,4,64,108,35,20,12,380,415,795,4,5,202041
9,2,362,42,384,563,105,82,6,1544,2016,3560,10,5,202041
9,3,176,5,174,199,31,29,19,633,606,1239,4,5,202041
9,4,323,20,237,392,52,50,24,1098,1370,2468,7,5,202041
9,5,271,5,252,414,42,71,5,1060,867,1927,7,5,202041
9,6,143,19,134,167,98,31,27,619,610,1229,7,5,202041
9,7,134,6,231,255,7,25,3,661,736,1397,6,5,202041
9,8,78,6,127,183,14,18,6,432,573,1005,3,5,202041
9,9,175,5,126,171,39,35,4,555,567,1122,3,5,202041
9,10,110,9,144,147,16,62,6,494,570,1064,3,5,202041
9,11,269,12,289,345,96,94,7,1112,752,1864,7,5,202041
9,12,164,42,276,374,24,62,2,944,1031,1975,7,5,202041
9,13,137,4,119,155,33,43,13,504,594,1098,3,5,202041
9,14,205,10,207,316,63,49,39,889,492,1381,5,5,202041
9,15,198,15,428,398,61,74,36,1210,1026,2236,6,5,202041
9,16,307,82,230,414,44,49,8,1134,1020,2154,11,5,202041
9,17,203,34,354,293,27,58,3,972,678,1650,6,5,202041
9,18,160,10,138,310,70,45,6,739,1028,1767,8,5,202041
9,19,158,20,109,150,46,11,6,500,632,1132,3,5,202041
9,20,84,6,93,112,30,16,3,344,399,743,3,5,202041
9,21,131,3,128,163,33,11,4,473,502,975,3,5,202041
9,22,120,6,75,108,22,19,11,361,457,818,2,5,202041
9,23,171,14,269,299,46,41,11,851,1178,2029,6,5,202041
9,24,410,27,463,589,156,84,14,1743,1957,3700,11,5,202041
10,1,253,20,201,225,8,77,28,812,695,1507,8,5,202041
10,2,211,13,86,203,5,32,7,557,517,1074,4,5,202041
10,3,196,17,124,152,42,53,11,595,628,1223,6,5,202041
10,4,423,80,249,386,13,4,2,1157,1111,2268,11,5,202041
11,1,253,33,131,165,55,45,7,689,600,1289,5,5,202041
11,2,205,22,165,156,37,68,10,663,627,1290,5,3.333333333,202041
11,3,133,16,86,79,17,59,7,397,489,886,3,5,202041
11,4,260,68,145,227,21,53,0,774,737,1511,4,5,202041
11,5,462,110,352,453,43,109,28,1557,1165,2722,7,5,202041
11,6,361,34,387,396,63,95,34,1370,588,1958,8,5,202041
11,7,395,30,355,362,38,88,2,1270,1138,2408,5,5,202041
11,8,414,30,359,491,56,110,21,1481,1424,2905,8,5,202041
11,9,365,43,271,396,15,67,25,1182,1047,2229,8,5,202041
11,10,297,39,236,233,28,55,51,939,790,1729,7,5,202041
11,11,193,14,140,176,5,22,0,550,845,1395,5,5,202041
11,12,207,43,228,225,9,33,14,759,957,1716,7,5,202041
11,13,139,27,99,128,27,36,19,475,535,1010,5,5,202041
11,14,222,23,169,179,39,23,0,655,621,1276,4,5,202041
11,15,163,25,147,202,11,72,20,640,688,1328,5,5,202041
12,1,140,14,90,94,20,19,3,380,335,715,2,5,202041
12,2,344,17,214,406,4,49,0,1034,931,1965,6,5,202041
12,3,236,17,236,222,20,34,0,765,631,1396,3,5,202041
12,4,370,23,443,530,25,89,2,1482,1150,2632,7,5,202041
12,5,161,23,133,103,2,15,53,490,404,894,4,5,202041
12,6,220,6,148,155,13,10,15,567,566,1133,4,5,202041
12,7,175,5,104,229,5,39,0,557,648,1205,4,5,202041
12,8,145,7,100,98,0,12,0,362,408,770,3,5,202041
12,9,478,37,408,566,31,63,2,1585,1463,3048,7,5,202041
13,1,0,0,0,130,0,0,0,130,134,264,5,5,202041
13,2,0,0,0,171,0,0,0,171,162,333,2,5,202041
13,3,0,0,0,198,0,0,1,199,170,369,5,5,202041
13,4,0,0,2,344,0,1,0,347,341,688,6,5,202041
13,5,1,0,0,430,0,0,0,431,343,774,7,5,202041
13,6,0,0,1,751,0,1,0,753,872,1625,9,5,202041
13,7,1,1,2,332,0,0,0,336,334,670,5,5,202041
14,1,114,22,66,40,36,16,3,297,383,680,3,5,202041
14,2,167,10,108,61,51,36,1,434,386,820,3,5,202041
14,3,226,8,210,75,10,59,4,592,558,1150,4,5,202041
14,4,322,23,351,340,36,76,13,1161,1197,2358,8,5,202041
14,5,173,16,258,155,18,46,0,666,683,1349,7,5,202041
14,6,327,16,381,254,13,45,4,1040,1094,2134,7,5,202041
14,7,205,9,257,138,0,15,0,624,634,1258,6,5,202041
14,8,502,33,731,593,13,101,4,1977,1696,3673,9,5,202041
14,9,226,20,205,331,16,49,11,858,899,1757,5,5,202041
14,10,220,19,300,142,13,76,31,801,679,1480,6,5,202041
14,11,249,11,183,183,28,109,20,783,513,1296,4,5,202041
14,12,352,11,294,153,18,17,1,846,856,1702,6,5,202041
14,13,226,7,230,166,6,41,7,683,774,1457,5,5,202041
14,14,196,11,218,233,32,114,16,820,602,1422,5,5,202041
14,15,324,29,279,237,96,87,27,1079,982,2061,6,5,202041
14,16,259,9,198,169,33,62,4,734,832,1566,5,5,202041
14,17,87,7,84,47,13,23,22,283,337,620,2,5,202041
14,18,281,21,203,121,97,38,44,805,700,1505,4,5,202041
14,19,134,22,126,91,4,24,2,403,615,1018,2,5,202041
14,20,328,24,456,263,8,34,0,1113,827,1940,7,5,202041
15,1,205,8,120,87,162,32,1,615,477,1092,3,5,202041
15,2,238,14,180,218,81,37,8,776,575,1351,5,5,202041
15,3,354,21,177,248,217,31,48,1096,984,2080,8,5,202041
15,4,214,8,118,225,51,38,16,670,525,1195,3,5,202041
15,5,285,36,254,235,23,30,5,868,588,1456,4,5,202041
15,6,221,7,181,334,16,40,30,829,603,1432,5,5,202041
15,7,308,12,312,206,52,61,3,954,952,1906,8,5,202041
15,8,205,8,168,287,11,26,13,718,659,1377,3,5,202041
15,9,281,11,70,113,148,105,4,732,626,1358,6,5,202041
15,10,194,6,132,227,16,34,8,617,800,1417,6,5,202041
15,11,233,14,213,255,31,25,8,779,911,1690,5,5,202041
15,12,390,11,417,366,41,40,2,1267,1177,2444,7,5,202041
15,13,121,11,86,142,67,27,0,454,567,1021,5,5,202041
15,14,136,12,100,197,14,40,3,502,666,1168,4,5,202041
15,15,128,34,107,186,30,36,13,534,530,1064,2,5,202041
15,16,391,19,342,577,24,75,22,1450,1496,2946,8,5,202041
15,17,190,8,133,230,36,38,42,677,572,1249,5,5,202041
15,18,357,15,301,327,41,63,17,1121,920,2041,5,5,202041
15,19,371,38,369,766,13,85,7,1649,1438,3087,8,5,202041
15,20,156,13,233,219,33,18,3,675,665,1340,5,5,202041
15,21,132,7,72,125,29,26,4,395,410,805,2,5,202041
15,22,405,85,309,503,28,81,71,1482,1417,2899,7,5,202041
15,23,169,7,95,244,21,33,0,569,453,1022,3,5,202041
15,24,193,33,146,211,26,23,7,639,385,1024,3,5,202041
15,25,258,30,184,250,32,43,17,814,724,1538,4,5,202041
15,26,294,5,218,281,104,47,9,958,822,1780,5,5,202041
15,27,305,20,280,312,28,65,50,1060,1286,2346,7,5,202041
15,28,387,18,406,277,20,36,24,1168,1036,2204,6,5,202041
15,29,301,12,276,448,5,74,12,1128,1461,2589,6,5,202041
15,30,438,57,356,441,65,57,42,1456,1433,2889,12,5,202041
15,31,308,128,206,324,33,33,0,1032,832,1864,4,5,202041
15,32,303,13,206,382,52,68,18,1042,795,1837,7,5,202041
15,33,283,21,263,313,32,35,2,949,771,1720,6,5,202041
15,34,181,6,154,287,13,28,11,680,721,1401,6,5,202041
15,35,295,11,168,336,6,51,6,873,817,1690,6,5,202041
15,36,312,13,249,363,0,43,1,981,889,1870,5,5,202041
15,37,368,17,260,419,92,70,19,1245,1052,2297,4,5,202041
15,38,205,20,134,160,45,28,7,599,553,1152,3,5,202041
15,39,205,36,179,200,28,40,0,688,638,1326,4,5,202041
15,40,441,58,287,508,171,65,19,1549,1296,2845,9,5,202041
15,41,352,13,361,385,59,47,38,1255,1344,2599,11,5,202041
16,1,146,9,186,78,5,6,0,430,352,782,3,5,202041
16,2,171,16,130,151,15,37,0,520,475,995,3,5,202041
16,3,258,15,156,278,22,57,0,786,725,1511,4,5,202041
16,4,172,15,181,110,33,34,0,545,621,1166,5,5,202041
16,5,213,11,123,155,29,52,33,616,552,1168,5,5,202041
16,6,250,35,152,169,54,40,5,705,723,1428,8,5,202041
16,7,399,43,288,321,28,56,0,1135,998,2133,5,5,202041
16,8,441,39,576,518,11,52,7,1644,1406,3050,12,5,202041
16,9,275,14,274,243,19,85,21,931,808,1739,9,5,202041
16,10,212,15,268,280,11,24,0,810,858,1668,5,5,202041
16,11,205,16,140,130,53,47,2,593,551,1144,6,5,202041
16,12,132,11,146,107,1,35,2,434,466,900,3,5,202041
17,1,162,16,207,276,17,34,5,717,715,1432,4,5,202041
17,2,357,10,305,398,7,50,8,1135,1009,2144,7,5,202041
17,3,278,8,270,269,25,61,0,911,903,1814,5,5,202041
17,4,351,9,364,384,23,34,22,1187,949,2136,8,5,202041
17,5,99,4,59,85,15,16,0,278,319,597,3,5,202041
18,1,69,3,59,75,15,12,11,244,186,430,2,5,202041
18,2,340,21,256,295,37,85,2,1036,964,2000,8,5,202041
18,3,115,6,198,103,4,17,0,443,430,873,4,5,202041
19,1,400,15,367,366,6,94,57,1305,1097,2402,8,5,202041
19,2,327,11,238,226,7,30,4,843,1070,1913,5,5,202041
19,3,378,18,328,185,42,54,7,1012,880,1892,7,5,202041
19,4,278,9,216,185,63,79,74,904,1025,1929,5,5,202041
19,5,516,23,486,447,22,86,38,1618,1497,3115,8,5,202041
19,6,271,16,350,458,7,116,11,1229,910,2139,5,5,202041
19,7,308,10,423,255,2,52,3,1053,827,1880,6,5,202041
19,8,246,9,240,246,4,41,0,786,1103,1889,6,5,202041
19,9,113,3,84,49,15,51,9,324,403,727,2,5,202041
19,10,220,9,239,231,7,71,34,811,803,1614,5,5,202041
19,11,572,37,411,608,11,138,45,1822,1756,3578,12,5,202041
19,12,287,12,407,156,25,29,5,921,642,1563,9,5,202041
20,1,150,4,136,123,28,13,22,476,459,935,3,5,202041
20,2,40,4,45,60,10,5,0,164,248,412,2,5,202041
20,3,124,7,79,76,33,32,26,377,319,696,2,5,202041
20,4,87,2,63,59,14,27,18,270,310,580,2,5,202041
20,5,139,6,128,119,4,16,0,412,433,845,3,5,202041
20,6,120,6,77,72,38,14,13,340,420,760,2,5,202041
20,7,205,8,125,165,21,28,5,557,422,979,3,5,202041
20,8,605,22,600,616,68,120,35,2066,1836,3902,13,5,202041
20,9,305,6,144,156,142,38,37,828,735,1563,6,5,202041
20,10,150,6,109,60,16,4,0,345,309,654,2,5,202041
21,1,349,5,208,214,31,24,0,831,727,1558,4,5,202041
21,2,123,9,78,56,46,14,0,326,285,611,2,5,202041
21,3,280,9,194,182,68,55,16,804,814,1618,5,5,202041
21,4,64,6,31,28,15,18,1,163,220,383,1,5,202041
21,5,266,10,314,187,37,44,15,873,913,1786,6,5,202041
21,6,206,2,133,195,52,52,15,655,840,1495,4,5,202041
21,7,276,7,118,163,84,72,5,725,645,1370,7,5,202041
21,8,123,6,73,71,15,20,15,323,396,719,3,5,202041
21,9,301,10,368,316,53,70,28,1146,965,2111,8,5,202041
21,10,182,6,128,132,7,43,23,521,485,1006,3,5,202041
21,11,134,3,132,123,25,22,7,446,510,956,3,5,202041
21,12,374,24,450,377,91,82,142,1540,1625,3165,7,5,202041
21,13,160,6,123,103,18,46,2,458,503,961,5,5,202041
21,14,76,9,27,43,18,18,6,197,268,465,2,5,202041
21,15,222,3,166,187,10,58,22,668,420,1088,4,5,202041
22,1,233,37,127,187,24,33,2,643,569,1212,3,5,202041
22,2,280,40,294,213,87,28,3,945,810,1755,5,5,202041
22,3,361,17,520,428,15,43,1,1385,1450,2835,7,5,202041
22,4,296,29,536,444,29,54,7,1395,1415,2810,7,5,202041
22,5,287,13,506,274,57,67,24,1228,1140,2368,6,5,202041
23,1,163,5,327,129,23,25,9,681,844,1525,8,4.666666667,202041
23,2,233,7,260,207,15,19,0,741,692,1433,5,5,202041
23,3,301,14,535,340,23,27,3,1243,1486,2729,14,5,202041
23,4,132,5,207,147,14,51,26,582,507,1089,3,5,202041
24,1,119,20,82,95,6,18,0,340,303,643,3,5,202041
24,2,156,15,119,114,21,27,10,462,449,911,4,5,202041
24,3,157,14,125,89,59,22,0,466,347,813,3,5,202041
24,4,156,9,78,103,22,26,42,436,566,1002,3,5,202041
24,5,479,40,503,539,17,62,1,1641,1187,2828,9,5,202041
24,6,169,38,225,237,27,39,0,735,748,1483,3,5,202041
24,7,152,7,55,81,19,3,0,317,361,678,3,5,202041
25,1,292,8,272,301,20,53,59,1005,1049,2054,10,5,202041
25,2,302,27,177,281,14,36,0,837,1020,1857,3,5,202041
25,3,356,13,224,387,37,51,34,1102,946,2048,6,5,202041
25,4,348,15,247,320,107,31,2,1070,643,1713,4,5,202041
25,5,281,18,302,495,17,75,20,1208,939,2147,6,5,202041
25,6,257,9,231,319,29,62,47,954,848,1802,5,5,202041
25,7,293,17,352,402,5,20,0,1089,1364,2453,5,5,202041
26,1,255,8,229,225,8,48,0,773,801,1574,6,5,202041
26,2,367,9,325,397,4,81,1,1184,993,2177,9,5,202041
26,3,416,13,257,320,23,118,23,1170,1051,2221,9,5,202041
26,4,94,6,63,99,4,17,15,298,237,535,3,5,202041
26,5,227,11,160,203,9,100,1,711,473,1184,7,5,202041
26,6,226,9,105,137,12,41,2,532,423,955,5,5,202041
26,7,230,11,147,200,41,17,4,650,715,1365,6,5,202041
27,1,268,4,138,196,40,27,13,686,670,1356,4,5,202041
27,2,359,14,162,397,30,32,15,1009,877,1886,6,5,202041
27,3,271,9,118,310,10,28,0,746,656,1402,4,4,202041
27,4,327,9,181,406,8,77,3,1011,997,2008,5,5,202041
27,5,123,6,70,132,4,15,0,350,292,642,2,5,202041
27,6,225,4,151,404,2,43,0,829,635,1464,5,5,202041
28,1,457,30,548,510,4,43,0,1592,1222,2814,8,5,202041
28,2,369,12,443,260,20,91,156,1351,1268,2619,10,5,202041
28,3,85,6,70,90,12,27,17,307,316,623,3,5,202041
28,4,418,35,381,277,100,103,73,1387,1310,2697,13,5,202041
28,5,283,11,149,206,12,90,23,774,841,1615,4,5,202041
28,6,198,9,121,187,9,24,3,551,592,1143,4,5,202041
28,7,249,16,236,201,58,45,85,890,788,1678,9,5,202041
28,8,253,19,235,220,37,90,84,938,804,1742,12,5,202041
28,9,298,8,342,184,13,86,40,971,704,1675,5,5,202041
29,1,299,12,227,278,32,51,4,903,1260,2163,6,5,202041
29,2,298,13,177,315,15,75,63,956,1008,1964,7,5,202041
29,3,127,11,66,160,4,16,1,385,677,1062,4,5,202041
30,1,103,4,106,97,25,15,22,372,350,722,3,5,202041
30,2,184,10,189,66,7,7,36,499,422,921,4,5,202041
30,3,257,5,175,121,118,67,46,789,662,1451,4,5,202041
30,4,186,7,205,135,35,38,0,606,968,1574,8,5,202041
30,5,347,8,400,236,11,48,0,1050,699,1749,6,3.5,202041
30,6,133,1,120,100,19,19,9,401,581,982,5,5,202041
30,7,122,8,61,85,19,26,27,348,514,862,5,5,202041
30,8,205,12,303,155,62,32,1,770,811,1581,5,5,202041
30,9,261,5,168,141,72,43,49,739,714,1453,4,5,202041
30,10,313,17,447,290,29,70,62,1228,1191,2419,6,5,202041
30,11,194,8,193,158,7,26,5,591,400,991,3,5,202041
30,12,292,8,394,323,23,52,0,1092,1411,2503,10,5,202041
30,13,247,5,136,137,52,43,46,666,545,1211,4,5,202041
30,14,184,9,226,112,34,21,8,594,587,1181,4,5,202041
30,15,340,10,227,252,70,80,75,1054,1306,2360,9,5,202041
30,16,355,9,245,279,50,71,117,1126,932,2058,6,5,202041
30,17,280,10,202,278,24,76,26,896,655,1551,4,5,202041
30,18,100,1,41,73,7,12,7,241,252,493,2,5,202041
30,19,151,4,109,91,8,25,6,394,547,941,5,5,202041
30,20,220,5,106,199,31,29,0,590,506,1096,4,5,202041
31,1,225,2,185,33,108,20,0,573,423,996,4,5,202041
31,2,35,1,46,10,52,4,0,148,187,335,2,5,202041
31,3,482,22,499,246,94,51,0,1394,1699,3093,16,5,202041
31,4,149,9,166,121,81,42,43,611,957,1568,4,5,202041
31,5,98,0,79,36,0,16,2,231,369,600,3,5,202041
32,1,138,20,76,110,16,30,18,408,461,869,4,5,202041
32,2,88,9,50,52,26,25,11,261,306,567,2,5,202041
32,3,281,25,160,268,3,68,8,813,689,1502,7,5,202041
32,4,216,14,160,185,10,22,11,618,588,1206,4,5,202041
1,1,427,50,293,339,36,70,21,1236,1310,2546,12,4.5,202042
1,2,467,49,517,466,33,69,26,1627,1682,3309,15,5,202042
1,3,328,52,450,366,34,81,71,1382,1305,2687,13,5,202042
2,1,372,13,241,317,24,164,30,1161,908,2069,9,5,202042
2,2,203,5,142,272,3,44,0,669,645,1314,5,5,202042
2,3,276,16,221,239,9,114,48,923,1053,1976,7,5,202042
2,4,323,11,287,162,40,35,27,885,880,1765,8,5,202042
2,5,293,19,334,197,79,65,20,1007,1183,2190,8,5,202042
2,6,233,12,239,214,36,81,51,866,792,1658,7,5,202042
2,7,319,7,305,264,32,125,38,1090,918,2008,10,5,202042
2,8,173,6,154,167,8,31,23,562,615,1177,4,5,202042
3,1,235,17,245,289,31,53,12,882,833,1715,9,5,202042
3,2,246,8,475,218,51,35,9,1042,1063,2105,9,4.333333333,202042
4,1,191,4,130,202,32,59,11,629,732,1361,4,4,202042
4,2,123,3,83,144,12,17,22,404,432,836,4,5,202042
5,1,0,0,0,0,0,0,0,0,465,465,6,5,202042
5,2,0,0,0,1,0,0,0,1,199,200,2,5,202042
5,3,0,0,0,0,0,0,0,0,363,363,6,5,202042
5,4,4,0,4,4,0,0,0,12,914,926,6,5,202042
5,5,0,0,3,10,0,0,1,14,920,934,10,5,202042
5,6,0,0,0,2,0,0,0,2,364,366,2,5,202042
5,7,0,0,0,0,0,0,0,0,371,371,5,5,202042
6,1,243,6,207,172,14,55,57,754,900,1654,10,4.6,202042
6,2,158,7,146,106,31,30,19,497,502,999,7,4.333333333,202042
7,1,293,3,127,108,8,30,1,570,354,924,7,3.666666667,202042
7,2,220,6,301,214,65,21,0,827,850,1677,9,3.5,202042
7,3,235,3,123,76,88,14,0,539,685,1224,7,3.666666667,202042
7,4,335,18,171,261,14,57,45,901,671,1572,11,3.8,202042
7,5,265,7,99,216,15,16,0,618,785,1403,11,4.333333333,202042
7,6,351,10,261,279,41,46,25,1013,949,1962,8,3.666666667,202042
7,7,435,22,295,300,67,85,4,1208,1164,2372,8,4,202042
7,8,316,17,158,187,82,32,19,811,637,1448,12,3.5,202042
7,9,280,8,223,336,27,58,11,943,1196,2139,9,4.333333333,202042
7,10,246,3,154,167,41,19,0,630,537,1167,9,4,202042
7,11,67,4,32,36,17,14,0,170,289,459,2,5,202042
7,12,336,5,226,362,8,13,2,952,922,1874,9,4,202042
7,13,209,9,85,224,6,17,0,550,455,1005,9,3.5,202042
8,1,191,7,251,120,1,13,2,585,483,1068,4,5,202042
8,2,440,73,513,369,9,24,2,1430,1553,2983,10,5,202042
8,3,271,14,268,294,17,38,32,934,1066,2000,4,5,202042
8,4,435,18,550,464,38,108,55,1668,1764,3432,8,5,202042
8,5,224,20,113,194,8,19,0,578,687,1265,7,3,202042
8,6,417,24,353,374,40,78,39,1325,1101,2426,5,5,202042
8,7,212,34,169,249,4,43,0,711,569,1280,6,3.5,202042
8,8,411,23,343,505,13,74,10,1379,1788,3167,7,5,202042
8,9,124,1,103,72,32,26,56,414,419,833,4,4,202042
9,1,121,4,83,108,44,12,4,376,437,813,4,5,202042
9,2,339,28,361,548,88,76,5,1445,2244,3689,10,5,202042
9,3,209,3,166,208,28,26,33,673,653,1326,4,5,202042
9,4,320,25,316,491,71,65,38,1326,1308,2634,7,5,202042
9,5,238,6,282,374,57,71,6,1034,1039,2073,7,5,202042
9,6,118,7,120,179,84,32,15,555,683,1238,7,5,202042
9,7,145,6,265,296,6,30,3,751,663,1414,6,5,202042
9,8,91,8,135,165,14,22,14,449,465,914,3,5,202042
9,9,157,1,134,238,48,24,3,605,508,1113,3,5,202042
9,10,96,9,169,169,19,52,9,523,689,1212,3,5,202042
9,11,251,12,263,361,87,100,2,1076,877,1953,7,5,202042
9,12,194,32,311,442,46,64,2,1091,960,2051,7,5,202042
9,13,134,5,126,170,41,29,10,515,613,1128,3,5,202042
9,14,197,5,218,320,64,39,43,886,570,1456,5,5,202042
9,15,219,11,494,409,55,73,66,1327,1349,2676,6,5,202042
9,16,290,66,237,419,37,52,13,1114,1153,2267,11,5,202042
9,17,177,16,345,311,25,52,5,931,831,1762,6,5,202042
9,18,188,5,183,325,73,63,18,855,1022,1877,8,5,202042
9,19,170,12,116,175,69,20,3,565,616,1181,3,5,202042
9,20,101,2,94,108,32,18,17,372,340,712,3,5,202042
9,21,163,5,143,206,38,22,13,590,549,1139,3,5,202042
9,22,110,2,58,96,26,15,16,323,510,833,2,5,202042
9,23,179,18,290,336,54,33,9,919,1288,2207,6,5,202042
9,24,434,25,570,745,193,122,3,2092,1672,3764,11,5,202042
10,1,485,29,291,361,29,113,60,1368,1117,2485,12,3.833333333,202042
10,2,289,10,146,323,5,34,15,822,713,1535,10,3.5,202042
10,3,352,17,166,267,42,83,53,980,816,1796,11,3.8,202042
10,4,438,89,274,410,11,6,1,1229,1140,2369,11,5,202042
11,1,273,36,153,194,47,66,8,777,882,1659,6,4.333333333,202042
11,2,203,15,171,165,38,66,14,672,703,1375,5,3.333333333,202042
11,3,127,14,102,112,24,43,10,432,510,942,3,5,202042
11,4,248,75,178,241,37,58,0,837,969,1806,6,4.333333333,202042
11,5,388,82,376,489,33,110,23,1501,1715,3216,7,5,202042
11,6,335,37,413,437,67,81,35,1405,861,2266,8,5,202042
11,7,460,40,479,440,66,117,3,1605,1204,2809,9,4,202042
11,8,426,47,366,546,83,103,36,1607,1470,3077,9,4.5,202042
11,9,403,48,363,403,15,68,32,1332,1378,2710,10,4.333333333,202042
11,10,303,53,263,266,51,78,51,1065,879,1944,10,4.2,202042
11,11,201,13,154,201,7,39,0,615,682,1297,5,5,202042
11,12,207,36,248,233,12,29,15,780,1002,1782,7,5,202042
11,13,212,32,168,153,41,40,39,685,610,1295,8,4,202042
11,14,233,35,231,214,63,29,0,805,783,1588,8,4,202042
11,15,204,22,179,189,13,46,33,686,688,1374,5,5,202042
12,1,128,12,98,90,15,27,2,372,428,800,2,5,202042
12,2,295,17,257,420,4,68,4,1065,1126,2191,6,5,202042
12,3,209,8,241,204,8,21,11,702,784,1486,3,5,202042
12,4,383,21,389,518,36,72,10,1429,1505,2934,7,5,202042
12,5,153,25,158,99,1,12,62,510,597,1107,4,5,202042
12,6,230,16,155,127,37,9,7,581,608,1189,4,5,202042
12,7,157,21,122,184,7,23,4,518,673,1191,4,5,202042
12,8,165,7,90,101,0,8,0,371,444,815,3,5,202042
12,9,436,29,401,574,44,54,3,1541,1660,3201,7,5,202042
13,1,0,0,0,0,0,0,0,0,198,198,5,5,202042
13,2,0,0,0,0,0,0,0,0,155,155,2,5,202042
13,3,0,0,2,1,0,1,0,4,247,251,5,5,202042
13,4,4,0,2,3,0,2,0,11,367,378,6,5,202042
13,5,0,0,2,8,0,0,0,10,483,493,7,5,202042
13,6,0,0,0,0,0,0,0,0,1057,1057,9,5,202042
13,7,0,0,5,7,0,1,0,13,381,394,5,5,202042
14,1,170,35,118,77,66,47,6,519,459,978,6,4,202042
14,2,206,16,136,76,48,35,1,518,524,1042,4,4.333333333,202042
14,3,265,9,322,158,11,87,3,855,716,1571,7,3.8,202042
14,4,287,19,333,281,24,78,16,1038,1397,2435,8,5,202042
14,5,256,15,258,207,35,48,3,822,878,1700,9,4,202042
14,6,332,13,432,231,16,54,3,1081,1250,2331,7,5,202042
14,7,225,15,224,154,0,16,0,634,631,1265,6,5,202042
14,8,497,37,741,627,16,89,0,2007,1913,3920,9,5,202042
14,9,236,19,170,368,11,49,8,861,932,1793,5,5,202042
14,10,248,23,304,143,17,88,24,847,795,1642,6,5,202042
14,11,237,13,196,189,35,99,41,810,712,1522,4,5,202042
14,12,333,15,349,212,25,15,1,950,876,1826,9,4,202042
14,13,260,22,247,169,4,47,7,756,600,1356,5,5,202042
14,14,246,16,233,248,27,81,12,863,728,1591,5,5,202042
14,15,433,44,310,266,114,97,31,1295,1099,2394,10,4.2,202042
14,16,216,16,218,198,46,61,5,760,886,1646,5,5,202042
14,17,240,26,214,113,31,72,27,723,394,1117,7,3.5,202042
14,18,296,34,298,160,120,57,49,1014,811,1825,9,3.8,202042
14,19,300,18,228,210,48,55,0,859,650,1509,8,3.5,202042
14,20,381,30,481,340,10,36,0,1278,1074,2352,9,4.333333333,202042
15,1,381,13,203,140,286,39,0,1062,701,1763,5,3.666666667,202042
15,2,219,12,188,266,100,34,20,839,857,1696,5,5,202042
15,3,389,15,206,246,264,49,73,1242,1164,2406,8,5,202042
15,4,237,13,122,262,35,23,15,707,676,1383,3,5,202042
15,5,261,21,299,236,24,25,4,870,804,1674,5,4.333333333,202042
15,6,220,9,212,310,22,51,39,863,836,1699,5,5,202042
15,7,272,8,327,163,74,88,2,934,1139,2073,8,5,202042
15,8,197,8,161,311,24,23,24,748,845,1593,3,5,202042
15,9,263,10,103,114,187,119,14,810,807,1617,7,4.5,202042
15,10,181,6,119,247,11,30,8,602,1042,1644,6,5,202042
15,11,237,15,199,265,42,34,8,800,968,1768,5,5,202042
15,12,360,9,453,374,54,63,0,1313,1271,2584,7,5,202042
15,13,101,10,96,148,75,29,0,459,606,1065,5,5,202042
15,14,116,22,90,152,10,40,6,436,672,1108,4,5,202042
15,15,140,47,145,168,54,15,25,594,681,1275,2,5,202042
15,16,323,25,337,607,33,81,31,1437,1799,3236,8,5,202042
15,17,175,9,151,213,46,47,44,685,793,1478,5,5,202042
15,18,392,22,359,411,46,73,19,1322,1171,2493,6,4.333333333,202042
15,19,317,18,368,727,27,80,13,1550,1647,3197,8,5,202042
15,20,133,17,247,285,39,31,2,754,695,1449,5,5,202042
15,21,109,11,87,158,19,36,4,424,403,827,2,5,202042
15,22,341,57,322,558,27,72,63,1440,1907,3347,7,5,202042
15,23,169,5,118,286,19,53,10,660,690,1350,5,3.666666667,202042
15,24,189,23,146,244,26,26,17,671,453,1124,3,5,202042
15,25,241,22,172,246,31,58,38,808,849,1657,4,5,202042
15,26,287,6,212,290,111,37,8,951,910,1861,5,5,202042
15,27,316,16,356,353,15,66,71,1193,1238,2431,8,4.333333333,202042
15,28,399,23,455,316,44,53,46,1336,1156,2492,7,4.333333333,202042
15,29,242,12,285,492,4,69,32,1136,1111,2247,6,5,202042
15,30,393,48,379,424,96,77,43,1460,1964,3424,12,5,202042
15,31,257,130,232,349,14,42,0,1024,1216,2240,4,5,202042
15,32,311,13,184,332,64,71,9,984,1064,2048,7,5,202042
15,33,298,24,326,314,37,47,0,1046,806,1852,6,5,202042
15,34,166,7,158,265,32,27,12,667,713,1380,6,5,202042
15,35,365,17,233,406,9,65,6,1101,898,1999,7,4.333333333,202042
15,36,463,24,303,482,18,57,0,1347,1062,2409,7,4,202042
15,37,341,17,256,445,83,93,15,1250,1261,2511,4,5,202042
15,38,180,33,150,189,30,21,5,608,820,1428,3,5,202042
15,39,208,29,206,232,51,45,7,778,698,1476,4,5,202042
15,40,434,61,294,478,173,88,6,1534,1755,3289,9,5,202042
15,41,322,20,384,370,66,52,46,1260,1772,3032,11,5,202042
16,1,143,6,168,84,5,6,1,413,434,847,3,5,202042
16,2,130,7,105,95,13,26,5,381,547,928,4,4,202042
16,3,276,13,185,324,23,51,3,875,664,1539,10,3.5,202042
16,4,193,23,194,144,28,36,0,618,562,1180,7,4,202042
16,5,186,18,128,232,45,49,15,673,701,1374,7,4.333333333,202042
16,6,326,38,287,232,68,36,2,989,715,1704,12,4,202042
16,7,391,49,294,380,29,59,0,1202,1047,2249,9,4,202042
16,8,427,39,551,595,8,56,1,1677,1645,3322,12,5,202042
16,9,291,25,314,287,17,85,25,1044,817,1861,9,5,202042
16,10,181,18,336,295,14,53,0,897,872,1769,5,5,202042
16,11,208,22,149,126,61,28,3,597,533,1130,10,3.8,202042
16,12,135,16,133,84,0,49,0,417,555,972,3,5,202042
17,1,194,12,218,271,16,30,4,745,868,1613,4,5,202042
17,2,264,10,353,461,12,54,3,1157,1235,2392,7,5,202042
17,3,242,18,271,306,25,76,0,938,1128,2066,5,5,202042
17,4,310,15,438,384,37,42,25,1251,1123,2374,10,4.333333333,202042
17,5,77,10,61,86,24,8,0,266,391,657,3,5,202042
18,1,130,5,69,90,14,11,9,328,264,592,3,4,202042
18,2,302,24,225,276,36,94,3,960,1305,2265,8,5,202042
18,3,106,8,167,106,1,14,0,402,457,859,4,5,202042
19,1,340,21,341,352,10,132,99,1295,1355,2650,8,5,202042
19,2,305,16,273,247,11,32,4,888,1205,2093,5,5,202042
19,3,319,19,336,176,29,64,16,959,1257,2216,7,5,202042
19,4,258,9,188,184,66,67,72,844,1340,2184,5,5,202042
19,5,461,38,454,508,39,93,51,1644,1933,3577,8,5,202042
19,6,236,6,383,471,14,134,22,1266,1179,2445,5,5,202042
19,7,443,15,600,371,8,65,3,1505,1006,2511,10,4,202042
19,8,224,12,290,321,15,56,0,918,884,1802,6,5,202042
19,9,350,11,250,173,16,38,30,868,521,1389,8,3.5,202042
19,10,177,8,221,246,15,75,54,796,995,1791,5,5,202042
19,11,540,35,450,635,9,153,68,1890,1824,3714,12,5,202042
19,12,308,11,602,171,26,27,7,1152,1145,2297,11,4.333333333,202042
20,1,137,2,104,103,31,13,26,416,473,889,3,5,202042
20,2,61,2,50,58,20,6,0,197,261,458,2,5,202042
20,3,122,6,72,70,32,30,12,344,411,755,2,5,202042
20,4,88,1,63,47,19,46,22,286,307,593,2,5,202042
20,5,129,9,171,119,28,9,0,465,300,765,3,5,202042
20,6,167,1,106,82,60,15,11,442,388,830,2,5,202042
20,7,210,5,110,180,17,13,14,549,552,1101,3,5,202042
20,8,593,28,600,680,53,127,32,2113,2068,4181,13,5,202042
20,9,334,5,159,150,142,45,29,864,927,1791,6,5,202042
20,10,131,1,147,78,9,7,0,373,310,683,2,5,202042
21,1,372,18,299,271,35,39,0,1034,999,2033,7,4,202042
21,2,282,13,232,130,122,33,0,812,564,1376,6,3.4,202042
21,3,374,13,293,241,63,68,24,1076,856,1932,8,4,202042
21,4,150,8,102,41,40,24,2,367,328,695,4,3.5,202042
21,5,341,15,408,245,29,42,13,1093,1180,2273,7,4.333333333,202042
21,6,214,9,163,211,56,62,16,731,815,1546,4,5,202042
21,7,239,10,135,189,77,68,1,719,815,1534,7,5,202042
21,8,113,2,50,89,17,29,24,324,445,769,3,5,202042
21,9,262,11,391,338,74,65,34,1175,1228,2403,8,5,202042
21,10,184,4,132,131,16,69,36,572,624,1196,3,5,202042
21,11,138,3,152,144,42,11,2,492,499,991,2,5,202042
21,12,316,22,437,357,98,70,151,1451,2072,3523,7,5,202042
21,13,136,4,157,108,20,44,4,473,591,1064,5,5,202042
21,14,187,7,117,91,43,44,7,496,332,828,6,3.666666667,202042
21,15,312,6,207,253,26,72,30,906,1005,1911,6,4,202042
22,1,886,97,409,553,45,68,0,2058,1013,3071,11,3.4,202042
22,2,337,32,367,265,115,33,5,1154,935,2089,7,4,202042
22,3,480,69,618,517,24,61,3,1772,1650,3422,9,4.333333333,202042
22,4,290,34,606,479,25,74,10,1518,1581,3099,7,5,202042
22,5,534,44,761,402,127,92,49,2009,1354,3363,10,4,202042
23,1,95,5,231,71,7,16,6,431,573,1004,8,3,202042
23,2,477,12,474,340,20,25,0,1348,916,2264,10,3.5,202042
23,3,118,3,194,131,9,4,0,459,624,1083,14,2,202042
23,4,95,4,144,80,9,21,10,363,364,727,5,3,202042
24,1,109,22,84,109,5,23,0,352,347,699,3,5,202042
24,2,143,11,143,111,18,21,15,462,484,946,4,5,202042
24,3,160,19,89,107,68,27,0,470,418,888,3,5,202042
24,4,132,13,86,86,28,32,60,437,388,825,3,5,202042
24,5,388,41,547,539,19,48,0,1582,1468,3050,9,5,202042
24,6,186,58,269,248,19,30,0,810,641,1451,3,5,202042
24,7,154,8,72,80,18,3,0,335,325,660,3,5,202042
25,1,273,15,262,312,25,71,59,1017,1065,2082,10,5,202042
25,2,286,26,243,350,19,51,0,975,1107,2082,3,5,202042
25,3,401,17,233,407,35,49,27,1169,1157,2326,7,4.5,202042
25,4,303,13,256,326,61,30,1,990,984,1974,6,4,202042
25,5,306,14,303,478,36,72,17,1226,1335,2561,6,5,202042
25,6,272,15,307,348,46,65,49,1102,1001,2103,6,4.5,202042
25,7,331,14,387,418,8,25,0,1183,1233,2416,5,5,202042
26,1,244,8,227,241,3,48,0,771,801,1572,8,4.333333333,202042
26,2,383,13,289,388,2,68,0,1143,1123,2266,10,4.333333333,202042
26,3,380,12,238,280,18,87,17,1032,1044,2076,9,5,202042
26,4,207,10,113,152,31,26,13,552,319,871,7,3.4,202042
26,5,270,7,140,207,20,102,2,748,612,1360,7,5,202042
26,6,254,18,131,152,8,67,3,633,542,1175,6,4,202042
26,7,226,12,182,272,42,35,2,771,699,1470,8,4.333333333,202042
27,1,252,6,136,262,46,27,9,738,822,1560,4,5,202042
27,2,372,10,185,448,21,38,26,1100,1171,2271,6,5,202042
27,3,275,6,119,348,18,31,0,797,909,1706,4,4,202042
27,4,308,6,212,453,10,79,3,1071,1203,2274,5,5,202042
27,5,124,1,97,158,3,9,0,392,407,799,2,5,202042
27,6,235,4,159,399,9,66,0,872,974,1846,5,5,202042
28,1,373,30,499,433,8,53,0,1396,1494,2890,13,5,202042
28,2,368,31,440,292,41,97,178,1447,1729,3176,13,5,202042
28,3,179,5,156,190,12,25,17,584,503,1087,7,3.666666667,202042
28,4,394,37,413,295,81,96,77,1393,1587,2980,17,5,202042
28,5,299,16,180,312,17,99,40,963,1046,2009,5,4,202042
28,6,409,13,219,380,34,39,16,1110,974,2084,12,3.4,202042
28,7,258,12,225,227,44,49,79,894,1039,1933,13,5,202042
28,8,242,17,233,236,37,90,65,920,836,1756,12,5,202042
28,9,291,13,389,222,26,85,38,1064,924,1988,9,5,202042
29,1,298,15,234,321,34,47,9,958,1246,2204,6,5,202042
29,2,304,3,200,315,32,77,58,989,1109,2098,7,5,202042
29,3,153,5,82,152,15,31,0,438,722,1160,4,5,202042
30,1,181,7,146,127,22,17,39,539,512,1051,5,4,202042
30,2,331,17,255,137,64,18,143,965,623,1588,10,3.5,202042
30,3,310,11,209,133,139,64,84,950,876,1826,6,4.333333333,202042
30,4,174,3,231,150,49,41,0,648,1009,1657,8,5,202042
30,5,423,15,491,317,14,50,0,1310,866,2176,8,4.333333333,202042
30,6,234,5,226,133,46,23,11,678,552,1230,9,3.666666667,202042
30,7,158,4,97,98,31,33,26,447,673,1120,7,4,202042
30,8,375,10,427,200,80,62,5,1159,812,1971,11,3.8,202042
30,9,329,7,269,179,122,72,64,1042,830,1872,8,4,202042
30,10,343,13,472,291,42,69,77,1307,1205,2512,6,5,202042
30,11,223,14,276,239,13,31,23,819,633,1452,5,4,202042
30,12,283,8,374,315,20,58,0,1058,1685,2743,10,5,202042
30,13,450,16,216,192,101,78,68,1121,800,1921,10,3.8,202042
30,14,230,5,216,160,37,37,26,711,907,1618,6,4.333333333,202042
30,15,387,18,269,261,88,93,106,1222,1152,2374,11,4.333333333,202042
30,16,377,5,280,286,61,77,152,1238,1160,2398,8,4,202042
30,17,342,14,254,283,32,93,23,1041,798,1839,8,4,202042
30,18,206,8,111,139,24,33,30,551,357,908,6,3.666666667,202042
30,19,228,8,165,184,23,34,13,655,941,1596,9,4,202042
30,20,309,9,136,222,61,22,0,759,626,1385,6,4.333333333,202042
31,1,83,2,84,21,32,9,0,231,339,570,4,3,202042
31,2,27,0,26,3,25,2,0,83,91,174,2,3,202042
31,3,237,18,266,165,48,26,1,761,1379,2140,16,3,202042
31,4,90,4,111,76,35,17,28,361,558,919,4,3,202042
31,5,84,1,63,33,0,8,1,190,332,522,3,4,202042
32,1,145,16,99,103,17,33,19,432,577,1009,4,5,202042
32,2,110,9,53,52,24,19,17,284,342,626,2,5,202042
32,3,222,21,130,260,4,50,19,706,896,1602,7,5,202042
32,4,267,19,190,244,13,48,15,796,700,1496,4,5,202042
1,1,451,46,322,292,34,85,15,1245,1358,2603,12,5,202043
1,2,462,52,475,447,52,52,32,1572,1781,3353,15,5,202043
1,3,322,57,429,312,32,58,51,1261,1483,2744,13,5,202043
2,1,409,11,225,342,25,159,23,1194,851,2045,9,5,202043
2,2,187,11,165,334,4,46,0,747,800,1547,5,5,202043
2,3,301,14,346,290,13,151,54,1169,1219,2388,9,5,202043
2,4,284,7,298,138,43,40,22,832,868,1700,8,5,202043
2,5,406,11,507,301,127,95,22,1469,1048,2517,10,5,202043
2,6,252,4,262,205,30,72,37,862,818,1680,7,5,202043
2,7,343,17,344,259,16,126,38,1143,932,2075,10,5,202043
2,8,208,4,160,145,16,19,21,573,580,1153,4,5,202043
3,1,240,9,255,309,34,54,14,915,865,1780,6,5,202043
3,2,269,19,522,212,68,39,16,1145,1093,2238,7,5,202043
4,1,361,15,185,288,61,84,16,1010,1078,2088,6,4.5,202043
4,2,435,17,224,306,20,57,44,1103,789,1892,8,5,202043
5,1,0,0,0,0,0,0,0,0,201,201,6,5,202043
5,2,0,0,0,2,0,0,0,2,101,103,2,5,202043
5,3,0,0,0,0,0,0,0,0,133,133,6,5,202043
5,4,0,0,3,7,0,0,1,11,289,300,6,5,202043
5,5,0,0,2,3,0,1,0,6,537,543,10,5,202043
5,6,1,0,0,1,0,0,0,2,254,256,2,5,202043
5,7,0,0,0,0,0,0,0,0,105,105,5,5,202043
6,1,256,10,271,205,15,60,50,867,903,1770,10,5,202043
6,2,190,9,175,156,33,48,24,635,464,1099,7,5,202043
7,1,404,7,196,142,13,27,0,789,423,1212,7,5,202043
7,2,493,10,521,483,67,23,0,1597,1092,2689,9,5,202043
7,3,384,9,186,110,122,35,1,847,595,1442,7,5,202043
7,4,551,22,302,437,29,105,56,1502,634,2136,11,5,202043
7,5,339,14,127,224,20,17,0,741,783,1524,11,5,202043
7,6,430,15,462,369,46,36,23,1381,838,2219,8,5,202043
7,7,584,28,429,397,88,94,6,1626,1214,2840,8,5,202043
7,8,480,23,213,298,58,67,27,1166,668,1834,12,5,202043
7,9,339,14,244,327,27,71,24,1046,1132,2178,9,5,202043
7,10,255,4,241,202,88,22,0,812,571,1383,9,5,202043
7,11,115,0,48,36,13,4,0,216,323,539,6,5,202043
7,12,430,6,272,407,4,12,3,1134,1010,2144,9,5,202043
7,13,328,24,180,362,1,26,0,921,842,1763,7,3.75,202043
8,1,210,3,244,154,0,7,0,618,596,1214,4,5,202043
8,2,609,61,681,516,11,52,1,1931,1514,3445,12,5,202043
8,3,285,29,330,305,52,37,42,1080,1032,2112,4,5,202043
8,4,433,22,427,399,50,91,82,1504,1616,3120,8,5,202043
8,5,479,57,325,443,42,61,2,1409,808,2217,9,5,202043
8,6,393,33,372,381,34,64,51,1328,1347,2675,5,5,202043
8,7,341,59,249,346,13,51,2,1061,574,1635,6,5,202043
8,8,459,30,442,597,20,98,8,1654,1767,3421,7,5,202043
8,9,312,33,206,170,43,58,61,883,635,1518,10,3.8,202043
9,1,115,8,93,118,48,23,3,408,430,838,4,5,202043
9,2,404,32,401,625,111,90,3,1666,2018,3684,10,5,202043
9,3,213,7,178,216,38,30,23,705,852,1557,4,5,202043
9,4,333,18,274,519,71,65,39,1319,1427,2746,7,5,202043
9,5,245,3,225,360,54,67,12,966,1042,2008,7,5,202043
9,6,138,20,124,169,72,21,3,547,663,1210,7,5,202043
9,7,168,8,250,323,16,38,0,803,722,1525,6,5,202043
9,8,91,4,160,209,22,20,10,516,498,1014,3,5,202043
9,9,179,12,131,215,60,20,7,624,577,1201,3,5,202043
9,10,103,6,169,182,18,62,3,543,751,1294,3,5,202043
9,11,227,19,244,337,102,95,1,1025,1059,2084,7,5,202043
9,12,213,23,346,483,32,51,1,1149,935,2084,7,5,202043
9,13,147,12,149,162,41,22,16,549,662,1211,3,5,202043
9,14,164,10,219,283,54,37,56,823,708,1531,5,5,202043
9,15,197,12,491,435,59,90,39,1323,1438,2761,6,5,202043
9,16,308,66,249,432,45,51,13,1164,1064,2228,11,5,202043
9,17,210,28,368,264,23,44,6,943,811,1754,6,5,202043
9,18,236,9,177,347,101,74,2,946,1012,1958,8,5,202043
9,19,226,31,166,269,78,40,23,833,555,1388,3,5,202043
9,20,90,2,68,118,54,20,20,372,351,723,3,5,202043
9,21,182,9,128,197,41,26,10,593,558,1151,3,5,202043
9,22,120,11,71,96,29,16,12,355,642,997,2,5,202043
9,23,166,16,322,381,68,44,16,1013,1324,2337,6,5,202043
9,24,436,23,577,724,154,109,5,2028,2096,4124,11,5,202043
10,1,606,66,354,471,59,98,78,1732,1008,2740,12,4.833333333,202043
10,2,306,31,206,361,17,45,12,978,636,1614,10,5,202043
10,3,504,31,224,374,53,78,90,1354,803,2157,11,5,202043
10,4,417,95,316,465,15,11,1,1320,1213,2533,11,5,202043
11,1,325,51,218,197,62,56,17,926,943,1869,6,5,202043
11,2,241,27,203,187,69,86,13,826,1176,2002,6,5,202043
11,3,133,24,91,99,27,48,10,432,484,916,3,5,202043
11,4,278,62,203,256,63,59,2,923,959,1882,6,5,202043
11,5,339,84,368,461,20,79,12,1363,2239,3602,7,5,202043
11,6,427,38,379,388,53,123,46,1454,1108,2562,8,5,202043
11,7,477,46,498,500,57,81,4,1663,1560,3223,9,5,202043
11,8,461,56,409,510,113,118,36,1703,1473,3176,9,5,202043
11,9,361,61,319,488,7,76,9,1321,1367,2688,10,5,202043
11,10,295,64,330,298,45,80,63,1175,943,2118,10,5,202043
11,11,221,15,168,194,6,33,0,637,697,1334,5,5,202043
11,12,212,50,225,267,20,36,11,821,1235,2056,7,5,202043
11,13,315,44,226,225,62,43,42,957,606,1563,8,5,202043
11,14,300,52,246,257,77,37,0,969,813,1782,8,5,202043
11,15,186,30,161,198,10,78,13,676,591,1267,5,5,202043
12,1,139,10,110,108,25,30,4,426,478,904,4,3,202043
12,2,329,30,256,437,9,47,0,1108,1130,2238,6,5,202043
12,3,318,24,280,319,19,35,5,1000,954,1954,5,5,202043
12,4,365,44,409,581,44,80,4,1527,1471,2998,7,5,202043
12,5,203,21,131,92,2,18,68,535,651,1186,4,5,202043
12,6,409,29,197,329,30,9,16,1019,1027,2046,6,5,202043
12,7,192,6,140,232,5,39,0,614,733,1347,4,5,202043
12,8,240,14,118,143,1,11,0,527,610,1137,5,5,202043
12,9,381,27,317,488,37,59,1,1310,1640,2950,7,5,202043
13,1,0,0,0,0,0,0,0,0,110,110,5,5,202043
13,2,0,0,0,0,0,0,0,0,308,308,2,5,202043
13,3,1,0,0,0,0,0,0,1,61,62,5,5,202043
13,4,0,0,1,3,0,1,0,5,347,352,6,5,202043
13,5,1,0,2,376,2,0,0,381,281,662,7,5,202043
13,6,0,0,0,0,0,0,0,0,628,628,9,5,202043
13,7,1,0,3,5,0,0,0,9,282,291,5,5,202043
14,1,219,31,181,124,60,59,14,688,483,1171,6,5,202043
14,2,201,21,119,77,70,43,6,537,572,1109,4,5,202043
14,3,468,33,454,125,35,98,24,1237,688,1925,7,5,202043
14,4,327,10,376,270,20,68,32,1103,1187,2290,8,5,202043
14,5,324,22,328,224,51,45,0,994,904,1898,9,5,202043
14,6,333,14,411,203,11,65,4,1041,1185,2226,7,5,202043
14,7,212,12,264,157,0,10,0,655,522,1177,6,5,202043
14,8,476,33,694,623,18,88,4,1936,2013,3949,9,5,202043
14,9,141,8,139,259,3,24,1,575,961,1536,5,5,202043
14,10,240,25,306,179,17,79,28,874,886,1760,6,5,202043
14,11,253,21,182,197,45,74,21,793,770,1563,4,5,202043
14,12,382,16,421,242,53,39,0,1153,798,1951,9,5,202043
14,13,226,16,219,158,11,57,12,699,859,1558,5,5,202043
14,14,231,17,221,240,34,81,17,841,925,1766,5,5,202043
14,15,519,43,375,309,119,84,41,1490,1212,2702,10,5,202043
14,16,240,15,193,170,51,76,11,756,894,1650,5,5,202043
14,17,335,41,299,159,40,101,18,993,416,1409,7,5,202043
14,18,338,28,304,202,140,73,56,1141,972,2113,7,5,202043
14,19,398,34,372,259,80,67,11,1221,718,1939,8,5,202043
14,20,512,30,529,360,9,57,0,1497,1215,2712,9,5,202043
15,1,391,16,235,128,419,48,1,1238,811,2049,5,5,202043
15,2,268,9,211,252,109,37,24,910,834,1744,5,5,202043
15,3,410,23,183,289,235,51,72,1263,1393,2656,8,5,202043
15,4,217,9,141,306,44,40,17,774,749,1523,3,5,202043
15,5,276,25,240,244,44,44,15,888,919,1807,5,5,202043
15,6,229,7,186,355,24,56,29,886,1051,1937,5,5,202043
15,7,264,16,327,172,87,46,7,919,994,1913,8,5,202043
15,8,183,14,167,276,18,40,17,715,751,1466,3,5,202043
15,9,354,24,123,137,151,135,9,933,821,1754,7,5,202043
15,10,175,9,140,248,18,41,12,643,1040,1683,6,5,202043
15,11,250,9,183,274,35,27,3,781,1038,1819,5,5,202043
15,12,357,9,418,373,46,35,0,1238,1357,2595,7,5,202043
15,13,137,8,72,140,65,34,0,456,594,1050,5,5,202043
15,14,133,10,95,216,19,40,6,519,683,1202,4,5,202043
15,15,102,36,131,169,34,35,31,538,710,1248,2,5,202043
15,16,365,32,341,590,29,79,23,1459,1895,3354,8,5,202043
15,17,175,4,140,231,26,39,47,662,876,1538,5,5,202043
15,18,482,28,386,415,48,96,24,1479,1218,2697,6,5,202043
15,19,394,42,347,778,23,84,30,1698,1710,3408,8,5,202043
15,20,141,13,257,235,33,23,3,705,771,1476,5,5,202043
15,21,211,15,163,190,60,58,15,712,446,1158,3,5,202043
15,22,371,86,338,634,28,88,29,1574,1533,3107,7,5,202043
15,23,269,14,187,335,23,61,13,902,811,1713,5,5,202043
15,24,200,8,143,228,17,22,23,641,726,1367,3,5,202043
15,25,243,29,188,245,60,38,32,835,878,1713,4,5,202043
15,26,312,5,210,311,120,27,5,990,1092,2082,5,5,202043
15,27,327,21,357,350,14,69,90,1228,1228,2456,8,5,202043
15,28,473,37,506,341,50,53,49,1509,1227,2736,7,5,202043
15,29,295,15,271,487,16,69,21,1174,1345,2519,6,5,202043
15,30,427,36,383,443,81,61,43,1474,1967,3441,12,5,202043
15,31,279,79,225,331,25,39,1,979,1304,2283,4,5,202043
15,32,288,8,223,359,58,75,13,1024,1477,2501,7,5,202043
15,33,291,16,317,311,40,43,0,1018,969,1987,6,5,202043
15,34,168,6,177,311,15,42,6,725,683,1408,6,5,202043
15,35,384,16,288,452,13,56,10,1219,1040,2259,7,5,202043
15,36,455,15,349,530,74,61,0,1484,1137,2621,7,5,202043
15,37,354,22,298,448,85,96,17,1320,1314,2634,4,5,202043
15,38,180,43,166,198,24,27,1,639,835,1474,3,5,202043
15,39,227,28,186,267,39,44,5,796,727,1523,4,5,202043
15,40,468,33,274,455,143,77,11,1461,1955,3416,9,5,202043
15,41,351,15,344,356,54,50,38,1208,1783,2991,11,5,202043
16,1,273,21,271,157,33,19,0,774,565,1339,5,5,202043
16,2,266,35,158,276,32,42,4,813,606,1419,9,5,202043
16,3,288,15,172,290,39,50,0,854,893,1747,10,5,202043
16,4,259,15,212,165,58,42,0,751,670,1421,8,5,202043
16,5,213,15,148,176,22,61,34,669,665,1334,7,5,202043
16,6,380,52,293,300,80,32,1,1138,893,2031,12,5,202043
16,7,398,51,291,373,41,52,1,1207,1327,2534,9,5,202043
16,8,457,27,604,539,9,56,0,1692,1663,3355,12,5,202043
16,9,305,31,287,317,12,85,31,1068,956,2024,9,5,202043
16,10,227,16,319,308,13,42,0,925,914,1839,5,5,202043
16,11,176,20,167,141,44,31,1,580,635,1215,10,5,202043
16,12,337,36,322,202,40,97,8,1042,666,1708,8,5,202043
17,1,173,17,202,289,15,37,1,734,1082,1816,4,5,202043
17,2,287,15,337,417,10,56,4,1126,1103,2229,7,5,202043
17,3,355,12,356,375,18,81,0,1197,1149,2346,7,5,202043
17,4,310,20,581,349,40,66,34,1400,1208,2608,10,5,202043
17,5,82,5,81,94,15,11,2,290,487,777,3,5,202043
18,1,122,8,78,137,21,24,15,405,350,755,3,5,202043
18,2,300,24,284,325,49,93,0,1075,1272,2347,8,5,202043
18,3,184,13,192,132,4,29,1,555,506,1061,5,5,202043
19,1,311,24,326,366,12,118,101,1258,1510,2768,8,5,202043
19,2,325,9,280,205,9,40,0,868,1224,2092,5,5,202043
19,3,292,10,320,191,23,54,13,903,1383,2286,7,5,202043
19,4,209,7,188,152,38,74,77,745,1361,2106,5,5,202043
19,5,479,37,415,503,39,84,77,1634,1993,3627,8,5,202043
19,6,253,10,358,450,13,99,35,1218,1251,2469,5,5,202043
19,7,468,12,641,421,18,63,3,1626,842,2468,10,5,202043
19,8,235,13,313,315,16,42,0,934,779,1713,6,5,202043
19,9,494,27,347,354,53,47,19,1341,567,1908,8,5,202043
19,10,161,6,250,253,8,61,63,802,1123,1925,5,5,202043
19,11,532,34,472,665,12,168,89,1972,2158,4130,12,5,202043
19,12,338,10,582,189,22,23,3,1167,1337,2504,11,5,202043
20,1,237,11,172,211,54,34,40,759,545,1304,5,5,202043
20,2,207,17,240,208,76,6,1,755,521,1276,6,5,202043
20,3,284,17,278,161,131,41,15,927,761,1688,6,5,202043
20,4,279,8,191,165,56,90,69,858,503,1361,6,5,202043
20,5,392,20,299,342,51,27,0,1131,878,2009,7,5,202043
20,6,229,8,122,94,62,28,20,563,558,1121,4,5,202043
20,7,225,9,127,207,34,33,9,644,679,1323,4,5,202043
20,8,599,32,647,733,53,138,80,2282,2100,4382,13,5,202043
20,9,451,9,243,288,171,143,43,1348,1304,2652,8,5,202043
20,10,424,10,459,226,40,31,12,1202,958,2160,9,5,202043
21,1,405,16,394,306,35,35,0,1191,916,2107,7,5,202043
21,2,406,23,364,148,252,31,2,1226,736,1962,6,5,202043
21,3,404,13,313,254,102,70,34,1190,1076,2266,8,5,202043
21,4,190,3,113,82,50,47,1,486,291,777,4,5,202043
21,5,354,25,371,224,37,62,13,1086,1384,2470,7,5,202043
21,6,206,6,162,204,58,91,24,751,1028,1779,4,5,202043
21,7,229,8,140,188,68,66,3,702,1046,1748,7,5,202043
21,8,588,13,381,236,105,87,43,1453,761,2214,8,5,202043
21,9,298,12,333,353,73,62,35,1166,1554,2720,8,5,202043
21,10,156,5,137,127,12,51,42,530,886,1416,3,5,202043
21,11,146,2,170,115,37,19,9,498,479,977,2,5,202043
21,12,320,21,399,358,76,51,101,1326,2193,3519,7,5,202043
21,13,152,2,161,121,25,40,4,505,599,1104,5,5,202043
21,14,198,8,170,101,90,51,10,628,390,1018,6,5,202043
21,15,382,10,202,308,23,41,42,1008,994,2002,6,5,202043
22,1,611,120,369,543,50,60,0,1753,1214,2967,11,5,202043
22,2,340,33,354,257,116,46,2,1148,1156,2304,7,5,202043
22,3,495,57,636,519,16,40,5,1768,1795,3563,9,5,202043
22,4,325,32,584,416,33,73,12,1475,1676,3151,7,5,202043
22,5,502,42,720,438,166,89,45,2002,1573,3575,10,5,202043
23,1,272,8,508,149,32,40,11,1020,974,1994,9,4.75,202043
23,2,490,14,469,343,41,27,0,1384,964,2348,10,5,202043
23,3,350,17,602,364,28,34,8,1403,1549,2952,14,5,202043
23,4,241,6,424,241,20,60,19,1011,840,1851,5,5,202043
24,1,103,12,63,104,5,14,0,301,382,683,3,5,202043
24,2,142,11,126,139,15,24,9,466,462,928,4,5,202043
24,3,186,21,110,92,41,17,1,468,479,947,3,5,202043
24,4,186,10,86,104,26,29,49,490,490,980,3,5,202043
24,5,430,47,457,507,10,56,1,1508,1533,3041,9,5,202043
24,6,225,55,238,243,21,23,0,805,902,1707,3,5,202043
24,7,143,7,66,83,11,5,0,315,356,671,3,5,202043
25,1,309,10,234,309,29,52,56,999,1109,2108,10,5,202043
25,2,312,25,222,390,18,62,1,1030,1093,2123,3,5,202043
25,3,408,13,237,422,35,62,22,1199,1194,2393,7,5,202043
25,4,311,16,234,334,54,26,3,978,1090,2068,6,5,202043
25,5,346,16,312,455,27,77,11,1244,1493,2737,6,5,202043
25,6,366,10,333,337,52,71,36,1205,1005,2210,6,5,202043
25,7,327,9,368,363,3,26,0,1096,1196,2292,5,5,202043
26,1,277,4,229,260,3,48,0,821,871,1692,8,5,202043
26,2,473,11,325,445,6,77,0,1337,1150,2487,10,5,202043
26,3,386,16,246,265,24,99,24,1060,1110,2170,8,5,202043
26,4,288,7,201,226,39,39,15,815,353,1168,7,5,202043
26,5,275,7,161,226,9,88,1,767,755,1522,7,5,202043
26,6,239,9,140,210,10,47,8,663,521,1184,6,5,202043
26,7,262,15,192,265,50,31,2,817,700,1517,8,5,202043
27,1,554,12,289,518,52,50,9,1484,1003,2487,8,5,202043
27,2,492,20,324,493,28,37,26,1420,1122,2542,8,5,202043
27,3,395,10,206,532,11,39,0,1193,877,2070,6,5,202043
27,4,420,9,379,539,12,94,7,1460,1172,2632,7,5,202043
27,5,434,7,218,358,19,51,9,1096,731,1827,6,5,202043
27,6,391,17,271,545,8,60,0,1292,1251,2543,7,5,202043
28,1,374,27,515,453,6,46,0,1421,1477,2898,13,5,202043
28,2,421,39,534,320,40,105,202,1661,1737,3398,15,5,202043
28,3,308,28,251,254,13,41,8,903,529,1432,7,5,202043
28,4,401,28,381,285,106,120,93,1414,1415,2829,17,5,202043
28,5,359,13,193,304,18,89,56,1032,1052,2084,5,5,202043
28,6,532,21,314,478,28,32,10,1415,892,2307,12,5,202043
28,7,250,20,241,227,61,49,77,925,1129,2054,13,5,202043
28,8,229,18,225,225,43,92,76,908,784,1692,12,5,202043
28,9,242,13,332,196,16,90,68,957,964,1921,9,5,202043
29,1,412,14,296,348,41,56,7,1174,1117,2291,6,5,202043
29,2,361,12,231,400,31,87,75,1197,1071,2268,7,5,202043
29,3,217,13,105,227,18,29,0,609,646,1255,4,5,202043
30,1,228,6,163,161,71,17,52,698,497,1195,5,5,202043
30,2,394,28,350,148,95,41,252,1308,558,1866,10,5,202043
30,3,338,13,246,147,123,63,96,1026,952,1978,6,5,202043
30,4,193,5,265,201,36,39,0,739,941,1680,8,5,202043
30,5,400,10,495,311,10,47,0,1273,1093,2366,9,5,202043
30,6,359,13,378,232,57,40,23,1102,614,1716,9,5,202043
30,7,234,10,131,138,55,31,41,640,765,1405,7,5,202043
30,8,453,18,548,302,120,62,28,1531,1071,2602,11,5,202043
30,9,390,7,281,205,103,55,62,1103,917,2020,8,5,202043
30,10,391,15,463,264,42,71,57,1303,1465,2768,6,5,202043
30,11,293,8,323,333,15,27,13,1012,887,1899,5,5,202043
30,12,344,18,480,372,25,78,0,1317,1587,2904,10,5,202043
30,13,503,28,270,262,111,114,129,1417,940,2357,10,5,202043
30,14,206,9,220,174,34,44,32,719,979,1698,6,5,202043
30,15,449,9,294,269,109,96,107,1333,1199,2532,11,5,202043
30,16,362,10,278,307,74,84,157,1272,1302,2574,8,5,202043
30,17,442,15,320,401,40,88,46,1352,810,2162,8,5,202043
30,18,329,16,158,198,54,60,50,865,327,1192,6,5,202043
30,19,289,9,233,258,18,50,12,869,648,1517,9,5,202043
30,20,296,16,138,307,49,32,2,840,786,1626,6,5,202043
31,1,312,10,222,43,107,26,0,720,1133,1853,8,4.75,202043
31,2,332,8,164,12,294,46,0,856,455,1311,4,5,202043
31,3,491,34,593,333,97,55,2,1605,2324,3929,16,5,202043
31,4,209,10,299,181,134,36,53,922,845,1767,4,5,202043
31,5,364,1,251,130,25,60,8,839,395,1234,5,5,202043
32,1,305,33,172,184,39,71,66,870,749,1619,8,5,202043
32,2,582,52,312,220,135,82,62,1445,747,2192,11,5,202043
32,3,471,63,265,434,20,77,22,1352,1136,2488,11,5,202043
32,4,519,48,269,402,33,84,14,1369,926,2295,8,5,202043
1,1,525,35,325,335,46,70,12,1348,1362,2710,12,5,202044
1,2,494,50,563,508,43,57,21,1736,1798,3534,15,5,202044
1,3,388,35,440,339,41,72,55,1370,1555,2925,13,5,202044
2,1,463,10,272,346,27,157,24,1299,842,2141,9,5,202044
2,2,224,9,195,358,7,58,0,851,861,1712,5,5,202044
2,3,396,15,341,311,16,123,53,1255,1364,2619,9,5,202044
2,4,282,10,294,150,33,25,16,810,1001,1811,8,5,202044
2,5,432,13,578,348,114,98,32,1615,1198,2813,10,5,202044
2,6,244,8,286,186,20,66,34,844,836,1680,7,5,202044
2,7,349,16,337,271,36,120,51,1180,966,2146,10,5,202044
2,8,229,14,273,236,36,32,43,863,613,1476,4,5,202044
3,1,431,5,455,341,26,105,18,1381,1067,2448,8,5,202044
3,2,274,8,542,244,51,37,4,1160,1163,2323,7,5,202044
4,1,342,10,228,320,73,80,42,1095,917,2012,6,5,202044
4,2,335,18,279,277,33,43,81,1066,656,1722,8,5,202044
5,1,511,23,250,274,15,98,38,1209,227,1436,8,5,202044
5,2,453,21,250,235,15,68,4,1046,117,1163,10,5,202044
5,3,411,26,232,220,37,141,13,1080,140,1220,10,5,202044
5,4,539,51,439,379,11,128,24,1571,397,1968,8,5,202044
5,5,530,35,322,290,14,157,48,1396,448,1844,9,5,202044
5,6,237,18,143,187,5,47,40,677,332,1009,4,5,202044
5,7,323,23,180,234,21,49,5,835,96,931,7,5,202044
6,1,228,16,303,211,12,74,66,910,893,1803,10,5,202044
6,2,194,5,195,165,49,32,24,664,516,1180,7,5,202044
7,1,386,8,219,139,10,34,0,796,484,1280,7,5,202044
7,2,632,9,453,580,94,34,0,1802,1396,3198,9,5,202044
7,3,339,4,194,108,140,34,0,819,483,1302,7,5,202044
7,4,455,16,295,399,15,93,41,1314,832,2146,11,5,202044
7,5,348,10,150,294,22,35,0,859,862,1721,11,5,202044
7,6,392,19,387,386,49,44,24,1301,1055,2356,8,5,202044
7,7,498,19,420,312,82,113,8,1452,1315,2767,8,5,202044
7,8,456,38,223,311,59,71,28,1186,896,2082,12,5,202044
7,9,362,15,308,401,36,75,15,1212,1159,2371,9,5,202044
7,10,220,5,219,188,129,20,0,781,782,1563,9,5,202044
7,11,271,3,180,116,42,24,0,636,406,1042,6,5,202044
7,12,406,10,318,427,7,19,15,1202,1201,2403,9,5,202044
7,13,340,12,210,414,2,43,0,1021,928,1949,7,3.75,202044
8,1,215,5,271,119,5,18,7,640,640,1280,4,5,202044
8,2,549,54,614,508,14,44,3,1786,1437,3223,12,5,202044
8,3,242,20,253,293,19,42,33,902,1190,2092,4,5,202044
8,4,410,37,416,366,40,80,75,1424,1597,3021,8,5,202044
8,5,409,52,275,376,51,42,0,1205,659,1864,9,5,202044
8,6,298,26,312,335,31,69,44,1115,1376,2491,5,5,202044
8,7,304,70,234,306,15,52,0,981,648,1629,6,5,202044
8,8,426,19,425,634,19,87,28,1638,1764,3402,7,5,202044
8,9,371,29,261,272,71,98,66,1168,620,1788,10,5,202044
9,1,107,3,85,129,38,21,5,388,463,851,4,5,202044
9,2,373,27,464,730,102,76,4,1776,2136,3912,10,5,202044
9,3,205,6,164,247,31,25,31,709,834,1543,4,5,202044
9,4,304,21,333,572,56,51,33,1370,1472,2842,7,5,202044
9,5,260,6,282,394,70,69,0,1081,992,2073,7,5,202044
9,6,144,20,123,210,84,20,3,604,656,1260,7,5,202044
9,7,153,9,266,369,2,30,5,834,827,1661,6,5,202044
9,8,108,4,203,245,14,21,17,612,647,1259,3,5,202044
9,9,150,2,169,227,47,28,4,627,570,1197,3,5,202044
9,10,119,15,204,175,25,51,3,592,729,1321,3,5,202044
9,11,218,12,236,356,76,81,0,979,1200,2179,7,5,202044
9,12,199,28,365,468,53,70,3,1186,998,2184,7,5,202044
9,13,141,6,142,169,40,32,12,542,635,1177,3,5,202044
9,14,161,8,196,335,53,56,51,860,796,1656,5,5,202044
9,15,223,8,475,428,50,79,38,1301,1399,2700,6,5,202044
9,16,293,76,247,436,47,32,5,1136,1075,2211,11,5,202044
9,17,220,44,343,284,35,34,3,963,843,1806,6,5,202044
9,18,193,7,241,359,107,81,3,991,1005,1996,8,5,202044
9,19,227,24,159,284,101,52,13,860,667,1527,3,5,202044
9,20,82,4,88,128,46,8,11,367,382,749,3,5,202044
9,21,160,4,135,209,41,29,11,589,528,1117,3,5,202044
9,22,115,12,86,116,50,17,22,418,629,1047,2,5,202044
9,23,193,10,305,419,71,58,14,1070,1224,2294,6,5,202044
9,24,449,30,606,698,164,127,3,2077,2344,4421,11,5,202044
10,1,510,89,436,411,56,38,74,1614,1257,2871,12,4.833333333,202044
10,2,273,20,196,305,8,43,7,852,859,1711,10,5,202044
10,3,446,42,266,372,57,79,103,1365,857,2222,10,5,202044
10,4,450,92,312,505,11,15,2,1387,1375,2762,11,5,202044
11,1,349,41,254,257,79,65,11,1056,946,2002,6,5,202044
11,2,293,41,253,210,63,75,17,952,964,1916,6,5,202044
11,3,155,18,102,92,33,50,13,463,505,968,3,5,202044
11,4,300,60,216,265,56,76,2,975,1065,2040,6,5,202044
11,5,385,86,358,417,31,79,11,1367,1796,3163,7,4.5,202044
11,6,364,37,392,386,56,99,41,1375,1170,2545,8,5,202044
11,7,454,43,502,467,38,73,4,1581,1713,3294,9,5,202044
11,8,450,47,417,531,85,110,36,1676,1783,3459,9,5,202044
11,9,390,65,373,459,15,77,31,1410,1513,2923,10,5,202044
11,10,361,63,311,347,65,84,72,1303,877,2180,10,5,202044
11,11,202,12,202,222,9,30,0,677,653,1330,5,5,202044
11,12,266,54,230,261,28,36,12,887,1090,1977,7,5,202044
11,13,272,36,185,172,53,42,36,796,1007,1803,8,4.75,202044
11,14,288,64,279,254,75,46,0,1006,942,1948,8,5,202044
11,15,205,26,178,246,18,64,25,762,692,1454,6,5,202044
12,1,230,21,165,160,59,45,18,698,527,1225,4,5,202044
12,2,317,25,264,452,8,69,0,1135,1142,2277,6,5,202044
12,3,371,23,350,374,20,32,1,1171,809,1980,7,5,202044
12,4,420,30,444,539,43,64,2,1542,1607,3149,7,5,202044
12,5,176,20,145,110,0,10,64,525,633,1158,4,5,202044
12,6,317,23,216,337,24,9,9,935,708,1643,7,5,202044
12,7,238,16,156,320,6,36,4,776,647,1423,4,5,202044
12,8,292,7,150,228,0,12,0,689,572,1261,5,5,202044
12,9,325,28,349,486,56,44,1,1289,1302,2591,7,5,202044
13,1,418,8,175,151,26,39,57,874,175,1049,9,5,202044
13,2,437,17,124,160,86,80,62,966,44,1010,6,5,202044
13,3,360,11,131,159,82,46,8,797,320,1117,9,5,202044
13,4,526,23,264,245,46,75,34,1213,111,1324,8,5,202044
13,5,517,25,276,197,44,115,55,1229,428,1657,9,5,202044
13,6,734,54,445,478,25,113,27,1876,333,2209,11,5,202044
13,7,533,32,350,306,21,72,3,1317,190,1507,8,5,202044
14,1,192,38,169,90,61,44,18,612,443,1055,6,5,202044
14,2,169,19,116,84,82,47,3,520,595,1115,4,5,202044
14,3,358,32,455,150,35,88,9,1127,977,2104,7,5,202044
14,4,296,14,351,367,28,67,20,1143,1195,2338,8,5,202044
14,5,326,17,357,222,55,48,1,1026,900,1926,9,5,202044
14,6,347,17,446,237,18,54,3,1122,1204,2326,7,5,202044
14,7,189,15,259,149,0,19,0,631,624,1255,6,5,202044
14,8,359,20,612,465,8,73,1,1538,1711,3249,9,4.25,202044
14,9,139,7,120,213,3,33,8,523,795,1318,5,5,202044
14,10,217,25,286,173,20,55,18,794,1018,1812,6,5,202044
14,11,228,17,199,210,42,86,39,821,937,1758,4,5,202044
14,12,398,11,431,239,33,21,0,1133,1226,2359,9,5,202044
14,13,211,7,288,184,9,50,8,757,773,1530,5,5,202044
14,14,201,14,222,247,27,82,26,819,1077,1896,5,5,202044
14,15,464,57,372,287,124,117,59,1480,1522,3002,10,5,202044
14,16,240,14,215,172,39,51,10,741,888,1629,5,5,202044
14,17,306,38,290,136,45,137,19,971,727,1698,7,5,202044
14,18,295,38,284,164,119,49,61,1010,1003,2013,7,5,202044
14,19,345,40,392,281,55,56,15,1184,1178,2362,8,5,202044
14,20,436,26,561,378,17,46,0,1464,1375,2839,9,5,202044
15,1,410,14,249,131,374,34,0,1212,1309,2521,7,5,202044
15,2,234,11,219,297,95,38,26,920,1019,1939,5,5,202044
15,3,414,13,223,298,237,45,80,1310,1432,2742,8,5,202044
15,4,231,10,130,243,40,38,10,702,810,1512,3,5,202044
15,5,294,24,273,285,47,41,16,980,882,1862,8,5,202044
15,6,259,4,206,325,23,39,44,900,991,1891,5,5,202044
15,7,255,13,361,191,79,59,4,962,1049,2011,9,5,202044
15,8,172,10,183,311,13,43,29,761,844,1605,4,5,202044
15,9,341,8,157,131,192,152,12,993,903,1896,8,5,202044
15,10,187,6,149,275,15,33,9,674,1029,1703,6,5,202044
15,11,261,22,192,259,39,33,2,808,984,1792,6,5,202044
15,12,337,6,415,428,45,33,0,1264,1467,2731,8,5,202044
15,13,133,11,105,134,87,28,0,498,574,1072,5,5,202044
15,14,155,14,112,189,23,44,3,540,602,1142,4,5,202044
15,15,112,65,112,152,32,22,33,528,696,1224,2,5,202044
15,16,378,36,364,622,30,84,44,1558,1761,3319,8,5,202044
15,17,146,10,153,256,37,52,33,687,865,1552,6,5,202044
15,18,396,16,450,459,45,114,23,1503,1508,3011,7,5,202044
15,19,355,38,429,715,26,74,25,1662,1677,3339,8,5,202044
15,20,143,12,286,242,32,31,3,749,728,1477,5,5,202044
15,21,167,11,143,204,36,56,25,642,517,1159,4,5,202044
15,22,385,87,371,593,34,68,61,1599,1658,3257,10,5,202044
15,23,275,13,212,411,31,72,11,1025,802,1827,6,5,202044
15,24,205,9,181,219,23,26,15,678,818,1496,3,5,202044
15,25,262,12,200,308,35,59,20,896,901,1797,4,5,202044
15,26,265,13,225,334,119,37,9,1002,1123,2125,5,5,202044
15,27,350,22,356,317,24,72,84,1225,1278,2503,9,5,202044
15,28,455,37,496,375,70,50,64,1547,1602,3149,9,5,202044
15,29,267,11,264,456,26,90,29,1143,1430,2573,6,5,202044
15,30,429,57,337,463,88,73,44,1491,1839,3330,12,5,202044
15,31,277,95,245,340,42,46,0,1045,1310,2355,6,5,202044
15,32,289,10,218,372,92,65,6,1052,1288,2340,7,5,202044
15,33,279,17,336,330,43,47,0,1052,1449,2501,6,5,202044
15,34,148,11,137,297,45,31,12,681,823,1504,6,5,202044
15,35,346,16,276,438,8,71,8,1163,1226,2389,8,5,202044
15,36,463,25,366,550,56,59,0,1519,1408,2927,9,5,202044
15,37,296,19,261,448,73,86,28,1211,1365,2576,6,5,202044
15,38,182,26,200,165,15,30,3,621,835,1456,2,5,202044
15,39,243,34,204,259,29,70,2,841,904,1745,4,5,202044
15,40,443,40,301,456,150,88,12,1490,1851,3341,9,5,202044
15,41,347,33,369,383,53,43,56,1284,1823,3107,11,5,202044
16,1,237,14,317,161,39,22,0,790,802,1592,5,5,202044
16,2,213,42,147,225,18,43,5,693,608,1301,9,5,202044
16,3,311,11,255,324,26,68,3,998,961,1959,10,5,202044
16,4,274,34,219,192,79,59,0,857,732,1589,7,5,202044
16,5,215,13,164,206,49,40,6,693,754,1447,7,5,202044
16,6,323,58,282,257,82,37,8,1047,1253,2300,12,5,202044
16,7,598,51,419,485,53,82,0,1688,1377,3065,9,5,202044
16,8,451,28,548,589,12,53,0,1681,1755,3436,12,5,202044
16,9,315,27,295,290,19,92,40,1078,1221,2299,9,5,202044
16,10,209,24,338,342,20,37,0,970,1050,2020,5,5,202044
16,11,322,28,299,205,76,55,4,989,763,1752,10,5,202044
16,12,287,30,269,177,27,86,4,880,595,1475,8,5,202044
17,1,147,13,204,270,13,33,7,687,1085,1772,4,5,202044
17,2,297,9,333,474,14,64,25,1216,971,2187,7,5,202044
17,3,349,14,334,338,24,96,0,1155,1267,2422,7,5,202044
17,4,348,11,480,348,86,60,40,1373,1463,2836,10,5,202044
17,5,89,7,84,96,18,11,0,305,441,746,3,5,202044
18,1,153,4,90,130,15,19,18,429,285,714,3,5,202044
18,2,327,15,303,417,57,110,5,1234,1508,2742,8,5,202044
18,3,177,18,218,138,7,14,7,579,490,1069,5,5,202044
19,1,356,18,371,349,14,122,93,1323,1355,2678,8,5,202044
19,2,327,11,279,270,10,40,1,938,1114,2052,5,5,202044
19,3,358,13,332,197,26,49,15,990,1244,2234,7,5,202044
19,4,289,13,205,183,59,67,102,918,1049,1967,5,5,202044
19,5,436,29,482,546,28,98,70,1689,2033,3722,8,5,202044
19,6,260,12,356,463,14,113,32,1250,1266,2516,5,5,202044
19,7,437,18,638,420,15,93,4,1625,1608,3233,10,5,202044
19,8,256,18,300,323,19,60,1,977,902,1879,6,5,202044
19,9,339,27,321,301,53,72,17,1130,1120,2250,8,4.75,202044
19,10,199,5,229,281,8,83,50,855,945,1800,5,5,202044
19,11,498,48,522,713,16,180,95,2072,2094,4166,12,5,202044
19,12,335,13,632,199,21,22,2,1224,1373,2597,11,5,202044
20,1,254,14,207,227,96,43,39,880,494,1374,5,5,202044
20,2,189,31,266,211,78,7,0,782,377,1159,6,5,202044
20,3,278,7,240,150,156,49,31,911,502,1413,6,5,202044
20,4,293,14,209,153,65,89,58,881,474,1355,6,5,202044
20,5,298,14,277,402,59,42,0,1092,942,2034,7,5,202044
20,6,212,5,119,85,54,33,28,536,639,1175,4,5,202044
20,7,281,6,150,246,35,36,10,764,616,1380,4,5,202044
20,8,628,28,651,715,59,117,59,2257,2276,4533,13,5,202044
20,9,368,15,275,245,192,52,43,1190,1159,2349,8,5,202044
20,10,436,12,477,305,56,35,3,1324,888,2212,9,5,202044
21,1,376,15,352,254,40,30,0,1067,988,2055,7,5,202044
21,2,335,22,354,164,225,46,1,1147,1098,2245,6,5,202044
21,3,396,20,282,218,101,70,52,1139,1211,2350,7,5,202044
21,4,309,9,172,126,128,86,1,831,465,1296,5,5,202044
21,5,349,23,452,264,31,42,21,1182,1327,2509,7,5,202044
21,6,201,13,188,178,62,61,21,724,928,1652,4,5,202044
21,7,267,16,153,253,68,77,10,844,979,1823,7,5,202044
21,8,422,15,380,230,105,84,38,1274,995,2269,8,5,202044
21,9,298,13,441,361,63,67,36,1279,1625,2904,8,5,202044
21,10,164,4,143,176,15,60,45,607,856,1463,3,5,202044
21,11,152,3,187,150,40,29,8,569,543,1112,3,5,202044
21,12,324,30,477,399,89,71,128,1518,1923,3441,7,5,202044
21,13,183,4,196,135,32,68,8,626,647,1273,6,5,202044
21,14,228,14,200,98,100,58,19,717,566,1283,6,5,202044
21,15,359,15,215,281,49,54,30,1003,1160,2163,6,5,202044
22,1,504,76,330,433,47,47,0,1437,1940,3377,11,5,202044
22,2,338,27,369,258,118,34,5,1149,1311,2460,7,5,202044
22,3,432,65,627,572,23,57,2,1778,2052,3830,9,5,202044
22,4,285,34,597,412,26,64,20,1438,1662,3100,7,5,202044
22,5,475,47,672,379,142,64,53,1832,1962,3794,10,5,202044
23,1,385,8,569,167,33,24,21,1207,856,2063,11,5,202044
23,2,360,13,484,327,29,35,0,1248,1591,2839,10,5,202044
23,3,348,12,661,399,40,36,3,1499,2337,3836,16,5,202044
23,4,166,2,347,193,29,63,20,820,689,1509,5,5,202044
24,1,96,9,67,107,7,20,2,308,331,639,3,5,202044
24,2,129,11,117,137,19,27,3,443,500,943,4,5,202044
24,3,144,20,83,76,50,16,3,392,474,866,3,5,202044
24,4,156,8,115,98,28,24,35,464,538,1002,3,5,202044
24,5,417,55,566,546,13,54,1,1652,1605,3257,9,5,202044
24,6,204,41,274,257,25,32,0,833,891,1724,3,5,202044
24,7,150,8,78,70,15,3,0,324,366,690,3,5,202044
25,1,301,11,235,323,24,41,70,1005,1042,2047,10,5,202044
25,2,366,37,241,315,8,47,2,1016,1130,2146,5,5,202044
25,3,357,12,224,371,29,40,41,1074,1203,2277,7,5,202044
25,4,384,27,251,364,44,19,1,1090,969,2059,6,5,202044
25,5,321,13,307,464,36,80,15,1236,1547,2783,6,5,202044
25,6,362,9,334,369,43,76,38,1231,1188,2419,6,5,202044
25,7,327,11,392,398,2,36,0,1166,1208,2374,5,5,202044
26,1,258,5,271,283,6,57,0,880,807,1687,8,5,202044
26,2,427,12,333,475,4,84,1,1336,1213,2549,10,5,202044
26,3,450,17,328,348,15,94,40,1292,1261,2553,8,5,202044
26,4,261,13,199,219,47,25,6,770,573,1343,7,5,202044
26,5,244,10,205,252,17,82,1,811,890,1701,7,5,202044
26,6,285,7,156,222,4,61,3,738,645,1383,6,5,202044
26,7,312,16,224,302,64,44,5,967,828,1795,10,5,202044
27,1,440,12,335,541,62,32,10,1432,828,2260,8,5,202044
27,2,423,22,318,521,45,41,32,1402,1464,2866,8,5,202044
27,3,340,11,198,575,11,41,0,1176,1094,2270,6,5,202044
27,4,411,8,425,654,20,126,7,1651,1501,3152,7,5,202044
27,5,397,8,235,389,14,61,13,1117,677,1794,6,5,202044
27,6,349,7,290,590,7,71,0,1314,1219,2533,7,5,202044
28,1,375,39,457,428,7,33,0,1339,1506,2845,7,5,202044
28,2,474,36,557,309,51,104,225,1756,1605,3361,12,5,202044
28,3,245,17,242,247,12,56,10,829,531,1360,7,5,202044
28,4,409,27,412,269,95,101,93,1406,1540,2946,13,5,202044
28,5,347,15,223,300,13,88,72,1058,1079,2137,5,5,202044
28,6,372,16,309,420,33,62,8,1220,1137,2357,8,5,202044
28,7,306,19,237,221,67,43,107,1000,1002,2002,9,5,202044
28,8,249,17,194,245,45,78,67,895,1027,1922,12,5,202044
28,9,259,6,369,178,24,55,38,929,1046,1975,5,5,202044
29,1,352,28,292,348,35,50,3,1108,1161,2269,6,5,202044
29,2,370,19,240,383,32,93,91,1228,1274,2502,7,5,202044
29,3,185,12,103,258,15,38,0,611,623,1234,4,5,202044
30,1,239,13,195,162,62,20,38,729,669,1398,5,5,202044
30,2,311,20,334,143,46,19,192,1065,875,1940,10,5,202044
30,3,319,10,218,133,180,60,96,1016,1056,2072,6,5,202044
30,4,213,7,308,181,44,45,1,799,858,1657,8,5,202044
30,5,382,11,565,288,12,63,0,1321,1271,2592,9,5,202044
30,6,311,17,407,243,42,42,18,1080,699,1779,9,5,202044
30,7,234,11,133,171,60,44,54,707,693,1400,7,5,202044
30,8,338,15,506,243,135,54,17,1308,1447,2755,11,5,202044
30,9,407,9,274,214,129,51,54,1138,1235,2373,8,5,202044
30,10,385,12,518,247,46,63,57,1328,1269,2597,6,5,202044
30,11,277,6,308,341,13,28,6,979,858,1837,5,5,202044
30,12,390,11,512,455,29,83,0,1480,1540,3020,10,5,202044
30,13,475,17,228,254,129,77,154,1334,1491,2825,10,5,202044
30,14,295,10,313,166,56,57,42,939,930,1869,6,5,202044
30,15,429,15,316,242,104,85,103,1294,1438,2732,11,5,202044
30,16,362,13,293,265,81,79,151,1244,1475,2719,8,5,202044
30,17,380,20,392,426,57,93,57,1425,1154,2579,8,5,202044
30,18,297,8,218,201,45,69,54,892,670,1562,6,5,202044
30,19,314,7,327,357,22,51,16,1094,603,1697,9,5,202044
30,20,283,11,143,289,50,46,4,826,937,1763,6,5,202044
31,1,360,25,292,40,189,23,1,930,545,1475,8,4.75,202044
31,2,251,13,177,22,277,52,0,792,545,1337,6,5,202044
31,3,502,21,608,371,89,66,0,1657,1546,3203,20,5,202044
31,4,196,9,227,140,93,33,42,740,624,1364,4,5,202044
31,5,301,5,296,197,28,40,11,878,484,1362,6,5,202044
32,1,307,27,177,182,44,71,85,893,662,1555,8,5,202044
32,2,545,43,329,197,152,104,70,1440,865,2305,11,5,202044
32,3,395,48,236,387,13,70,21,1170,894,2064,11,5,202044
32,4,614,69,338,466,27,119,33,1666,1020,2686,10,5,202044
1,1,548,49,324,287,27,76,12,1323,1431,2754,12,5,202045
1,2,604,33,496,454,57,49,31,1724,1691,3415,15,5,202045
1,3,415,59,446,329,42,72,60,1423,1603,3026,13,5,202045
2,1,411,18,290,334,21,170,38,1282,1451,2733,9,5,202045
2,2,238,8,216,358,6,66,0,892,1128,2020,5,5,202045
2,3,368,24,401,308,7,143,62,1313,1231,2544,9,5,202045
2,4,352,6,290,131,36,25,24,864,1046,1910,8,5,202045
2,5,478,14,591,357,131,92,37,1700,1920,3620,10,5,202045
2,6,262,4,286,194,32,74,45,897,860,1757,7,5,202045
2,7,378,27,341,287,18,129,53,1233,1026,2259,10,5,202045
2,8,223,7,249,193,23,52,40,787,587,1374,4,5,202045
3,1,364,16,434,415,31,104,12,1376,1156,2532,8,5,202045
3,2,265,19,531,256,68,25,21,1185,1232,2417,8,5,202045
4,1,377,13,204,287,46,54,35,1016,1091,2107,6,4.5,202045
4,2,331,10,230,260,19,49,78,977,884,1861,8,5,202045
5,1,474,24,252,270,34,91,22,1167,938,2105,8,5,202045
5,2,548,23,283,246,36,68,5,1209,445,1654,10,5,202045
5,3,473,15,240,232,39,101,22,1122,817,1939,10,5,202045
5,4,548,36,425,379,6,75,20,1489,1184,2673,8,5,202045
5,5,549,21,317,267,12,113,24,1303,1322,2625,9,5,202045
5,6,251,9,149,138,4,25,37,613,753,1366,9,5,202045
5,7,319,21,193,238,28,32,18,849,665,1514,7,5,202045
6,1,279,19,268,212,23,81,74,956,1057,2013,10,5,202045
6,2,202,11,183,163,40,49,15,663,668,1331,7,5,202045
7,1,325,6,160,123,9,54,3,680,752,1432,7,5,202045
7,2,474,8,521,476,60,29,0,1568,1506,3074,9,5,202045
7,3,317,66,105,106,107,24,1,726,743,1469,7,5,202045
7,4,356,15,284,329,21,73,61,1139,1245,2384,11,5,202045
7,5,322,4,165,285,19,26,0,821,933,1754,11,5,202045
7,6,409,10,368,408,62,43,27,1327,1430,2757,8,5,202045
7,7,486,21,389,320,83,101,5,1405,1586,2991,8,5,202045
7,8,395,21,223,342,67,49,19,1116,1018,2134,12,5,202045
7,9,408,11,245,342,26,58,10,1100,1176,2276,9,5,202045
7,10,212,54,229,133,149,28,0,805,847,1652,9,5,202045
7,11,249,4,191,107,42,20,0,613,286,899,6,5,202045
7,12,396,8,291,437,6,14,5,1157,1156,2313,9,5,202045
7,13,306,23,193,358,3,31,0,914,1100,2014,9,4.5,202045
8,1,193,6,218,113,4,11,5,550,570,1120,4,5,202045
8,2,450,46,539,380,17,24,5,1461,1083,2544,12,5,202045
8,3,248,22,184,188,15,37,26,720,936,1656,4,5,202045
8,4,358,20,382,321,36,52,43,1212,1344,2556,8,5,202045
8,5,275,39,197,284,28,31,1,855,1118,1973,9,5,202045
8,6,380,10,216,224,26,37,22,915,1159,2074,7,5,202045
8,7,299,58,220,271,5,46,0,899,913,1812,6,5,202045
8,8,412,12,329,477,4,51,1,1286,1660,2946,4,5,202045
8,9,310,29,183,186,67,83,63,921,855,1776,10,5,202045
9,1,98,6,96,118,43,21,9,391,463,854,4,5,202045
9,2,490,37,444,770,123,88,6,1958,1942,3900,10,5,202045
9,3,180,6,184,249,35,34,26,714,817,1531,4,5,202045
9,4,388,28,374,576,71,57,32,1526,1399,2925,7,5,202045
9,5,350,8,261,441,56,86,0,1202,1176,2378,7,5,202045
9,6,144,30,124,172,116,29,1,616,623,1239,7,5,202045
9,7,168,13,227,371,2,29,4,814,835,1649,6,5,202045
9,8,90,10,199,236,18,32,18,603,838,1441,3,5,202045
9,9,185,7,130,204,41,26,11,604,718,1322,3,5,202045
9,10,92,7,183,182,18,79,4,565,697,1262,3,5,202045
9,11,253,9,288,363,76,85,3,1077,1112,2189,7,5,202045
9,12,215,23,327,472,30,72,1,1140,1064,2204,7,5,202045
9,13,129,9,155,196,82,37,23,631,580,1211,3,5,202045
9,14,262,11,248,353,49,53,63,1039,565,1604,5,5,202045
9,15,201,21,462,445,54,98,57,1338,1327,2665,6,5,202045
9,16,265,58,258,459,45,39,21,1145,1421,2566,11,5,202045
9,17,254,27,384,277,48,8,1,999,722,1721,6,5,202045
9,18,235,9,233,357,84,77,3,998,1069,2067,8,5,202045
9,19,214,25,181,285,87,38,14,844,639,1483,3,5,202045
9,20,79,8,83,126,47,17,25,385,382,767,3,5,202045
9,21,173,0,154,175,36,30,22,590,532,1122,3,5,202045
9,22,128,7,83,115,53,22,21,429,554,983,2,5,202045
9,23,236,7,381,387,85,59,30,1185,1099,2284,6,5,202045
9,24,504,41,571,729,204,83,4,2136,2106,4242,11,5,202045
10,1,505,72,440,408,43,34,88,1590,1641,3231,14,4.833333333,202045
10,2,296,18,175,259,11,30,11,800,1004,1804,7,5,202045
10,3,422,29,201,371,59,71,87,1240,1280,2520,8,5,202045
10,4,413,67,275,474,8,22,3,1262,1354,2616,11,5,202045
11,1,367,54,228,233,102,52,19,1055,1129,2184,6,5,202045
11,2,348,31,284,193,79,80,16,1031,1072,2103,7,5,202045
11,3,125,22,103,112,32,41,18,453,472,925,3,5,202045
11,4,307,64,222,280,58,81,6,1018,1188,2206,6,5,202045
11,5,311,62,285,382,27,70,8,1145,1081,2226,5,2.5,202045
11,6,457,36,356,381,54,90,32,1406,1617,3023,8,5,202045
11,7,457,34,484,446,46,89,6,1562,1794,3356,9,5,202045
11,8,416,42,440,515,79,83,30,1605,1706,3311,9,5,202045
11,9,450,43,387,518,17,59,36,1510,1681,3191,10,5,202045
11,10,348,71,349,306,67,107,71,1319,1015,2334,10,5,202045
11,11,224,25,191,231,7,34,0,712,800,1512,5,5,202045
11,12,247,45,249,273,33,41,9,897,1108,2005,7,5,202045
11,13,256,33,155,164,34,32,44,718,805,1523,8,4.25,202045
11,14,267,44,292,281,69,47,0,1000,1213,2213,8,5,202045
11,15,249,33,161,219,17,59,24,762,767,1529,6,5,202045
12,1,234,24,202,133,60,47,12,712,541,1253,4,5,202045
12,2,337,21,268,387,11,27,0,1051,1067,2118,6,5,202045
12,3,325,24,293,368,14,26,4,1054,1015,2069,7,5,202045
12,4,381,27,375,491,40,67,5,1386,1495,2881,7,5,202045
12,5,287,18,186,146,1,17,63,718,787,1505,6,5,202045
12,6,393,13,220,357,19,10,8,1020,621,1641,7,5,202045
12,7,309,16,139,324,8,27,1,824,829,1653,4,5,202045
12,8,270,9,123,214,0,26,0,642,567,1209,5,5,202045
12,9,320,22,278,447,34,48,3,1152,1524,2676,7,5,202045
13,1,441,16,257,223,44,47,73,1101,647,1748,9,5,202045
13,2,359,21,142,153,103,65,52,895,438,1333,6,5,202045
13,3,526,25,211,222,95,55,8,1142,1156,2298,11,4.5,202045
13,4,497,18,268,253,48,66,48,1198,794,1992,8,5,202045
13,5,517,25,282,251,64,106,60,1305,801,2106,9,5,202045
13,6,662,38,491,509,21,102,71,1894,1592,3486,11,5,202045
13,7,480,27,388,322,17,53,4,1291,1010,2301,8,4.75,202045
14,1,219,52,158,101,75,38,15,658,802,1460,6,5,202045
14,2,211,16,129,99,80,33,5,573,570,1143,4,5,202045
14,3,342,22,425,151,45,82,10,1077,1359,2436,7,5,202045
14,4,355,17,381,342,18,63,21,1197,1395,2592,8,5,202045
14,5,286,27,368,209,61,42,0,993,1203,2196,9,5,202045
14,6,390,10,413,184,17,52,9,1075,1125,2200,7,5,202045
14,7,247,12,246,174,0,14,0,693,890,1583,6,5,202045
14,8,471,24,656,520,9,74,7,1761,2368,4129,9,5,202045
14,9,218,9,175,269,8,37,25,741,609,1350,5,5,202045
14,10,263,34,297,162,17,65,24,862,998,1860,6,5,202045
14,11,321,16,170,172,48,66,45,838,891,1729,4,5,202045
14,12,472,11,417,214,39,21,0,1174,1603,2777,9,5,202045
14,13,264,12,246,160,6,52,4,744,719,1463,5,5,202045
14,14,251,15,196,162,33,64,23,744,1184,1928,5,5,202045
14,15,451,44,327,290,113,100,41,1366,1656,3022,10,5,202045
14,16,287,12,163,165,28,57,15,727,772,1499,5,5,202045
14,17,259,39,258,110,48,103,29,846,1296,2142,7,5,202045
14,18,329,32,286,161,110,49,69,1036,1217,2253,7,5,202045
14,19,339,37,403,234,60,58,40,1171,1289,2460,8,5,202045
14,20,460,24,473,378,17,43,0,1395,1531,2926,9,5,202045
15,1,434,27,277,99,434,33,0,1304,1350,2654,7,5,202045
15,2,268,9,202,244,94,32,28,877,974,1851,5,5,202045
15,3,404,14,192,226,271,45,97,1249,1360,2609,8,5,202045
15,4,227,8,159,227,36,33,16,706,812,1518,3,5,202045
15,5,347,24,265,244,50,41,22,993,1030,2023,8,5,202045
15,6,313,10,190,307,21,50,52,943,980,1923,5,5,202045
15,7,331,13,385,186,71,65,6,1057,1047,2104,9,5,202045
15,8,214,14,168,230,22,45,44,737,840,1577,4,5,202045
15,9,340,10,148,125,161,147,17,948,1028,1976,8,5,202045
15,10,257,8,142,286,19,37,5,754,956,1710,6,5,202045
15,11,288,17,195,242,40,33,9,824,892,1716,6,5,202045
15,12,436,12,439,400,44,30,0,1361,1200,2561,8,5,202045
15,13,160,4,113,156,91,32,0,556,542,1098,5,5,202045
15,14,174,14,113,179,22,50,11,563,669,1232,4,5,202045
15,15,119,35,106,150,36,14,19,479,661,1140,2,5,202045
15,16,449,29,304,508,33,89,49,1461,1795,3256,8,5,202045
15,17,204,8,155,252,23,48,64,754,805,1559,6,5,202045
15,18,444,26,377,435,39,92,26,1439,1671,3110,7,5,202045
15,19,396,38,393,738,21,73,6,1665,1741,3406,8,5,202045
15,20,181,19,266,243,24,35,4,772,830,1602,5,5,202045
15,21,161,7,112,152,67,52,24,575,731,1306,4,5,202045
15,22,389,65,341,508,20,77,39,1439,1984,3423,10,5,202045
15,23,350,10,192,359,22,64,14,1011,1069,2080,6,5,202045
15,24,219,26,157,251,31,24,11,719,762,1481,3,5,202045
15,25,260,18,193,210,54,38,12,785,935,1720,4,5,202045
15,26,266,12,191,236,92,35,12,844,1266,2110,5,5,202045
15,27,425,16,354,303,19,82,92,1291,1244,2535,9,5,202045
15,28,480,29,548,346,66,62,57,1588,1535,3123,9,5,202045
15,29,337,14,256,427,21,79,46,1180,1476,2656,6,5,202045
15,30,480,38,380,418,81,57,41,1495,1608,3103,12,5,202045
15,31,258,86,209,321,16,49,0,939,1110,2049,6,5,202045
15,32,348,15,229,315,76,62,12,1057,1093,2150,7,5,202045
15,33,360,14,275,299,45,55,1,1049,1275,2324,6,5,202045
15,34,213,17,167,274,32,25,1,729,779,1508,6,5,202045
15,35,381,20,221,398,13,45,11,1089,1151,2240,8,5,202045
15,36,459,25,340,473,74,63,1,1435,1339,2774,9,5,202045
15,37,336,21,296,456,106,113,27,1355,1385,2740,6,5,202045
15,38,235,20,163,171,30,28,1,648,749,1397,2,5,202045
15,39,293,51,178,202,43,54,3,824,773,1597,4,5,202045
15,40,589,50,311,465,202,55,6,1678,1666,3344,9,5,202045
15,41,429,18,358,394,60,54,73,1386,1551,2937,11,5,202045
16,1,231,18,282,125,20,25,1,702,853,1555,5,5,202045
16,2,198,25,137,212,18,57,1,648,793,1441,9,5,202045
16,3,275,23,208,297,26,54,1,884,923,1807,10,5,202045
16,4,267,29,252,192,91,50,1,882,827,1709,7,5,202045
16,5,242,25,179,205,41,50,64,806,778,1584,7,5,202045
16,6,349,48,291,294,88,49,6,1125,1101,2226,12,5,202045
16,7,377,39,324,345,59,63,0,1207,1231,2438,9,5,202045
16,8,507,34,573,515,10,51,8,1698,1754,3452,12,5,202045
16,9,349,21,285,305,17,77,47,1101,1299,2400,9,5,202045
16,10,277,24,382,346,10,44,0,1083,963,2046,5,5,202045
16,11,335,36,250,183,97,54,1,956,938,1894,10,5,202045
16,12,238,17,267,152,26,55,3,758,1057,1815,8,5,202045
17,1,173,19,215,231,22,32,1,693,1080,1773,4,5,202045
17,2,349,5,328,396,10,58,21,1167,1187,2354,7,5,202045
17,3,376,8,270,356,20,79,0,1109,1293,2402,7,5,202045
17,4,362,15,374,331,159,50,28,1319,1748,3067,10,5,202045
17,5,134,6,87,100,11,9,0,347,390,737,3,5,202045
18,1,139,11,66,105,25,20,17,383,432,815,3,5,202045
18,2,477,22,311,360,52,107,3,1332,1668,3000,8,5,202045
18,3,160,20,195,165,4,21,6,571,634,1205,5,5,202045
19,1,398,23,369,360,11,122,82,1365,1258,2623,8,5,202045
19,2,310,10,346,203,11,35,1,916,1067,1983,5,5,202045
19,3,379,9,334,213,48,53,9,1045,1031,2076,7,5,202045
19,4,332,14,259,177,48,79,92,1001,934,1935,5,5,202045
19,5,554,21,439,493,35,93,48,1683,1931,3614,8,5,202045
19,6,280,10,351,391,11,87,29,1159,1263,2422,5,5,202045
19,7,451,19,584,415,13,56,1,1539,1348,2887,10,5,202045
19,8,268,13,295,320,15,52,0,963,1016,1979,6,5,202045
19,9,384,16,340,306,41,54,25,1166,1132,2298,8,5,202045
19,10,257,9,237,270,13,59,51,896,969,1865,5,5,202045
19,11,589,35,508,695,20,141,103,2091,2118,4209,12,5,202045
19,12,448,9,670,190,27,37,4,1385,1356,2741,11,5,202045
20,1,270,14,187,189,82,33,41,816,884,1700,5,5,202045
20,2,126,13,193,134,51,5,0,522,751,1273,6,5,202045
20,3,268,7,216,144,160,51,28,874,1058,1932,6,5,202045
20,4,218,9,173,119,57,81,73,730,885,1615,6,5,202045
20,5,254,16,258,365,40,46,0,979,1233,2212,7,5,202045
20,6,171,6,133,93,63,32,32,530,645,1175,4,5,202045
20,7,262,9,171,248,21,21,6,738,709,1447,4,5,202045
20,8,649,42,599,683,62,93,60,2188,2308,4496,13,5,202045
20,9,368,4,213,179,167,44,28,1003,1389,2392,8,4.333333333,202045
20,10,347,10,389,192,66,35,9,1048,1312,2360,9,5,202045
21,1,327,9,319,265,39,21,0,980,1229,2209,7,5,202045
21,2,297,17,292,148,155,39,5,953,1140,2093,6,5,202045
21,3,417,19,309,248,96,40,48,1177,1241,2418,7,5,202045
21,4,312,9,157,126,146,91,4,845,613,1458,5,5,202045
21,5,437,19,512,279,33,47,15,1342,1264,2606,7,5,202045
21,6,278,8,176,174,70,79,19,804,675,1479,4,5,202045
21,7,340,14,188,200,81,119,3,945,923,1868,7,5,202045
21,8,352,4,320,195,47,59,39,1016,1573,2589,8,5,202045
21,9,372,7,402,328,72,71,40,1292,1602,2894,8,5,202045
21,10,210,12,188,154,10,61,43,678,795,1473,3,5,202045
21,11,166,6,209,162,25,19,7,594,540,1134,4,5,202045
21,12,543,31,529,433,80,57,117,1790,1630,3420,8,5,202045
21,13,260,9,226,184,35,80,9,803,589,1392,7,5,202045
21,14,196,8,154,103,96,44,17,618,728,1346,7,5,202045
21,15,361,10,188,284,31,47,43,964,1245,2209,6,5,202045
22,1,499,72,353,401,36,55,0,1416,1815,3231,11,5,202045
22,2,363,30,332,283,111,49,7,1175,1188,2363,7,5,202045
22,3,535,38,626,530,19,53,5,1806,1972,3778,9,5,202045
22,4,383,33,544,437,21,70,20,1508,1581,3089,7,5,202045
22,5,515,53,648,361,147,79,55,1858,2308,4166,10,5,202045
23,1,248,3,309,106,25,11,15,717,732,1449,11,3.6,202045
23,2,400,15,505,338,35,26,0,1319,1326,2645,10,5,202045
23,3,386,20,619,311,35,35,4,1410,1657,3067,16,4,202045
23,4,121,1,235,127,22,37,34,577,888,1465,6,5,202045
24,1,119,12,88,107,4,29,3,362,340,702,3,5,202045
24,2,162,8,134,101,22,24,7,458,476,934,4,5,202045
24,3,152,13,110,95,48,13,0,431,508,939,3,5,202045
24,4,182,12,112,116,17,29,65,533,566,1099,3,5,202045
24,5,519,34,564,508,19,56,2,1702,1607,3309,9,5,202045
24,6,216,49,234,244,26,30,0,799,882,1681,3,5,202045
24,7,145,8,76,80,21,4,0,334,350,684,3,5,202045
25,1,307,9,271,349,39,59,57,1091,1351,2442,10,5,202045
25,2,364,37,236,358,23,52,1,1071,1165,2236,5,5,202045
25,3,351,13,273,367,36,56,37,1133,1281,2414,7,5,202045
25,4,407,29,300,355,56,19,2,1168,1091,2259,6,5,202045
25,5,373,11,347,458,21,83,24,1317,1484,2801,6,5,202045
25,6,333,14,332,343,64,61,53,1200,1282,2482,6,5,202045
25,7,375,7,411,354,3,28,0,1178,1266,2444,5,5,202045
26,1,273,10,243,283,2,51,0,862,913,1775,8,5,202045
26,2,404,10,329,421,7,57,0,1228,1133,2361,10,4.666666667,202045
26,3,489,19,273,318,20,77,19,1215,1190,2405,8,5,202045
26,4,243,12,205,202,52,42,6,762,736,1498,7,5,202045
26,5,276,8,155,183,22,71,0,715,1015,1730,7,5,202045
26,6,314,18,165,220,10,53,9,789,642,1431,6,5,202045
26,7,326,20,247,295,94,19,0,1001,909,1910,10,5,202045
27,1,438,16,282,422,50,35,6,1249,1094,2343,8,5,202045
27,2,394,16,265,460,29,51,36,1251,1397,2648,8,5,202045
27,3,344,8,162,453,9,47,1,1024,1161,2185,6,5,202045
27,4,460,7,298,516,11,81,7,1380,1243,2623,7,4.5,202045
27,5,340,1,228,369,20,59,9,1026,1176,2202,6,5,202045
27,6,344,9,207,434,11,54,0,1059,1144,2203,7,5,202045
28,1,321,27,489,441,9,42,0,1329,1475,2804,7,5,202045
28,2,500,33,545,326,51,90,225,1770,1414,3184,12,5,202045
28,3,232,14,211,214,13,42,15,741,1005,1746,7,5,202045
28,4,453,28,386,311,102,76,106,1462,1883,3345,13,5,202045
28,5,412,20,177,250,21,88,66,1034,1026,2060,5,5,202045
28,6,351,18,269,398,30,39,15,1120,1403,2523,8,5,202045
28,7,317,27,244,189,49,34,107,967,1145,2112,9,5,202045
28,8,296,9,202,188,48,82,90,915,1291,2206,12,5,202045
28,9,225,10,321,168,18,52,51,845,1063,1908,5,5,202045
29,1,386,15,280,302,45,54,13,1095,1162,2257,6,5,202045
29,2,406,19,236,347,25,70,104,1207,1312,2519,7,5,202045
29,3,209,10,138,216,17,34,0,624,690,1314,4,5,202045
30,1,194,11,199,195,58,21,41,719,700,1419,5,5,202045
30,2,260,20,253,114,36,23,160,866,1015,1881,10,4.5,202045
30,3,334,5,219,134,141,48,79,960,971,1931,6,5,202045
30,4,264,10,233,209,30,32,0,778,893,1671,8,5,202045
30,5,376,11,495,315,17,50,0,1264,1268,2532,9,5,202045
30,6,308,13,405,205,48,38,16,1033,1076,2109,9,5,202045
30,7,250,9,166,156,57,34,56,728,730,1458,7,5,202045
30,8,394,18,456,197,103,31,8,1207,1427,2634,11,5,202045
30,9,373,8,265,197,112,43,70,1068,1261,2329,8,5,202045
30,10,345,22,514,235,35,54,72,1277,1152,2429,6,5,202045
30,11,274,9,309,321,20,32,7,972,945,1917,5,5,202045
30,12,427,8,508,407,30,73,0,1453,1563,3016,10,5,202045
30,13,423,21,281,244,142,104,121,1336,1407,2743,10,5,202045
30,14,287,11,310,195,43,31,40,917,838,1755,6,5,202045
30,15,418,11,287,202,102,82,102,1204,1519,2723,11,5,202045
30,16,388,9,262,269,71,73,191,1263,1386,2649,8,5,202045
30,17,391,19,381,397,43,90,31,1352,1728,3080,8,5,202045
30,18,274,11,197,226,59,56,55,878,693,1571,6,5,202045
30,19,266,6,296,282,13,43,19,925,730,1655,9,5,202045
30,20,240,11,132,248,63,39,1,734,883,1617,6,5,202045
31,1,262,5,261,38,153,20,0,739,637,1376,8,4,202045
31,2,184,6,125,13,223,37,0,588,857,1445,6,4,202045
31,3,453,21,512,341,67,51,0,1445,1643,3088,16,4,202045
31,4,167,3,162,76,68,25,56,557,835,1392,4,4,202045
31,5,214,4,250,139,27,28,4,666,538,1204,7,4,202045
32,1,324,25,194,172,51,68,81,915,786,1701,8,5,202045
32,2,395,47,259,204,151,97,64,1217,1349,2566,11,5,202045
32,3,401,42,236,391,15,61,40,1186,1222,2408,11,5,202045
32,4,476,53,304,390,26,81,27,1357,1374,2731,10,5,202045
1,1,211,18,200,152,14,17,11,623,805,1428,8,3,202046
1,2,485,42,411,378,29,43,14,1402,1634,3036,15,4,202046
1,3,280,44,405,282,34,44,59,1148,1514,2662,13,4,202046
2,1,356,14,220,297,20,168,34,1109,1149,2258,9,4,202046
2,2,172,5,153,366,4,36,1,737,884,1621,5,4,202046
2,3,329,18,325,270,11,128,57,1138,1428,2566,9,4,202046
2,4,283,4,251,124,44,17,31,754,811,1565,8,4,202046
2,5,407,15,455,305,112,84,20,1398,1533,2931,10,4,202046
2,6,252,12,213,172,20,55,39,763,718,1481,7,4,202046
2,7,324,13,309,243,16,98,31,1034,874,1908,10,4,202046
2,8,185,6,196,137,20,31,41,616,595,1211,4,4,202046
3,1,256,16,334,338,20,60,14,1038,971,2009,8,4,202046
3,2,216,8,409,174,49,24,5,885,1147,2032,7,4,202046
4,1,322,19,232,234,60,54,48,969,1049,2018,7,4,202046
4,2,204,9,194,253,22,41,42,765,1074,1839,8,4,202046
5,1,334,16,218,252,14,75,19,928,1254,2182,8,4,202046
5,2,379,15,225,223,40,60,4,946,742,1688,10,4,202046
5,3,366,16,234,204,46,69,23,958,1153,2111,10,4,202046
5,4,424,25,376,376,3,77,20,1301,1489,2790,8,4,202046
5,5,451,6,228,201,14,115,41,1056,1513,2569,10,4,202046
5,6,289,9,190,211,8,44,45,796,648,1444,9,4,202046
5,7,250,15,158,188,10,28,4,653,701,1354,7,4,202046
6,1,209,14,271,197,15,67,52,825,1183,2008,10,4,202046
6,2,138,5,133,141,42,23,30,512,659,1171,7,4,202046
7,1,214,0,111,143,7,36,2,513,636,1149,9,3.75,202046
7,2,304,3,243,258,32,12,0,852,1172,2024,9,3.25,202046
7,3,181,8,141,50,96,18,4,498,545,1043,7,4,202046
7,4,189,7,137,232,8,53,8,634,1018,1652,11,4,202046
7,5,278,5,110,207,16,20,0,636,684,1320,11,4,202046
7,6,286,10,303,403,57,53,21,1133,1203,2336,8,4,202046
7,7,335,22,316,282,73,65,6,1099,1279,2378,8,4,202046
7,8,317,29,186,244,54,45,22,897,1091,1988,12,4,202046
7,9,224,7,243,339,40,50,14,917,1071,1988,9,4,202046
7,10,185,4,169,173,94,8,0,633,885,1518,9,4,202046
7,11,171,6,139,75,38,22,0,451,717,1168,6,4,202046
7,12,304,3,242,371,4,24,10,958,941,1899,9,4,202046
7,13,269,16,211,313,0,30,0,839,1271,2110,9,4,202046
8,1,131,7,193,101,0,4,0,436,297,733,4,4,202046
8,2,295,38,383,243,14,22,6,1001,1675,2676,12,4,202046
8,3,153,8,131,146,16,21,29,504,768,1272,4,3.5,202046
8,4,261,19,323,247,33,38,73,994,943,1937,8,4,202046
8,5,203,24,151,206,14,31,1,630,1068,1698,9,4,202046
8,6,178,12,149,149,13,30,22,553,951,1504,7,4,202046
8,7,208,35,160,178,8,26,2,617,871,1488,6,4,202046
8,8,277,14,254,343,8,45,0,941,1409,2350,7,4,202046
8,9,168,22,159,110,50,47,38,594,779,1373,10,4,202046
9,1,122,4,85,110,38,22,12,393,378,771,4,4,202046
9,2,267,21,325,612,81,76,2,1384,1370,2754,10,4,202046
9,3,170,4,117,224,33,22,20,590,694,1284,4,4,202046
9,4,236,22,266,503,51,52,63,1193,1182,2375,7,4,202046
9,5,247,2,258,351,41,66,0,965,986,1951,7,4,202046
9,6,93,8,96,157,65,21,7,447,581,1028,7,4,202046
9,7,143,13,266,420,3,37,2,884,709,1593,6,4,202046
9,8,78,7,128,220,17,30,12,492,626,1118,3,4,202046
9,9,142,7,96,184,43,24,9,505,495,1000,3,4,202046
9,10,110,9,156,136,15,62,1,489,506,995,3,4,202046
9,11,208,8,198,282,57,74,2,829,971,1800,7,4,202046
9,12,155,22,316,408,37,50,1,989,836,1825,7,4,202046
9,13,112,13,121,150,37,19,13,465,468,933,3,4,202046
9,14,140,13,216,308,38,27,74,816,533,1349,5,4,202046
9,15,169,10,399,380,41,71,45,1115,1095,2210,6,4,202046
9,16,217,83,219,373,22,26,5,945,1381,2326,11,4,202046
9,17,152,21,330,253,56,13,3,828,626,1454,6,4,202046
9,18,166,1,186,329,63,64,3,812,851,1663,8,4,202046
9,19,182,26,155,238,58,28,24,711,567,1278,3,4,202046
9,20,67,7,63,92,27,6,20,282,299,581,3,4,202046
9,21,102,2,119,190,40,23,4,480,425,905,3,4,202046
9,22,111,6,55,90,37,16,22,337,463,800,2,4,202046
9,23,170,10,329,360,53,41,15,978,1052,2030,6,4,202046
9,24,352,45,423,597,211,94,3,1725,1695,3420,11,4,202046
10,1,316,60,288,325,31,18,69,1107,1477,2584,14,4,202046
10,2,208,13,151,176,7,25,18,598,756,1354,7,4,202046
10,3,216,15,164,214,21,75,22,727,1012,1739,8,4,202046
10,4,250,43,214,383,10,15,1,916,1202,2118,10,4,202046
11,1,238,23,182,156,60,52,20,731,906,1637,6,4,202046
11,2,244,30,230,214,72,66,16,872,1017,1889,7,4,202046
11,3,103,12,84,70,10,45,7,331,423,754,3,4,202046
11,4,245,59,173,234,57,67,1,836,874,1710,6,4,202046
11,5,268,57,293,312,23,59,13,1025,1336,2361,7,2.5,202046
11,6,292,24,344,300,38,88,34,1120,1312,2432,8,4,202046
11,7,336,28,411,358,54,75,4,1266,1491,2757,9,4,202046
11,8,351,53,362,447,68,70,31,1382,1396,2778,9,4,202046
11,9,327,52,337,357,15,45,23,1156,1537,2693,10,4,202046
11,10,217,44,239,210,60,79,52,901,782,1683,10,4,202046
11,11,183,13,164,215,6,27,0,608,572,1180,5,4,202046
11,12,225,54,201,221,13,24,6,744,886,1630,7,4,202046
11,13,152,24,125,102,23,26,46,498,668,1166,6,3,202046
11,14,237,29,241,209,65,37,0,818,1029,1847,8,4,202046
11,15,170,19,132,169,15,51,20,576,771,1347,6,4,202046
12,1,196,18,155,149,56,31,10,615,701,1316,4,4,202046
12,2,247,13,217,364,4,39,0,884,1138,2022,6,4,202046
12,3,204,12,218,271,8,18,0,731,1063,1794,7,4,202046
12,4,269,22,322,421,57,38,1,1130,1338,2468,7,4,202046
12,5,240,28,176,171,8,17,59,699,611,1310,6,4,202046
12,6,189,10,112,243,14,12,2,582,1257,1839,7,4,202046
12,7,211,8,134,265,5,38,2,663,808,1471,4,4,202046
12,8,195,7,124,183,0,16,0,525,507,1032,5,4,202046
12,9,252,24,233,364,35,29,3,940,1019,1959,7,4,202046
13,1,278,12,195,226,35,23,54,823,841,1664,9,4,202046
13,2,269,13,101,204,75,54,39,755,839,1594,6,4,202046
13,3,454,24,196,273,98,47,12,1104,1286,2390,11,4,202046
13,4,313,18,261,220,46,35,44,937,1007,1944,8,4,202046
13,5,393,14,236,251,62,82,44,1082,1329,2411,9,4,202046
13,6,316,25,242,260,12,53,36,944,1678,2622,11,4,202046
13,7,262,14,297,268,27,37,4,909,1573,2482,8,4,202046
14,1,139,27,132,73,73,38,11,493,529,1022,6,4,202046
14,2,151,16,98,68,65,29,2,429,493,922,4,4,202046
14,3,283,20,326,112,30,65,9,845,862,1707,7,4,202046
14,4,274,14,265,232,13,54,17,869,1000,1869,8,4,202046
14,5,231,22,298,195,44,36,0,826,1080,1906,9,4,202046
14,6,231,8,331,180,13,50,7,820,1058,1878,7,4,202046
14,7,152,16,191,104,0,9,0,472,792,1264,6,4,202046
14,8,329,22,535,478,14,66,3,1447,1429,2876,9,4,202046
14,9,205,13,177,276,6,36,14,727,552,1279,5,4,202046
14,10,169,29,236,131,11,58,21,655,858,1513,6,4,202046
14,11,167,8,168,148,27,52,44,614,794,1408,4,4,202046
14,12,321,18,329,192,35,18,0,913,1191,2104,9,4,202046
14,13,195,17,206,155,9,30,2,614,741,1355,5,4,202046
14,14,161,18,156,172,25,47,20,599,790,1389,5,4,202046
14,15,306,47,264,207,88,69,56,1037,1201,2238,10,4,202046
14,16,154,18,158,109,66,47,14,566,627,1193,5,4,202046
14,17,126,22,183,68,35,53,20,507,823,1330,7,4,202046
14,18,245,24,229,121,78,39,58,794,984,1778,7,4,202046
14,19,188,19,308,200,38,35,22,810,1103,1913,8,4,202046
14,20,300,22,419,334,13,45,0,1133,1402,2535,9,4,202046
15,1,242,17,186,104,309,37,0,895,1166,2061,7,4,202046
15,2,197,17,183,192,88,37,15,729,893,1622,5,4,202046
15,3,302,16,167,173,206,43,91,998,1165,2163,8,4,202046
15,4,177,2,107,212,42,29,19,588,600,1188,3,4,202046
15,5,238,15,215,222,27,33,11,761,955,1716,8,4,202046
15,6,201,5,175,278,28,37,49,773,895,1668,5,4,202046
15,7,249,7,314,155,72,45,1,843,994,1837,9,4,202046
15,8,165,6,139,230,20,30,30,620,803,1423,4,4,202046
15,9,234,6,109,86,148,121,18,722,870,1592,8,4,202046
15,10,191,4,133,265,16,29,10,648,793,1441,6,4,202046
15,11,189,15,200,209,37,25,5,680,829,1509,6,4,202046
15,12,300,9,362,337,43,36,0,1087,1115,2202,8,4,202046
15,13,116,4,86,144,68,28,0,446,564,1010,5,4,202046
15,14,128,12,72,170,21,38,6,447,544,991,4,4,202046
15,15,109,44,97,112,22,21,28,433,588,1021,2,4,202046
15,16,308,28,264,439,19,74,45,1177,1491,2668,8,4,202046
15,17,130,13,123,184,23,43,75,591,673,1264,6,4,202046
15,18,338,13,308,336,32,65,24,1116,1530,2646,7,4,202046
15,19,278,29,310,641,13,67,2,1340,1533,2873,10,4,202046
15,20,111,14,212,189,27,18,0,571,641,1212,5,4,202046
15,21,109,4,84,113,26,55,40,431,580,1011,4,4,202046
15,22,306,56,272,467,24,53,33,1211,1531,2742,11,4,202046
15,23,239,12,164,288,21,66,23,813,1095,1908,6,4,202046
15,24,147,29,141,231,22,31,12,613,570,1183,4,4,202046
15,25,185,20,129,204,35,30,20,623,842,1465,4,4,202046
15,26,213,10,157,237,79,34,18,748,1022,1770,6,4,202046
15,27,277,13,305,271,24,63,86,1039,1151,2190,9,4,202046
15,28,320,19,422,304,42,45,42,1194,1471,2665,9,4,202046
15,29,236,20,226,414,15,83,40,1034,1281,2315,7,4,202046
15,30,313,40,305,353,56,60,34,1161,1585,2746,12,4,202046
15,31,171,72,147,236,13,39,0,678,1057,1735,6,4,202046
15,32,219,16,191,323,42,53,17,861,1153,2014,7,4,202046
15,33,238,12,281,286,34,43,0,894,1106,2000,6,4,202046
15,34,136,3,130,213,35,21,16,554,678,1232,6,4,202046
15,35,257,15,205,358,10,49,12,906,1124,2030,8,4,202046
15,36,357,16,290,427,40,33,0,1163,1181,2344,9,4,202046
15,37,285,19,247,384,100,65,24,1124,1300,2424,6,4,202046
15,38,163,26,153,168,24,20,0,554,678,1232,2,4,202046
15,39,169,28,182,185,49,41,5,659,846,1505,4,4,202046
15,40,415,37,300,446,186,73,5,1462,1471,2933,9,4,202046
15,41,340,15,342,331,56,45,48,1177,1439,2616,11,4,202046
16,1,151,16,235,126,29,7,0,564,738,1302,5,4,202046
16,2,137,22,137,157,6,29,1,489,541,1030,9,4,202046
16,3,215,20,160,250,18,36,5,704,907,1611,10,4,202046
16,4,195,18,204,148,57,37,2,661,734,1395,7,4,202046
16,5,147,17,129,159,44,40,25,561,695,1256,7,4,202046
16,6,260,37,207,225,80,31,0,840,1010,1850,12,4,202046
16,7,276,33,290,291,39,50,0,979,1161,2140,9,4,202046
16,8,340,25,467,454,8,47,12,1353,1644,2997,12,4,202046
16,9,276,17,240,251,13,64,34,895,1121,2016,9,4,202046
16,10,203,15,293,284,12,52,2,861,999,1860,5,4,202046
16,11,156,8,144,91,57,27,1,484,916,1400,10,4,202046
16,12,182,21,197,157,19,49,1,626,914,1540,8,4,202046
17,1,182,13,142,188,17,17,11,570,641,1211,4,4,202046
17,2,288,7,348,444,15,73,17,1192,1109,2301,8,4,202046
17,3,250,9,260,317,17,74,0,927,1142,2069,7,4,202046
17,4,248,16,343,395,57,38,11,1108,1088,2196,10,4,202046
17,5,75,4,66,100,8,23,0,276,305,581,3,4,202046
18,1,108,6,60,93,18,22,13,320,324,644,3,4,202046
18,2,253,23,329,325,24,80,14,1048,1548,2596,8,4,202046
18,3,143,15,142,144,7,23,6,480,607,1087,5,4,202046
19,1,270,15,320,325,12,106,74,1122,1046,2168,8,4,202046
19,2,298,7,281,177,6,19,2,790,844,1634,5,4,202046
19,3,269,11,289,201,53,44,10,877,946,1823,7,4,202046
19,4,226,11,193,192,33,62,110,827,855,1682,5,4,202046
19,5,362,20,380,422,24,66,37,1311,1767,3078,8,4,202046
19,6,215,14,258,400,9,109,22,1027,1160,2187,5,4,202046
19,7,308,18,544,327,10,55,0,1262,1405,2667,10,4,202046
19,8,186,9,223,248,10,49,0,725,992,1717,6,4,202046
19,9,262,11,232,234,35,44,23,841,1032,1873,8,4,202046
19,10,172,10,194,234,9,66,50,735,933,1668,5,4,202046
19,11,447,41,419,661,13,144,71,1796,1943,3739,12,4,202046
19,12,301,11,560,163,17,27,2,1081,1112,2193,11,4,202046
20,1,189,7,164,164,62,27,52,665,682,1347,5,4,202046
20,2,119,19,151,113,57,6,0,465,811,1276,6,4,202046
20,3,163,5,156,103,98,38,22,585,855,1440,6,4,202046
20,4,162,4,143,115,34,61,42,561,630,1191,6,4,202046
20,5,171,15,222,254,37,23,1,723,1001,1724,7,4,202046
20,6,137,5,91,79,36,14,19,381,484,865,4,4,202046
20,7,175,6,158,220,26,25,3,613,664,1277,4,4,202046
20,8,428,21,525,567,44,74,66,1725,1922,3647,13,4,202046
20,9,230,4,193,129,130,41,33,760,978,1738,8,4,202046
20,10,224,11,256,179,33,21,3,727,1215,1942,9,4,202046
21,1,238,7,306,215,19,23,0,808,1099,1907,7,4,202046
21,2,219,9,230,144,144,41,2,789,1185,1974,6,4,202046
21,3,311,4,243,191,96,47,37,929,1132,2061,7,4,202046
21,4,215,10,127,103,88,55,5,603,755,1358,5,4,202046
21,5,323,19,417,273,39,47,28,1146,1273,2419,7,4,202046
21,6,199,9,141,197,44,55,28,673,848,1521,4,4,202046
21,7,260,13,136,217,81,70,2,779,990,1769,7,4,202046
21,8,268,7,291,171,51,59,58,905,1220,2125,8,4,202046
21,9,271,12,335,279,37,49,34,1017,1582,2599,8,4,202046
21,10,162,4,135,116,13,54,56,540,725,1265,3,4,202046
21,11,128,4,160,100,35,19,11,457,512,969,4,4,202046
21,12,333,19,486,348,76,59,105,1426,1489,2915,8,4,202046
21,13,184,6,204,134,27,48,8,611,613,1224,7,4,202046
21,14,163,8,131,85,78,34,12,511,718,1229,7,4,202046
21,15,279,11,196,234,23,47,46,836,1013,1849,6,4,202046
22,1,275,35,245,292,32,30,2,911,1335,2246,11,4,202046
22,2,252,26,289,202,111,25,2,907,1072,1979,7,4,202046
22,3,340,41,489,395,12,46,5,1328,1626,2954,9,4,202046
22,4,278,28,473,376,19,45,18,1237,1300,2537,7,4,202046
22,5,292,29,518,316,80,53,27,1315,1589,2904,10,4,202046
23,1,222,1,515,140,23,25,14,940,1284,2224,11,4,202046
23,2,217,14,390,253,34,30,2,940,1053,1993,10,4,202046
23,3,333,7,500,262,29,30,4,1165,1948,3113,6,4,202046
23,4,142,3,257,113,24,32,14,585,817,1402,6,4,202046
24,1,408,46,212,269,12,53,0,1000,617,1617,9,4,202046
24,2,124,10,85,100,15,23,6,363,459,822,4,4,202046
24,3,218,43,192,179,54,33,3,722,505,1227,9,4,202046
24,4,158,13,100,116,21,26,53,487,421,908,3,4,202046
24,5,347,32,474,458,7,50,0,1368,1585,2953,9,4,202046
24,6,161,54,196,213,22,14,0,660,780,1440,3,4,202046
24,7,510,15,271,263,34,25,0,1118,520,1638,9,4,202046
25,1,247,10,255,271,24,52,54,913,965,1878,10,4,202046
25,2,283,37,218,343,12,40,2,935,1099,2034,5,4,202046
25,3,261,6,202,329,18,47,27,890,1012,1902,7,4,202046
25,4,294,18,213,267,46,25,0,863,963,1826,6,4,202046
25,5,325,15,320,413,33,76,24,1206,1177,2383,8,4,202046
25,6,252,6,291,285,56,48,39,977,1174,2151,6,4,202046
25,7,293,5,305,307,1,12,0,923,1214,2137,5,4,202046
26,1,173,10,183,235,7,39,0,647,781,1428,8,4,202046
26,2,229,10,189,290,5,36,0,759,703,1462,8,2.666666667,202046
26,3,396,13,234,235,10,51,10,949,1091,2040,8,4,202046
26,4,231,16,192,154,44,22,1,660,642,1302,7,4,202046
26,5,249,5,124,145,17,50,0,590,758,1348,7,4,202046
26,6,281,6,135,172,8,44,2,648,585,1233,6,4,202046
26,7,274,13,220,246,79,24,4,860,872,1732,10,4,202046
27,1,185,8,220,372,44,23,2,854,1170,2024,8,4,202046
27,2,322,10,205,352,19,29,25,962,1224,2186,8,4,202046
27,3,277,6,152,423,4,31,2,895,1045,1940,6,4,202046
27,4,325,11,273,482,5,69,9,1174,1664,2838,7,4,202046
27,5,188,7,166,274,7,34,8,684,888,1572,6,3.666666667,202046
27,6,179,6,164,340,1,32,0,722,1208,1930,7,4,202046
28,1,281,17,396,362,5,30,0,1091,1259,2350,7,4,202046
28,2,398,34,414,305,33,80,213,1477,1479,2956,12,4,202046
28,3,166,19,192,183,6,33,21,620,877,1497,7,4,202046
28,4,311,24,298,217,95,75,116,1136,1742,2878,13,4,202046
28,5,303,12,164,230,18,75,57,859,1031,1890,5,4,202046
28,6,207,12,174,294,20,22,5,734,972,1706,8,4,202046
28,7,239,12,201,160,50,38,91,791,843,1634,9,4,202046
28,8,194,18,188,192,33,70,85,780,1147,1927,12,4,202046
28,9,173,10,256,164,12,52,33,700,869,1569,5,4,202046
29,1,275,19,246,283,39,35,8,905,1097,2002,6,4,202046
29,2,291,22,190,316,24,75,118,1036,1061,2097,7,4,202046
29,3,143,9,104,232,16,33,0,537,687,1224,4,4,202046
30,1,138,5,158,178,48,12,35,574,734,1308,5,4,202046
30,2,183,13,218,85,29,11,112,651,1037,1688,10,4,202046
30,3,206,11,206,120,118,41,81,783,709,1492,6,4,202046
30,4,187,9,269,156,29,39,0,689,806,1495,8,4,202046
30,5,206,12,494,255,18,35,0,1020,1226,2246,9,4,202046
30,6,219,7,315,174,41,32,16,804,982,1786,9,4,202046
30,7,220,5,127,157,53,31,47,640,647,1287,7,4,202046
30,8,261,6,392,147,69,32,12,919,1249,2168,11,4,202046
30,9,254,8,242,170,87,52,58,871,1066,1937,8,4,202046
30,10,262,14,442,239,25,48,48,1078,1115,2193,6,4,202046
30,11,209,4,239,287,16,27,4,786,907,1693,5,4,202046
30,12,277,12,413,410,28,62,0,1202,1446,2648,10,4,202046
30,13,273,18,205,188,95,65,84,928,1180,2108,10,4,202046
30,14,202,11,245,171,38,44,49,760,674,1434,6,4,202046
30,15,271,6,207,192,87,73,92,928,1206,2134,11,4,202046
30,16,269,8,276,257,52,42,174,1078,1152,2230,8,4,202046
30,17,314,26,326,354,54,75,27,1176,1349,2525,8,4,202046
30,18,210,7,152,160,47,40,53,669,855,1524,6,4,202046
30,19,200,9,252,186,41,24,11,723,1009,1732,9,4,202046
30,20,191,8,127,295,51,19,1,692,745,1437,6,4,202046
31,1,256,10,249,44,185,17,0,761,560,1321,8,4,202046
31,2,139,5,121,10,204,34,0,513,604,1117,6,3.333333333,202046
31,3,508,28,549,422,81,54,0,1642,1558,3200,16,4,202046
31,4,170,5,198,95,83,24,30,605,696,1301,4,4,202046
31,5,215,7,228,130,31,32,8,651,752,1403,6,4,202046
32,1,235,24,137,145,30,53,61,685,770,1455,8,4,202046
32,2,329,36,245,147,136,63,61,1017,1223,2240,13,4,202046
32,3,324,41,217,358,22,52,40,1054,1143,2197,13,4,202046
32,4,314,44,247,299,29,62,17,1012,1476,2488,10,4,202046
1,1,369,61,296,282,46,50,18,1122,969,2091,14,4.4,202047
1,2,547,62,582,495,63,69,36,1854,1827,3681,15,5,202047
1,3,412,54,533,369,43,72,82,1565,1568,3133,13,5,202047
2,1,404,22,311,420,26,162,59,1404,1187,2591,9,5,202047
2,2,242,10,230,386,7,58,0,933,1070,2003,5,5,202047
2,3,394,17,386,373,13,151,88,1422,1262,2684,9,5,202047
2,4,353,11,318,145,53,42,30,952,1072,2024,8,5,202047
2,5,416,21,575,374,138,109,28,1661,1815,3476,10,5,202047
2,6,283,19,275,219,23,72,47,938,841,1779,7,5,202047
2,7,372,20,383,266,43,123,37,1244,1075,2319,10,5,202047
2,8,187,10,226,246,21,53,44,787,719,1506,4,5,202047
3,1,303,21,304,346,20,52,12,1058,1131,2189,8,5,202047
3,2,277,7,467,214,57,31,0,1053,948,2001,7,5,202047
4,1,368,18,321,301,114,86,56,1264,1164,2428,7,5,202047
4,2,304,8,258,294,14,52,80,1010,1344,2354,8,5,202047
5,1,447,26,272,327,27,83,41,1223,1267,2490,8,5,202047
5,2,450,26,265,265,50,47,11,1114,946,2060,10,5,202047
5,3,480,20,261,205,70,85,48,1169,1437,2606,10,5,202047
5,4,627,37,523,457,7,101,40,1792,1499,3291,8,5,202047
5,5,542,29,358,324,11,176,40,1480,1326,2806,10,5,202047
5,6,412,20,235,258,14,63,62,1064,930,1994,9,5,202047
5,7,332,19,198,206,7,45,11,818,949,1767,7,5,202047
6,1,286,33,355,274,21,94,83,1146,1215,2361,10,5,202047
6,2,172,10,200,160,38,43,17,640,787,1427,7,5,202047
7,1,292,9,179,129,9,59,1,678,746,1424,7,3.75,202047
7,2,351,7,458,298,96,18,0,1228,1403,2631,9,4.5,202047
7,3,273,5,179,84,117,24,4,686,1293,1979,7,5,202047
7,4,247,15,245,296,14,55,43,915,1155,2070,11,5,202047
7,5,369,19,181,313,27,35,0,944,868,1812,11,5,202047
7,6,384,7,442,469,64,65,28,1459,1532,2991,8,5,202047
7,7,456,18,445,380,104,102,13,1518,1164,2682,8,5,202047
7,8,414,34,283,324,71,67,19,1212,1170,2382,12,5,202047
7,9,326,10,294,405,44,67,35,1181,1075,2256,9,5,202047
7,10,247,10,219,205,178,17,0,876,868,1744,9,5,202047
7,11,228,4,191,136,31,26,0,616,650,1266,6,5,202047
7,12,413,11,285,425,9,31,8,1182,1231,2413,9,5,202047
7,13,327,28,251,481,6,40,0,1133,785,1918,9,5,202047
8,1,159,3,236,108,1,9,0,516,329,845,4,5,202047
8,2,352,46,439,373,13,29,1,1253,2060,3313,12,5,202047
8,3,249,12,201,213,15,24,30,744,740,1484,4,5,202047
8,4,340,19,385,338,50,81,73,1286,1234,2520,8,5,202047
8,5,268,26,201,268,22,28,1,814,977,1791,9,5,202047
8,6,206,30,230,176,20,35,31,728,788,1516,7,5,202047
8,7,222,29,184,230,6,40,0,711,1027,1738,6,5,202047
8,8,350,16,313,382,8,42,0,1111,1138,2249,7,5,202047
8,9,171,17,181,168,46,53,53,689,880,1569,10,5,202047
9,1,162,6,87,148,73,19,14,509,504,1013,4,5,202047
9,2,319,40,366,620,77,71,22,1515,1643,3158,8,5,202047
9,3,210,5,180,323,42,34,13,807,773,1580,4,5,202047
9,4,315,20,363,675,75,72,64,1584,1599,3183,7,5,202047
9,5,313,3,343,462,72,74,11,1278,1417,2695,7,5,202047
9,6,137,20,146,199,108,16,2,628,740,1368,7,5,202047
9,7,192,17,384,534,2,65,4,1198,867,2065,9,5,202047
9,8,98,12,208,305,15,25,25,688,648,1336,3,5,202047
9,9,170,8,163,232,47,24,19,663,650,1313,3,5,202047
9,10,128,9,187,234,17,86,4,665,626,1291,3,5,202047
9,11,241,13,288,380,81,109,0,1112,1167,2279,7,5,202047
9,12,218,20,416,548,53,72,8,1335,1073,2408,8,5,202047
9,13,114,11,176,227,61,35,21,645,665,1310,4,5,202047
9,14,190,10,308,337,73,56,89,1063,694,1757,5,5,202047
9,15,214,10,521,432,81,80,49,1387,1371,2758,6,5,202047
9,16,260,98,243,544,22,26,7,1200,1724,2924,11,5,202047
9,17,206,26,386,305,59,16,4,1002,859,1861,6,5,202047
9,18,216,15,232,426,90,88,13,1080,1061,2141,8,5,202047
9,19,205,32,187,269,96,52,37,878,740,1618,3,5,202047
9,20,91,5,103,121,59,11,33,423,398,821,3,5,202047
9,21,139,6,167,236,40,35,11,634,551,1185,3,5,202047
9,22,113,11,77,133,39,19,36,428,496,924,2,5,202047
9,23,214,17,446,486,74,51,18,1306,913,2219,6,5,202047
9,24,485,45,584,758,233,96,2,2203,2260,4463,11,5,202047
10,1,338,48,325,369,37,15,87,1219,1763,2982,14,4.833333333,202047
10,2,262,18,190,263,11,29,14,787,883,1670,7,5,202047
10,3,228,28,166,233,35,43,45,778,1211,1989,8,5,202047
10,4,401,57,299,510,16,8,6,1297,1298,2595,10,5,202047
11,1,218,23,168,150,66,36,2,663,693,1356,4,3.333333333,202047
11,2,325,39,295,230,106,95,37,1127,1073,2200,7,5,202047
11,3,122,28,115,103,23,43,22,456,411,867,3,5,202047
11,4,293,89,240,332,71,54,6,1085,996,2081,6,5,202047
11,5,446,90,435,547,43,98,24,1683,1610,3293,7,5,202047
11,6,399,40,444,386,46,123,50,1488,1361,2849,8,5,202047
11,7,387,43,477,457,42,74,6,1486,1486,2972,9,5,202047
11,8,358,45,491,594,75,100,38,1701,1652,3353,9,5,202047
11,9,438,65,441,526,30,88,56,1644,1391,3035,10,5,202047
11,10,321,72,351,329,59,94,73,1299,1193,2492,10,5,202047
11,11,207,16,203,231,5,40,0,702,699,1401,5,5,202047
11,12,259,52,307,291,20,30,14,973,997,1970,7,5,202047
11,13,215,56,221,155,28,36,83,794,898,1692,8,4.75,202047
11,14,257,44,372,287,79,41,0,1080,918,1998,8,5,202047
11,15,191,24,189,198,22,78,43,745,874,1619,6,5,202047
12,1,223,33,242,182,51,44,12,787,662,1449,4,5,202047
12,2,313,22,295,473,11,54,3,1171,980,2151,6,5,202047
12,3,238,20,326,296,20,36,1,937,1217,2154,7,5,202047
12,4,276,32,400,569,50,62,4,1393,1454,2847,7,5,202047
12,5,263,40,193,243,6,25,74,844,942,1786,6,5,202047
12,6,247,15,179,429,22,15,18,925,1025,1950,7,5,202047
12,7,244,11,158,340,7,26,0,786,827,1613,4,5,202047
12,8,358,20,248,332,0,32,0,990,824,1814,7,5,202047
12,9,331,18,324,493,51,46,3,1266,1066,2332,7,5,202047
13,1,378,31,250,430,86,44,95,1314,1588,2902,9,5,202047
13,2,283,22,132,206,68,90,67,868,1197,2065,6,5,202047
13,3,492,42,312,384,137,69,16,1452,1624,3076,11,5,202047
13,4,441,23,322,308,49,50,47,1240,1471,2711,8,5,202047
13,5,486,20,351,323,73,101,61,1415,1895,3310,9,5,202047
13,6,303,29,375,344,17,50,40,1158,2113,3271,11,5,202047
13,7,365,33,403,349,39,46,9,1244,1193,2437,8,5,202047
14,1,201,33,165,93,115,38,25,670,656,1326,6,5,202047
14,2,189,24,132,94,59,55,2,555,510,1065,4,5,202047
14,3,304,33,373,164,33,105,8,1020,1077,2097,7,5,202047
14,4,307,23,446,322,22,53,13,1186,1231,2417,8,5,202047
14,5,276,28,400,240,67,47,0,1058,1210,2268,9,5,202047
14,6,308,15,417,222,13,70,10,1055,878,1933,7,5,202047
14,7,193,13,265,142,0,17,0,630,740,1370,6,5,202047
14,8,402,31,660,612,13,87,7,1812,1641,3453,9,5,202047
14,9,230,16,270,376,12,42,7,953,743,1696,5,5,202047
14,10,248,35,278,163,19,58,41,842,932,1774,6,5,202047
14,11,236,12,214,182,62,81,48,835,672,1507,4,5,202047
14,12,393,13,459,223,44,19,0,1151,1130,2281,9,5,202047
14,13,235,17,270,188,17,51,9,787,703,1490,5,5,202047
14,14,240,10,184,195,35,59,35,758,894,1652,5,5,202047
14,15,455,43,351,294,144,76,57,1420,1222,2642,10,5,202047
14,16,229,15,230,147,49,63,12,745,755,1500,5,5,202047
14,17,201,29,235,87,27,79,24,682,859,1541,7,4.75,202047
14,18,289,31,320,163,109,52,75,1039,1164,2203,7,5,202047
14,19,303,50,386,251,65,59,51,1165,979,2144,8,5,202047
14,20,386,26,668,416,9,56,0,1561,1258,2819,9,5,202047
15,1,298,9,246,130,333,29,1,1046,1071,2117,7,5,202047
15,2,234,18,265,270,99,45,29,960,834,1794,5,5,202047
15,3,415,22,221,260,278,55,121,1372,1242,2614,8,5,202047
15,4,221,8,143,263,45,30,23,733,697,1430,3,5,202047
15,5,300,25,306,286,29,41,27,1014,1132,2146,8,5,202047
15,6,241,10,237,391,46,62,64,1051,913,1964,5,5,202047
15,7,261,20,396,206,102,60,8,1053,969,2022,9,5,202047
15,8,178,13,168,296,20,45,43,763,634,1397,4,5,202047
15,9,259,5,127,91,200,161,16,859,930,1789,8,5,202047
15,10,218,9,162,333,26,42,18,808,783,1591,6,5,202047
15,11,248,19,284,290,49,33,10,933,822,1755,6,5,202047
15,12,366,10,520,363,69,46,2,1376,1401,2777,8,5,202047
15,13,163,9,130,181,94,36,2,615,518,1133,5,5,202047
15,14,157,17,113,237,17,35,15,591,569,1160,4,5,202047
15,15,136,43,88,161,60,22,18,528,493,1021,2,5,202047
15,16,358,20,340,607,35,103,67,1530,1385,2915,8,5,202047
15,17,182,14,181,270,42,46,95,830,817,1647,6,5,202047
15,18,427,31,416,505,56,97,22,1554,1348,2902,7,5,202047
15,19,328,33,376,749,41,96,40,1663,1492,3155,10,5,202047
15,20,138,12,276,269,41,17,3,756,875,1631,5,5,202047
15,21,156,11,146,170,72,54,40,649,475,1124,4,5,202047
15,22,385,111,371,584,21,74,88,1634,1819,3453,11,5,202047
15,23,341,20,265,405,36,80,38,1185,929,2114,6,5,202047
15,24,214,22,193,254,34,26,15,758,679,1437,4,5,202047
15,25,243,28,208,230,54,66,39,868,767,1635,4,5,202047
15,26,271,13,230,282,115,60,17,988,894,1882,6,5,202047
15,27,336,15,380,352,44,83,133,1343,1208,2551,9,5,202047
15,28,397,18,588,359,75,56,72,1565,1554,3119,9,5,202047
15,29,283,15,327,488,20,93,49,1275,1180,2455,7,5,202047
15,30,364,66,396,418,90,56,72,1462,1317,2779,12,5,202047
15,31,204,112,184,332,9,49,0,890,882,1772,6,5,202047
15,32,271,15,266,396,64,83,20,1115,1135,2250,7,5,202047
15,33,301,12,344,333,57,43,0,1090,1099,2189,6,5,202047
15,34,193,16,161,321,16,32,0,739,690,1429,6,5,202047
15,35,346,11,268,465,16,73,18,1197,1054,2251,8,5,202047
15,36,379,19,343,594,64,60,1,1460,1525,2985,9,5,202047
15,37,369,24,321,485,149,85,60,1493,1261,2754,6,5,202047
15,38,200,28,162,232,79,26,13,740,663,1403,2,5,202047
15,39,218,53,205,224,70,44,5,819,736,1555,4,5,202047
15,40,513,50,372,588,227,85,12,1847,1656,3503,9,5,202047
15,41,399,22,479,456,76,47,75,1554,1427,2981,11,5,202047
16,1,199,11,291,177,18,17,1,714,639,1353,5,5,202047
16,2,165,29,141,191,24,24,3,577,678,1255,9,5,202047
16,3,235,13,280,322,24,58,4,936,783,1719,10,5,202047
16,4,248,22,234,248,77,50,4,883,948,1831,7,5,202047
16,5,199,21,143,180,43,50,69,705,731,1436,7,5,202047
16,6,269,54,257,294,102,45,5,1026,1335,2361,12,5,202047
16,7,356,47,332,437,42,62,0,1276,1262,2538,9,5,202047
16,8,455,36,626,605,13,62,22,1819,1630,3449,12,5,202047
16,9,335,33,333,337,20,106,56,1220,1205,2425,9,5,202047
16,10,263,19,444,365,12,53,0,1156,1010,2166,5,5,202047
16,11,222,7,186,146,83,48,3,695,1022,1717,10,5,202047
16,12,183,53,236,201,59,73,5,810,652,1462,8,5,202047
17,1,183,19,210,264,24,26,17,743,875,1618,4,5,202047
17,2,337,6,468,519,20,78,58,1486,1263,2749,8,5,202047
17,3,369,15,345,425,24,80,0,1258,1065,2323,7,5,202047
17,4,327,23,426,617,45,54,16,1508,1095,2603,10,5,202047
17,5,94,5,101,100,20,23,0,343,413,756,3,5,202047
18,1,167,8,97,124,17,24,20,457,430,887,3,5,202047
18,2,380,35,355,484,50,108,0,1412,1478,2890,8,5,202047
18,3,158,14,186,182,10,24,5,579,785,1364,5,5,202047
19,1,341,21,424,374,9,141,123,1433,1388,2821,8,5,202047
19,2,298,13,333,257,21,38,1,961,997,1958,5,5,202047
19,3,334,14,354,246,71,67,22,1108,1145,2253,7,5,202047
19,4,273,13,296,232,65,59,132,1070,1089,2159,5,5,202047
19,5,539,23,438,537,26,94,73,1730,1454,3184,8,5,202047
19,6,260,13,347,458,22,116,27,1243,1163,2406,5,5,202047
19,7,413,16,642,395,12,54,0,1532,1539,3071,10,5,202047
19,8,234,11,306,321,11,50,0,933,1016,1949,6,5,202047
19,9,304,22,355,322,50,60,37,1150,1119,2269,8,5,202047
19,10,230,7,233,312,3,71,50,906,835,1741,5,5,202047
19,11,559,31,559,807,13,179,94,2242,2100,4342,12,5,202047
19,12,369,15,680,208,29,32,3,1336,1392,2728,11,5,202047
20,1,195,8,213,149,83,27,74,749,1090,1839,5,5,202047
20,2,215,27,340,231,76,14,0,903,795,1698,6,5,202047
20,3,171,12,191,110,107,45,32,668,908,1576,6,5,202047
20,4,221,10,200,164,65,89,52,801,788,1589,6,5,202047
20,5,265,24,294,480,51,23,0,1137,957,2094,7,5,202047
20,6,146,5,164,111,77,30,18,551,609,1160,4,5,202047
20,7,243,7,227,290,17,32,9,825,915,1740,4,5,202047
20,8,548,29,705,656,57,103,78,2176,2119,4295,13,5,202047
20,9,424,13,301,268,212,52,37,1307,959,2266,8,5,202047
20,10,342,13,377,271,45,30,5,1083,1178,2261,9,5,202047
21,1,349,14,457,330,47,27,1,1225,991,2216,7,5,202047
21,2,308,22,382,151,194,45,0,1102,1015,2117,6,5,202047
21,3,362,15,417,254,85,81,72,1286,1280,2566,7,5,202047
21,4,282,10,207,115,196,100,5,915,824,1739,5,5,202047
21,5,408,19,555,371,45,69,38,1505,1223,2728,7,5,202047
21,6,277,13,217,218,74,76,48,923,1065,1988,4,5,202047
21,7,261,20,188,265,119,91,1,945,1113,2058,7,5,202047
21,8,350,9,351,264,81,80,56,1191,1061,2252,8,5,202047
21,9,353,14,490,339,85,68,66,1415,1388,2803,8,5,202047
21,10,192,9,182,165,17,67,71,703,832,1535,3,5,202047
21,11,151,7,234,158,33,28,18,629,587,1216,4,5,202047
21,12,453,24,602,486,94,84,136,1879,2056,3935,8,5,202047
21,13,206,7,302,187,40,67,10,819,969,1788,7,5,202047
21,14,214,5,195,113,127,50,19,723,708,1431,7,5,202047
21,15,382,5,275,296,46,63,72,1139,1063,2202,6,5,202047
22,1,360,69,300,337,24,52,0,1142,1354,2496,11,5,202047
22,2,315,31,399,272,108,29,10,1164,1091,2255,7,5,202047
22,3,426,32,684,541,13,49,4,1749,1720,3469,9,5,202047
22,4,321,32,646,489,21,54,16,1579,1620,3199,7,5,202047
22,5,389,32,663,379,127,49,27,1666,1673,3339,10,5,202047
23,1,338,6,804,168,35,30,19,1400,1388,2788,12,5,202047
23,2,320,21,499,416,48,29,8,1341,1325,2666,10,5,202047
23,3,435,13,675,432,51,41,7,1654,2182,3836,16,5,202047
23,4,186,5,322,188,26,43,37,807,834,1641,6,5,202047
24,1,418,60,243,410,16,50,2,1199,555,1754,9,5,202047
24,2,138,7,121,134,16,29,6,451,529,980,4,5,202047
24,3,377,43,252,269,83,43,11,1078,782,1860,9,5,202047
24,4,187,18,144,145,27,27,66,614,593,1207,3,5,202047
24,5,522,53,598,639,25,60,1,1898,1719,3617,9,5,202047
24,6,211,58,263,265,26,25,0,848,788,1636,3,5,202047
24,7,481,28,357,353,53,21,0,1293,546,1839,9,5,202047
25,1,355,17,328,399,38,63,110,1310,1242,2552,10,5,202047
25,2,332,35,342,405,25,61,1,1201,986,2187,5,5,202047
25,3,362,13,283,387,43,51,34,1173,1125,2298,7,5,202047
25,4,419,22,283,483,63,12,3,1285,1094,2379,8,5,202047
25,5,388,17,424,610,29,92,22,1582,1389,2971,8,5,202047
25,6,348,8,320,355,62,67,56,1216,1241,2457,6,5,202047
25,7,359,13,400,355,5,21,0,1153,1183,2336,5,5,202047
26,1,288,14,240,324,4,58,0,928,825,1753,8,5,202047
26,2,283,6,256,358,4,57,0,964,1229,2193,5,3.333333333,202047
26,3,424,17,270,354,9,99,30,1203,1240,2443,8,5,202047
26,4,265,21,267,255,57,35,5,905,741,1646,7,5,202047
26,5,292,7,159,280,20,63,0,821,721,1542,7,5,202047
26,6,348,10,169,273,6,53,8,867,867,1734,6,5,202047
26,7,376,20,222,354,111,35,1,1119,860,1979,10,5,202047
27,1,178,17,279,351,39,34,1,899,1245,2144,8,4,202047
27,2,379,22,277,475,43,45,31,1272,1260,2532,8,5,202047
27,3,344,10,229,591,8,44,4,1230,1283,2513,6,5,202047
27,4,305,5,422,560,19,87,14,1412,1295,2707,7,5,202047
27,5,295,6,260,427,17,52,4,1061,1227,2288,6,5,202047
27,6,216,6,299,420,9,56,0,1006,1051,2057,7,5,202047
28,1,382,31,532,498,7,36,0,1486,1445,2931,7,5,202047
28,2,468,41,559,343,63,107,268,1849,1799,3648,12,5,202047
28,3,242,17,236,220,13,33,22,783,869,1652,7,5,202047
28,4,416,29,479,345,68,86,131,1554,1682,3236,13,5,202047
28,5,339,19,263,275,25,105,87,1113,1049,2162,5,5,202047
28,6,273,17,255,341,36,39,6,967,1301,2268,8,5,202047
28,7,304,19,267,201,59,40,104,994,1163,2157,9,5,202047
28,8,272,11,252,263,60,102,92,1052,1242,2294,12,5,202047
28,9,211,10,297,180,14,60,50,822,827,1649,4,5,202047
29,1,343,23,313,396,58,48,5,1186,981,2167,6,5,202047
29,2,352,21,245,345,38,82,127,1210,1294,2504,7,5,202047
29,3,180,21,143,264,17,46,0,671,673,1344,4,5,202047
30,1,190,12,219,229,67,27,55,799,535,1334,5,5,202047
30,2,266,25,382,152,89,25,258,1197,1044,2241,10,5,202047
30,3,277,3,275,141,148,55,95,994,1107,2101,6,5,202047
30,4,199,10,304,196,47,53,0,809,649,1458,8,5,202047
30,5,330,12,601,309,23,33,0,1308,1425,2733,9,5,202047
30,6,326,11,377,270,49,34,20,1087,1174,2261,9,5,202047
30,7,246,7,148,207,71,54,58,791,650,1441,7,5,202047
30,8,322,21,479,260,115,52,6,1255,1424,2679,11,5,202047
30,9,358,15,331,214,134,59,79,1190,1056,2246,8,5,202047
30,10,311,20,564,283,35,57,90,1360,1378,2738,6,5,202047
30,11,229,10,351,328,18,21,2,959,1104,2063,5,5,202047
30,12,371,7,594,442,40,94,1,1549,1469,3018,10,5,202047
30,13,372,17,269,312,151,78,138,1337,1127,2464,10,5,202047
30,14,257,15,351,212,46,41,44,966,789,1755,6,5,202047
30,15,367,18,340,274,106,76,134,1315,1167,2482,11,5,202047
30,16,353,10,344,333,66,72,186,1364,1300,2664,8,5,202047
30,17,422,21,438,460,69,98,33,1541,1396,2937,8,5,202047
30,18,263,11,196,220,78,53,91,912,860,1772,6,5,202047
30,19,299,9,426,261,28,39,19,1081,1313,2394,9,5,202047
30,20,219,9,176,342,53,40,2,841,755,1596,6,5,202047
31,1,348,14,312,40,201,34,1,950,1221,2171,8,5,202047
31,2,176,11,176,20,333,52,0,768,693,1461,6,4.666666667,202047
31,3,618,32,769,499,115,61,0,2094,2004,4098,16,5,202047
31,4,190,8,208,141,106,26,63,742,840,1582,4,5,202047
31,5,239,10,277,150,60,39,9,784,1085,1869,6,5,202047
32,1,278,20,176,176,39,77,63,829,1043,1872,8,5,202047
32,2,428,45,328,182,177,98,73,1331,1144,2475,13,5,202047
32,3,351,57,322,495,13,63,47,1348,1357,2705,13,5,202047
32,4,395,48,337,344,20,68,26,1238,1322,2560,10,5,202047
1,1,385,45,279,304,66,59,13,1151,1077,2228,13,4,202048
1,2,454,44,440,419,39,63,20,1479,1640,3119,15,4,202048
1,3,321,50,420,354,37,53,54,1289,1524,2813,13,4,202048
2,1,345,16,261,322,21,135,41,1141,1005,2146,9,4,202048
2,2,200,7,193,322,5,57,3,787,854,1641,5,4,202048
2,3,290,12,362,326,14,140,60,1204,834,2038,10,4,202048
2,4,241,11,288,140,44,16,16,756,869,1625,8,4,202048
2,5,330,16,508,322,106,79,27,1388,1508,2896,10,4,202048
2,6,228,12,242,197,39,87,24,829,790,1619,7,4,202048
2,7,332,16,340,308,30,127,54,1207,891,2098,12,4,202048
2,8,179,5,247,194,26,57,52,760,519,1279,4,4,202048
3,1,258,20,384,284,18,64,9,1037,1395,2432,9,4,202048
3,2,169,11,372,214,55,21,8,850,1074,1924,7,4,202048
4,1,234,13,234,300,74,63,64,982,854,1836,7,3,202048
4,2,244,5,218,274,22,34,95,892,988,1880,8,4,202048
5,1,406,14,231,244,21,68,21,1005,1029,2034,8,4,202048
5,2,330,12,223,203,36,28,5,837,908,1745,10,4,202048
5,3,402,19,207,212,80,57,16,993,1189,2182,10,4,202048
5,4,456,35,441,314,4,61,26,1337,1629,2966,8,4,202048
5,5,459,13,238,278,10,102,33,1133,1451,2584,10,4,202048
5,6,336,13,234,186,3,51,32,855,742,1597,9,4,202048
5,7,280,17,150,203,15,29,14,708,768,1476,7,4,202048
6,1,294,18,283,210,21,74,68,968,994,1962,10,4,202048
6,2,145,12,207,156,41,38,31,630,610,1240,7,4,202048
7,1,209,7,154,104,30,17,0,521,770,1291,9,3.5,202048
7,2,127,5,39,104,4,12,0,291,277,568,8,3.25,202048
7,3,183,4,167,84,97,16,9,560,1047,1607,7,4,202048
7,4,195,10,225,251,5,39,63,788,826,1614,11,4,202048
7,5,273,12,151,218,8,11,0,673,737,1410,11,4,202048
7,6,301,17,392,367,63,57,24,1221,1111,2332,8,4,202048
7,7,342,15,403,323,107,76,1,1267,857,2124,8,4,202048
7,8,333,42,224,272,62,50,17,1000,1230,2230,12,4,202048
7,9,273,5,257,311,26,50,8,930,1160,2090,9,4,202048
7,10,218,11,248,249,184,20,0,930,621,1551,9,4,202048
7,11,174,2,158,81,45,24,0,484,574,1058,6,4,202048
7,12,290,5,294,348,4,25,8,974,1004,1978,9,4,202048
7,13,278,17,200,352,2,30,0,879,820,1699,9,4,202048
8,1,135,4,177,98,2,3,0,419,580,999,4,4,202048
8,2,311,37,391,331,8,21,0,1099,1216,2315,12,4,202048
8,3,185,14,167,157,15,29,26,593,770,1363,4,4,202048
8,4,250,12,345,279,39,47,47,1019,1247,2266,8,4,202048
8,5,202,34,176,236,10,27,0,685,816,1501,9,4,202048
8,6,149,20,133,141,18,18,19,498,710,1208,7,4,202048
8,7,193,19,145,191,8,41,0,597,678,1275,6,4,202048
8,8,260,20,284,370,8,50,0,992,1233,2225,7,4,202048
8,9,179,14,137,158,55,69,39,651,708,1359,10,4,202048
9,1,120,7,90,115,40,20,8,400,396,796,4,4,202048
9,2,396,38,450,685,108,106,34,1817,1437,3254,8,4,202048
9,3,161,8,159,240,48,21,30,667,759,1426,4,4,202048
9,4,276,17,305,513,61,43,57,1272,1261,2533,7,4,202048
9,5,223,0,278,422,61,47,2,1033,1204,2237,7,4,202048
9,6,120,15,96,174,71,12,1,489,627,1116,7,4,202048
9,7,174,10,286,452,3,38,2,965,819,1784,9,4,202048
9,8,96,5,176,242,16,17,19,571,589,1160,3,4,202048
9,9,116,4,135,193,47,23,9,527,522,1049,3,4,202048
9,10,102,6,157,164,13,73,3,518,471,989,3,4,202048
9,11,204,12,256,311,93,74,4,954,891,1845,7,4,202048
9,12,175,16,415,455,58,58,7,1184,839,2023,8,4,202048
9,13,148,10,149,207,67,29,18,628,534,1162,4,4,202048
9,14,160,14,230,288,51,42,83,868,595,1463,5,4,202048
9,15,161,7,439,392,50,70,48,1167,1173,2340,6,4,202048
9,16,243,82,235,423,21,18,5,1027,1289,2316,11,4,202048
9,17,173,25,291,238,36,17,0,780,752,1532,6,4,202048
9,18,157,7,195,324,68,75,10,836,833,1669,8,4,202048
9,19,168,22,144,267,64,39,33,737,657,1394,3,4,202048
9,20,70,5,79,99,30,15,28,326,305,631,3,4,202048
9,21,115,5,123,202,48,22,29,544,448,992,3,4,202048
9,22,111,7,69,130,48,16,21,402,391,793,2,4,202048
9,23,155,3,316,403,64,35,13,989,883,1872,6,4,202048
9,24,365,40,536,585,182,81,3,1792,1761,3553,11,4,202048
10,1,258,32,250,295,32,23,51,941,1257,2198,14,4,202048
10,2,187,14,161,238,8,27,15,650,637,1287,7,4,202048
10,3,161,17,105,182,35,26,41,567,777,1344,8,3.6,202048
10,4,294,59,240,418,6,20,3,1040,1080,2120,10,4,202048
11,1,16,2,9,14,1,5,0,47,58,105,3,0.333333333,202048
11,2,281,31,252,185,90,85,16,940,1099,2039,7,4,202048
11,3,109,16,87,88,14,42,13,369,357,726,3,4,202048
11,4,247,65,239,315,55,56,0,977,959,1936,6,4,202048
11,5,345,90,389,466,27,72,18,1407,1602,3009,7,4,202048
11,6,291,30,370,274,57,105,32,1159,1109,2268,8,4,202048
11,7,322,35,380,372,25,55,4,1193,1388,2581,9,4,202048
11,8,299,36,361,454,58,74,23,1305,1455,2760,9,4,202048
11,9,327,44,323,426,17,68,13,1218,1457,2675,10,4,202048
11,10,289,51,305,292,50,82,66,1135,1023,2158,10,4,202048
11,11,194,12,182,157,4,25,0,574,706,1280,5,4,202048
11,12,226,42,269,231,35,38,16,857,843,1700,7,4,202048
11,13,206,37,167,147,39,40,57,693,699,1392,8,4,202048
11,14,218,45,253,241,58,29,0,844,947,1791,8,4,202048
11,15,143,16,136,176,30,62,52,615,800,1415,6,4,202048
12,1,216,43,245,252,85,39,10,890,662,1552,6,4,202048
12,2,506,27,425,627,26,64,3,1678,1085,2763,10,4,202048
12,3,297,35,306,432,22,30,3,1125,993,2118,11,3.2,202048
12,4,262,18,327,412,55,59,14,1147,1194,2341,7,4,202048
12,5,304,41,258,282,12,27,91,1015,924,1939,10,4,202048
12,6,304,22,237,407,22,18,9,1019,825,1844,10,4,202048
12,7,296,24,234,354,12,39,87,1046,928,1974,6,4,202048
12,8,321,20,245,333,1,19,0,939,516,1455,9,4,202048
12,9,280,25,315,423,35,40,6,1124,1197,2321,9,4,202048
13,1,291,21,181,407,59,42,74,1075,772,1847,9,4,202048
13,2,250,18,120,176,92,79,44,779,825,1604,6,4,202048
13,3,366,38,256,288,100,41,9,1098,1389,2487,11,4,202048
13,4,308,22,226,254,52,43,38,943,1371,2314,8,4,202048
13,5,382,17,270,264,78,82,42,1135,1391,2526,9,4,202048
13,6,461,37,394,377,19,76,55,1419,1633,3052,11,4,202048
13,7,251,22,293,300,35,36,2,939,1054,1993,8,4,202048
14,1,164,41,128,96,85,25,18,557,559,1116,6,4,202048
14,2,170,18,114,90,65,35,3,495,490,985,4,4,202048
14,3,285,22,409,140,26,84,11,977,830,1807,7,4,202048
14,4,225,10,338,268,25,57,20,943,1067,2010,8,4,202048
14,5,245,17,328,215,49,38,0,892,1031,1923,9,4,202048
14,6,193,10,413,210,13,25,3,867,1050,1917,7,4,202048
14,7,117,18,261,146,0,18,0,560,644,1204,6,4,202048
14,8,343,30,581,504,15,76,4,1553,1663,3216,9,4,202048
14,9,187,13,204,288,15,35,17,759,814,1573,5,4,202048
14,10,187,41,254,147,6,73,45,753,792,1545,6,4,202048
14,11,167,19,182,163,50,62,56,699,806,1505,4,4,202048
14,12,344,19,399,204,32,19,0,1017,1128,2145,9,4,202048
14,13,188,15,221,148,16,24,6,618,805,1423,5,4,202048
14,14,183,5,198,185,35,63,38,707,688,1395,5,4,202048
14,15,311,41,275,256,131,74,57,1145,1293,2438,10,4,202048
14,16,169,20,225,139,35,50,11,649,594,1243,5,4,202048
14,17,177,28,232,95,24,65,18,639,589,1228,7,4,202048
14,18,226,27,298,131,102,41,65,890,925,1815,7,4,202048
14,19,259,27,307,200,39,45,30,907,1042,1949,8,4,202048
14,20,322,32,516,345,6,36,0,1257,1293,2550,9,4,202048
15,1,211,8,170,81,254,23,1,748,994,1742,7,4,202048
15,2,182,7,208,207,98,24,22,748,906,1654,5,4,202048
15,3,317,11,172,227,230,43,107,1107,1139,2246,8,4,202048
15,4,200,12,116,208,45,28,11,620,656,1276,3,4,202048
15,5,222,15,274,258,37,36,24,866,824,1690,8,4,202048
15,6,208,6,200,311,30,38,42,835,905,1740,5,4,202048
15,7,199,14,340,165,50,49,2,819,1013,1832,9,4,202048
15,8,131,14,147,228,15,26,77,638,735,1373,4,4,202048
15,9,231,11,86,79,133,109,5,654,670,1324,8,3.75,202048
15,10,185,8,143,292,26,45,28,727,940,1667,6,4,202048
15,11,199,14,223,219,29,20,6,710,842,1552,6,4,202048
15,12,264,11,405,349,80,31,1,1141,1181,2322,8,4,202048
15,13,106,6,103,156,77,19,0,467,628,1095,5,4,202048
15,14,136,7,112,208,26,21,2,512,539,1051,4,4,202048
15,15,109,29,89,113,23,10,28,401,549,950,2,4,202048
15,16,292,20,281,493,29,54,48,1217,1470,2687,8,4,202048
15,17,172,9,130,188,33,39,65,636,581,1217,6,4,202048
15,18,340,19,352,360,44,72,31,1218,1386,2604,7,4,202048
15,19,234,24,324,599,20,65,17,1283,1603,2886,10,4,202048
15,20,106,11,204,159,9,18,1,508,619,1127,5,4,202048
15,21,141,4,85,113,25,57,25,450,548,998,4,4,202048
15,22,315,83,317,485,14,50,60,1324,1431,2755,11,4,202048
15,23,259,20,195,341,23,65,20,923,1001,1924,6,4,202048
15,24,160,20,175,237,33,27,19,671,915,1586,4,4,202048
15,25,206,20,168,209,34,28,32,697,842,1539,4,4,202048
15,26,212,7,203,235,87,36,18,798,892,1690,6,4,202048
15,27,274,11,340,299,34,49,104,1111,820,1931,9,4,202048
15,28,351,18,473,311,44,32,63,1292,1441,2733,9,4,202048
15,29,199,13,241,358,7,36,41,895,1263,2158,7,4,202048
15,30,281,42,372,326,68,52,66,1207,1415,2622,12,4,202048
15,31,146,91,166,253,13,21,0,690,846,1536,6,4,202048
15,32,200,18,188,267,60,61,19,813,925,1738,7,4,202048
15,33,228,9,270,290,38,29,0,864,995,1859,6,4,202048
15,34,158,8,129,260,24,23,5,607,609,1216,6,4,202048
15,35,286,8,199,377,13,51,20,954,883,1837,8,4,202048
15,36,328,13,276,500,49,51,2,1219,1124,2343,9,4,202048
15,37,313,12,291,386,107,65,46,1220,1363,2583,6,4,202048
15,38,184,21,148,149,64,18,14,598,628,1226,2,4,202048
15,39,180,42,160,182,55,47,5,671,757,1428,4,4,202048
15,40,430,48,281,436,197,68,13,1473,1777,3250,9,4,202048
15,41,339,17,401,374,60,32,64,1287,1533,2820,11,4,202048
16,1,157,19,248,128,19,9,0,580,718,1298,5,4,202048
16,2,124,25,142,195,15,28,0,529,523,1052,9,4,202048
16,3,217,16,185,281,24,42,0,765,792,1557,10,4,202048
16,4,215,26,220,168,53,40,3,725,719,1444,7,3.25,202048
16,5,152,17,168,170,53,43,23,626,638,1264,7,4,202048
16,6,207,34,235,199,66,36,9,786,988,1774,12,4,202048
16,7,250,43,287,319,38,45,0,982,1221,2203,9,4,202048
16,8,376,30,549,476,18,59,19,1527,1621,3148,12,4,202048
16,9,284,25,284,272,24,77,44,1010,1012,2022,9,4,202048
16,10,208,16,319,304,16,34,0,897,1018,1915,5,4,202048
16,11,167,10,191,140,43,35,2,588,745,1333,10,4,202048
16,12,145,18,146,136,7,49,0,501,537,1038,6,2.666666667,202048
17,1,160,12,174,248,22,30,12,658,658,1316,4,4,202048
17,2,273,9,392,396,22,58,38,1188,1329,2517,8,4,202048
17,3,283,18,292,340,30,66,0,1029,1145,2174,7,4,202048
17,4,265,16,366,332,99,33,41,1152,1286,2438,10,4,202048
17,5,68,5,96,95,13,12,0,289,327,616,3,4,202048
18,1,124,9,74,125,19,21,18,390,349,739,3,4,202048
18,2,347,26,371,373,59,103,9,1288,1428,2716,8,4,202048
18,3,146,15,174,145,6,25,11,522,612,1134,5,4,202048
19,1,281,14,354,312,12,72,74,1119,1109,2228,8,4,202048
19,2,252,11,280,199,17,28,1,788,818,1606,5,4,202048
19,3,273,11,357,224,54,48,16,983,938,1921,7,4,202048
19,4,214,12,208,165,64,74,117,854,1072,1926,5,4,202048
19,5,379,24,384,427,33,76,46,1369,1680,3049,8,4,202048
19,6,225,15,302,337,16,62,79,1036,1054,2090,5,4,202048
19,7,283,8,482,350,4,71,5,1203,1514,2717,10,4,202048
19,8,183,11,261,265,5,32,0,757,721,1478,6,4,202048
19,9,265,16,290,247,42,48,49,957,1018,1975,8,4,202048
19,10,168,5,205,213,13,59,56,719,932,1651,5,4,202048
19,11,429,35,463,683,15,139,84,1848,1873,3721,12,4,202048
19,12,307,13,593,153,18,24,2,1110,1183,2293,11,4,202048
20,1,223,8,178,131,118,33,70,761,635,1396,5,4,202048
20,2,257,5,203,199,63,5,0,732,726,1458,6,4,202048
20,3,154,6,146,96,114,22,16,554,646,1200,6,4,202048
20,4,182,12,168,194,36,106,44,742,739,1481,6,4,202048
20,5,218,13,271,331,62,36,0,931,1253,2184,7,4,202048
20,6,124,1,114,101,64,18,20,442,486,928,4,4,202048
20,7,187,8,172,246,15,24,3,655,487,1142,4,4,202048
20,8,455,44,498,530,52,87,92,1758,2023,3781,13,4,202048
20,9,321,6,255,210,203,47,40,1082,889,1971,8,4,202048
20,10,300,7,364,202,54,20,2,949,897,1846,9,4,202048
21,1,299,13,352,265,32,30,2,993,1020,2013,7,4,202048
21,2,212,14,348,155,152,35,8,924,955,1879,6,4,202048
21,3,289,5,298,198,119,48,67,1024,1206,2230,7,4,202048
21,4,269,13,189,90,159,53,5,778,703,1481,5,4,202048
21,5,330,16,483,259,41,46,36,1211,1398,2609,7,4,202048
21,6,197,2,186,178,65,61,32,721,901,1622,4,4,202048
21,7,219,10,153,203,94,58,2,739,997,1736,7,4,202048
21,8,277,11,281,154,50,44,54,871,1130,2001,8,4,202048
21,9,269,13,373,301,70,63,52,1141,1379,2520,8,4,202048
21,10,168,5,122,138,16,56,64,569,647,1216,3,4,202048
21,11,152,8,194,129,28,20,13,544,511,1055,4,4,202048
21,12,363,13,564,378,100,59,123,1600,1910,3510,8,4,202048
21,13,218,7,253,169,37,74,7,765,660,1425,7,4,202048
21,14,157,5,169,98,114,20,11,574,548,1122,7,4,202048
21,15,294,9,232,285,40,49,56,965,934,1899,6,4,202048
22,1,278,48,241,300,29,37,1,934,1174,2108,11,4,202048
22,2,215,29,325,242,112,37,10,970,1037,2007,7,4,202048
22,3,323,24,455,359,19,23,3,1206,1518,2724,9,3,202048
22,4,232,36,556,385,30,50,10,1299,1241,2540,7,4,202048
22,5,288,29,603,281,103,68,24,1396,1535,2931,10,4,202048
23,1,232,5,623,150,26,29,13,1078,1258,2336,12,4,202048
23,2,270,8,382,298,28,22,6,1014,1156,2170,10,4,202048
23,3,330,19,650,380,29,34,3,1445,1970,3415,16,4,202048
23,4,137,7,299,158,31,48,32,712,734,1446,6,4,202048
24,1,296,51,168,274,24,27,1,841,778,1619,9,4,202048
24,2,122,7,123,104,13,18,4,391,346,737,4,4,202048
24,3,339,37,229,203,82,44,6,940,757,1697,9,4,202048
24,4,138,11,119,100,24,33,70,495,536,1031,3,4,202048
24,5,355,33,498,521,14,36,2,1459,1610,3069,9,4,202048
24,6,176,61,194,220,20,26,0,697,828,1525,3,4,202048
24,7,324,28,267,282,28,21,0,950,729,1679,9,4,202048
25,1,293,8,299,332,31,52,66,1081,1081,2162,10,4,202048
25,2,300,47,250,322,19,35,0,973,1230,2203,5,4,202048
25,3,248,15,233,393,22,42,31,984,1025,2009,7,4,202048
25,4,281,15,274,361,61,12,0,1004,1038,2042,8,4,202048
25,5,364,13,320,489,44,69,21,1320,1263,2583,8,4,202048
25,6,319,8,279,279,44,62,54,1045,1111,2156,6,4,202048
25,7,240,14,322,293,4,18,0,891,1122,2013,5,4,202048
26,1,232,8,255,286,5,52,0,838,719,1557,8,4,202048
26,2,297,12,288,411,3,52,0,1063,1333,2396,7,4,202048
26,3,352,14,244,261,4,74,19,968,1216,2184,8,4,202048
26,4,198,11,236,204,45,26,6,726,769,1495,7,4,202048
26,5,203,6,187,177,13,49,0,635,597,1232,7,4,202048
26,6,240,6,144,212,5,55,8,670,807,1477,6,4,202048
26,7,269,22,212,292,89,19,2,905,915,1820,10,4,202048
27,1,270,14,347,330,79,34,1,1075,856,1931,8,4,202048
27,2,276,12,208,399,12,33,30,970,944,1914,8,4,202048
27,3,273,8,212,453,8,40,0,994,1045,2039,6,4,202048
27,4,287,4,548,551,23,91,12,1516,1284,2800,7,4,202048
27,5,252,11,237,357,11,45,3,916,740,1656,6,4,202048
27,6,258,10,337,495,4,37,1,1142,952,2094,7,4,202048
28,1,269,22,417,399,9,33,0,1149,1183,2332,7,4,202048
28,2,346,21,494,300,43,84,237,1525,1415,2940,12,4,202048
28,3,187,18,214,201,10,33,23,686,717,1403,7,4,202048
28,4,373,42,428,275,100,75,106,1399,1500,2899,13,4,202048
28,5,293,19,188,227,9,87,67,890,824,1714,5,4,202048
28,6,218,12,210,315,38,22,10,825,903,1728,8,4,202048
28,7,219,13,234,169,53,40,119,847,880,1727,9,4,202048
28,8,248,20,249,270,50,71,81,989,980,1969,12,4,202048
28,9,137,7,226,116,17,43,42,588,828,1416,4,4,202048
29,1,281,16,254,327,41,40,8,967,1133,2100,6,4,202048
29,2,255,9,238,290,20,70,107,989,1124,2113,7,4,202048
29,3,132,10,127,233,10,32,0,544,675,1219,4,4,202048
30,1,141,13,167,166,64,19,49,619,521,1140,5,4,202048
30,2,177,15,221,79,35,8,150,685,541,1226,10,4,202048
30,3,198,12,217,120,118,22,83,770,863,1633,6,4,202048
30,4,155,6,265,162,24,41,0,653,816,1469,8,4,202048
30,5,217,12,432,286,13,36,0,996,1119,2115,9,4,202048
30,6,258,17,351,194,43,40,21,924,711,1635,9,4,202048
30,7,189,15,118,142,41,47,31,583,530,1113,7,4,202048
30,8,275,12,432,206,109,36,8,1078,1052,2130,11,4,202048
30,9,266,4,280,165,114,57,76,962,942,1904,8,4,202048
30,10,251,15,444,198,39,40,53,1040,926,1966,6,4,202048
30,11,164,1,313,243,19,21,1,762,843,1605,5,4,202048
30,12,262,11,498,369,42,78,1,1261,1438,2699,10,4,202048
30,13,282,17,287,216,119,43,115,1079,967,2046,10,4,202048
30,14,182,10,260,179,54,28,59,772,660,1432,6,4,202048
30,15,287,14,270,206,121,57,135,1090,1214,2304,11,4,202048
30,16,288,10,260,251,49,66,160,1084,1128,2212,8,4,202048
30,17,333,15,349,358,44,66,30,1195,1204,2399,8,4,202048
30,18,228,12,166,184,76,58,89,813,663,1476,6,4,202048
30,19,182,9,295,190,44,34,27,781,761,1542,9,4,202048
30,20,154,8,141,219,28,29,3,582,698,1280,6,4,202048
31,1,256,16,314,57,206,27,1,877,762,1639,8,4,202048
31,2,136,5,182,14,229,40,0,606,676,1282,6,4,202048
31,3,491,33,682,499,92,55,1,1853,1844,3697,16,4,202048
31,4,166,9,190,123,84,34,48,654,657,1311,4,4,202048
31,5,200,6,221,143,48,26,13,657,677,1334,6,4,202048
32,1,237,20,172,173,37,59,73,771,911,1682,8,4,202048
32,2,269,50,265,140,157,64,67,1012,1203,2215,13,4,202048
32,3,219,47,242,386,14,42,52,1002,1156,2158,13,4,202048
32,4,301,46,250,242,21,53,23,936,1217,2153,10,4,202048
1,1,466,58,398,395,45,106,17,1485,1372,2857,12,5,202049
1,2,573,62,574,474,51,69,33,1836,1615,3451,15,5,202049
1,3,495,75,615,443,38,83,72,1821,1390,3211,14,5,202049
2,1,412,26,317,353,43,153,88,1392,1453,2845,9,5,202049
2,2,220,11,265,389,5,75,2,967,896,1863,5,5,202049
2,3,412,19,475,388,19,168,90,1571,1035,2606,10,5,202049
2,4,298,5,387,203,49,37,22,1001,1204,2205,8,5,202049
2,5,377,17,662,399,160,115,34,1764,1803,3567,10,5,202049
2,6,285,17,343,274,62,86,52,1119,995,2114,7,5,202049
2,7,467,16,459,422,37,148,59,1608,983,2591,12,5,202049
2,8,239,9,348,268,33,55,73,1025,640,1665,4,5,202049
3,1,329,9,441,398,34,83,32,1326,908,2234,9,5,202049
3,2,209,9,495,203,61,27,25,1029,937,1966,7,5,202049
4,1,366,11,293,331,89,72,62,1224,1213,2437,7,3.666666667,202049
4,2,274,7,288,323,26,49,103,1070,991,2061,8,5,202049
5,1,475,18,277,324,35,92,27,1248,1324,2572,8,5,202049
5,2,406,15,288,262,45,40,13,1069,1177,2246,10,5,202049
5,3,400,19,295,283,90,60,27,1174,1225,2399,10,5,202049
5,4,521,36,520,408,8,80,30,1603,1781,3384,8,5,202049
5,5,528,19,295,303,10,132,76,1363,1398,2761,10,5,202049
5,6,408,19,274,232,6,64,88,1091,1027,2118,9,5,202049
5,7,296,8,175,227,22,31,14,773,812,1585,7,5,202049
6,1,369,25,380,294,23,68,108,1267,1177,2444,10,5,202049
6,2,240,9,259,196,61,39,47,851,690,1541,7,5,202049
7,1,275,4,194,146,8,50,2,679,662,1341,9,4.25,202049
7,2,371,28,334,291,18,15,1,1058,1635,2693,9,5,202049
7,3,362,10,241,96,114,26,6,855,731,1586,7,5,202049
7,4,311,24,299,404,22,66,32,1158,1055,2213,11,5,202049
7,5,374,13,169,280,42,31,19,928,932,1860,11,5,202049
7,6,365,12,410,453,43,53,20,1356,1145,2501,8,4.666666667,202049
7,7,473,14,484,373,91,74,14,1523,1417,2940,8,5,202049
7,8,361,34,255,390,41,60,13,1154,1209,2363,12,5,202049
7,9,334,15,330,344,42,61,17,1143,1014,2157,9,5,202049
7,10,319,6,326,362,283,30,1,1327,909,2236,9,5,202049
7,11,264,2,212,149,36,25,3,691,534,1225,6,5,202049
7,12,362,3,347,419,3,35,15,1184,1244,2428,9,5,202049
7,13,264,11,207,389,3,42,7,923,1006,1929,9,5,202049
8,1,171,8,239,121,0,7,0,546,697,1243,4,5,202049
8,2,463,38,537,469,11,35,2,1555,1589,3144,12,5,202049
8,3,244,19,277,282,35,37,33,927,675,1602,4,5,202049
8,4,403,24,466,431,65,80,86,1555,1565,3120,8,5,202049
8,5,289,45,221,310,20,47,4,936,878,1814,9,5,202049
8,6,204,21,185,149,17,28,43,647,673,1320,7,5,202049
8,7,236,24,204,242,5,45,0,756,749,1505,6,5,202049
8,8,212,12,277,362,5,42,0,910,1093,2003,7,5,202049
8,9,214,29,190,146,49,58,75,761,743,1504,10,5,202049
9,1,125,8,99,149,67,19,23,490,510,1000,4,5,202049
9,2,489,34,605,853,152,106,51,2290,1798,4088,8,5,202049
9,3,195,11,201,320,45,34,27,833,836,1669,4,5,202049
9,4,318,22,358,648,56,78,66,1546,1654,3200,7,5,202049
9,5,314,3,334,575,52,87,0,1365,1330,2695,7,5,202049
9,6,164,30,149,272,117,35,4,771,619,1390,7,5,202049
9,7,205,10,359,524,5,55,3,1161,1142,2303,9,5,202049
9,8,107,8,204,325,17,22,23,706,721,1427,3,5,202049
9,9,178,7,155,229,49,25,15,658,685,1343,3,5,202049
9,10,126,11,204,212,15,91,3,662,590,1252,3,5,202049
9,11,215,20,306,447,88,95,1,1172,1091,2263,7,5,202049
9,12,216,21,423,631,60,78,4,1433,1229,2662,8,5,202049
9,13,163,10,224,281,71,41,28,818,799,1617,4,5,202049
9,14,193,9,249,319,51,48,72,941,890,1831,5,5,202049
9,15,198,13,523,488,66,78,62,1428,1472,2900,6,5,202049
9,16,287,96,345,620,25,33,4,1410,1485,2895,11,5,202049
9,17,207,17,362,323,49,18,2,978,1000,1978,6,5,202049
9,18,193,6,223,459,78,86,12,1057,1064,2121,8,5,202049
9,19,204,21,169,307,86,47,39,873,800,1673,3,5,202049
9,20,98,4,120,116,38,16,26,418,378,796,3,5,202049
9,21,168,2,138,253,36,24,20,641,587,1228,3,5,202049
9,22,123,8,111,141,48,26,22,479,548,1027,2,5,202049
9,23,222,17,396,492,90,54,26,1297,1333,2630,6,5,202049
9,24,427,36,675,742,276,98,2,2256,2246,4502,11,5,202049
10,1,381,42,322,415,29,32,77,1298,1291,2589,14,4.833333333,202049
10,2,285,21,184,290,12,32,19,843,811,1654,7,5,202049
10,3,133,25,115,184,18,23,46,544,389,933,5,4,202049
10,4,396,42,280,475,7,18,6,1224,1257,2481,10,5,202049
11,1,122,30,101,97,32,24,16,422,345,767,2,1.666666667,202049
11,2,334,49,336,286,77,88,35,1205,1003,2208,7,5,202049
11,3,107,21,130,125,11,32,19,445,477,922,3,5,202049
11,4,308,70,258,381,80,75,6,1178,1000,2178,6,5,202049
11,5,375,73,411,487,32,81,31,1490,1425,2915,7,5,202049
11,6,398,55,433,404,66,92,32,1480,1432,2912,8,5,202049
11,7,362,40,408,412,58,76,8,1364,1481,2845,9,5,202049
11,8,385,54,438,503,107,70,35,1592,1594,3186,9,5,202049
11,9,449,70,384,484,20,66,51,1524,1449,2973,10,5,202049
11,10,353,69,374,320,75,107,120,1418,1418,2836,10,5,202049
11,11,186,14,172,179,9,28,0,588,548,1136,5,5,202049
11,12,236,45,368,287,31,27,29,1023,1061,2084,7,5,202049
11,13,266,49,235,245,62,47,80,984,856,1840,7,5,202049
11,14,263,57,332,307,76,29,15,1079,1012,2091,8,5,202049
11,15,236,31,227,257,19,40,61,871,716,1587,6,5,202049
12,1,257,74,269,322,117,47,19,1105,907,2012,6,5,202049
12,2,467,65,392,597,22,65,20,1628,1063,2691,10,5,202049
12,3,528,53,602,682,24,62,3,1954,1047,3001,11,5,202049
12,4,325,20,373,578,59,58,7,1420,1282,2702,7,5,202049
12,5,490,54,325,524,2,30,140,1565,791,2356,10,5,202049
12,6,386,26,335,574,28,22,13,1384,792,2176,10,5,202049
12,7,419,49,296,459,5,39,106,1373,821,2194,6,5,202049
12,8,444,22,311,399,1,29,0,1206,699,1905,9,5,202049
12,9,363,28,367,569,47,38,5,1417,1190,2607,9,5,202049
13,1,362,34,226,495,85,46,82,1330,1314,2644,9,5,202049
13,2,272,25,160,218,125,98,43,941,1031,1972,6,5,202049
13,3,472,38,315,406,139,68,17,1455,1651,3106,11,5,202049
13,4,350,27,272,294,87,54,83,1167,1511,2678,8,4.666666667,202049
13,5,462,27,378,380,110,100,72,1529,1565,3094,9,5,202049
13,6,560,39,464,465,19,68,85,1700,1653,3353,11,5,202049
13,7,299,20,395,389,22,50,3,1178,1263,2441,8,5,202049
14,1,210,47,167,103,97,37,12,673,681,1354,6,4.75,202049
14,2,191,23,164,103,106,28,0,615,543,1158,4,5,202049
14,3,356,30,458,196,31,80,16,1167,1121,2288,7,5,202049
14,4,293,15,434,327,17,74,60,1220,1151,2371,8,5,202049
14,5,320,20,452,269,60,39,0,1160,1110,2270,9,5,202049
14,6,289,25,512,229,15,55,8,1133,888,2021,7,5,202049
14,7,198,21,294,200,0,19,0,732,585,1317,6,5,202049
14,8,423,31,660,584,14,88,10,1810,1741,3551,9,5,202049
14,9,234,16,243,351,25,38,26,933,796,1729,5,5,202049
14,10,227,38,332,172,18,66,32,885,995,1880,6,5,202049
14,11,213,14,221,202,47,64,86,847,722,1569,4,5,202049
14,12,440,21,512,262,43,32,5,1315,1115,2430,9,5,202049
14,13,213,25,296,199,17,42,7,799,924,1723,5,5,202049
14,14,209,23,242,236,55,90,26,881,836,1717,5,5,202049
14,15,379,46,398,347,143,77,58,1448,1301,2749,10,5,202049
14,16,220,21,242,193,37,59,22,794,818,1612,5,5,202049
14,17,241,34,238,114,68,86,20,801,450,1251,7,5,202049
14,18,295,42,340,185,104,71,89,1126,1110,2236,7,5,202049
14,19,326,40,376,254,60,71,45,1172,1104,2276,8,5,202049
14,20,413,25,607,389,2,51,2,1489,1375,2864,9,5,202049
15,1,269,14,270,146,297,38,5,1039,926,1965,7,5,202049
15,2,238,16,269,306,115,26,35,1005,833,1838,5,5,202049
15,3,393,16,250,235,296,48,161,1399,1444,2843,8,5,202049
15,4,232,10,151,275,44,21,39,772,687,1459,3,5,202049
15,5,297,19,340,357,52,37,48,1150,1003,2153,8,5,202049
15,6,237,7,251,418,36,56,61,1066,943,2009,5,5,202049
15,7,302,15,413,183,79,69,4,1065,932,1997,9,5,202049
15,8,191,17,181,282,30,39,75,815,649,1464,4,5,202049
15,9,275,12,144,117,159,125,13,845,954,1799,8,5,202049
15,10,226,7,194,361,22,49,25,884,801,1685,6,5,202049
15,11,236,24,226,300,56,37,14,893,806,1699,6,5,202049
15,12,313,11,549,468,67,43,1,1452,1394,2846,8,5,202049
15,13,132,9,120,173,104,40,2,580,525,1105,5,5,202049
15,14,141,15,136,254,25,25,13,609,551,1160,4,5,202049
15,15,127,50,106,139,45,18,18,503,480,983,2,5,202049
15,16,359,28,332,600,27,80,77,1503,1332,2835,8,5,202049
15,17,182,12,151,227,44,66,66,748,838,1586,6,5,202049
15,18,382,29,435,422,37,92,39,1436,1301,2737,7,5,202049
15,19,323,29,399,704,24,65,40,1584,1456,3040,10,5,202049
15,20,140,16,249,202,27,18,3,655,1009,1664,5,5,202049
15,21,122,6,103,123,29,47,37,467,497,964,4,5,202049
15,22,369,85,443,653,25,56,47,1678,1808,3486,11,5,202049
15,23,298,9,186,423,35,51,43,1045,1108,2153,6,5,202049
15,24,236,19,184,229,35,29,24,756,891,1647,4,5,202049
15,25,256,23,187,244,41,52,34,837,835,1672,4,5,202049
15,26,295,14,232,347,109,46,19,1062,894,1956,6,5,202049
15,27,311,13,406,396,24,82,123,1355,1561,2916,9,5,202049
15,28,429,31,625,415,51,58,41,1650,1483,3133,9,5,202049
15,29,240,9,247,373,14,106,44,1033,1297,2330,7,5,202049
15,30,376,52,406,417,72,48,99,1470,1428,2898,12,5,202049
15,31,220,82,214,358,12,38,2,926,808,1734,6,5,202049
15,32,328,15,266,427,84,71,18,1209,973,2182,7,5,202049
15,33,250,15,352,376,48,39,0,1080,907,1987,6,5,202049
15,34,174,11,203,324,5,30,6,753,719,1472,6,5,202049
15,35,346,19,245,480,13,63,18,1184,1106,2290,8,5,202049
15,36,406,17,343,581,51,41,8,1447,1287,2734,9,5,202049
15,37,327,20,341,471,104,86,33,1382,1339,2721,6,5,202049
15,38,229,32,204,182,52,16,17,732,705,1437,2,5,202049
15,39,245,41,189,231,71,64,5,846,793,1639,4,5,202049
15,40,543,66,328,611,250,78,19,1895,1745,3640,9,5,202049
15,41,433,16,498,466,71,63,72,1619,1461,3080,11,5,202049
16,1,185,19,290,179,20,14,3,710,579,1289,5,5,202049
16,2,187,26,186,242,22,39,1,703,640,1343,9,5,202049
16,3,274,27,251,314,34,47,4,951,880,1831,10,5,202049
16,4,254,27,275,238,81,65,7,947,910,1857,7,4,202049
16,5,169,21,166,233,46,55,44,734,718,1452,7,5,202049
16,6,294,50,240,281,78,34,6,983,920,1903,12,5,202049
16,7,327,44,335,392,28,48,7,1181,1121,2302,9,5,202049
16,8,465,45,594,696,25,53,41,1919,1650,3569,12,5,202049
16,9,384,24,328,354,25,105,73,1293,1182,2475,9,5,202049
16,10,286,26,452,385,19,58,2,1228,969,2197,5,5,202049
16,11,256,23,229,156,52,40,3,759,762,1521,10,5,202049
16,12,146,15,190,151,14,60,5,581,523,1104,7,3.666666667,202049
17,1,199,20,248,312,25,29,9,842,919,1761,4,5,202049
17,2,329,15,493,516,19,62,40,1474,1468,2942,8,5,202049
17,3,348,19,383,413,22,105,0,1290,1173,2463,7,5,202049
17,4,386,21,450,382,170,49,76,1534,1564,3098,10,5,202049
17,5,110,11,100,117,22,12,1,373,378,751,3,5,202049
18,1,142,11,109,148,41,14,17,482,448,930,3,5,202049
18,2,469,28,443,535,72,129,5,1681,1412,3093,8,5,202049
18,3,169,13,233,197,5,33,12,662,716,1378,5,5,202049
19,1,334,21,404,401,9,109,100,1378,1514,2892,8,5,202049
19,2,313,9,335,304,23,46,4,1034,1036,2070,5,5,202049
19,3,350,18,504,316,58,71,24,1341,1144,2485,7,5,202049
19,4,261,8,299,194,64,74,172,1072,945,2017,5,5,202049
19,5,479,31,468,499,39,108,116,1740,1538,3278,8,5,202049
19,6,218,12,366,377,12,118,117,1220,1166,2386,5,5,202049
19,7,359,16,526,328,7,64,1,1301,1272,2573,10,4.5,202049
19,8,196,18,271,327,6,47,3,868,968,1836,6,5,202049
19,9,323,19,382,316,49,64,55,1208,1104,2312,8,5,202049
19,10,205,9,276,300,7,66,77,940,838,1778,5,5,202049
19,11,616,40,540,881,13,171,117,2378,2295,4673,12,5,202049
19,12,368,14,697,269,20,39,2,1409,1450,2859,11,4.666666667,202049
20,1,294,15,267,154,106,20,67,923,887,1810,5,5,202049
20,2,317,34,379,270,113,9,0,1122,380,1502,6,5,202049
20,3,189,8,200,138,110,33,45,723,688,1411,6,5,202049
20,4,205,21,226,228,80,92,82,934,829,1763,6,5,202049
20,5,304,17,371,458,54,38,0,1242,1202,2444,7,5,202049
20,6,144,3,150,124,72,20,30,543,501,1044,4,5,202049
20,7,249,11,228,307,20,39,15,869,863,1732,4,5,202049
20,8,547,30,618,722,47,70,83,2117,2203,4320,13,5,202049
20,9,345,19,283,254,247,46,48,1242,1212,2454,8,5,202049
20,10,295,14,304,225,79,24,14,955,1076,2031,9,5,202049
21,1,301,13,489,373,46,46,2,1270,1197,2467,7,5,202049
21,2,293,16,417,212,168,35,6,1147,1037,2184,6,5,202049
21,3,447,14,378,250,134,67,71,1361,1159,2520,7,5,202049
21,4,319,13,269,135,150,98,9,993,906,1899,5,5,202049
21,5,447,24,578,395,37,55,45,1581,1353,2934,7,5,202049
21,6,258,3,240,194,73,76,37,881,1059,1940,4,5,202049
21,7,305,19,191,300,53,73,4,945,978,1923,7,5,202049
21,8,389,10,392,241,84,72,101,1289,1130,2419,8,5,202049
21,9,383,17,468,361,67,47,66,1409,1425,2834,8,5,202049
21,10,200,8,213,170,13,44,52,700,800,1500,3,5,202049
21,11,171,4,253,155,28,27,9,647,629,1276,4,5,202049
21,12,483,25,586,449,82,74,168,1867,1951,3818,8,5,202049
21,13,282,10,231,291,34,75,26,949,773,1722,7,5,202049
21,14,221,16,203,113,130,60,13,756,786,1542,7,5,202049
21,15,366,9,290,323,48,76,81,1193,942,2135,6,5,202049
22,1,303,68,348,354,46,35,2,1156,1231,2387,11,5,202049
22,2,285,38,427,331,117,43,8,1249,1062,2311,7,5,202049
22,3,391,25,619,444,13,33,10,1535,1641,3176,9,3.666666667,202049
22,4,293,33,625,480,26,59,9,1525,1583,3108,7,5,202049
22,5,378,49,736,364,115,58,43,1743,1520,3263,10,5,202049
23,1,376,8,767,215,26,29,36,1457,1423,2880,12,5,202049
23,2,345,19,547,391,38,20,9,1369,1558,2927,10,5,202049
23,3,471,23,903,488,47,46,8,1986,1654,3640,16,5,202049
23,4,155,3,393,175,33,60,39,858,860,1718,6,5,202049
24,1,424,53,214,379,32,37,6,1145,1271,2416,9,5,202049
24,2,154,11,152,96,25,19,14,471,543,1014,4,5,202049
24,3,387,59,280,281,86,46,11,1150,1075,2225,9,5,202049
24,4,139,24,151,125,39,38,89,605,659,1264,3,5,202049
24,5,488,50,584,593,15,61,1,1792,1777,3569,9,5,202049
24,6,185,57,308,233,29,32,0,844,787,1631,3,5,202049
24,7,404,29,339,349,39,19,0,1179,1223,2402,9,5,202049
25,1,325,11,390,457,49,68,134,1434,1281,2715,10,5,202049
25,2,341,50,334,361,19,48,0,1153,910,2063,5,5,202049
25,3,309,7,314,435,23,49,42,1179,996,2175,7,5,202049
25,4,320,15,311,489,69,22,0,1226,1329,2555,8,5,202049
25,5,413,9,453,657,23,77,55,1687,1488,3175,8,5,202049
25,6,373,6,320,326,88,71,95,1279,1162,2441,6,5,202049
25,7,349,12,424,379,5,28,0,1197,1048,2245,5,5,202049
26,1,264,23,297,362,12,62,0,1020,874,1894,8,5,202049
26,2,405,6,360,512,9,68,1,1361,1063,2424,10,5,202049
26,3,417,13,305,334,17,110,41,1237,1193,2430,8,5,202049
26,4,258,11,278,270,67,33,6,923,902,1825,7,5,202049
26,5,280,3,215,278,30,64,0,870,667,1537,7,5,202049
26,6,263,7,180,259,16,63,16,804,854,1658,6,5,202049
26,7,328,18,262,352,115,32,8,1115,1077,2192,10,5,202049
27,1,345,20,425,503,107,46,10,1456,564,2020,8,5,202049
27,2,360,18,303,522,29,40,40,1312,1081,2393,8,5,202049
27,3,303,11,325,662,14,45,0,1360,922,2282,6,5,202049
27,4,387,3,644,698,22,124,17,1895,1478,3373,7,5,202049
27,5,312,5,386,497,12,71,8,1291,1045,2336,6,5,202049
27,6,412,17,484,668,16,59,2,1658,923,2581,7,5,202049
28,1,338,32,542,475,12,44,0,1443,1357,2800,7,5,202049
28,2,454,40,582,315,53,120,326,1890,1785,3675,12,5,202049
28,3,219,13,275,244,12,52,25,840,744,1584,7,5,202049
28,4,466,40,560,387,143,111,132,1839,1534,3373,13,5,202049
28,5,338,17,268,242,28,95,79,1067,1066,2133,5,5,202049
28,6,400,34,358,555,20,47,10,1424,1026,2450,8,5,202049
28,7,296,23,307,186,62,46,121,1041,900,1941,9,5,202049
28,8,317,14,286,307,50,101,116,1191,1163,2354,12,5,202049
28,9,199,4,296,143,21,48,57,768,744,1512,4,5,202049
29,1,338,34,331,396,43,71,20,1233,1085,2318,6,5,202049
29,2,353,15,243,362,26,76,158,1233,1197,2430,7,5,202049
29,3,209,10,140,268,15,33,0,675,597,1272,4,5,202049
30,1,181,15,215,207,82,26,73,799,880,1679,5,5,202049
30,2,245,15,343,110,55,13,188,969,1029,1998,10,5,202049
30,3,271,14,306,164,135,53,108,1051,967,2018,6,5,202049
30,4,226,7,308,257,30,26,0,854,794,1648,8,5,202049
30,5,321,10,513,441,18,61,7,1371,1269,2640,9,5,202049
30,6,276,18,395,253,47,46,31,1066,1162,2228,9,5,202049
30,7,268,9,158,196,69,32,77,809,740,1549,7,5,202049
30,8,404,14,521,351,97,53,11,1451,1227,2678,11,5,202049
30,9,339,8,325,266,94,61,143,1236,1143,2379,8,4.75,202049
30,10,357,19,482,327,48,53,114,1400,1188,2588,6,5,202049
30,11,181,9,353,273,5,33,6,860,968,1828,5,5,202049
30,12,333,13,585,491,58,83,4,1567,1389,2956,10,5,202049
30,13,337,20,339,277,163,84,149,1369,1080,2449,10,5,202049
30,14,272,5,335,223,76,36,59,1006,822,1828,6,5,202049
30,15,377,18,367,272,97,84,156,1371,1136,2507,11,5,202049
30,16,374,11,402,308,65,64,220,1444,1353,2797,8,5,202049
30,17,371,28,451,539,71,80,34,1574,1419,2993,8,5,202049
30,18,270,9,201,216,64,41,49,850,1044,1894,6,4.666666667,202049
30,19,305,20,415,272,73,26,23,1134,1036,2170,9,5,202049
30,20,215,7,170,277,58,31,11,769,801,1570,6,5,202049
31,1,344,9,417,49,284,23,1,1127,1147,2274,8,5,202049
31,2,159,9,189,25,241,42,0,665,643,1308,6,5,202049
31,3,669,31,824,534,101,71,1,2231,2097,4328,16,5,202049
31,4,199,7,245,143,104,33,58,789,766,1555,4,5,202049
31,5,258,5,332,167,52,33,32,879,886,1765,6,5,202049
32,1,312,32,209,219,64,57,126,1019,797,1816,8,5,202049
32,2,361,55,330,162,181,80,78,1247,1252,2499,13,5,202049
32,3,380,50,323,457,12,65,42,1329,1607,2936,13,5,202049
32,4,338,52,281,328,28,57,31,1115,1286,2401,10,5,202049
1,1,430,40,366,343,59,82,16,1336,1399,2735,13,5,202050
1,2,617,42,665,525,88,67,47,2051,1858,3909,15,5,202050
1,3,517,62,670,495,46,86,86,1962,1840,3802,14,5,202050
2,1,404,10,345,401,22,121,86,1389,1782,3171,9,5,202050
2,2,239,12,271,471,6,64,2,1065,1015,2080,5,5,202050
2,3,467,34,481,419,12,138,87,1638,1174,2812,10,5,202050
2,4,319,5,439,175,52,27,25,1042,1100,2142,8,5,202050
2,5,471,21,727,418,169,128,34,1968,1814,3782,10,5,202050
2,6,335,18,372,236,42,132,40,1175,963,2138,7,5,202050
2,7,401,22,426,368,50,133,47,1447,1060,2507,12,5,202050
2,8,269,5,330,258,31,47,82,1022,766,1788,4,5,202050
3,1,345,14,450,441,33,70,24,1377,1084,2461,12,5,202050
3,2,251,8,604,270,51,33,10,1227,1046,2273,8,5,202050
4,1,330,19,294,304,61,75,81,1164,1216,2380,7,3.666666667,202050
4,2,292,9,280,341,33,37,119,1111,1156,2267,8,5,202050
5,1,449,8,345,353,40,88,33,1316,1167,2483,8,5,202050
5,2,341,20,272,290,55,37,18,1033,1145,2178,10,5,202050
5,3,416,27,295,320,98,52,28,1236,1355,2591,10,5,202050
5,4,500,28,509,417,13,78,65,1610,1749,3359,8,5,202050
5,5,475,22,315,408,14,123,40,1397,1536,2933,10,5,202050
5,6,354,27,255,289,13,80,84,1102,1203,2305,9,5,202050
5,7,303,15,185,237,11,38,24,813,884,1697,7,5,202050
6,1,403,21,423,265,35,101,103,1351,1267,2618,12,5,202050
6,2,232,16,285,174,56,45,40,848,845,1693,7,5,202050
7,1,248,3,203,159,12,63,3,691,671,1362,9,4.25,202050
7,2,379,66,392,772,90,18,0,1717,918,2635,9,5,202050
7,3,403,8,330,166,92,45,13,1057,708,1765,7,5,202050
7,4,454,15,342,303,18,77,23,1232,537,1769,11,5,202050
7,5,383,14,159,309,40,40,15,960,936,1896,11,5,202050
7,6,428,10,393,438,36,48,27,1380,1606,2986,8,5,202050
7,7,446,16,491,406,84,100,11,1554,1439,2993,8,5,202050
7,8,369,32,274,398,70,54,21,1218,1237,2455,12,5,202050
7,9,393,23,326,345,39,59,8,1193,1188,2381,9,5,202050
7,10,251,5,272,235,333,25,1,1122,926,2048,9,5,202050
7,11,291,4,167,120,35,18,0,635,790,1425,6,5,202050
7,12,375,10,324,447,6,23,8,1193,1130,2323,9,5,202050
7,13,199,16,179,602,2,28,4,1030,1187,2217,9,5,202050
8,1,197,10,255,132,1,10,4,609,662,1271,4,5,202050
8,2,449,41,551,470,8,31,4,1554,1412,2966,16,5,202050
8,3,289,17,280,286,21,28,36,957,793,1750,4,5,202050
8,4,335,39,539,458,52,68,76,1567,1250,2817,11,5,202050
8,5,254,45,242,296,17,32,3,889,824,1713,10,5,202050
8,6,209,13,282,232,7,35,50,828,666,1494,7,5,202050
8,7,208,31,180,269,5,27,3,723,711,1434,7,5,202050
8,8,235,18,271,341,3,36,4,908,1148,2056,10,5,202050
8,9,225,22,170,183,40,58,55,753,810,1563,10,5,202050
9,1,145,2,111,148,59,27,11,503,493,996,4,5,202050
9,2,392,36,433,767,120,87,41,1876,1899,3775,8,5,202050
9,3,188,9,207,320,47,26,57,854,882,1736,4,5,202050
9,4,296,19,425,642,66,76,84,1608,1597,3205,7,5,202050
9,5,317,0,364,562,56,101,0,1400,1402,2802,7,5,202050
9,6,193,15,174,270,108,33,3,796,724,1520,7,5,202050
9,7,219,12,371,535,9,48,6,1200,1202,2402,9,5,202050
9,8,118,6,201,316,21,33,31,726,732,1458,3,5,202050
9,9,157,5,164,287,48,38,10,709,687,1396,3,5,202050
9,10,142,16,240,232,28,75,2,735,628,1363,3,5,202050
9,11,244,17,282,462,149,82,1,1237,1031,2268,7,5,202050
9,12,261,23,445,603,75,58,4,1469,1431,2900,8,5,202050
9,13,203,20,235,267,83,40,25,873,875,1748,4,5,202050
9,14,219,8,243,309,39,36,80,934,1262,2196,5,5,202050
9,15,219,21,553,516,87,72,59,1527,1509,3036,6,5,202050
9,16,344,107,360,608,27,32,11,1489,1481,2970,11,5,202050
9,17,218,30,379,290,41,19,2,979,1321,2300,6,5,202050
9,18,220,11,246,466,96,72,28,1139,1037,2176,8,5,202050
9,19,228,30,244,316,85,40,34,977,945,1922,3,5,202050
9,20,95,4,78,145,54,14,27,417,394,811,3,5,202050
9,21,191,4,169,259,31,20,19,693,564,1257,3,5,202050
9,22,145,4,135,163,77,22,38,584,518,1102,2,5,202050
9,23,239,19,418,465,46,46,25,1258,1353,2611,6,5,202050
9,24,462,36,627,845,234,123,12,2339,2384,4723,11,5,202050
10,1,263,35,272,386,24,27,80,1087,1090,2177,13,4.833333333,202050
10,2,311,11,189,274,15,19,21,840,780,1620,8,5,202050
10,3,197,14,154,218,35,31,49,698,812,1510,9,4.8,202050
10,4,370,39,305,533,10,35,8,1300,1299,2599,11,5,202050
11,1,218,52,149,215,41,50,10,735,686,1421,5,2.666666667,202050
11,2,327,44,339,262,66,100,49,1187,1197,2384,7,5,202050
11,3,160,23,194,197,15,47,16,652,465,1117,3,5,202050
11,4,282,73,250,349,75,64,6,1099,1202,2301,7,5,202050
11,5,506,92,428,559,23,84,45,1737,1779,3516,7,5,202050
11,6,394,46,438,348,51,76,45,1398,1558,2956,8,5,202050
11,7,330,37,453,394,47,64,11,1336,1311,2647,9,5,202050
11,8,379,56,406,521,160,65,34,1621,1494,3115,9,5,202050
11,9,414,89,427,446,6,55,48,1485,1427,2912,10,5,202050
11,10,340,73,389,349,85,97,83,1416,1369,2785,10,5,202050
11,11,241,26,237,289,12,36,9,850,786,1636,5,5,202050
11,12,289,75,393,399,34,45,20,1255,1002,2257,7,5,202050
11,13,243,56,205,247,48,49,96,944,940,1884,8,5,202050
11,14,228,70,334,326,65,33,7,1063,1041,2104,8,5,202050
11,15,259,36,246,326,19,65,69,1020,842,1862,7,5,202050
12,1,268,61,282,309,113,52,32,1117,968,2085,6,5,202050
12,2,491,60,535,773,49,79,38,2025,1211,3236,10,5,202050
12,3,439,64,392,591,19,52,5,1562,1194,2756,11,5,202050
12,4,266,15,350,486,43,36,4,1200,1380,2580,7,5,202050
12,5,376,43,353,375,10,20,122,1299,1167,2466,10,5,202050
12,6,374,24,324,445,16,29,20,1232,929,2161,10,5,202050
12,7,384,24,252,473,8,47,104,1292,959,2251,6,5,202050
12,8,329,26,259,431,0,42,0,1087,1078,2165,9,5,202050
12,9,345,26,406,597,49,35,13,1471,1352,2823,9,5,202050
13,1,298,24,209,457,61,39,57,1145,1527,2672,9,5,202050
13,2,219,18,153,207,129,100,62,888,1219,2107,6,5,202050
13,3,393,29,310,366,161,64,14,1337,1536,2873,11,5,202050
13,4,331,27,239,342,69,52,81,1141,860,2001,8,4.666666667,202050
13,5,437,15,370,342,115,93,125,1497,1528,3025,9,5,202050
13,6,453,34,437,427,22,64,60,1497,1982,3479,11,5,202050
13,7,344,30,434,468,48,48,3,1375,1230,2605,8,5,202050
14,1,188,45,171,112,96,38,26,676,637,1313,6,5,202050
14,2,181,26,169,148,50,31,7,612,644,1256,5,5,202050
14,3,298,44,450,233,34,78,26,1163,999,2162,8,5,202050
14,4,356,20,445,382,29,63,42,1337,1137,2474,10,5,202050
14,5,295,28,476,268,42,54,6,1169,1079,2248,9,5,202050
14,6,330,13,509,284,19,54,17,1226,1085,2311,9,5,202050
14,7,213,14,264,209,0,21,2,723,761,1484,6,5,202050
14,8,422,36,763,733,12,78,18,2062,1783,3845,10,5,202050
14,9,223,23,299,397,12,40,19,1013,877,1890,9,5,202050
14,10,221,26,376,191,21,55,28,918,868,1786,6,5,202050
14,11,240,14,241,210,40,60,78,883,855,1738,5,5,202050
14,12,405,19,519,323,56,30,3,1355,1280,2635,9,5,202050
14,13,210,14,258,200,10,40,20,752,816,1568,6,5,202050
14,14,272,21,265,282,43,54,38,975,1067,2042,7,5,202050
14,15,368,50,370,299,131,79,55,1352,1150,2502,10,5,202050
14,16,231,12,265,183,32,36,26,785,685,1470,5,5,202050
14,17,204,29,249,92,56,84,22,736,699,1435,7,5,202050
14,18,321,50,382,222,116,42,59,1192,1107,2299,8,5,202050
14,19,309,34,395,254,40,47,35,1114,1121,2235,8,5,202050
14,20,357,38,609,447,1,62,2,1516,1568,3084,10,5,202050
15,1,259,10,273,144,363,38,11,1098,958,2056,7,5,202050
15,2,241,13,265,239,130,21,20,929,971,1900,6,5,202050
15,3,413,6,241,318,259,39,90,1366,1421,2787,8,5,202050
15,4,247,14,157,265,31,34,15,763,735,1498,4,5,202050
15,5,322,15,322,371,49,28,36,1143,1095,2238,8,5,202050
15,6,280,8,266,352,32,45,86,1069,1086,2155,8,5,202050
15,7,280,15,450,212,77,73,5,1112,1004,2116,10,5,202050
15,8,176,10,135,247,19,25,65,677,806,1483,4,5,202050
15,9,279,13,149,128,168,118,12,867,772,1639,9,5,202050
15,10,257,8,199,304,35,35,19,857,939,1796,6,5,202050
15,11,256,16,217,299,52,48,12,900,844,1744,8,5,202050
15,12,366,7,503,443,50,46,1,1416,1404,2820,8,5,202050
15,13,146,10,128,154,104,34,1,577,584,1161,8,5,202050
15,14,193,12,134,231,37,32,19,658,623,1281,4,5,202050
15,15,155,41,116,138,49,11,18,528,512,1040,6,5,202050
15,16,360,32,366,582,36,77,67,1520,1492,3012,8,5,202050
15,17,196,23,141,247,27,45,114,793,716,1509,8,5,202050
15,18,428,24,435,476,66,86,33,1548,1470,3018,7,5,202050
15,19,337,36,302,715,15,61,54,1520,1510,3030,9,5,202050
15,20,125,14,256,218,24,17,7,661,728,1389,6,5,202050
15,21,148,4,131,126,40,53,31,533,510,1043,6,5,202050
15,22,414,80,415,655,26,72,64,1726,1714,3440,14,5,202050
15,23,251,16,218,477,42,45,39,1088,1016,2104,6,5,202050
15,24,210,29,235,214,36,32,33,789,750,1539,4,5,202050
15,25,242,26,177,245,42,31,38,801,860,1661,6,5,202050
15,26,323,9,233,289,115,34,39,1042,997,2039,8,5,202050
15,27,326,21,373,387,34,64,175,1380,1257,2637,9,5,202050
15,28,419,20,599,376,44,53,78,1589,1537,3126,9,5,202050
15,29,250,7,250,388,9,69,68,1041,1079,2120,7,5,202050
15,30,350,46,429,435,86,43,73,1462,1407,2869,15,5,202050
15,31,252,96,219,378,19,33,0,997,894,1891,6,5,202050
15,32,302,18,272,437,51,79,43,1202,1164,2366,9,5,202050
15,33,317,14,321,341,29,36,0,1058,1055,2113,7,5,202050
15,34,181,7,167,290,35,21,16,717,670,1387,8,5,202050
15,35,378,15,243,512,11,65,19,1243,1130,2373,9,5,202050
15,36,334,17,342,551,43,28,9,1324,1337,2661,9,5,202050
15,37,360,32,366,440,119,93,55,1465,1383,2848,7,5,202050
15,38,244,18,195,178,45,21,30,731,776,1507,4,5,202050
15,39,247,33,209,246,71,59,11,876,785,1661,4,5,202050
15,40,481,59,395,531,219,73,12,1770,1762,3532,9,5,202050
15,41,414,13,485,491,82,67,82,1634,1636,3270,13,5,202050
16,1,194,19,277,181,22,22,1,716,709,1425,5,5,202050
16,2,180,30,156,253,14,43,4,680,646,1326,9,5,202050
16,3,230,24,225,345,24,33,3,884,911,1795,10,5,202050
16,4,243,36,232,220,95,61,9,896,898,1794,7,4,202050
16,5,212,27,190,257,20,44,17,767,714,1481,7,5,202050
16,6,272,62,272,271,92,29,0,998,990,1988,12,5,202050
16,7,330,47,342,438,40,44,9,1250,1240,2490,9,5,202050
16,8,502,41,604,664,19,43,32,1905,1880,3785,12,5,202050
16,9,334,47,304,352,22,99,78,1236,1112,2348,9,5,202050
16,10,257,25,476,407,19,47,3,1234,1108,2342,5,5,202050
16,11,199,34,237,198,48,30,1,747,761,1508,10,5,202050
16,12,203,19,211,194,26,53,5,711,751,1462,8,5,202050
17,1,203,18,272,305,29,28,27,882,1059,1941,8,5,202050
17,2,302,16,478,568,17,69,57,1507,1583,3090,7,5,202050
17,3,356,16,376,478,26,83,0,1335,1252,2587,8,5,202050
17,4,348,13,454,532,103,46,45,1541,1583,3124,10,5,202050
17,5,158,12,133,182,36,32,1,554,427,981,5,5,202050
18,1,208,16,186,203,26,30,26,695,457,1152,7,4.5,202050
18,2,449,28,443,535,68,112,14,1649,1688,3337,8,5,202050
18,3,218,17,324,239,13,35,23,869,728,1597,8,4.75,202050
19,1,304,13,410,416,21,88,103,1355,1470,2825,9,5,202050
19,2,322,11,291,309,16,43,7,999,1006,2005,9,5,202050
19,3,368,22,484,344,44,61,24,1347,1192,2539,7,5,202050
19,4,292,10,262,193,49,71,153,1030,1051,2081,5,5,202050
19,5,477,38,502,541,29,85,107,1779,1735,3514,8,5,202050
19,6,273,15,403,465,5,90,61,1312,1281,2593,5,5,202050
19,7,338,14,581,363,15,41,3,1355,1091,2446,10,4.5,202050
19,8,214,14,306,283,4,25,6,852,889,1741,7,5,202050
19,9,238,21,335,281,29,43,71,1018,1270,2288,9,5,202050
19,10,206,14,263,288,7,69,87,934,930,1864,5,5,202050
19,11,571,31,574,934,10,156,176,2452,2229,4681,13,5,202050
19,12,349,10,650,227,11,38,13,1298,1471,2769,13,5,202050
20,1,248,16,216,160,148,26,84,898,1230,2128,5,5,202050
20,2,315,28,381,240,69,17,2,1052,492,1544,6,5,202050
20,3,205,2,229,170,130,27,59,822,697,1519,6,5,202050
20,4,189,20,187,231,108,69,62,866,764,1630,6,5,202050
20,5,268,6,365,413,26,35,10,1123,1199,2322,7,5,202050
20,6,322,8,217,180,131,52,46,956,737,1693,8,5,202050
20,7,245,8,236,299,13,32,13,846,768,1614,7,5,202050
20,8,551,35,674,801,60,84,94,2299,2271,4570,13,5,202050
20,9,334,13,241,244,242,35,53,1162,1401,2563,8,5,202050
20,10,274,12,341,289,66,27,13,1022,1086,2108,9,5,202050
21,1,324,17,378,378,27,42,11,1177,1119,2296,7,5,202050
21,2,267,9,381,223,154,38,13,1085,1076,2161,6,5,202050
21,3,381,9,433,278,127,70,52,1350,1238,2588,7,5,202050
21,4,257,13,234,157,112,78,21,872,889,1761,5,5,202050
21,5,408,27,551,413,37,63,75,1574,1575,3149,7,5,202050
21,6,288,4,184,237,59,81,55,908,1296,2204,4,5,202050
21,7,279,12,164,327,67,75,4,928,1069,1997,7,5,202050
21,8,330,16,365,229,67,67,85,1159,1164,2323,8,5,202050
21,9,371,13,475,404,57,72,72,1464,1453,2917,8,5,202050
21,10,228,8,171,188,21,59,74,749,794,1543,3,5,202050
21,11,183,7,225,179,24,19,12,649,677,1326,4,5,202050
21,12,434,32,630,501,93,63,206,1959,1956,3915,8,5,202050
21,13,240,6,271,324,31,73,27,972,803,1775,7,5,202050
21,14,192,11,228,146,120,49,39,785,718,1503,7,4.833333333,202050
21,15,375,12,265,299,22,111,70,1154,1046,2200,6,5,202050
22,1,291,59,275,372,31,39,1,1068,1051,2119,11,5,202050
22,2,272,37,433,302,120,26,6,1196,1193,2389,7,5,202050
22,3,367,28,569,443,13,37,11,1468,1650,3118,9,3.666666667,202050
22,4,297,39,616,473,33,41,1,1500,1412,2912,8,5,202050
22,5,348,38,708,326,130,71,37,1658,1663,3321,10,5,202050
23,1,356,16,723,219,46,27,33,1420,1616,3036,14,5,202050
23,2,420,23,489,371,62,21,22,1408,1263,2671,10,5,202050
23,3,522,21,889,557,68,55,10,2122,2078,4200,19,5,202050
23,4,205,7,402,228,39,40,33,954,887,1841,6,5,202050
24,1,383,52,242,339,36,38,4,1094,1000,2094,10,4.8,202050
24,2,245,26,201,173,60,26,16,747,379,1126,6,4.5,202050
24,3,318,42,230,231,98,31,1,951,1139,2090,9,5,202050
24,4,281,24,201,189,44,34,108,881,698,1579,5,4.5,202050
24,5,519,45,601,615,12,46,0,1838,1685,3523,9,5,202050
24,6,260,68,340,328,11,25,1,1033,831,1864,6,5,202050
24,7,321,15,279,257,53,15,0,940,1167,2107,9,5,202050
25,1,319,22,381,374,46,48,135,1325,1417,2742,10,5,202050
25,2,331,44,355,342,21,44,0,1137,1263,2400,5,5,202050
25,3,323,9,295,475,37,44,39,1222,1188,2410,7,5,202050
25,4,266,20,340,452,57,12,0,1147,1257,2404,8,5,202050
25,5,406,12,452,622,33,92,51,1668,1417,3085,8,5,202050
25,6,333,12,356,357,73,59,108,1298,1238,2536,6,5,202050
25,7,335,9,442,435,9,25,0,1255,1050,2305,5,5,202050
26,1,332,10,321,430,4,64,0,1161,968,2129,9,5,202050
26,2,357,10,387,539,9,55,6,1363,1226,2589,12,5,202050
26,3,431,16,295,300,15,90,44,1191,1271,2462,13,5,202050
26,4,242,16,262,286,73,32,5,916,950,1866,9,4.8,202050
26,5,299,12,228,277,30,74,0,920,849,1769,11,5,202050
26,6,358,11,198,268,15,67,23,940,880,1820,8,5,202050
26,7,324,15,228,359,116,36,18,1096,1117,2213,10,5,202050
27,1,319,13,410,525,117,56,22,1462,757,2219,8,5,202050
27,2,354,18,339,497,22,37,31,1298,1239,2537,8,5,202050
27,3,295,8,255,597,9,43,40,1247,1376,2623,6,5,202050
27,4,360,6,463,669,16,102,14,1630,2071,3701,7,5,202050
27,5,240,6,335,454,27,70,13,1145,936,2081,6,5,202050
27,6,332,9,413,642,13,50,0,1459,1470,2929,7,5,202050
28,1,275,38,524,463,4,27,7,1338,1365,2703,10,5,202050
28,2,388,49,632,321,32,87,237,1746,1832,3578,13,5,202050
28,3,208,14,253,232,8,49,34,798,850,1648,8,5,202050
28,4,478,33,507,355,84,111,166,1734,1776,3510,13,5,202050
28,5,303,15,214,278,57,70,67,1004,890,1894,10,4.5,202050
28,6,385,28,314,419,36,44,8,1234,1184,2418,13,4.833333333,202050
28,7,327,21,260,210,52,45,117,1032,1057,2089,9,5,202050
28,8,250,22,240,257,47,69,117,1002,1140,2142,12,4,202050
28,9,152,9,225,124,16,35,47,608,773,1381,7,5,202050
29,1,452,20,393,462,65,72,20,1484,1260,2744,9,4.666666667,202050
29,2,403,16,320,417,43,86,203,1488,1257,2745,10,4.666666667,202050
29,3,288,30,171,368,25,56,0,938,712,1650,6,4.666666667,202050
30,1,214,23,259,263,108,32,62,961,757,1718,7,4.666666667,202050
30,2,244,17,337,106,72,10,142,928,934,1862,10,5,202050
30,3,262,12,274,165,172,49,141,1075,921,1996,6,5,202050
30,4,241,5,300,231,43,38,2,860,791,1651,8,5,202050
30,5,311,16,509,424,26,51,4,1341,1333,2674,9,5,202050
30,6,250,11,379,270,39,42,26,1017,889,1906,9,5,202050
30,7,375,14,288,282,127,31,67,1184,872,2056,11,4.5,202050
30,8,340,14,432,371,109,47,28,1341,1424,2765,11,5,202050
30,9,350,7,330,286,88,60,136,1257,1128,2385,8,5,202050
30,10,330,28,468,347,42,56,151,1422,1433,2855,6,5,202050
30,11,219,4,383,346,22,16,13,1003,823,1826,7,5,202050
30,12,364,16,552,530,42,84,8,1596,1533,3129,10,5,202050
30,13,273,16,301,308,153,74,170,1295,1239,2534,10,5,202050
30,14,282,12,372,239,106,54,72,1137,886,2023,8,4.75,202050
30,15,374,12,335,270,104,88,185,1368,1287,2655,11,5,202050
30,16,307,8,410,375,66,61,242,1469,1408,2877,10,4.666666667,202050
30,17,362,28,506,510,58,78,19,1561,1382,2943,8,5,202050
30,18,312,16,248,345,84,57,73,1135,828,1963,8,4.75,202050
30,19,259,18,458,221,36,29,4,1025,950,1975,11,5,202050
30,20,219,10,203,364,50,28,3,877,668,1545,8,4.5,202050
31,1,372,11,387,51,306,26,1,1154,1108,2262,8,5,202050
31,2,155,5,151,13,226,24,0,574,702,1276,6,5,202050
31,3,727,47,826,616,90,62,0,2368,2310,4678,16,5,202050
31,4,200,4,284,164,108,40,63,863,823,1686,4,5,202050
31,5,229,9,353,183,52,38,14,878,783,1661,6,5,202050
32,1,341,47,259,290,51,68,103,1159,1009,2168,8,5,202050
32,2,314,36,291,158,152,79,77,1107,1256,2363,13,5,202050
32,3,282,65,256,421,7,56,48,1135,1152,2287,13,5,202050
32,4,419,76,313,411,29,62,17,1327,1172,2499,12,4.8,202050
1,1,375,48,334,334,53,71,18,1233,1828,3061,13,5,202051
1,2,521,56,688,575,72,77,47,2036,2038,4074,15,5,202051
1,3,420,60,552,406,53,75,105,1671,2004,3675,13,5,202051
2,1,410,25,332,378,31,164,118,1458,1500,2958,9,5,202051
2,2,269,12,288,510,9,67,0,1155,1021,2176,5,5,202051
2,3,412,25,518,383,18,152,98,1606,1435,3041,10,5,202051
2,4,309,8,436,191,49,42,39,1074,1099,2173,8,5,202051
2,5,474,19,712,403,172,105,44,1929,1866,3795,10,5,202051
2,6,311,19,370,316,53,85,58,1212,938,2150,7,5,202051
2,7,368,26,441,348,50,143,60,1436,1121,2557,12,5,202051
2,8,260,11,384,299,29,39,76,1098,864,1962,4,5,202051
3,1,291,16,418,462,25,63,31,1306,1231,2537,12,4.666666667,202051
3,2,233,16,515,254,43,20,15,1096,1097,2193,8,5,202051
4,1,366,27,360,423,146,72,103,1497,1256,2753,11,4,202051
4,2,281,16,307,328,32,51,117,1132,1121,2253,10,5,202051
5,1,460,26,324,453,38,90,36,1427,1265,2692,8,5,202051
5,2,348,15,297,313,48,45,17,1083,1454,2537,10,5,202051
5,3,392,22,331,401,110,73,25,1354,1293,2647,10,5,202051
5,4,502,25,599,482,16,45,78,1747,1680,3427,8,5,202051
5,5,440,32,314,433,19,140,57,1435,1527,2962,10,5,202051
5,6,361,16,350,289,10,55,88,1169,1221,2390,9,5,202051
5,7,274,8,185,253,18,34,14,786,850,1636,7,5,202051
6,1,355,28,522,366,40,66,139,1516,1322,2838,12,5,202051
6,2,205,13,255,183,58,58,77,849,848,1697,7,5,202051
7,1,344,4,282,181,6,82,5,904,808,1712,9,5,202051
7,2,320,47,217,858,56,32,1,1531,1122,2653,9,5,202051
7,3,374,8,296,167,132,65,15,1057,786,1843,7,5,202051
7,4,257,21,276,390,15,74,23,1056,1255,2311,11,5,202051
7,5,358,20,188,332,54,31,3,986,939,1925,11,5,202051
7,6,294,10,423,523,49,46,58,1403,1736,3139,8,5,202051
7,7,385,16,506,447,82,90,6,1532,1647,3179,8,5,202051
7,8,413,31,249,410,47,69,17,1236,1190,2426,12,5,202051
7,9,305,15,352,400,31,67,16,1186,1251,2437,9,5,202051
7,10,265,2,261,308,291,20,3,1150,909,2059,9,5,202051
7,11,224,6,224,107,55,12,1,629,570,1199,6,5,202051
7,12,401,8,338,404,3,24,5,1183,1235,2418,9,5,202051
7,13,146,23,174,714,1,16,5,1079,566,1645,9,5,202051
8,1,233,9,316,218,2,15,6,799,581,1380,4,5,202051
8,2,517,51,740,639,13,45,6,2011,2068,4079,16,5,202051
8,3,233,19,295,289,11,24,60,931,1009,1940,4,5,202051
8,4,369,48,568,528,35,77,96,1721,1676,3397,11,5,202051
8,5,283,62,236,353,30,37,2,1003,850,1853,10,5,202051
8,6,347,32,404,377,17,32,49,1258,814,2072,7,5,202051
8,7,277,43,237,241,6,76,7,887,725,1612,7,5,202051
8,8,312,10,398,549,6,54,11,1340,935,2275,10,5,202051
8,9,230,23,217,186,47,51,67,821,826,1647,10,5,202051
9,1,145,6,130,139,64,20,23,527,491,1018,4,5,202051
9,2,413,49,583,891,180,115,30,2261,2334,4595,8,5,202051
9,3,218,9,269,369,58,38,63,1024,874,1898,4,5,202051
9,4,367,18,413,748,82,62,113,1803,1573,3376,7,5,202051
9,5,321,1,386,656,77,105,0,1546,1355,2901,7,5,202051
9,6,147,26,192,266,87,30,6,754,865,1619,7,5,202051
9,7,189,12,373,539,15,51,8,1187,1197,2384,9,5,202051
9,8,144,15,323,437,27,46,43,1035,765,1800,3,5,202051
9,9,219,12,308,359,72,36,31,1037,676,1713,3,5,202051
9,10,176,20,320,345,26,100,8,995,538,1533,3,5,202051
9,11,207,22,353,441,109,71,0,1203,1098,2301,7,5,202051
9,12,246,30,539,717,81,74,12,1699,1437,3136,8,5,202051
9,13,189,19,210,263,101,36,55,873,874,1747,4,5,202051
9,14,179,11,211,320,54,48,89,912,1440,2352,5,5,202051
9,15,186,18,630,600,77,78,37,1626,1426,3052,6,5,202051
9,16,403,131,437,848,47,48,14,1928,1505,3433,11,5,202051
9,17,205,37,387,304,37,13,1,984,1428,2412,6,5,202051
9,18,257,23,353,580,151,118,40,1522,1053,2575,8,5,202051
9,19,268,43,269,348,120,56,44,1148,962,2110,3,5,202051
9,20,114,8,150,163,88,15,36,574,426,1000,3,5,202051
9,21,148,4,163,235,48,19,38,655,583,1238,3,5,202051
9,22,231,10,223,327,123,55,74,1043,573,1616,2,5,202051
9,23,201,18,400,503,79,66,45,1312,1832,3144,6,5,202051
9,24,490,36,827,1041,243,137,11,2785,2422,5207,11,5,202051
10,1,235,19,230,292,18,20,70,884,1278,2162,13,4.833333333,202051
10,2,300,7,220,341,27,37,25,957,892,1849,8,5,202051
10,3,263,23,186,234,50,55,77,888,1158,2046,11,5,202051
10,4,455,64,442,697,16,41,24,1739,1541,3280,11,5,202051
11,1,306,76,265,259,46,62,20,1034,1053,2087,6,5,202051
11,2,331,59,341,292,86,103,53,1265,1231,2496,7,5,202051
11,3,186,23,171,201,32,34,30,677,536,1213,3,5,202051
11,4,308,73,301,399,74,87,8,1250,1104,2354,7,5,202051
11,5,427,98,470,514,24,97,59,1689,1687,3376,7,5,202051
11,6,386,56,401,400,54,82,48,1427,1510,2937,8,5,202051
11,7,351,46,454,404,53,66,19,1393,1269,2662,9,5,202051
11,8,349,50,414,520,187,65,32,1617,1799,3416,9,5,202051
11,9,436,117,478,569,16,86,59,1761,1567,3328,10,5,202051
11,10,382,86,392,413,80,86,87,1526,1323,2849,10,5,202051
11,11,225,28,239,339,12,42,7,892,676,1568,5,5,202051
11,12,379,80,483,444,36,39,18,1479,1133,2612,7,5,202051
11,13,239,38,182,198,40,38,106,841,809,1650,8,4,202051
11,14,232,66,359,314,72,42,14,1099,1035,2134,8,5,202051
11,15,262,49,325,353,26,76,79,1170,861,2031,7,5,202051
12,1,203,50,251,251,65,44,13,877,1068,1945,6,5,202051
12,2,411,47,464,691,26,58,51,1748,1506,3254,10,5,202051
12,3,306,35,386,524,8,33,4,1296,2067,3363,11,5,202051
12,4,227,22,322,499,24,45,15,1154,1403,2557,7,5,202051
12,5,412,44,357,714,7,20,105,1659,1052,2711,10,5,202051
12,6,321,22,234,368,21,25,19,1010,605,1615,10,5,202051
12,7,362,24,287,484,7,52,88,1304,1308,2612,6,5,202051
12,8,310,19,253,405,1,34,2,1024,1309,2333,9,5,202051
12,9,318,31,355,535,30,33,8,1310,1485,2795,9,5,202051
13,1,361,34,229,524,87,36,55,1326,1679,3005,9,5,202051
13,2,223,14,130,212,120,83,78,860,1034,1894,6,5,202051
13,3,396,35,277,402,187,49,12,1358,1534,2892,11,5,202051
13,4,395,30,302,388,90,51,111,1367,1764,3131,8,4.666666667,202051
13,5,454,25,407,417,115,76,108,1602,1666,3268,9,5,202051
13,6,433,44,409,531,25,58,78,1578,1898,3476,11,5,202051
13,7,376,29,460,505,38,49,5,1462,1355,2817,8,5,202051
14,1,182,50,203,108,85,29,23,680,627,1307,6,5,202051
14,2,202,25,219,206,71,52,5,780,620,1400,5,5,202051
14,3,342,55,486,257,28,81,21,1270,1181,2451,8,5,202051
14,4,390,28,539,530,32,65,61,1645,1294,2939,10,5,202051
14,5,299,18,526,316,26,35,3,1223,1203,2426,9,5,202051
14,6,392,19,651,385,20,62,22,1551,1176,2727,9,5,202051
14,7,192,13,313,193,0,27,4,742,747,1489,6,5,202051
14,8,439,46,896,810,7,121,16,2335,1891,4226,10,5,202051
14,9,298,17,387,495,14,38,44,1293,944,2237,9,5,202051
14,10,239,20,474,259,19,70,24,1105,1027,2132,6,5,202051
14,11,258,25,297,269,45,84,132,1110,897,2007,5,5,202051
14,12,433,26,498,309,33,17,4,1320,1364,2684,9,5,202051
14,13,272,16,318,252,9,25,34,926,915,1841,6,5,202051
14,14,241,23,352,405,46,78,71,1216,1099,2315,7,5,202051
14,15,368,43,360,341,114,76,73,1375,1401,2776,10,5,202051
14,16,231,17,292,253,32,50,36,911,804,1715,5,5,202051
14,17,189,42,224,129,34,89,45,752,929,1681,7,5,202051
14,18,303,46,493,271,121,57,79,1370,1304,2674,8,5,202051
14,19,252,28,423,277,35,51,34,1100,1192,2292,8,5,202051
14,20,454,31,648,499,5,65,11,1713,1478,3191,10,5,202051
15,1,278,10,265,134,382,50,13,1132,1108,2240,7,5,202051
15,2,225,15,272,287,110,20,35,964,959,1923,6,5,202051
15,3,406,20,299,370,328,35,133,1591,1349,2940,10,5,202051
15,4,231,8,129,290,38,27,22,745,758,1503,4,5,202051
15,5,302,29,330,346,47,33,39,1126,1201,2327,8,5,202051
15,6,207,3,283,391,22,43,91,1040,1077,2117,8,5,202051
15,7,239,15,534,202,67,46,3,1106,1072,2178,10,5,202051
15,8,170,15,158,242,35,19,51,690,741,1431,4,5,202051
15,9,274,10,151,130,194,107,20,886,822,1708,9,5,202051
15,10,194,6,179,311,28,33,48,799,895,1694,6,5,202051
15,11,246,20,245,304,57,33,25,930,941,1871,8,5,202051
15,12,392,13,505,494,47,45,8,1504,1460,2964,8,5,202051
15,13,143,10,128,184,98,37,0,600,641,1241,8,5,202051
15,14,188,19,160,271,46,35,14,733,579,1312,4,5,202051
15,15,126,47,114,147,65,11,20,530,536,1066,6,5,202051
15,16,366,31,351,642,29,84,110,1613,1592,3205,8,5,202051
15,17,189,12,172,237,39,58,99,806,769,1575,8,5,202051
15,18,376,31,470,426,37,102,36,1478,1513,2991,7,5,202051
15,19,271,20,359,690,21,74,59,1494,1522,3016,9,5,202051
15,20,125,13,279,217,34,14,4,686,705,1391,6,5,202051
15,21,136,6,122,144,30,34,51,523,560,1083,6,5,202051
15,22,369,72,468,713,24,74,84,1804,1758,3562,14,5,202051
15,23,244,25,221,462,22,70,33,1077,1060,2137,6,5,202051
15,24,197,24,222,252,36,38,23,792,978,1770,4,5,202051
15,25,194,15,194,270,42,37,59,811,824,1635,6,5,202051
15,26,261,12,241,325,100,40,26,1005,1082,2087,8,5,202051
15,27,308,28,347,404,23,52,140,1302,1457,2759,9,5,202051
15,28,392,18,618,411,49,55,77,1620,1700,3320,9,5,202051
15,29,257,19,296,541,6,77,37,1233,918,2151,7,5,202051
15,30,350,47,432,426,70,39,88,1452,1491,2943,15,5,202051
15,31,250,111,241,386,16,30,4,1038,1014,2052,6,5,202051
15,32,302,14,300,422,61,61,43,1203,1252,2455,9,5,202051
15,33,288,20,357,367,44,42,1,1119,1063,2182,7,5,202051
15,34,190,12,169,355,4,23,4,757,810,1567,8,5,202051
15,35,313,17,234,552,12,51,21,1200,1259,2459,9,5,202051
15,36,326,24,323,554,61,40,20,1348,1390,2738,9,5,202051
15,37,306,20,348,454,112,86,40,1366,1383,2749,7,5,202051
15,38,234,22,248,242,63,27,31,867,776,1643,6,5,202051
15,39,209,45,196,243,65,42,20,820,879,1699,4,5,202051
15,40,472,46,409,507,260,79,21,1794,1865,3659,9,5,202051
15,41,428,27,555,454,55,53,66,1638,1727,3365,13,5,202051
16,1,172,23,294,175,22,13,3,702,737,1439,5,5,202051
16,2,180,30,162,240,17,42,5,676,648,1324,9,5,202051
16,3,247,17,204,328,35,46,13,890,826,1716,10,5,202051
16,4,234,25,252,229,76,50,11,877,1024,1901,7,4,202051
16,5,201,33,185,238,17,48,55,777,810,1587,7,5,202051
16,6,262,60,247,253,86,28,0,936,1203,2139,12,5,202051
16,7,284,41,319,444,27,59,10,1184,1234,2418,9,5,202051
16,8,423,38,704,749,23,52,41,2030,1966,3996,12,5,202051
16,9,334,36,310,346,18,83,88,1215,1258,2473,9,5,202051
16,10,269,27,505,451,6,50,3,1311,1242,2553,5,5,202051
16,11,205,22,247,169,60,44,4,751,762,1513,10,5,202051
16,12,201,27,244,171,20,37,3,703,809,1512,8,4.333333333,202051
17,1,266,28,419,567,36,49,33,1398,873,2271,8,5,202051
17,2,334,20,456,562,18,55,48,1493,1390,2883,9,5,202051
17,3,376,23,396,528,20,80,3,1426,1234,2660,8,5,202051
17,4,317,25,416,619,49,63,56,1545,1509,3054,10,5,202051
17,5,178,15,150,233,35,33,1,645,500,1145,5,5,202051
18,1,277,20,177,235,68,25,34,836,579,1415,7,5,202051
18,2,440,29,416,610,44,110,9,1658,1816,3474,8,5,202051
18,3,245,32,373,301,8,35,26,1020,675,1695,8,5,202051
19,1,329,20,474,424,15,87,126,1475,1434,2909,9,5,202051
19,2,349,9,419,434,19,43,9,1282,1173,2455,9,5,202051
19,3,417,16,539,395,60,96,21,1544,1383,2927,7,5,202051
19,4,269,16,257,191,68,69,176,1046,1090,2136,5,5,202051
19,5,466,46,502,588,28,101,82,1813,1812,3625,8,5,202051
19,6,266,12,372,413,6,88,127,1284,1297,2581,5,5,202051
19,7,386,16,716,467,11,68,10,1674,1384,3058,10,5,202051
19,8,206,14,293,376,10,41,3,943,878,1821,7,5,202051
19,9,266,29,348,333,50,48,78,1152,1293,2445,9,5,202051
19,10,204,23,320,354,12,59,90,1062,939,2001,5,5,202051
19,11,557,33,635,905,10,138,163,2441,2379,4820,13,5,202051
19,12,345,11,680,259,17,51,10,1373,1512,2885,13,5,202051
20,1,237,6,256,197,113,25,87,921,674,1595,7,5,202051
20,2,181,23,284,322,57,13,0,880,701,1581,6,5,202051
20,3,288,13,239,170,189,44,57,1000,670,1670,6,5,202051
20,4,124,7,125,126,64,60,74,580,991,1571,6,5,202051
20,5,246,16,292,431,41,38,3,1067,1397,2464,11,5,202051
20,6,351,4,253,192,199,61,53,1113,606,1719,8,5,202051
20,7,250,24,303,444,27,42,21,1111,960,2071,7,4.75,202051
20,8,522,23,655,826,54,97,136,2313,2286,4599,13,5,202051
20,9,295,14,206,174,246,43,71,1049,1114,2163,8,5,202051
20,10,313,8,343,317,52,20,12,1065,1023,2088,9,5,202051
21,1,309,20,415,381,24,44,12,1205,1308,2513,8,4.75,202051
21,2,268,21,383,240,139,41,11,1103,1131,2234,9,5,202051
21,3,364,18,426,312,123,58,82,1383,1482,2865,8,5,202051
21,4,236,9,223,151,118,65,28,830,1021,1851,6,5,202051
21,5,427,13,519,479,64,46,95,1643,1620,3263,7,5,202051
21,6,264,5,278,262,88,80,67,1044,958,2002,5,5,202051
21,7,298,14,210,328,66,77,2,995,1035,2030,7,5,202051
21,8,290,14,380,241,69,68,100,1162,1299,2461,9,5,202051
21,9,356,18,522,414,77,79,77,1543,1467,3010,8,5,202051
21,10,256,11,238,273,29,81,102,990,725,1715,5,5,202051
21,11,156,7,251,159,45,25,22,665,632,1297,4,5,202051
21,12,468,26,782,657,100,84,271,2388,1936,4324,15,5,202051
21,13,241,14,265,318,50,82,27,997,827,1824,7,5,202051
21,14,200,13,237,196,98,44,67,855,688,1543,8,5,202051
21,15,362,13,323,325,33,86,111,1253,991,2244,7,5,202051
22,1,302,63,254,351,28,37,3,1038,1206,2244,11,5,202051
22,2,324,33,406,384,80,35,10,1272,1170,2442,7,5,202051
22,3,324,28,560,386,6,39,15,1358,1480,2838,9,3.666666667,202051
22,4,219,33,540,413,12,39,16,1272,1431,2703,8,5,202051
22,5,336,21,608,329,53,50,40,1437,1710,3147,10,5,202051
23,1,345,8,673,207,44,18,39,1334,1467,2801,14,5,202051
23,2,364,19,518,343,59,15,25,1343,1122,2465,10,5,202051
23,3,453,18,1015,644,74,70,14,2288,2286,4574,19,5,202051
23,4,164,1,378,205,32,46,82,908,982,1890,6,5,202051
24,1,298,35,230,340,27,32,3,965,1198,2163,10,5,202051
24,2,264,30,219,185,60,30,19,807,370,1177,6,5,202051
24,3,302,37,244,237,60,32,6,918,1109,2027,9,5,202051
24,4,279,39,216,213,46,46,146,985,776,1761,5,5,202051
24,5,436,52,552,574,4,54,2,1674,1784,3458,9,5,202051
24,6,322,109,488,438,25,26,8,1416,852,2268,6,5,202051
24,7,305,31,243,281,54,18,4,936,1229,2165,9,5,202051
25,1,248,6,281,404,31,44,141,1155,1464,2619,10,5,202051
25,2,310,59,268,425,6,29,3,1100,1152,2252,5,5,202051
25,3,272,12,229,463,22,45,63,1106,1169,2275,7,5,202051
25,4,283,10,298,418,87,7,1,1104,1242,2346,8,5,202051
25,5,375,11,452,589,26,75,75,1603,1643,3246,8,5,202051
25,6,350,20,330,381,96,43,88,1308,1272,2580,6,5,202051
25,7,305,21,376,444,2,42,5,1195,1210,2405,5,5,202051
26,1,297,15,301,415,6,50,5,1089,944,2033,9,5,202051
26,2,327,21,325,471,8,52,28,1232,1341,2573,12,5,202051
26,3,407,7,330,354,21,95,64,1278,1179,2457,13,5,202051
26,4,214,11,209,245,32,34,9,754,862,1616,9,3.8,202051
26,5,314,22,282,346,28,63,3,1058,880,1938,14,5,202051
26,6,308,12,268,352,19,63,34,1056,863,1919,9,5,202051
26,7,280,31,231,333,128,26,5,1034,1155,2189,10,4.75,202051
27,1,264,15,294,404,92,34,11,1114,1683,2797,8,5,202051
27,2,291,15,287,528,26,26,34,1207,1178,2385,8,5,202051
27,3,277,5,207,466,12,45,81,1093,1167,2260,6,5,202051
27,4,315,7,447,626,10,74,23,1502,1490,2992,7,5,202051
27,5,184,6,242,395,11,29,12,879,1194,2073,6,5,202051
27,6,288,26,449,553,8,47,8,1379,1343,2722,7,5,202051
28,1,304,33,431,498,2,46,4,1318,1400,2718,10,5,202051
28,2,454,50,662,345,36,90,241,1878,1753,3631,13,5,202051
28,3,217,16,253,269,10,30,58,853,796,1649,8,5,202051
28,4,468,42,507,415,116,79,211,1838,1800,3638,13,5,202051
28,5,362,38,367,388,39,93,180,1467,1140,2607,10,5,202051
28,6,240,18,281,448,29,29,14,1059,1039,2098,13,5,202051
28,7,317,20,442,334,83,43,135,1374,1070,2444,9,5,202051
28,8,236,18,304,320,29,58,116,1081,1113,2194,12,5,202051
28,9,100,9,215,115,14,41,30,524,738,1262,6,5,202051
29,1,508,38,394,539,57,49,35,1620,1313,2933,9,5,202051
29,2,415,22,377,552,50,91,288,1795,1348,3143,10,5,202051
29,3,288,24,215,421,18,63,2,1031,801,1832,6,5,202051
30,1,206,21,356,216,103,34,87,1023,776,1799,7,5,202051
30,2,243,9,310,125,56,13,181,937,906,1843,10,5,202051
30,3,248,3,292,165,136,26,168,1038,954,1992,6,5,202051
30,4,285,5,292,251,37,42,1,913,800,1713,8,5,202051
30,5,277,16,536,437,8,51,2,1327,1205,2532,9,5,202051
30,6,246,16,366,290,43,46,29,1036,901,1937,9,5,202051
30,7,314,20,359,331,122,46,116,1308,769,2077,11,5,202051
30,8,317,23,466,383,86,57,31,1363,1281,2644,11,5,202051
30,9,293,20,308,318,84,66,144,1233,1154,2387,8,5,202051
30,10,306,23,484,370,50,68,151,1452,1250,2702,6,5,202051
30,11,200,8,347,422,15,20,8,1020,951,1971,7,5,202051
30,12,369,15,589,545,46,65,7,1636,1403,3039,10,5,202051
30,13,305,13,293,380,177,65,179,1412,1255,2667,10,5,202051
30,14,295,18,332,260,93,45,56,1099,969,2068,8,5,202051
30,15,347,13,322,287,106,73,196,1344,1144,2488,11,5,202051
30,16,332,9,395,389,62,56,253,1496,1237,2733,10,5,202051
30,17,361,14,470,518,47,74,28,1512,1418,2930,8,5,202051
30,18,274,10,249,370,88,47,58,1096,961,2057,8,5,202051
30,19,272,18,569,261,76,44,7,1247,1083,2330,11,5,202051
30,20,207,15,246,414,95,41,6,1024,534,1558,8,5,202051
31,1,308,21,409,38,257,26,3,1062,1180,2242,8,5,202051
31,2,135,5,144,10,222,15,1,532,667,1199,6,5,202051
31,3,521,39,746,717,64,66,10,2163,2368,4531,18,5,202051
31,4,163,11,289,152,129,32,67,843,805,1648,4,5,202051
31,5,213,7,316,177,55,23,8,799,839,1638,6,5,202051
32,1,348,60,278,254,45,66,118,1169,1177,2346,10,5,202051
32,2,311,50,241,215,81,61,60,1019,1008,2027,13,5,202051
32,3,273,65,268,416,11,48,57,1138,1297,2435,13,5,202051
32,4,367,47,281,377,35,58,39,1204,1164,2368,12,5,202051
1,1,432,47,356,395,73,93,29,1425,1301,2726,15,5,202052
1,2,583,44,615,522,66,62,93,1985,2130,4115,8,5,202052
1,3,411,57,612,398,60,53,117,1708,1915,3623,7,5,202052
2,1,345,14,340,431,35,149,97,1411,1317,2728,9,5,202052
2,2,239,9,284,494,8,74,0,1108,1060,2168,5,5,202052
2,3,341,11,426,345,12,142,76,1353,1537,2890,10,5,202052
2,4,330,6,446,191,47,32,31,1083,1013,2096,8,5,202052
2,5,458,27,749,428,155,124,31,1972,1787,3759,10,5,202052
2,6,345,18,346,279,44,108,50,1190,864,2054,7,5,202052
2,7,354,20,439,346,52,149,88,1448,1057,2505,12,5,202052
2,8,257,14,413,248,21,44,71,1068,801,1869,4,5,202052
3,1,365,20,457,477,30,67,43,1459,1480,2939,13,5,202052
3,2,270,8,536,284,52,32,16,1198,1249,2447,8,5,202052
4,1,446,27,426,463,182,80,118,1742,1499,3241,11,4,202052
4,2,527,26,541,502,64,58,118,1836,1334,3170,14,5,202052
5,1,411,19,366,456,46,57,40,1395,1379,2774,8,5,202052
5,2,343,29,315,299,52,40,8,1086,1244,2330,10,5,202052
5,3,401,27,318,417,106,65,49,1383,1386,2769,10,5,202052
5,4,501,37,546,513,11,57,67,1732,1862,3594,8,5,202052
5,5,517,27,336,454,16,111,111,1572,1457,3029,10,5,202052
5,6,358,23,382,276,12,67,136,1254,1174,2428,9,5,202052
5,7,333,20,239,334,16,41,32,1015,788,1803,7,5,202052
6,1,411,25,578,362,36,86,172,1670,1436,3106,12,5,202052
6,2,213,15,258,184,47,54,70,841,817,1658,9,5,202052
7,1,315,7,243,187,8,56,4,820,810,1630,9,5,202052
7,2,418,12,305,574,62,21,0,1392,1686,3078,9,5,202052
7,3,290,6,240,387,162,44,13,1142,1096,2238,7,5,202052
7,4,276,22,340,408,28,96,40,1210,1175,2385,11,5,202052
7,5,347,29,195,350,57,31,12,1021,963,1984,11,4.666666667,202052
7,6,311,12,459,450,53,41,61,1387,1544,2931,8,5,202052
7,7,409,27,433,453,101,75,17,1515,1558,3073,8,5,202052
7,8,410,31,261,450,77,47,24,1300,1315,2615,12,5,202052
7,9,290,27,320,364,47,65,23,1136,1205,2341,9,5,202052
7,10,340,4,344,423,271,36,3,1421,1666,3087,9,5,202052
7,11,218,5,152,104,53,18,2,552,586,1138,6,5,202052
7,12,358,10,351,482,4,21,9,1235,1358,2593,9,5,202052
7,13,202,18,187,760,1,19,2,1189,1051,2240,9,5,202052
8,1,230,2,356,187,0,14,0,789,700,1489,4,5,202052
8,2,564,77,718,589,4,43,8,2003,1771,3774,16,5,202052
8,3,269,24,275,291,21,36,31,947,956,1903,4,5,202052
8,4,368,39,487,489,44,73,98,1598,1652,3250,11,5,202052
8,5,294,44,273,419,29,31,1,1091,938,2029,10,5,202052
8,6,383,49,455,447,34,72,60,1500,1045,2545,7,5,202052
8,7,313,30,271,378,11,63,3,1069,918,1987,7,5,202052
8,8,544,33,654,920,15,88,26,2280,1319,3599,10,5,202052
8,9,268,27,196,185,49,69,86,880,863,1743,10,5,202052
9,1,128,7,94,147,70,25,15,486,481,967,4,5,202052
9,2,394,36,559,915,141,86,32,2163,2785,4948,8,5,202052
9,3,187,5,240,364,55,32,69,952,919,1871,4,5,202052
9,4,343,25,367,787,63,77,105,1767,1724,3491,7,5,202052
9,5,331,5,388,622,67,102,0,1515,1550,3065,7,5,202052
9,6,139,20,155,237,95,25,7,678,986,1664,7,5,202052
9,7,181,8,345,561,3,34,1,1133,1191,2324,9,5,202052
9,8,117,14,267,358,35,37,48,876,953,1829,3,5,202052
9,9,204,12,246,413,82,40,43,1040,776,1816,3,5,202052
9,10,157,2,339,293,27,100,12,930,629,1559,3,5,202052
9,11,210,20,296,399,121,78,0,1124,1370,2494,7,5,202052
9,12,237,38,505,633,69,75,19,1576,1551,3127,8,5,202052
9,13,197,13,199,263,110,49,41,872,900,1772,4,5,202052
9,14,158,7,173,245,32,30,61,706,1900,2606,5,5,202052
9,15,209,12,552,637,70,101,41,1622,1488,3110,6,5,202052
9,16,385,168,409,741,26,56,4,1789,1627,3416,11,5,202052
9,17,204,25,349,294,47,22,3,944,1503,2447,6,5,202052
9,18,264,17,320,535,170,115,53,1474,1068,2542,8,5,202052
9,19,241,49,224,324,136,49,33,1056,1153,2209,3,5,202052
9,20,123,4,136,189,84,15,37,588,404,992,3,5,202052
9,21,155,9,158,232,64,17,34,669,634,1303,3,5,202052
9,22,239,7,224,307,137,40,55,1009,517,1526,2,5,202052
9,23,204,19,422,489,94,34,23,1285,1328,2613,6,5,202052
9,24,448,27,624,862,292,102,5,2360,2457,4817,11,5,202052
10,1,268,22,234,287,26,20,116,973,1217,2190,13,4.833333333,202052
10,2,396,18,282,445,19,34,33,1227,895,2122,8,5,202052
10,3,341,35,230,331,84,48,98,1167,893,2060,11,5,202052
10,4,496,43,412,689,16,53,36,1745,1580,3325,11,5,202052
11,1,348,71,264,313,49,61,26,1132,1097,2229,6,5,202052
11,2,324,54,340,326,119,79,59,1301,1280,2581,7,5,202052
11,3,165,31,191,180,22,57,28,674,500,1174,3,5,202052
11,4,283,68,275,382,61,74,20,1163,1212,2375,7,5,202052
11,5,358,75,384,479,26,77,40,1439,1637,3076,7,5,202052
11,6,323,45,464,408,50,68,53,1411,1504,2915,8,5,202052
11,7,404,46,469,436,20,78,16,1469,1491,2960,9,5,202052
11,8,369,68,371,497,162,64,36,1567,1592,3159,9,5,202052
11,9,426,135,424,542,15,39,73,1654,1662,3316,10,5,202052
11,10,397,92,441,437,82,114,116,1679,1277,2956,10,5,202052
11,11,231,30,252,352,7,48,9,929,943,1872,5,5,202052
11,12,365,91,443,474,46,43,29,1491,1472,2963,7,5,202052
11,13,242,44,163,155,50,31,110,795,871,1666,7,3.75,202052
11,14,249,58,355,293,65,44,3,1067,1208,2275,8,5,202052
11,15,272,57,298,320,23,76,63,1109,1156,2265,7,5,202052
12,1,234,51,271,252,92,30,17,947,1133,2080,6,5,202052
12,2,394,60,396,635,49,65,83,1682,1821,3503,10,5,202052
12,3,294,35,422,499,16,39,5,1310,1635,2945,11,5,202052
12,4,240,18,325,508,31,47,14,1183,1234,2417,7,5,202052
12,5,396,40,344,415,10,34,85,1324,1006,2330,10,4.75,202052
12,6,446,29,295,450,11,24,23,1278,978,2256,10,5,202052
12,7,362,28,319,560,10,60,48,1387,982,2369,6,5,202052
12,8,320,19,243,365,0,26,2,975,1373,2348,9,5,202052
12,9,299,21,299,521,26,31,2,1199,1243,2442,9,5,202052
13,1,340,20,202,587,70,23,55,1297,1273,2570,9,5,202052
13,2,201,20,127,214,110,96,77,845,941,1786,6,5,202052
13,3,372,31,320,370,185,43,4,1325,1507,2832,11,5,202052
13,4,405,28,332,383,111,50,132,1441,1394,2835,8,4.666666667,202052
13,5,443,24,408,373,125,83,140,1596,1687,3283,9,5,202052
13,6,540,37,536,636,32,79,67,1927,1636,3563,11,5,202052
13,7,338,34,353,404,46,32,4,1211,1384,2595,8,5,202052
14,1,220,53,179,115,96,20,22,705,814,1519,6,5,202052
14,2,235,30,220,182,78,55,5,805,715,1520,5,5,202052
14,3,353,26,502,245,36,83,30,1275,1180,2455,8,4.8,202052
14,4,395,39,574,518,18,79,71,1694,1519,3213,10,5,202052
14,5,271,24,479,322,35,51,4,1186,1298,2484,9,5,202052
14,6,371,19,666,368,18,55,45,1542,1400,2942,9,5,202052
14,7,209,14,264,224,0,25,3,739,752,1491,6,5,202052
14,8,455,42,823,807,8,104,18,2257,2163,4420,10,5,202052
14,9,300,17,385,552,15,37,30,1336,1082,2418,9,5,202052
14,10,228,31,501,242,25,51,25,1103,1036,2139,6,5,202052
14,11,249,27,296,273,46,61,141,1093,991,2084,5,5,202052
14,12,393,37,549,300,51,19,8,1357,1311,2668,9,5,202052
14,13,250,22,333,294,13,40,21,973,778,1751,6,5,202052
14,14,248,18,312,345,68,73,92,1156,1104,2260,7,5,202052
14,15,344,55,403,380,107,81,72,1442,1409,2851,10,5,202052
14,16,205,24,301,242,33,62,30,897,838,1735,5,5,202052
14,17,196,28,276,132,40,93,36,801,828,1629,7,5,202052
14,18,350,52,527,279,135,66,71,1480,1387,2867,8,5,202052
14,19,263,29,387,296,58,69,40,1142,1169,2311,8,5,202052
14,20,428,49,617,458,4,50,2,1608,1679,3287,10,5,202052
15,1,280,14,229,126,338,47,11,1045,1200,2245,7,5,202052
15,2,230,8,306,284,102,29,29,988,1022,2010,6,5,202052
15,3,395,19,301,400,357,42,130,1644,1433,3077,10,5,202052
15,4,234,13,151,318,32,29,18,795,764,1559,4,5,202052
15,5,306,34,341,348,57,34,73,1193,1137,2330,8,5,202052
15,6,216,6,318,485,30,54,79,1188,985,2173,8,5,202052
15,7,230,24,724,24,95,6,0,1103,1151,2254,10,5,202052
15,8,148,17,143,254,18,20,59,659,739,1398,4,5,202052
15,9,273,14,168,146,203,119,21,944,1010,1954,9,5,202052
15,10,227,8,184,319,20,36,44,838,867,1705,6,5,202052
15,11,270,10,267,407,66,35,11,1066,888,1954,8,5,202052
15,12,329,19,557,475,34,35,3,1452,1461,2913,8,5,202052
15,13,169,17,204,202,125,32,6,755,587,1342,8,5,202052
15,14,178,13,124,278,29,40,19,681,727,1408,4,5,202052
15,15,139,39,122,228,49,8,22,607,553,1160,6,5,202052
15,16,330,39,367,635,37,81,114,1603,1620,3223,8,5,202052
15,17,175,27,170,288,22,44,134,860,762,1622,8,5,202052
15,18,351,19,394,438,43,93,36,1374,1588,2962,7,5,202052
15,19,294,34,345,882,20,58,61,1694,1638,3332,9,5,202052
15,20,132,21,298,239,27,17,12,746,712,1458,6,5,202052
15,21,184,11,168,146,55,43,61,668,520,1188,6,5,202052
15,22,366,73,518,794,26,92,80,1949,1870,3819,14,5,202052
15,23,287,21,212,429,18,64,25,1056,1214,2270,6,5,202052
15,24,179,20,205,270,30,26,31,761,726,1487,4,5,202052
15,25,267,28,213,288,42,42,57,937,860,1797,6,5,202052
15,26,276,12,292,376,147,39,33,1175,1070,2245,8,5,202052
15,27,291,11,360,434,21,58,135,1310,1488,2798,9,5,202052
15,28,388,20,642,413,47,51,88,1649,1675,3324,9,5,202052
15,29,341,19,325,566,4,73,52,1380,1029,2409,7,5,202052
15,30,396,38,486,554,96,72,59,1701,1537,3238,15,5,202052
15,31,247,117,237,409,20,37,7,1074,1080,2154,6,5,202052
15,32,364,19,260,494,51,74,46,1308,1124,2432,9,5,202052
15,33,284,27,419,462,41,37,1,1271,1112,2383,7,5,202052
15,34,143,9,222,379,40,36,12,841,744,1585,8,5,202052
15,35,313,18,252,536,7,63,19,1208,1381,2589,9,5,202052
15,36,378,27,272,601,70,41,18,1407,1475,2882,9,5,202052
15,37,334,23,328,486,113,92,44,1420,1447,2867,7,5,202052
15,38,226,25,290,320,65,21,26,973,776,1749,6,5,202052
15,39,231,30,212,248,49,43,18,831,881,1712,4,5,202052
15,40,486,25,425,512,248,81,10,1787,1870,3657,9,5,202052
15,41,414,23,664,521,62,61,58,1803,1760,3563,13,5,202052
16,1,332,50,531,368,48,27,5,1361,590,1951,6,5,202052
16,2,226,44,188,352,24,66,6,906,707,1613,9,5,202052
16,3,333,35,305,453,35,56,13,1230,962,2192,10,5,202052
16,4,265,30,307,270,98,51,13,1034,893,1927,7,5,202052
16,5,255,42,234,342,49,81,59,1062,823,1885,7,5,202052
16,6,272,64,318,321,93,39,5,1112,850,1962,12,5,202052
16,7,434,74,511,534,52,87,10,1702,1494,3196,9,5,202052
16,8,425,43,679,667,15,47,37,1913,2042,3955,12,5,202052
16,9,317,35,330,408,29,64,74,1257,1249,2506,9,5,202052
16,10,271,35,512,537,6,77,4,1442,1290,2732,5,5,202052
16,11,392,41,427,379,188,85,15,1527,720,2247,10,5,202052
16,12,396,48,480,315,44,78,23,1384,957,2341,10,5,202052
17,1,260,26,431,546,47,46,55,1411,790,2201,8,5,202052
17,2,324,20,451,521,9,44,65,1434,1501,2935,9,5,202052
17,3,365,22,433,530,31,65,0,1446,1452,2898,8,5,202052
17,4,307,22,524,557,34,32,24,1500,1616,3116,10,5,202052
17,5,131,13,149,226,22,28,2,571,737,1308,5,5,202052
18,1,222,22,211,309,63,30,52,909,802,1711,7,5,202052
18,2,450,25,428,655,42,87,13,1700,1702,3402,8,5,202052
18,3,285,29,410,285,12,31,17,1069,865,1934,8,5,202052
19,1,381,31,507,480,15,88,87,1589,1310,2899,9,5,202052
19,2,418,14,497,408,17,73,9,1436,993,2429,9,5,202052
19,3,393,22,577,382,61,68,25,1528,1387,2915,7,5,202052
19,4,258,18,274,208,67,65,190,1080,1006,2086,5,5,202052
19,5,450,29,497,544,47,85,121,1773,1833,3606,8,5,202052
19,6,229,15,391,445,11,70,96,1257,1353,2610,5,5,202052
19,7,348,16,663,428,7,67,4,1533,1756,3289,10,5,202052
19,8,210,14,322,340,11,40,4,941,875,1816,7,5,202052
19,9,266,20,354,283,46,58,70,1097,1140,2237,9,5,202052
19,10,201,7,322,372,8,75,98,1083,1023,2106,5,5,202052
19,11,504,50,574,936,8,145,182,2399,2534,4933,13,5,202052
19,12,381,17,711,293,17,45,9,1473,1418,2891,13,5,202052
20,1,250,7,271,180,103,29,86,926,843,1769,7,5,202052
20,2,243,18,314,319,30,16,2,942,432,1374,6,5,202052
20,3,324,13,294,206,290,52,56,1235,719,1954,6,5,202052
20,4,151,10,136,194,58,81,28,658,1243,1901,6,5,202052
20,5,282,7,330,467,32,30,3,1151,1540,2691,11,5,202052
20,6,308,14,204,160,200,42,43,971,980,1951,8,5,202052
20,7,323,16,324,428,23,33,31,1178,832,2010,7,5,202052
20,8,500,24,649,870,51,69,89,2252,2412,4664,13,5,202052
20,9,264,11,221,221,273,32,64,1086,1038,2124,8,5,202052
20,10,321,14,352,341,109,15,7,1159,1123,2282,9,5,202052
21,1,328,9,405,419,35,48,17,1261,1223,2484,8,5,202052
21,2,235,19,409,253,136,39,7,1098,1355,2453,9,5,202052
21,3,380,12,360,297,159,66,100,1374,1514,2888,8,5,202052
21,4,251,9,236,174,117,65,27,879,944,1823,6,5,202052
21,5,419,27,543,439,59,46,89,1622,1643,3265,7,5,202052
21,6,269,11,299,250,85,87,56,1057,1039,2096,5,5,202052
21,7,253,19,185,310,83,67,2,919,1029,1948,7,5,202052
21,8,281,12,338,199,66,53,103,1052,1304,2356,9,5,202052
21,9,336,13,497,400,79,68,89,1482,1603,3085,8,5,202052
21,10,273,11,299,311,19,65,119,1097,906,2003,5,5,202052
21,11,166,2,243,169,32,22,16,650,681,1331,4,5,202052
21,12,512,42,837,825,104,104,279,2703,2175,4878,15,5,202052
21,13,277,14,255,303,54,64,19,986,980,1966,7,5,202052
21,14,205,14,232,209,76,43,63,842,887,1729,8,5,202052
21,15,397,9,311,290,41,130,63,1241,1569,2810,7,5,202052
22,1,359,59,274,457,16,33,8,1206,1121,2327,11,5,202052
22,2,334,34,401,364,91,34,14,1272,1270,2542,7,5,202052
22,3,360,31,634,520,24,31,16,1616,1634,3250,9,4,202052
22,4,289,35,564,401,20,29,23,1361,1302,2663,8,5,202052
22,5,341,26,662,413,74,39,42,1597,1670,3267,10,5,202052
23,1,290,9,916,208,41,34,39,1537,1444,2981,14,5,202052
23,2,329,21,505,345,37,14,19,1270,1455,2725,10,5,202052
23,3,473,29,1265,737,64,52,10,2630,2148,4778,19,5,202052
23,4,166,5,448,206,39,48,56,968,985,1953,6,5,202052
24,1,294,22,219,344,30,37,11,957,1154,2111,10,5,202052
24,2,161,40,172,125,46,23,7,574,720,1294,6,3.5,202052
24,3,316,61,257,234,78,29,2,977,1059,2036,9,5,202052
24,4,239,20,222,247,47,51,156,982,949,1931,5,5,202052
24,5,447,56,571,630,8,44,4,1760,1792,3552,9,5,202052
24,6,352,93,451,436,10,31,5,1378,1276,2654,6,5,202052
24,7,308,24,252,306,55,17,1,963,1065,2028,9,5,202052
25,1,276,10,287,376,26,55,126,1156,1327,2483,10,5,202052
25,2,282,58,260,418,7,31,6,1062,1187,2249,5,5,202052
25,3,261,23,249,473,29,47,51,1133,1149,2282,7,5,202052
25,4,247,18,333,388,99,11,1,1097,1289,2386,8,5,202052
25,5,323,12,396,583,27,66,75,1482,1651,3133,8,5,202052
25,6,328,13,336,403,49,45,91,1265,1341,2606,6,5,202052
25,7,286,7,402,443,2,31,3,1174,1488,2662,5,5,202052
26,1,289,12,319,433,2,47,11,1113,1177,2290,9,5,202052
26,2,401,18,406,603,7,45,21,1501,1489,2990,12,5,202052
26,3,384,17,382,460,15,101,60,1419,1221,2640,13,5,202052
26,4,212,15,255,262,53,25,3,825,914,1739,9,4.2,202052
26,5,341,18,348,460,42,83,4,1296,997,2293,14,5,202052
26,6,310,21,271,380,27,66,24,1099,982,2081,9,5,202052
26,7,294,37,256,356,96,14,5,1058,1076,2134,10,5,202052
27,1,299,11,354,436,105,37,13,1255,1448,2703,8,5,202052
27,2,224,14,226,432,15,31,25,967,1452,2419,8,5,202052
27,3,239,10,199,462,13,42,63,1028,1497,2525,6,5,202052
27,4,231,4,298,443,10,54,13,1053,1720,2773,7,5,202052
27,5,154,5,164,331,6,37,4,701,1006,1707,6,4.333333333,202052
27,6,233,15,267,442,13,32,9,1011,1829,2840,7,5,202052
28,1,259,17,409,420,3,25,1,1134,1518,2652,10,5,202052
28,2,405,41,629,348,34,67,262,1786,2097,3883,13,5,202052
28,3,239,17,252,227,8,42,69,854,914,1768,8,5,202052
28,4,477,34,539,388,96,103,162,1799,1899,3698,13,5,202052
28,5,467,31,495,485,44,71,129,1722,1052,2774,10,5,202052
28,6,307,42,361,468,24,36,20,1258,1638,2896,13,5,202052
28,7,321,29,384,336,66,58,213,1407,1185,2592,9,5,202052
28,8,281,17,302,302,46,70,129,1147,1175,2322,12,5,202052
28,9,121,4,191,110,14,35,35,510,587,1097,6,5,202052
29,1,463,34,429,558,41,69,30,1624,1596,3220,9,5,202052
29,2,471,25,391,499,45,85,263,1779,1626,3405,10,5,202052
29,3,284,19,212,439,23,63,3,1043,1076,2119,6,5,202052
30,1,194,29,266,190,117,22,111,929,809,1738,7,5,202052
30,2,261,12,252,138,62,17,177,919,1140,2059,10,5,202052
30,3,222,15,335,164,150,45,175,1106,1177,2283,6,5,202052
30,4,234,7,320,255,45,40,0,901,955,1856,8,5,202052
30,5,263,22,468,438,20,41,1,1253,1478,2731,9,5,202052
30,6,259,16,337,302,48,49,24,1035,1009,2044,9,5,202052
30,7,328,21,323,342,89,44,102,1249,1351,2600,11,5,202052
30,8,303,17,510,358,103,35,23,1349,1374,2723,11,5,202052
30,9,313,19,322,325,94,54,173,1300,1311,2611,8,5,202052
30,10,321,14,463,338,40,47,163,1386,1576,2962,6,5,202052
30,11,183,12,340,409,26,19,6,995,1083,2078,7,5,202052
30,12,324,15,547,550,41,70,2,1549,1812,3361,10,5,202052
30,13,322,15,355,354,213,109,208,1576,1432,3008,10,5,202052
30,14,255,8,342,269,109,28,70,1081,1172,2253,8,5,202052
30,15,365,11,332,285,138,88,179,1398,1559,2957,11,5,202052
30,16,348,10,375,369,77,67,267,1513,1643,3156,10,5,202052
30,17,341,21,442,496,73,67,24,1464,1612,3076,8,5,202052
30,18,289,27,242,335,100,37,65,1095,1071,2166,8,5,202052
30,19,266,17,416,177,204,28,2,1110,1558,2668,11,5,202052
30,20,235,8,251,418,104,40,10,1066,1055,2121,8,5,202052
31,1,325,20,409,53,322,20,1,1150,1047,2197,8,5,202052
31,2,151,4,153,17,207,30,1,563,557,1120,6,5,202052
31,3,613,51,906,817,61,57,7,2512,2361,4873,18,5,202052
31,4,153,7,299,166,127,28,55,835,1086,1921,4,5,202052
31,5,229,6,288,164,58,26,7,778,911,1689,6,5,202052
32,1,378,48,270,271,78,81,110,1236,1197,2433,10,5,202052
32,2,337,45,287,247,101,87,84,1188,1219,2407,13,5,202052
32,3,290,59,282,415,12,49,65,1172,1164,2336,13,5,202052
32,4,338,54,309,399,26,51,32,1209,1216,2425,12,5,202052
1,1,247,36,253,245,34,58,6,879,801,1680,15,3,202053
1,2,284,38,339,263,35,30,34,1023,1357,2380,8,3,202053
1,3,241,42,308,263,35,38,62,989,1033,2022,7,3,202053
2,1,170,6,188,200,17,54,60,695,760,1455,9,2.333333333,202053
2,2,166,6,176,293,5,43,1,690,646,1336,5,3,202053
2,3,164,4,166,132,10,39,45,560,592,1152,10,3,202053
2,4,160,7,277,101,36,16,42,639,615,1254,8,3,202053
2,5,301,12,417,222,89,86,15,1142,1036,2178,10,3,202053
2,6,163,12,206,161,41,74,28,685,539,1224,7,3,202053
2,7,219,9,254,178,34,87,42,823,697,1520,12,3,202053
2,8,166,3,192,164,11,37,47,620,468,1088,4,3,202053
3,1,180,7,248,269,22,29,18,773,1039,1812,12,3,202053
3,2,137,12,309,134,40,9,1,642,646,1288,8,3,202053
4,1,251,13,216,280,95,50,64,969,1371,2340,11,2.5,202053
4,2,259,11,291,266,39,30,70,966,815,1781,14,3,202053
5,1,250,9,200,232,29,29,16,765,1030,1795,8,3,202053
5,2,197,14,191,208,28,24,6,668,736,1404,10,3,202053
5,3,236,10,173,225,39,30,29,742,891,1633,10,3,202053
5,4,303,23,349,318,16,37,72,1118,1110,2228,8,3,202053
5,5,237,13,221,264,22,70,50,877,944,1821,10,3,202053
5,6,225,12,197,149,6,35,60,684,742,1426,9,3,202053
5,7,197,11,127,183,3,26,13,560,648,1208,7,3,202053
6,1,284,14,286,245,29,42,120,1020,1055,2075,12,3,202053
6,2,125,13,158,98,24,31,49,498,446,944,9,3,202053
7,1,134,2,106,83,2,29,1,357,534,891,9,3,202053
7,2,143,3,75,157,17,7,0,402,1504,1906,9,3,202053
7,3,169,1,117,240,105,20,10,662,472,1134,7,3,202053
7,4,255,13,184,195,4,65,35,751,1014,1765,11,3,202053
7,5,197,13,116,239,28,16,17,626,641,1267,11,3,202053
7,6,178,7,271,242,31,25,27,781,944,1725,8,3,202053
7,7,253,16,279,220,51,56,6,881,1000,1881,8,3,202053
7,8,210,8,184,284,42,30,5,763,854,1617,12,3,202053
7,9,191,13,146,235,15,41,16,657,692,1349,9,3,202053
7,10,179,2,194,233,146,19,0,773,834,1607,9,3,202053
7,11,107,8,101,67,43,16,1,343,571,914,6,3,202053
7,12,184,3,211,253,2,12,3,668,931,1599,9,3,202053
7,13,91,7,75,289,0,5,2,469,364,833,9,3,202053
8,1,169,4,192,81,1,4,2,453,464,917,4,3,202053
8,2,285,46,387,360,8,21,5,1112,1141,2253,16,3,202053
8,3,154,13,130,176,11,14,32,530,641,1171,4,3,202053
8,4,224,28,283,283,26,45,65,954,1210,2164,11,3,202053
8,5,183,36,182,215,15,31,3,665,708,1373,10,3,202053
8,6,243,28,248,237,21,41,38,856,821,1677,7,3,202053
8,7,194,28,164,220,4,38,4,652,749,1401,7,3,202053
8,8,315,43,354,530,6,37,6,1291,854,2145,10,3,202053
8,9,168,19,107,105,25,43,42,509,659,1168,10,3,202053
9,1,47,4,56,84,31,4,10,236,309,545,4,3,202053
9,2,222,18,250,383,56,43,14,986,1071,2057,8,3,202053
9,3,82,6,109,172,31,22,27,449,498,947,4,3,202053
9,4,183,15,164,293,35,28,50,768,955,1723,7,3,202053
9,5,162,0,168,253,27,55,1,666,851,1517,7,3,202053
9,6,95,22,93,148,55,13,5,431,524,955,7,3,202053
9,7,117,2,188,297,10,19,1,634,677,1311,9,3,202053
9,8,62,2,131,166,9,17,9,396,502,898,3,3,202053
9,9,98,4,103,159,32,20,27,443,529,972,3,3,202053
9,10,63,10,130,129,9,36,3,380,267,647,3,3,202053
9,11,101,8,137,192,72,32,0,542,539,1081,7,3,202053
9,12,114,11,262,314,44,32,8,785,823,1608,8,3,202053
9,13,89,18,117,113,37,15,19,408,435,843,4,3,202053
9,14,75,2,83,108,27,16,40,351,856,1207,5,3,202053
9,15,100,7,291,239,42,42,27,748,866,1614,6,3,202053
9,16,253,89,271,417,28,18,8,1084,1086,2170,11,3,202053
9,17,110,14,207,140,24,6,0,501,588,1089,6,3,202053
9,18,150,9,187,329,89,37,22,823,530,1353,8,3,202053
9,19,116,46,130,150,33,20,15,510,528,1038,3,3,202053
9,20,74,1,81,101,36,8,19,320,290,610,3,3,202053
9,21,88,2,77,88,12,12,18,297,392,689,3,3,202053
9,22,117,8,85,143,64,29,34,480,233,713,2,3,202053
9,23,107,3,194,211,43,17,13,588,779,1367,6,3,202053
9,24,173,12,294,380,116,40,1,1016,1183,2199,11,3,202053
10,1,200,16,155,202,19,5,53,650,767,1417,13,2.833333333,202053
10,2,265,17,175,319,17,26,18,837,591,1428,8,3,202053
10,3,261,24,158,249,38,26,68,824,543,1367,11,3,202053
10,4,257,29,189,392,9,26,9,911,1062,1973,11,3,202053
11,1,205,25,159,167,34,54,17,661,817,1478,6,3,202053
11,2,175,21,203,188,44,59,33,723,792,1515,7,3,202053
11,3,89,18,111,117,17,18,14,384,394,778,3,3,202053
11,4,176,44,180,195,48,39,5,687,729,1416,7,3,202053
11,5,189,41,236,306,15,39,30,856,1050,1906,7,3,202053
11,6,199,21,257,198,32,54,36,797,959,1756,8,3,202053
11,7,211,29,266,254,15,42,9,826,1051,1877,9,3,202053
11,8,208,30,209,353,98,32,15,945,1051,1996,9,3,202053
11,9,271,87,252,303,5,22,13,953,1178,2131,10,3,202053
11,10,223,63,269,292,38,71,51,1007,807,1814,10,3,202053
11,11,127,21,158,196,10,25,9,546,552,1098,5,3,202053
11,12,210,33,268,260,26,20,25,842,913,1755,7,3,202053
11,13,155,38,112,120,29,28,65,547,840,1387,8,3,202053
11,14,138,22,204,201,45,25,0,635,743,1378,8,3,202053
11,15,181,28,164,181,8,21,45,628,780,1408,7,3,202053
12,1,116,25,148,134,44,23,8,498,569,1067,6,3,202053
12,2,210,25,227,348,23,37,25,895,1283,2178,10,3,202053
12,3,166,14,184,272,7,25,7,675,1034,1709,11,3,202053
12,4,126,11,185,271,18,37,5,653,845,1498,7,3,202053
12,5,215,26,253,198,8,11,47,758,642,1400,10,3,202053
12,6,141,9,141,173,10,10,3,487,500,987,10,3,202053
12,7,203,17,147,272,16,33,45,733,875,1608,6,3,202053
12,8,174,12,123,227,2,16,1,555,822,1377,9,3,202053
12,9,145,13,193,276,12,23,2,664,734,1398,9,3,202053
13,1,246,11,105,291,50,13,50,766,852,1618,9,3,202053
13,2,139,8,82,140,82,39,57,547,689,1236,6,3,202053
13,3,230,19,182,206,99,33,2,771,893,1664,11,3,202053
13,4,245,22,168,203,54,32,57,781,1022,1803,8,3,202053
13,5,261,13,239,239,80,55,78,965,980,1945,9,3,202053
13,6,310,38,265,344,20,43,85,1105,1104,2209,11,3,202053
13,7,204,18,240,274,23,29,4,792,1005,1797,8,3,202053
14,1,97,18,87,67,66,25,9,369,462,831,6,3,202053
14,2,146,13,129,116,40,24,2,470,472,942,5,3,202053
14,3,206,29,251,121,16,68,10,701,723,1424,8,2.8,202053
14,4,216,18,378,258,15,31,23,939,999,1938,10,3,202053
14,5,171,18,265,180,12,30,3,679,735,1414,9,3,202053
14,6,221,17,438,193,10,23,21,923,915,1838,11,3,202053
14,7,119,7,165,123,0,16,1,431,454,885,6,3,202053
14,8,286,16,480,473,6,54,13,1328,1511,2839,9,3,202053
14,9,163,18,242,313,3,22,23,784,774,1558,9,3,202053
14,10,127,11,332,104,9,33,15,631,721,1352,7,3,202053
14,11,139,11,168,148,25,31,64,586,679,1265,5,3,202053
14,12,240,16,317,148,18,15,2,756,872,1628,9,3,202053
14,13,154,13,169,141,7,28,26,538,592,1130,6,3,202053
14,14,149,13,183,177,32,40,49,643,700,1343,7,3,202053
14,15,219,27,210,176,56,45,35,768,928,1696,10,3,202053
14,16,129,26,188,141,39,29,15,567,649,1216,5,3,202053
14,17,120,15,181,63,21,51,11,462,591,1053,7,3,202053
14,18,206,35,286,143,91,35,39,835,861,1696,8,3,202053
14,19,149,10,206,144,23,38,19,589,709,1298,8,3,202053
14,20,244,26,332,270,2,21,1,896,1084,1980,10,3,202053
15,1,163,14,90,49,152,11,4,483,672,1155,7,3,202053
15,2,134,6,99,132,71,12,6,460,566,1026,6,3,202053
15,3,228,11,161,159,155,24,76,814,911,1725,10,3,202053
15,4,122,5,87,175,25,12,10,436,464,900,4,3,202053
15,5,163,25,160,174,35,21,40,618,676,1294,8,3,202053
15,6,153,5,172,258,16,25,48,677,742,1419,8,3,202053
15,7,120,8,401,5,42,3,0,579,610,1189,10,3,202053
15,8,87,4,64,131,8,14,34,342,364,706,4,3,202053
15,9,159,9,100,87,114,66,10,545,784,1329,9,3,202053
15,10,98,2,107,146,8,15,18,394,468,862,6,3,202053
15,11,165,11,166,197,21,20,7,587,553,1140,8,3,202053
15,12,190,9,253,211,12,14,3,692,900,1592,8,3,202053
15,13,91,14,118,123,66,26,10,448,371,819,8,3,202053
15,14,90,11,63,139,25,17,12,357,470,827,4,3,202053
15,15,101,32,115,160,45,17,23,493,322,815,6,3,202053
15,16,187,14,168,273,23,40,66,771,950,1721,8,3,202053
15,17,116,15,107,170,27,38,63,536,498,1034,8,3,202053
15,18,177,6,221,177,21,34,28,664,794,1458,7,3,202053
15,19,159,26,191,468,5,35,20,904,873,1777,9,3,202053
15,20,84,9,155,145,19,14,2,428,426,854,6,3,202053
15,21,95,5,51,93,36,20,27,327,308,635,6,3,202053
15,22,241,50,254,408,16,43,67,1079,970,2049,14,3,202053
15,23,152,6,107,211,12,33,9,530,671,1201,6,3,202053
15,24,99,9,99,122,18,12,15,374,427,801,4,3,202053
15,25,171,17,123,144,27,19,39,540,494,1034,6,3,202053
15,26,151,2,131,169,70,24,9,556,595,1151,8,3,202053
15,27,172,11,133,161,7,34,60,578,952,1530,9,3,202053
15,28,212,7,296,215,8,12,39,789,1054,1843,9,3,202053
15,29,159,17,161,282,2,38,40,699,897,1596,7,3,202053
15,30,239,29,256,272,43,35,42,916,931,1847,15,3,202053
15,31,130,68,110,223,5,13,1,550,651,1201,6,3,202053
15,32,215,11,150,272,32,39,35,754,552,1306,9,3,202053
15,33,155,9,171,203,20,16,3,577,638,1215,7,3,202053
15,34,104,3,118,235,10,12,1,483,433,916,8,3,202053
15,35,180,15,156,277,1,23,12,664,859,1523,9,3,202053
15,36,201,5,154,270,29,16,6,681,939,1620,9,3,202053
15,37,172,13,150,227,55,37,30,684,848,1532,7,3,202053
15,38,129,28,111,118,40,12,4,442,471,913,6,3,202053
15,39,155,14,106,118,19,25,17,454,484,938,4,3,202053
15,40,259,21,167,260,136,32,11,886,1075,1961,9,3,202053
15,41,257,12,339,302,40,22,53,1025,836,1861,13,3,202053
16,1,177,21,316,239,11,9,2,775,637,1412,6,3,202053
16,2,144,29,112,191,10,29,2,517,563,1080,9,3,202053
16,3,242,23,216,278,18,44,4,825,454,1279,10,3,202053
16,4,175,21,171,171,71,41,17,667,566,1233,7,3,202053
16,5,173,19,151,144,26,48,45,606,431,1037,7,3,202053
16,6,213,40,180,192,73,19,9,726,676,1402,12,3,202053
16,7,275,36,294,268,29,53,6,961,893,1854,9,3,202053
16,8,283,15,338,414,9,22,22,1103,1266,2369,12,3,202053
16,9,202,17,161,203,14,45,37,679,962,1641,9,3,202053
16,10,161,20,295,274,5,44,2,801,838,1639,5,3,202053
16,11,229,33,229,270,121,56,6,944,448,1392,10,3,202053
16,12,246,27,293,188,38,55,7,854,498,1352,10,3,202053
17,1,148,14,219,299,27,34,26,767,790,1557,8,3,202053
17,2,204,10,259,318,6,31,30,858,975,1833,9,3,202053
17,3,226,11,252,305,15,45,8,862,831,1693,8,3,202053
17,4,192,18,336,292,23,31,19,911,909,1820,10,3,202053
17,5,98,5,92,116,28,12,1,352,326,678,5,3,202053
18,1,162,9,123,156,52,26,23,551,582,1133,7,3,202053
18,2,209,17,259,325,23,33,19,885,1140,2025,8,3,202053
18,3,148,20,225,178,4,27,10,612,551,1163,8,3,202053
19,1,212,17,264,275,6,45,76,895,1060,1955,9,3,202053
19,2,224,6,308,194,12,37,12,793,694,1487,9,3,202053
19,3,223,21,359,198,34,47,21,903,1105,2008,7,3,202053
19,4,160,6,133,107,42,38,101,587,839,1426,5,3,202053
19,5,291,23,260,307,17,56,84,1038,1074,2112,8,3,202053
19,6,137,4,219,245,7,52,71,735,826,1561,5,3,202053
19,7,231,8,337,183,6,35,7,807,1282,2089,10,3,202053
19,8,113,11,173,195,2,21,1,516,575,1091,7,3,202053
19,9,138,18,205,171,12,42,42,628,907,1535,9,3,202053
19,10,135,6,204,198,8,28,52,631,669,1300,5,3,202053
19,11,337,23,306,497,7,83,99,1352,1660,3012,13,3,202053
19,12,185,5,349,153,8,23,7,730,694,1424,13,3,202053
20,1,135,4,151,104,80,30,51,555,632,1187,7,3,202053
20,2,117,19,207,155,36,10,1,545,1291,1836,6,3,202053
20,3,194,6,154,110,101,25,50,640,417,1057,6,3,202053
20,4,136,4,107,98,64,63,49,521,775,1296,6,3,202053
20,5,182,12,215,289,20,17,0,735,678,1413,11,3,202053
20,6,220,6,150,114,136,27,22,675,434,1109,8,3,202053
20,7,158,3,203,259,13,27,11,674,774,1448,7,3,202053
20,8,313,9,363,464,40,37,73,1299,1610,2909,13,3,202053
20,9,253,7,176,193,142,17,21,809,832,1641,8,3,202053
20,10,230,9,203,178,62,15,9,706,808,1514,9,3,202053
21,1,232,8,254,265,19,23,4,805,877,1682,8,3,202053
21,2,162,19,255,145,75,30,4,690,775,1465,9,3,202053
21,3,237,10,233,141,80,51,60,812,915,1727,8,3,202053
21,4,160,8,118,80,79,38,28,511,626,1137,6,3,202053
21,5,226,10,341,236,29,32,39,913,1117,2030,7,3,202053
21,6,154,3,189,135,43,41,27,592,634,1226,5,3,202053
21,7,180,4,126,186,52,46,1,595,604,1199,7,3,202053
21,8,184,5,200,121,27,41,76,654,718,1372,9,3,202053
21,9,196,3,270,232,46,37,44,828,931,1759,8,3,202053
21,10,185,6,172,164,8,36,54,625,653,1278,5,3,202053
21,11,113,2,133,81,17,7,6,359,420,779,4,3,202053
21,12,357,15,426,404,52,61,155,1470,1545,3015,15,3,202053
21,13,183,8,148,179,21,35,26,600,651,1251,7,3,202053
21,14,120,9,141,94,65,35,42,506,690,1196,8,3,202053
21,15,244,7,189,185,25,69,61,780,1010,1790,7,3,202053
22,1,176,37,149,261,18,30,2,673,816,1489,11,2.8,202053
22,2,151,14,179,151,34,17,3,549,749,1298,7,3,202053
22,3,284,30,361,400,7,22,8,1112,895,2007,9,3,202053
22,4,161,23,371,282,17,23,4,881,813,1694,8,3,202053
22,5,170,15,330,226,31,27,17,816,1016,1832,10,3,202053
23,1,194,4,578,111,26,20,19,952,1160,2112,14,3,202053
23,2,184,10,293,157,16,10,15,685,880,1565,10,3,202053
23,3,368,13,841,456,53,21,9,1761,1381,3142,19,3,202053
23,4,87,3,279,96,37,30,42,574,616,1190,6,3,202053
24,1,173,12,113,187,11,20,12,528,705,1233,10,3,202053
24,2,107,12,76,72,23,14,13,317,393,710,6,2.5,202053
24,3,186,34,134,130,46,22,2,554,712,1266,9,3,202053
24,4,143,12,106,102,26,25,89,503,636,1139,5,3,202053
24,5,271,21,326,332,5,29,1,985,1123,2108,9,3,202053
24,6,226,51,312,240,8,10,4,851,831,1682,6,3,202053
24,7,192,22,145,149,15,10,0,533,843,1376,9,3,202053
25,1,158,3,164,174,18,23,71,611,882,1493,10,3,202053
25,2,163,23,150,266,3,13,0,618,680,1298,5,3,202053
25,3,148,2,134,282,14,21,36,637,668,1305,7,3,202053
25,4,148,5,162,243,56,4,4,622,737,1359,8,3,202053
25,5,197,7,231,358,23,40,45,901,929,1830,8,3,202053
25,6,153,5,227,221,32,27,44,709,764,1473,6,3,202053
25,7,158,9,203,234,3,9,0,616,744,1360,5,3,202053
26,1,179,6,210,282,0,34,4,715,634,1349,9,3,202053
26,2,238,13,255,315,2,32,6,861,915,1776,12,3,202053
26,3,233,13,214,253,12,50,25,800,640,1440,13,3,202053
26,4,132,7,142,176,48,11,3,519,742,1261,9,3,202053
26,5,212,7,222,245,15,31,4,736,618,1354,14,3,202053
26,6,191,6,130,220,10,43,13,613,523,1136,9,3,202053
26,7,155,15,130,181,39,18,6,544,665,1209,10,3,202053
27,1,124,9,120,204,55,17,8,537,1450,1987,8,3,202053
27,2,130,7,164,250,16,11,16,594,1190,1784,8,3,202053
27,3,133,9,121,273,6,11,23,576,751,1327,6,3,202053
27,4,138,2,141,218,0,35,6,540,1223,1763,7,3,202053
27,5,100,3,133,198,8,26,2,470,803,1273,6,3,202053
27,6,120,3,170,254,4,14,5,570,721,1291,7,3,202053
28,1,142,16,212,181,0,9,1,561,878,1439,10,3,202053
28,2,229,20,337,199,19,45,168,1017,1057,2074,13,3,202053
28,3,108,12,118,111,13,26,44,432,547,979,8,3,202053
28,4,299,11,289,212,60,66,115,1052,1152,2204,13,3,202053
28,5,276,24,301,334,37,33,104,1109,748,1857,10,3,202053
28,6,123,9,125,174,11,19,11,472,828,1300,13,2.833333333,202053
28,7,175,14,258,205,36,27,138,853,878,1731,9,3,202053
28,8,145,17,168,215,31,36,65,677,730,1407,12,3,202053
28,9,70,2,111,48,4,25,19,279,332,611,6,3,202053
29,1,248,25,209,307,23,30,20,862,984,1846,9,3,202053
29,2,299,12,232,281,25,48,176,1073,1137,2210,10,3,202053
29,3,153,12,156,232,9,35,2,599,650,1249,6,3,202053
30,1,148,8,137,115,56,15,57,536,765,1301,7,3,202053
30,2,162,3,211,83,29,14,101,603,791,1394,10,3,202053
30,3,151,8,170,97,108,13,90,637,706,1343,6,3,202053
30,4,104,7,188,154,18,27,0,498,540,1038,8,3,202053
30,5,157,7,263,243,7,21,2,700,795,1495,9,3,202053
30,6,133,9,179,183,38,32,8,582,673,1255,9,3,202053
30,7,199,10,213,211,59,30,45,767,796,1563,11,3,202053
30,8,182,5,269,207,48,13,19,743,1073,1816,11,3,202053
30,9,221,5,201,160,74,29,93,783,786,1569,8,3,202053
30,10,176,7,288,204,28,35,94,832,975,1807,6,3,202053
30,11,107,7,202,228,11,11,2,568,702,1270,7,3,202053
30,12,215,9,316,333,30,30,1,934,1056,1990,10,3,202053
30,13,217,17,218,219,109,50,102,932,1216,2148,10,3,202053
30,14,149,2,217,147,48,19,34,616,769,1385,8,3,202053
30,15,212,11,227,146,86,44,105,831,913,1744,11,3,202053
30,16,226,8,220,188,29,41,180,892,986,1878,10,3,202053
30,17,196,13,252,338,37,20,16,872,1076,1948,8,3,202053
30,18,175,6,126,243,42,25,37,654,842,1496,8,3,202053
30,19,178,9,295,124,85,9,0,700,802,1502,11,3,202053
30,20,133,7,151,226,40,23,5,585,828,1413,8,2.75,202053
31,1,246,11,278,31,170,21,0,757,533,1290,8,3,202053
31,2,70,3,78,13,106,14,0,284,415,699,6,3,202053
31,3,368,21,497,455,35,41,2,1419,1912,3331,18,3,202053
31,4,104,6,152,66,87,22,42,479,484,963,4,3,202053
31,5,165,4,138,101,41,14,1,464,604,1068,6,3,202053
32,1,168,41,169,171,23,59,80,711,761,1472,10,3,202053
32,2,211,12,125,134,45,45,33,605,735,1340,12,2.571428571,202053
32,3,187,32,147,255,7,32,30,690,887,1577,13,3,202053
32,4,187,39,164,239,11,29,15,684,913,1597,12,3,202053
1,1,297,30,307,297,49,59,15,1054,773,1827,15,3,202054
1,2,286,25,368,335,42,20,42,1118,1206,2324,8,3,202054
1,3,230,41,369,289,36,39,62,1066,1058,2124,7,3,202054
2,1,165,10,160,240,22,63,55,715,810,1525,9,3,202054
2,2,175,7,168,333,3,42,0,728,660,1388,5,3,202054
2,3,143,6,168,135,7,44,56,559,817,1376,10,3,202054
2,4,173,3,260,91,30,26,30,613,621,1234,8,3,202054
2,5,264,6,437,254,126,58,20,1165,503,1668,10,3,202054
2,6,208,6,231,181,30,49,32,737,528,1265,7,3,202054
2,7,225,10,304,188,19,79,59,884,766,1650,12,3,202054
2,8,159,1,204,172,24,32,42,634,537,1171,4,3,202054
3,1,184,10,209,282,13,32,35,765,656,1421,12,3,202054
3,2,135,6,347,118,35,22,2,665,810,1475,8,3,202054
4,1,270,13,246,287,84,30,64,994,1082,2076,11,2.5,202054
4,2,253,8,239,249,36,24,74,883,1300,2183,14,3,202054
5,1,259,9,189,243,17,46,32,795,1026,1821,8,3,202054
5,2,206,14,209,218,34,29,5,715,668,1383,10,3,202054
5,3,218,13,169,242,59,27,26,754,826,1580,10,3,202054
5,4,295,29,375,378,18,42,81,1218,1158,2376,8,3,202054
5,5,283,17,231,263,13,59,77,943,1018,1961,10,3,202054
5,6,192,15,195,188,4,28,89,711,793,1504,9,3,202054
5,7,190,9,152,212,13,19,16,611,347,958,7,3,202054
6,1,215,19,301,220,22,49,118,944,980,1924,12,3,202054
6,2,125,10,157,99,21,24,60,496,473,969,9,3,202054
7,1,147,2,124,88,0,23,1,385,797,1182,9,3,202054
7,2,167,1,66,127,4,11,0,376,1885,2261,9,3,202054
7,3,243,4,162,115,97,31,6,658,406,1064,7,3,202054
7,4,130,6,191,244,16,44,25,656,792,1448,11,3,202054
7,5,209,13,102,253,28,13,2,620,619,1239,11,3,202054
7,6,163,8,263,287,30,31,26,808,823,1631,8,3,202054
7,7,189,15,218,228,45,38,9,742,1071,1813,8,3,202054
7,8,182,21,140,247,42,26,10,668,964,1632,12,3,202054
7,9,181,10,172,217,36,31,22,669,391,1060,9,3,202054
7,10,129,2,154,156,117,12,0,570,885,1455,9,2.5,202054
7,11,96,2,74,57,23,8,0,260,223,483,6,3,202054
7,12,191,4,170,230,3,9,4,611,700,1311,9,3,202054
7,13,55,7,57,212,1,7,0,339,460,799,9,3,202054
8,1,145,4,200,98,7,3,0,457,559,1016,4,3,202054
8,2,340,48,406,380,11,18,4,1207,841,2048,16,3,202054
8,3,202,11,150,156,19,32,25,595,582,1177,4,3,202054
8,4,237,12,359,310,29,51,85,1083,1000,2083,11,3,202054
8,5,197,39,196,223,15,18,7,695,550,1245,10,3,202054
8,6,232,14,260,255,14,37,51,863,836,1699,7,3,202054
8,7,137,25,125,189,1,20,1,498,443,941,7,2.75,202054
8,8,305,36,357,572,3,45,6,1324,1237,2561,10,3,202054
8,9,127,13,112,98,24,31,46,451,678,1129,10,3,202054
9,1,60,4,55,62,32,3,13,229,274,503,4,3,202054
9,2,225,16,250,420,48,42,7,1008,1066,2074,8,3,202054
9,3,86,2,120,179,15,13,42,457,539,996,4,3,202054
9,4,166,7,181,345,24,31,46,800,1037,1837,7,3,202054
9,5,168,0,167,290,30,35,0,690,792,1482,7,3,202054
9,6,74,13,89,168,74,20,1,439,532,971,7,3,202054
9,7,133,7,199,279,7,28,3,656,650,1306,9,3,202054
9,8,55,3,127,180,7,16,18,406,543,949,3,3,202054
9,9,115,3,114,152,41,11,28,464,433,897,3,3,202054
9,10,73,4,109,146,17,48,4,401,270,671,3,3,202054
9,11,108,2,149,188,43,25,1,516,482,998,7,3,202054
9,12,120,14,248,355,34,32,13,816,835,1651,8,3,202054
9,13,102,7,91,136,29,16,29,410,467,877,4,3,202054
9,14,90,3,71,107,15,18,55,359,530,889,5,3,202054
9,15,103,3,275,291,35,34,43,784,931,1715,6,3,202054
9,16,269,83,253,437,25,20,3,1090,1031,2121,11,3,202054
9,17,122,11,197,182,26,5,0,543,588,1131,6,3,202054
9,18,130,9,131,274,60,43,19,666,409,1075,8,3,202054
9,19,114,23,144,148,43,25,18,515,614,1129,3,3,202054
9,20,72,0,66,94,31,14,30,307,315,622,3,3,202054
9,21,91,1,64,88,18,6,28,296,469,765,3,3,202054
9,22,121,5,84,142,68,15,41,476,246,722,2,3,202054
9,23,90,9,196,220,46,17,22,600,966,1566,6,3,202054
9,24,234,13,325,529,105,44,1,1251,1511,2762,11,3,202054
10,1,272,45,224,330,38,27,140,1076,764,1840,13,3,202054
10,2,263,9,170,287,6,27,16,778,673,1451,8,3,202054
10,3,260,21,134,250,43,37,95,840,370,1210,11,3,202054
10,4,285,23,224,464,7,31,14,1048,1090,2138,11,3,202054
11,1,211,22,183,146,45,35,18,660,814,1474,6,3,202054
11,2,187,23,198,179,52,51,42,732,821,1553,7,3,202054
11,3,115,19,96,129,13,25,19,416,254,670,3,3,202054
11,4,169,38,152,214,41,31,7,652,902,1554,7,3,202054
11,5,218,45,234,256,15,44,48,860,1029,1889,7,3,202054
11,6,206,29,222,202,36,49,62,806,857,1663,8,3,202054
11,7,206,22,239,271,20,48,3,809,976,1785,9,3,202054
11,8,222,26,246,331,74,39,24,962,1125,2087,9,3,202054
11,9,221,71,221,281,7,33,48,882,768,1650,10,3,202054
11,10,251,44,252,255,35,62,81,980,964,1944,10,3,202054
11,11,160,28,152,157,16,25,2,540,559,1099,5,3,202054
11,12,221,54,227,279,25,21,14,841,965,1806,7,3,202054
11,13,137,30,135,125,25,21,76,549,357,906,8,3,202054
11,14,140,28,189,184,40,24,5,610,730,1340,8,3,202054
11,15,169,20,174,165,10,37,39,614,765,1379,7,3,202054
12,1,126,27,115,116,53,18,9,464,438,902,6,3,202054
12,2,193,13,219,429,9,34,35,932,1003,1935,10,3,202054
12,3,131,9,178,255,7,11,7,598,783,1381,11,3,202054
12,4,99,7,167,264,15,19,5,576,685,1261,7,3,202054
12,5,221,18,183,197,0,12,46,677,1300,1977,10,3,202054
12,6,210,15,124,265,14,13,10,651,665,1316,10,3,202054
12,7,216,10,155,288,8,33,57,767,665,1432,6,3,202054
12,8,202,6,134,224,0,14,3,583,612,1195,9,3,202054
12,9,112,9,152,280,12,9,2,576,788,1364,9,3,202054
13,1,207,10,116,283,53,8,26,703,849,1552,9,3,202054
13,2,126,9,67,110,75,61,45,493,736,1229,6,3,202054
13,3,220,11,170,205,145,24,1,776,960,1736,11,3,202054
13,4,227,12,165,220,56,25,70,775,1245,2020,8,3,202054
13,5,266,18,195,199,81,44,52,855,1028,1883,9,3,202054
13,6,315,15,296,328,12,48,81,1095,1031,2126,11,3,202054
13,7,224,14,244,281,25,21,6,815,617,1432,8,3,202054
14,1,87,30,119,46,27,10,16,335,523,858,6,3,202054
14,2,138,11,121,118,29,30,11,458,465,923,5,3,202054
14,3,185,23,336,143,18,70,27,802,844,1646,8,3,202054
14,4,210,21,365,280,8,34,35,953,943,1896,10,3,202054
14,5,134,8,275,164,8,18,7,614,736,1350,9,3,202054
14,6,235,17,394,206,10,27,19,908,888,1796,11,3,202054
14,7,110,10,144,128,0,12,2,406,392,798,6,3,202054
14,8,260,24,455,493,4,43,6,1285,1057,2342,9,3,202054
14,9,153,15,217,344,4,27,14,774,806,1580,9,3,202054
14,10,147,18,282,126,10,46,23,652,664,1316,7,3,202054
14,11,135,6,165,137,26,25,102,596,587,1183,5,3,202054
14,12,220,15,293,202,16,11,1,758,747,1505,9,3,202054
14,13,128,7,176,176,6,15,25,533,628,1161,6,3,202054
14,14,161,13,190,235,30,24,50,703,646,1349,7,3,202054
14,15,222,28,190,190,72,39,35,776,831,1607,10,3,202054
14,16,142,11,175,163,18,26,11,546,680,1226,5,3,202054
14,17,108,17,149,56,22,52,9,413,511,924,7,3,202054
14,18,219,21,286,141,71,39,56,833,871,1704,8,3,202054
14,19,133,19,239,173,15,29,20,628,779,1407,8,3,202054
14,20,224,15,368,294,4,35,4,944,955,1899,10,3,202054
15,1,148,4,107,60,188,13,6,526,768,1294,7,3,202054
15,2,123,7,138,113,61,12,12,466,737,1203,6,3,202054
15,3,194,5,137,181,168,24,83,792,954,1746,10,3,202054
15,4,118,6,83,139,10,23,21,400,569,969,4,3,202054
15,5,182,19,145,177,34,21,36,614,726,1340,8,3,202054
15,6,155,4,170,239,17,24,58,667,726,1393,8,3,202054
15,7,154,10,378,8,28,5,0,583,731,1314,10,3,202054
15,8,94,4,76,128,7,7,31,347,373,720,4,3,202054
15,9,177,4,93,107,101,59,12,553,679,1232,9,3,202054
15,10,131,1,101,161,14,13,27,448,544,992,6,3,202054
15,11,141,8,145,193,31,15,12,545,751,1296,8,3,202054
15,12,167,13,241,236,16,15,1,689,969,1658,8,3,202054
15,13,107,4,107,123,65,27,9,442,443,885,8,3,202054
15,14,124,11,76,128,10,14,10,373,360,733,4,3,202054
15,15,133,52,99,159,53,12,30,538,354,892,6,3,202054
15,16,200,25,175,314,12,45,44,815,1064,1879,8,3,202054
15,17,115,4,124,148,16,24,81,512,576,1088,8,3,202054
15,18,194,4,175,195,19,39,19,645,764,1409,7,3,202054
15,19,166,18,231,410,10,31,42,908,991,1899,9,3,202054
15,20,74,4,146,129,24,9,3,389,428,817,6,3,202054
15,21,82,3,54,92,23,25,30,309,453,762,6,3,202054
15,22,218,32,254,405,13,53,62,1037,1055,2092,14,3,202054
15,23,121,6,73,182,11,21,15,429,874,1303,6,3,202054
15,24,112,13,73,114,12,16,20,360,781,1141,4,3,202054
15,25,166,15,109,154,17,25,25,511,653,1164,6,3,202054
15,26,184,1,116,190,70,25,19,605,747,1352,8,3,202054
15,27,148,6,139,170,12,25,70,570,752,1322,9,3,202054
15,28,207,5,279,216,29,22,34,792,1040,1832,9,3,202054
15,29,163,7,162,364,3,29,15,743,1008,1751,7,3,202054
15,30,223,20,216,254,52,27,58,850,1094,1944,15,3,202054
15,31,131,41,113,245,10,18,1,559,613,1172,6,3,202054
15,32,181,6,118,269,35,24,42,675,1190,1865,9,3,202054
15,33,164,12,185,201,18,22,0,602,695,1297,7,3,202054
15,34,118,4,94,234,9,14,2,475,484,959,8,3,202054
15,35,200,4,107,305,3,37,14,670,615,1285,9,3,202054
15,36,252,9,188,382,34,23,8,896,552,1448,9,3,202054
15,37,166,11,125,208,48,35,33,626,1074,1700,7,3,202054
15,38,133,11,115,127,15,11,15,427,606,1033,6,3,202054
15,39,123,16,105,140,29,25,10,448,522,970,4,3,202054
15,40,241,25,200,247,93,30,13,849,1011,1860,9,3,202054
15,41,250,16,308,325,32,25,40,996,1241,2237,13,3,202054
16,1,91,14,113,109,3,11,1,342,366,708,6,2.333333333,202054
16,2,139,25,109,222,16,38,4,553,471,1024,9,3,202054
16,3,262,34,217,317,19,38,9,896,378,1274,10,3,202054
16,4,169,31,159,169,57,45,12,642,430,1072,7,3,202054
16,5,164,21,126,198,26,41,28,604,580,1184,7,3,202054
16,6,163,37,227,221,68,19,2,737,712,1449,12,3,202054
16,7,149,22,204,207,13,23,10,628,706,1334,9,2.25,202054
16,8,255,20,363,474,12,32,29,1185,1010,2195,12,3,202054
16,9,179,18,178,231,13,42,46,707,831,1538,9,3,202054
16,10,152,14,273,330,8,39,0,816,1062,1878,5,3,202054
16,11,295,25,208,289,126,55,11,1009,619,1628,10,3,202054
16,12,57,9,88,93,5,24,0,276,281,557,10,3,202054
17,1,155,19,219,312,12,28,21,766,689,1455,8,3,202054
17,2,180,11,249,311,8,28,45,832,898,1730,9,3,202054
17,3,237,15,229,336,22,30,1,870,935,1805,8,3,202054
17,4,177,9,314,288,15,32,22,857,967,1824,10,3,202054
17,5,97,5,102,123,13,17,2,359,317,676,5,3,202054
18,1,121,14,120,159,34,16,24,488,648,1136,7,3,202054
18,2,218,19,232,367,28,35,30,929,1101,2030,8,3,202054
18,3,127,14,242,190,9,22,4,608,492,1100,8,3,202054
19,1,203,17,231,304,7,54,82,898,914,1812,9,3,202054
19,2,204,10,258,253,12,42,11,790,707,1497,9,3,202054
19,3,225,17,338,200,26,54,19,879,1174,2053,7,3,202054
19,4,151,6,149,109,40,34,124,613,687,1300,5,3,202054
19,5,264,17,270,346,16,43,94,1050,1025,2075,8,3,202054
19,6,125,9,215,237,6,45,101,738,556,1294,5,3,202054
19,7,212,11,323,218,9,32,6,811,1023,1834,10,3,202054
19,8,111,7,171,185,2,22,1,499,496,995,7,3,202054
19,9,135,7,221,177,21,39,43,643,733,1376,9,3,202054
19,10,121,4,162,206,3,43,81,620,602,1222,5,3,202054
19,11,332,21,309,589,4,97,86,1438,1146,2584,13,3,202054
19,12,110,3,227,77,3,12,4,436,680,1116,13,3,202054
20,1,115,8,123,101,45,12,48,452,603,1055,7,3,202054
20,2,130,14,212,126,22,10,0,514,540,1054,6,3,202054
20,3,169,4,191,120,72,29,47,632,652,1284,6,3,202054
20,4,100,4,106,132,41,30,22,435,174,609,6,3,202054
20,5,143,10,191,272,17,16,0,649,633,1282,11,3,202054
20,6,195,8,135,97,103,22,41,601,340,941,8,3,202054
20,7,139,5,194,198,12,19,12,579,1026,1605,7,3,202054
20,8,303,12,347,501,27,47,95,1332,1396,2728,13,3,202054
20,9,192,6,196,239,149,17,25,824,782,1606,8,2.666666667,202054
20,10,188,11,218,197,40,14,3,671,842,1513,9,3,202054
21,1,183,7,243,274,12,30,7,756,811,1567,8,3,202054
21,2,155,12,228,159,63,35,18,670,713,1383,9,3,202054
21,3,188,6,242,186,90,29,54,795,999,1794,8,3,202054
21,4,148,4,150,68,71,25,25,491,660,1151,6,3,202054
21,5,206,8,281,259,35,32,40,861,1136,1997,7,3,202054
21,6,172,6,135,127,58,38,37,573,662,1235,5,3,202054
21,7,169,8,110,195,26,41,2,551,573,1124,7,3,202054
21,8,157,8,219,127,23,23,71,628,722,1350,9,3,202054
21,9,205,8,297,225,45,33,53,866,1034,1900,8,3,202054
21,10,163,3,131,111,15,36,93,552,597,1149,5,3,202054
21,11,97,4,119,105,19,11,16,371,357,728,4,3,202054
21,12,325,23,471,425,61,61,166,1532,1810,3342,15,3,202054
21,13,174,7,106,185,18,33,16,539,628,1167,7,3,202054
21,14,116,5,116,105,56,24,33,455,540,995,8,3,202054
21,15,213,3,162,171,9,56,33,647,848,1495,7,3,202054
22,1,205,43,156,274,12,24,1,715,822,1537,11,3,202054
22,2,149,20,183,197,54,20,2,625,779,1404,7,3,202054
22,3,304,26,400,410,11,35,18,1204,850,2054,9,3,202054
22,4,175,24,337,296,19,32,9,892,847,1739,8,3,202054
22,5,157,5,243,167,24,25,26,647,785,1432,10,2,202054
23,1,161,5,513,129,14,12,30,864,971,1835,14,3,202054
23,2,138,9,288,173,13,7,12,640,808,1448,10,3,202054
23,3,326,17,890,429,45,18,20,1745,1565,3310,19,3,202054
23,4,96,4,231,115,25,30,40,541,836,1377,6,3,202054
24,1,135,17,127,182,8,26,29,524,714,1238,10,3,202054
24,2,117,17,89,75,31,20,28,377,722,1099,6,3,202054
24,3,172,19,130,137,50,30,3,541,814,1355,9,3,202054
24,4,126,21,120,97,37,20,103,524,588,1112,5,3,202054
24,5,270,32,323,406,11,26,3,1071,1162,2233,9,3,202054
24,6,229,41,248,258,14,18,2,810,881,1691,6,3,202054
24,7,148,8,112,144,11,7,0,430,852,1282,9,3,202054
25,1,144,4,178,184,20,31,69,630,663,1293,10,3,202054
25,2,169,30,140,231,1,11,3,585,732,1317,5,3,202054
25,3,135,6,128,250,4,31,31,585,883,1468,7,3,202054
25,4,125,15,177,241,42,9,2,611,655,1266,8,3,202054
25,5,177,7,239,455,15,23,13,929,845,1774,8,3,202054
25,6,146,6,179,259,34,30,47,701,1048,1749,6,3,202054
25,7,170,12,226,288,0,16,3,715,426,1141,5,3,202054
26,1,175,5,152,257,6,33,23,651,616,1267,9,3,202054
26,2,237,8,273,410,8,29,8,973,746,1719,12,3,202054
26,3,218,6,221,270,7,37,23,782,727,1509,13,3,202054
26,4,133,3,146,162,39,14,9,506,601,1107,9,3,202054
26,5,190,6,208,273,15,34,2,728,706,1434,14,3,202054
26,6,172,8,139,229,4,45,22,619,546,1165,9,3,202054
26,7,132,14,120,198,42,18,14,538,633,1171,10,3,202054
27,1,131,5,159,180,51,13,4,543,817,1360,8,3,202054
27,2,121,9,106,230,5,16,13,500,600,1100,8,3,202054
27,3,139,9,99,286,3,20,26,582,625,1207,6,3,202054
27,4,111,2,170,220,8,29,14,554,685,1239,7,3,202054
27,5,122,2,122,239,12,24,2,523,669,1192,6,3,202054
27,6,101,7,157,293,4,14,2,578,642,1220,7,3,202054
28,1,143,13,275,258,6,19,3,717,825,1542,10,3,202054
28,2,211,15,317,243,12,35,179,1012,1128,2140,13,3,202054
28,3,119,5,127,92,8,24,47,422,462,884,8,3,202054
28,4,273,20,305,291,30,62,85,1066,1035,2101,13,3,202054
28,5,229,23,301,315,22,34,110,1034,958,1992,10,3,202054
28,6,81,8,109,162,16,18,10,404,797,1201,13,3,202054
28,7,200,6,249,182,24,40,136,837,819,1656,9,3,202054
28,8,163,11,180,203,22,40,99,718,717,1435,12,3,202054
28,9,74,2,154,76,7,21,34,368,286,654,6,3,202054
29,1,235,24,246,324,26,34,14,903,1040,1943,9,3,202054
29,2,261,13,228,292,32,48,168,1042,1150,2192,10,3,202054
29,3,149,14,110,260,21,30,2,586,654,1240,6,3,202054
30,1,110,7,129,125,33,9,57,470,682,1152,7,3,202054
30,2,146,5,114,80,17,10,103,475,541,1016,10,3,202054
30,3,130,6,189,112,82,35,87,641,592,1233,6,3,202054
30,4,106,2,185,151,35,18,0,497,628,1125,8,3,202054
30,5,149,5,314,194,11,14,0,687,710,1397,9,3,202054
30,6,120,10,192,161,31,25,15,554,553,1107,9,3,202054
30,7,211,10,157,180,47,24,58,687,974,1661,11,3,202054
30,8,206,5,267,219,52,31,17,797,1076,1873,11,3,202054
30,9,212,3,192,168,79,34,104,792,881,1673,8,3,202054
30,10,163,12,272,177,39,29,106,798,826,1624,6,3,202054
30,11,106,6,203,227,21,13,0,576,587,1163,7,3,202054
30,12,203,3,296,362,37,33,2,936,1135,2071,10,3,202054
30,13,226,7,210,228,122,48,108,949,1433,2382,10,3,202054
30,14,140,12,191,166,28,19,45,601,769,1370,8,3,202054
30,15,207,5,176,172,79,36,152,827,1109,1936,11,3,202054
30,16,206,2,190,247,38,39,162,884,933,1817,10,3,202054
30,17,162,12,212,294,21,33,12,746,919,1665,8,3,202054
30,18,166,7,125,221,34,27,41,621,800,1421,8,3,202054
30,19,153,6,243,144,96,11,0,653,809,1462,11,3,202054
30,20,105,2,120,219,52,19,2,519,895,1414,8,3,202054
31,1,257,7,284,46,188,11,0,793,281,1074,8,3,202054
31,2,81,1,76,8,110,7,2,285,452,737,6,3,202054
31,3,379,17,474,477,40,40,3,1430,1504,2934,18,3,202054
31,4,102,5,172,70,91,25,29,494,612,1106,4,3,202054
31,5,160,6,157,110,28,21,3,485,608,1093,6,3,202054
32,1,202,28,204,199,41,34,85,793,835,1628,10,3,202054
32,2,161,21,137,117,38,40,43,557,707,1264,12,2.571428571,202054
32,3,159,21,156,234,3,38,31,642,839,1481,13,3,202054
32,4,179,23,208,225,15,31,34,715,896,1611,12,3,202054
1,1,515,55,532,449,78,223,53,1905,1048,2953,15,5,202102
1,2,474,63,742,536,68,54,113,2050,1792,3842,8,5,202102
1,3,404,77,710,551,65,59,115,1981,1599,3580,7,5,202102
2,1,355,11,364,500,21,266,84,1601,1524,3125,9,5,202102
2,2,305,12,337,541,6,76,0,1277,1080,2357,5,5,202102
2,3,373,11,396,310,80,279,15,1464,1630,3094,10,5,202102
2,4,305,5,486,147,62,34,33,1072,1031,2103,8,5,202102
2,5,479,28,777,467,196,122,78,2147,1766,3913,10,5,202102
2,6,259,18,386,355,63,109,56,1246,1018,2264,7,5,202102
2,7,415,27,521,300,38,231,75,1607,1261,2868,12,5,202102
2,8,240,15,399,274,46,54,129,1157,952,2109,4,5,202102
3,1,296,25,418,509,29,58,75,1410,1133,2543,12,4.833333333,202102
3,2,238,25,601,297,48,26,24,1259,1127,2386,8,5,202102
4,1,421,21,468,400,263,291,42,1906,1615,3521,11,5,202102
4,2,477,15,563,559,140,33,173,1960,1214,3174,14,4.8,202102
5,1,418,22,425,556,44,71,72,1608,1349,2957,8,5,202102
5,2,323,37,461,354,67,85,20,1347,927,2274,10,5,202102
5,3,336,22,301,485,86,63,41,1334,1333,2667,10,5,202102
5,4,545,46,706,674,21,72,165,2229,1700,3929,8,5,202102
5,5,427,18,357,309,17,435,4,1567,1610,3177,10,5,202102
5,6,274,21,354,240,7,99,122,1117,1198,2315,9,5,202102
5,7,304,15,278,367,23,43,41,1071,815,1886,7,5,202102
6,1,409,32,647,435,62,77,227,1889,1373,3262,12,5,202102
6,2,255,18,341,181,67,63,117,1042,695,1737,9,5,202102
7,1,381,9,395,235,10,45,4,1079,401,1480,9,5,202102
7,2,488,14,220,560,29,19,3,1333,955,2288,9,5,202102
7,3,224,8,198,667,134,26,11,1268,994,2262,7,5,202102
7,4,241,26,296,452,12,88,47,1162,998,2160,11,4.8,202102
7,5,355,26,218,459,51,29,7,1145,1011,2156,11,5,202102
7,6,296,11,475,466,48,52,70,1418,860,2278,8,5,202102
7,7,316,8,400,432,86,98,21,1361,1539,2900,8,5,202102
7,8,328,43,302,440,51,35,3,1202,774,1976,12,5,202102
7,9,289,15,301,357,53,89,12,1116,1352,2468,9,5,202102
7,10,309,8,337,513,259,34,1,1461,1008,2469,9,5,202102
7,11,135,3,129,117,69,24,0,477,362,839,6,5,202102
7,12,369,5,415,599,9,22,16,1435,1034,2469,9,5,202102
7,13,139,11,179,769,0,19,0,1117,470,1587,9,5,202102
8,1,257,9,347,211,3,12,4,843,780,1623,4,5,202102
8,2,531,57,805,798,26,45,7,2269,1561,3830,16,5,202102
8,3,312,20,319,367,15,33,29,1095,923,2018,4,5,202102
8,4,368,34,651,644,61,93,173,2024,1709,3733,11,5,202102
8,5,303,79,368,478,37,58,17,1340,879,2219,10,5,202102
8,6,412,24,436,470,36,49,88,1515,1855,3370,7,5,202102
8,7,318,36,298,452,12,31,8,1155,817,1972,7,5,202102
8,8,498,36,697,979,4,99,6,2319,2150,4469,10,5,202102
8,9,408,42,316,293,77,103,95,1334,575,1909,10,5,202102
9,1,125,5,104,139,65,18,22,478,413,891,4,5,202102
9,2,381,39,443,722,137,73,36,1831,1786,3617,8,5,202102
9,3,153,2,171,319,40,21,74,780,803,1583,4,5,202102
9,4,269,15,290,570,31,42,121,1338,1444,2782,7,5,202102
9,5,302,2,294,519,46,81,1,1245,1244,2489,7,5,202102
9,6,153,15,168,296,123,26,10,791,719,1510,7,5,202102
9,7,190,11,317,563,16,31,3,1131,1067,2198,9,5,202102
9,8,111,13,222,329,21,34,44,774,696,1470,3,5,202102
9,9,192,4,188,301,54,38,42,819,533,1352,3,5,202102
9,10,104,15,217,220,33,81,11,681,535,1216,3,5,202102
9,11,181,11,238,319,107,70,0,926,899,1825,7,5,202102
9,12,189,18,447,549,91,74,17,1385,1341,2726,8,5,202102
9,13,172,7,187,213,83,32,54,748,775,1523,4,5,202102
9,14,171,4,170,268,53,38,90,794,315,1109,5,5,202102
9,15,196,12,550,514,62,64,78,1476,1587,3063,6,5,202102
9,16,375,158,395,852,35,38,9,1862,1779,3641,11,5,202102
9,17,190,16,352,326,24,17,2,927,975,1902,6,5,202102
9,18,213,11,192,408,99,74,35,1032,701,1733,8,5,202102
9,19,228,42,242,355,77,36,56,1036,823,1859,3,5,202102
9,20,112,3,157,192,70,13,15,562,551,1113,3,5,202102
9,21,136,7,136,211,35,20,46,591,657,1248,3,5,202102
9,22,242,5,151,243,103,32,52,828,464,1292,2,5,202102
9,23,177,13,354,441,68,50,16,1119,1083,2202,6,5,202102
9,24,435,16,595,795,193,143,5,2182,2463,4645,11,5,202102
10,1,405,46,410,534,56,31,244,1726,1045,2771,17,4.833333333,202102
10,2,434,32,412,652,24,65,7,1626,1202,2828,8,5,202102
10,3,316,36,225,342,78,68,166,1231,1213,2444,9,5,202102
10,4,443,42,485,866,8,60,10,1914,1513,3427,11,5,202102
11,1,315,49,270,279,87,70,37,1107,1246,2353,6,5,202102
11,2,292,57,308,288,73,165,45,1228,1127,2355,7,5,202102
11,3,185,29,189,193,25,41,33,695,749,1444,3,5,202102
11,4,249,59,279,392,68,65,14,1126,1083,2209,7,5,202102
11,5,414,87,415,549,24,87,57,1633,1360,2993,7,5,202102
11,6,290,34,381,356,45,57,49,1212,1503,2715,8,5,202102
11,7,418,37,463,473,38,81,13,1523,1284,2807,9,5,202102
11,8,361,41,448,577,147,57,76,1707,1588,3295,9,5,202102
11,9,421,110,480,569,7,55,72,1714,1471,3185,10,5,202102
11,10,368,75,401,464,58,234,73,1673,1427,3100,10,5,202102
11,11,255,36,281,384,7,37,7,1007,900,1907,5,5,202102
11,12,362,85,438,458,30,43,45,1461,1439,2900,7,5,202102
11,13,177,30,149,158,44,31,34,623,533,1156,5,3.75,202102
11,14,232,42,369,318,71,52,24,1108,761,1869,8,5,202102
11,15,278,48,286,323,28,54,130,1147,808,1955,7,5,202102
12,1,367,85,408,237,121,254,46,1518,503,2021,10,4.8,202102
12,2,378,50,440,796,17,48,36,1765,1703,3468,10,5,202102
12,3,259,40,406,619,31,49,4,1408,1011,2419,11,5,202102
12,4,266,20,443,738,37,63,17,1584,1054,2638,9,5,202102
12,5,286,36,270,344,6,19,108,1069,1133,2202,10,5,202102
12,6,310,14,286,469,14,24,21,1138,1022,2160,10,5,202102
12,7,358,37,327,538,9,89,111,1469,1716,3185,6,5,202102
12,8,391,28,231,536,2,32,0,1220,807,2027,9,5,202102
12,9,299,28,485,892,39,37,8,1788,1173,2961,9,5,202102
13,1,327,24,247,448,64,35,167,1312,1051,2363,9,5,202102
13,2,214,21,115,199,126,166,74,915,774,1689,6,5,202102
13,3,319,21,341,367,231,48,43,1370,1203,2573,11,5,202102
13,4,389,25,342,431,106,45,173,1511,1127,2638,8,5,202102
13,5,425,24,437,462,117,89,174,1728,1560,3288,9,5,202102
13,6,525,38,566,660,29,73,165,2056,1895,3951,11,5,202102
13,7,348,22,533,557,64,33,14,1571,1288,2859,8,5,202102
14,1,161,57,157,106,78,30,22,611,605,1216,6,5,202102
14,2,203,15,278,212,60,64,5,837,717,1554,5,5,202102
14,3,351,37,498,251,42,99,46,1324,1186,2510,8,5,202102
14,4,301,35,590,408,18,68,96,1516,1259,2775,10,5,202102
14,5,256,19,557,371,29,46,2,1280,1207,2487,9,5,202102
14,6,345,21,597,333,24,83,16,1419,1799,3218,9,5,202102
14,7,176,11,275,208,0,16,7,693,877,1570,6,5,202102
14,8,402,29,843,833,5,96,27,2235,2425,4660,10,5,202102
14,9,260,26,392,576,17,41,33,1345,1096,2441,9,5,202102
14,10,241,33,518,244,21,72,27,1156,796,1952,6,5,202102
14,11,155,11,190,184,30,60,93,723,749,1472,5,5,202102
14,12,363,24,518,304,27,22,1,1259,1413,2672,9,5,202102
14,13,255,18,340,274,7,35,32,961,929,1890,6,5,202102
14,14,259,26,276,405,45,55,73,1139,892,2031,7,5,202102
14,15,363,56,364,352,132,75,97,1439,1183,2622,10,5,202102
14,16,213,28,329,312,26,30,17,955,851,1806,5,5,202102
14,17,195,25,246,142,22,144,9,783,664,1447,7,5,202102
14,18,395,45,474,271,140,96,96,1517,1266,2783,8,5,202102
14,19,281,34,447,322,57,62,39,1242,973,2215,8,5,202102
14,20,440,34,641,535,3,63,1,1717,1043,2760,10,5,202102
15,1,238,10,184,110,270,33,17,862,755,1617,7,5,202102
15,2,205,11,303,206,102,12,20,859,769,1628,6,5,202102
15,3,357,9,238,300,300,44,159,1407,1356,2763,10,5,202102
15,4,195,11,153,271,38,35,20,723,666,1389,4,5,202102
15,5,304,28,304,320,33,28,69,1086,929,2015,8,5,202102
15,6,211,4,253,377,21,45,81,992,1036,2028,8,5,202102
15,7,217,10,686,8,72,8,0,1001,692,1693,10,5,202102
15,8,133,14,137,226,16,21,57,604,676,1280,4,5,202102
15,9,302,12,179,149,198,129,32,1001,704,1705,9,5,202102
15,10,234,6,182,292,18,33,46,811,791,1602,6,5,202102
15,11,288,5,273,429,59,33,17,1104,938,2042,8,5,202102
15,12,328,11,528,380,44,30,3,1324,1283,2607,8,5,202102
15,13,163,14,211,228,121,41,11,789,729,1518,8,5,202102
15,14,174,12,122,248,31,43,23,653,514,1167,4,5,202102
15,15,198,76,169,259,49,29,54,834,961,1795,6,5,202102
15,16,331,38,338,602,30,56,120,1515,1222,2737,8,5,202102
15,17,189,18,189,299,35,49,132,911,817,1728,8,5,202102
15,18,272,9,393,382,28,73,59,1216,1063,2279,7,5,202102
15,19,310,43,342,784,24,58,97,1658,1460,3118,9,5,202102
15,20,126,16,247,246,27,19,18,699,589,1288,6,5,202102
15,21,138,5,103,164,32,121,26,589,547,1136,6,5,202102
15,22,335,42,433,641,33,83,114,1681,1811,3492,14,5,202102
15,23,223,9,153,372,24,46,23,850,764,1614,6,5,202102
15,24,153,18,163,213,40,71,25,683,819,1502,4,5,202102
15,25,280,13,203,275,33,29,70,903,728,1631,6,5,202102
15,26,268,10,258,367,105,39,38,1085,705,1790,8,5,202102
15,27,267,14,294,282,20,42,114,1033,1042,2075,9,5,202102
15,28,321,11,534,400,48,44,59,1417,1085,2502,9,5,202102
15,29,291,16,336,599,9,93,66,1410,822,2232,7,5,202102
15,30,381,36,402,471,91,48,106,1535,1577,3112,15,5,202102
15,31,218,95,228,430,24,30,7,1032,922,1954,6,5,202102
15,32,252,14,262,437,41,78,51,1135,1053,2188,9,5,202102
15,33,289,18,326,388,38,37,1,1097,879,1976,7,5,202102
15,34,158,9,190,398,16,22,1,794,675,1469,8,5,202102
15,35,320,19,256,564,5,65,29,1258,1062,2320,9,5,202102
15,36,344,12,303,643,59,24,6,1391,1081,2472,9,5,202102
15,37,272,22,292,412,91,87,56,1232,994,2226,7,5,202102
15,38,268,22,274,307,65,26,42,1004,805,1809,6,5,202102
15,39,206,19,207,241,39,52,21,785,539,1324,4,5,202102
15,40,420,35,315,456,221,42,14,1503,1392,2895,9,5,202102
15,41,417,23,618,554,78,49,93,1832,1588,3420,13,5,202102
16,1,239,40,403,382,7,17,0,1088,546,1634,6,5,202102
16,2,213,55,247,354,19,57,51,996,667,1663,9,5,202102
16,3,307,22,243,426,37,57,10,1102,1096,2198,10,5,202102
16,4,200,39,289,245,114,52,14,953,931,1884,7,5,202102
16,5,172,32,198,201,40,34,62,739,959,1698,7,5,202102
16,6,335,74,347,328,101,65,11,1261,980,2241,12,5,202102
16,7,360,58,523,523,77,76,16,1633,967,2600,9,5,202102
16,8,369,29,593,728,19,41,48,1827,2067,3894,12,5,202102
16,9,272,31,338,389,23,117,79,1249,941,2190,9,5,202102
16,10,220,18,471,508,13,103,4,1337,1190,2527,5,5,202102
16,11,274,22,364,291,179,48,58,1236,1092,2328,10,5,202102
16,12,316,31,479,277,20,128,10,1261,1045,2306,10,5,202102
17,1,253,25,380,592,34,54,33,1371,1144,2515,8,5,202102
17,2,284,12,427,608,17,51,78,1477,1476,2953,9,5,202102
17,3,357,33,443,617,40,60,11,1561,1397,2958,8,5,202102
17,4,292,25,498,655,36,42,91,1639,1438,3077,10,5,202102
17,5,116,10,142,227,24,17,6,542,615,1157,5,5,202102
18,1,203,23,224,318,45,33,33,879,934,1813,7,5,202102
18,2,350,39,441,646,67,59,57,1659,1585,3244,8,5,202102
18,3,254,27,404,358,15,36,33,1127,932,2059,8,5,202102
19,1,376,24,491,526,22,75,126,1640,1453,3093,9,5,202102
19,2,364,20,499,447,19,52,16,1417,1205,2622,9,5,202102
19,3,403,18,572,329,53,182,44,1601,1378,2979,7,5,202102
19,4,247,10,274,167,109,49,201,1057,900,1957,5,5,202102
19,5,512,43,502,634,42,81,219,2033,1591,3624,8,5,202102
19,6,218,14,455,452,11,67,105,1322,1097,2419,5,5,202102
19,7,427,30,751,554,8,73,14,1857,1564,3421,10,5,202102
19,8,190,5,278,287,6,49,2,817,593,1410,7,5,202102
19,9,461,19,594,377,18,198,21,1688,702,2390,9,5,202102
19,10,252,14,298,301,10,59,137,1071,1075,2146,5,5,202102
19,11,527,41,556,881,13,164,178,2360,1780,4140,13,5,202102
19,12,211,19,527,193,10,27,11,998,1245,2243,13,5,202102
20,1,271,9,310,232,101,34,134,1091,749,1840,7,5,202102
20,2,282,12,290,256,50,15,0,905,851,1756,6,5,202102
20,3,175,7,173,141,112,43,55,706,553,1259,4,3.333333333,202102
20,4,178,9,132,159,65,98,97,738,617,1355,6,5,202102
20,5,328,16,348,692,20,44,1,1449,1085,2534,11,5,202102
20,6,459,9,206,185,156,91,75,1181,1219,2400,8,5,202102
20,7,299,21,379,593,18,46,29,1385,708,2093,7,5,202102
20,8,536,24,683,985,42,68,82,2420,2264,4684,13,5,202102
20,9,412,11,368,397,233,32,71,1524,889,2413,8,5,202102
20,10,373,16,497,351,113,19,6,1375,699,2074,9,5,202102
21,1,293,11,363,457,26,31,10,1191,1024,2215,8,5,202102
21,2,245,19,306,253,130,47,18,1018,735,1753,9,5,202102
21,3,303,16,338,274,139,53,80,1203,1183,2386,8,5,202102
21,4,230,9,234,141,116,34,58,822,749,1571,6,5,202102
21,5,317,15,527,429,55,45,83,1471,1105,2576,7,5,202102
21,6,220,11,203,194,46,214,14,902,1238,2140,5,5,202102
21,7,264,11,157,311,58,115,14,930,991,1921,7,5,202102
21,8,280,18,361,220,48,66,101,1094,1040,2134,9,5,202102
21,9,305,16,528,337,84,75,94,1439,1556,2995,8,5,202102
21,10,242,8,236,274,24,45,140,969,798,1767,5,5,202102
21,11,162,3,310,160,16,17,22,690,607,1297,4,5,202102
21,12,468,27,803,757,126,97,362,2640,2149,4789,15,5,202102
21,13,243,16,255,290,41,57,24,926,960,1886,7,5,202102
21,14,184,10,169,167,85,41,64,720,697,1417,8,4.833333333,202102
21,15,392,10,288,323,37,121,103,1274,1336,2610,7,5,202102
22,1,370,78,335,463,28,41,5,1320,969,2289,11,5,202102
22,2,240,29,339,287,91,40,5,1031,1000,2031,7,5,202102
22,3,479,63,751,657,21,58,27,2056,2006,4062,9,5,202102
22,4,296,38,594,605,30,45,20,1628,1665,3293,8,5,202102
22,5,349,25,596,425,70,60,51,1576,1474,3050,10,5,202102
23,1,346,15,1028,271,45,29,41,1775,1605,3380,14,5,202102
23,2,211,11,536,382,34,12,39,1225,893,2118,10,5,202102
23,3,499,29,1503,756,94,43,63,2987,2197,5184,19,5,202102
23,4,145,4,404,190,46,205,28,1022,618,1640,6,5,202102
24,1,278,28,271,344,15,56,40,1032,913,1945,10,5,202102
24,2,272,29,199,133,40,41,20,734,482,1216,6,5,202102
24,3,259,33,247,257,83,30,8,917,842,1759,9,5,202102
24,4,169,26,230,257,33,42,94,851,814,1665,5,5,202102
24,5,483,56,645,634,7,34,3,1862,1617,3479,9,5,202102
24,6,351,70,529,455,12,32,6,1455,1577,3032,6,5,202102
24,7,336,26,281,369,57,16,2,1087,567,1654,9,5,202102
25,1,240,13,360,328,38,67,245,1291,999,2290,10,5,202102
25,2,284,36,312,528,11,22,2,1195,1163,2358,5,5,202102
25,3,234,10,306,599,26,48,67,1290,1035,2325,7,5,202102
25,4,260,28,398,492,86,16,1,1281,870,2151,8,5,202102
25,5,301,18,439,784,39,63,42,1686,1532,3218,8,5,202102
25,6,307,12,388,383,69,54,133,1346,1260,2606,6,5,202102
25,7,303,9,477,576,3,15,2,1385,1003,2388,5,5,202102
26,1,282,14,350,551,9,64,12,1282,1027,2309,9,5,202102
26,2,390,23,534,837,3,52,26,1865,1470,3335,12,5,202102
26,3,340,14,450,555,8,85,70,1522,1386,2908,13,5,202102
26,4,252,15,313,361,64,32,13,1050,819,1869,9,5,202102
26,5,273,21,392,493,31,76,5,1291,1186,2477,14,5,202102
26,6,293,13,302,446,13,96,21,1184,1001,2185,9,5,202102
26,7,243,11,221,421,132,27,18,1073,860,1933,10,5,202102
27,1,220,9,322,387,95,36,8,1077,980,2057,8,5,202102
27,2,257,10,225,489,16,35,43,1075,725,1800,8,5,202102
27,3,267,11,213,597,13,30,86,1217,805,2022,6,5,202102
27,4,255,11,332,446,11,220,7,1282,872,2154,7,5,202102
27,5,207,7,239,303,12,134,5,907,440,1347,6,5,202102
27,6,249,14,334,605,4,33,12,1251,1113,2364,7,5,202102
28,1,339,48,632,742,3,40,6,1810,1084,2894,10,5,202102
28,2,448,46,713,550,33,64,357,2211,1560,3771,13,5,202102
28,3,195,18,290,277,14,53,107,954,966,1920,8,5,202102
28,4,570,43,791,580,111,118,249,2462,1248,3710,13,5,202102
28,5,470,63,714,387,55,199,59,1947,1695,3642,10,5,202102
28,6,263,27,356,542,18,33,37,1276,1100,2376,13,5,202102
28,7,335,21,455,406,72,50,218,1557,1178,2735,9,5,202102
28,8,316,15,360,301,54,169,97,1312,1139,2451,12,5,202102
28,9,193,6,272,134,7,156,16,784,566,1350,6,5,202102
29,1,487,28,432,614,73,65,33,1732,1499,3231,9,5,202102
29,2,443,21,395,508,50,101,315,1833,1610,3443,10,5,202102
29,3,252,20,210,470,22,63,4,1041,888,1929,6,5,202102
30,1,151,32,253,254,75,20,99,884,847,1731,7,5,202102
30,2,426,12,327,177,131,27,281,1381,686,2067,10,5,202102
30,3,196,6,358,191,112,37,155,1055,693,1748,6,5,202102
30,4,192,13,326,286,52,37,0,906,956,1862,8,5,202102
30,5,257,14,491,430,15,44,5,1256,910,2166,9,5,202102
30,6,213,10,342,307,51,27,31,981,849,1830,9,5,202102
30,7,319,21,301,321,120,48,118,1248,918,2166,11,5,202102
30,8,332,19,581,399,119,67,37,1554,1203,2757,11,5,202102
30,9,329,10,375,280,114,63,207,1378,1170,2548,8,5,202102
30,10,278,16,449,405,50,63,186,1447,1426,2873,6,5,202102
30,11,249,15,605,577,22,23,7,1498,683,2181,9,5,202102
30,12,331,12,582,674,64,54,6,1723,1319,3042,10,5,202102
30,13,315,19,344,358,210,66,161,1473,1440,2913,10,5,202102
30,14,241,7,362,305,82,36,62,1095,1057,2152,8,5,202102
30,15,359,14,302,311,114,88,238,1426,1432,2858,11,5,202102
30,16,332,8,407,414,81,66,315,1623,1375,2998,10,5,202102
30,17,309,24,410,636,40,51,37,1507,1101,2608,8,5,202102
30,18,274,11,191,338,64,78,93,1049,1073,2122,8,5,202102
30,19,288,18,509,244,134,30,1,1224,1109,2333,11,5,202102
30,20,226,7,274,567,117,43,3,1237,917,2154,8,5,202102
31,1,370,16,480,59,299,25,5,1254,1392,2646,8,5,202102
31,2,265,4,268,26,266,42,0,871,423,1294,6,5,202102
31,3,726,49,1172,1070,115,87,11,3230,1532,4762,18,5,202102
31,4,206,18,381,158,200,42,81,1086,817,1903,4,5,202102
31,5,334,21,400,241,79,56,17,1148,473,1621,6,5,202102
32,1,339,64,352,339,55,62,138,1349,1257,2606,10,5,202102
32,2,341,38,335,254,132,93,106,1299,1164,2463,13,5,202102
32,3,305,72,322,503,17,57,110,1386,999,2385,13,5,202102
32,4,462,64,409,505,35,75,67,1617,976,2593,12,5,202102
1,1,502,73,535,485,88,214,63,1960,1560,3520,14,5,202103
1,2,538,48,821,582,99,83,106,2277,1913,4190,8,5,202103
1,3,417,86,754,543,84,90,164,2138,2016,4154,7,5,202103
2,1,402,15,413,456,33,287,92,1698,1581,3279,9,5,202103
2,2,310,17,352,602,12,88,0,1381,1148,2529,5,5,202103
2,3,425,27,533,355,18,225,57,1640,1599,3239,10,5,202103
2,4,304,6,529,170,60,37,51,1157,1072,2229,8,5,202103
2,5,501,21,835,454,212,124,80,2227,1802,4029,10,5,202103
2,6,296,11,426,363,65,132,67,1360,1080,2440,7,5,202103
2,7,429,25,568,377,47,149,109,1704,1360,3064,12,5,202103
2,8,349,22,429,343,41,70,121,1375,953,2328,4,5,202103
3,1,311,14,471,553,30,50,71,1500,1444,2944,12,5,202103
3,2,250,21,659,321,54,29,21,1355,846,2201,8,5,202103
4,1,492,31,507,580,260,139,113,2122,1918,4040,11,5,202103
4,2,438,16,593,528,160,66,198,1999,1285,3284,14,5,202103
5,1,443,18,468,606,53,60,71,1719,1272,2991,9,5,202103
5,2,366,35,513,457,56,63,28,1518,1161,2679,10,5,202103
5,3,332,22,354,448,86,50,36,1328,1344,2672,10,5,202103
5,4,583,43,729,751,24,65,165,2360,1626,3986,8,5,202103
5,5,430,21,405,291,12,504,9,1672,1385,3057,10,5,202103
5,6,306,21,380,225,9,109,139,1189,1086,2275,9,5,202103
5,7,384,26,264,363,35,37,45,1154,970,2124,7,5,202103
6,1,388,34,708,425,48,95,242,1940,1228,3168,12,5,202103
6,2,245,30,476,165,64,45,151,1176,760,1936,8,5,202103
7,1,359,17,383,236,10,61,5,1071,739,1810,9,5,202103
7,2,531,9,336,1085,71,16,0,2048,615,2663,9,5,202103
7,3,300,5,308,190,159,43,10,1015,858,1873,7,5,202103
7,4,425,55,431,659,18,112,88,1788,1031,2819,11,5,202103
7,5,415,35,270,484,54,33,5,1296,1165,2461,11,5,202103
7,6,438,11,495,481,55,82,60,1622,995,2617,8,5,202103
7,7,407,12,525,428,134,138,13,1657,1214,2871,8,5,202103
7,8,394,60,312,493,47,39,3,1348,1226,2574,12,5,202103
7,9,276,29,307,346,56,85,7,1106,1145,2251,9,5,202103
7,10,298,7,399,898,293,30,4,1929,1051,2980,9,5,202103
7,11,166,3,250,146,65,23,1,654,448,1102,6,5,202103
7,12,413,8,498,622,6,23,26,1596,1169,2765,9,5,202103
7,13,259,21,329,902,7,33,2,1553,752,2305,9,5,202103
8,1,265,7,392,179,9,13,1,866,706,1572,4,5,202103
8,2,569,93,889,812,16,69,5,2453,1785,4238,16,5,202103
8,3,327,25,318,350,19,41,69,1149,955,2104,4,5,202103
8,4,331,58,689,619,75,72,233,2077,1325,3402,11,5,202103
8,5,284,85,313,482,20,29,9,1222,666,1888,10,4,202103
8,6,400,27,499,467,31,44,109,1577,1083,2660,7,5,202103
8,7,316,47,331,497,16,54,5,1266,798,2064,7,5,202103
8,8,453,34,762,983,4,85,8,2329,2243,4572,10,5,202103
8,9,568,73,511,571,134,142,142,2141,680,2821,10,4.8,202103
9,1,106,2,108,151,86,30,35,518,438,956,4,5,202103
9,2,398,42,425,818,136,66,50,1935,1892,3827,8,5,202103
9,3,163,9,188,319,41,32,57,809,777,1586,4,5,202103
9,4,295,19,306,543,43,58,128,1392,1365,2757,7,5,202103
9,5,351,5,330,493,67,96,1,1343,1199,2542,7,5,202103
9,6,157,44,179,318,110,35,11,854,753,1607,7,5,202103
9,7,240,8,336,624,3,34,3,1248,1090,2338,9,5,202103
9,8,143,20,284,299,35,40,59,880,757,1637,3,5,202103
9,9,232,4,204,328,76,29,46,919,515,1434,3,5,202103
9,10,111,16,260,257,28,75,3,750,529,1279,3,5,202103
9,11,202,8,252,333,106,58,1,960,1074,2034,7,5,202103
9,12,216,25,440,557,73,94,24,1429,1580,3009,8,5,202103
9,13,152,20,207,233,106,35,47,800,745,1545,4,5,202103
9,14,206,9,199,286,43,42,103,888,711,1599,5,5,202103
9,15,191,24,626,540,65,83,97,1626,1559,3185,6,5,202103
9,16,378,126,475,805,33,38,8,1863,1871,3734,11,5,202103
9,17,216,11,421,335,55,18,5,1061,1027,2088,6,5,202103
9,18,246,9,315,461,121,81,67,1300,845,2145,8,5,202103
9,19,270,33,273,316,94,59,47,1092,918,2010,3,5,202103
9,20,164,4,139,213,88,19,34,661,528,1189,3,5,202103
9,21,148,5,146,235,36,21,37,628,676,1304,3,5,202103
9,22,245,7,175,243,115,48,53,886,682,1568,2,5,202103
9,23,215,14,406,381,90,77,36,1219,986,2205,6,5,202103
9,24,404,28,606,802,233,127,6,2206,2367,4573,11,5,202103
10,1,485,62,509,575,71,34,239,1975,675,2650,17,4.666666667,202103
10,2,400,25,310,580,13,42,13,1383,1255,2638,8,4.75,202103
10,3,396,27,235,314,92,93,128,1285,1324,2609,9,5,202103
10,4,443,49,484,912,18,63,7,1976,1759,3735,11,5,202103
11,1,373,75,312,291,82,78,71,1282,859,2141,6,5,202103
11,2,347,41,316,268,71,207,45,1295,1259,2554,7,5,202103
11,3,214,26,204,213,25,32,35,749,688,1437,3,5,202103
11,4,316,79,376,424,90,65,16,1366,914,2280,7,5,202103
11,5,481,105,456,575,27,92,64,1800,1286,3086,7,5,202103
11,6,245,29,316,276,34,67,60,1027,1377,2404,8,5,202103
11,7,472,51,541,579,49,75,15,1782,1129,2911,9,5,202103
11,8,389,62,418,600,157,62,52,1740,1326,3066,9,5,202103
11,9,370,102,418,465,7,42,50,1454,1618,3072,8,3.333333333,202103
11,10,347,63,323,325,76,210,115,1459,1451,2910,10,5,202103
11,11,289,42,349,367,11,43,5,1106,918,2024,5,5,202103
11,12,364,116,492,504,30,44,23,1573,1039,2612,7,5,202103
11,13,215,51,171,181,54,35,37,744,348,1092,5,3.75,202103
11,14,274,58,359,353,59,32,2,1137,1195,2332,8,5,202103
11,15,312,56,329,328,31,55,149,1260,986,2246,7,5,202103
12,1,383,92,471,249,125,196,69,1585,785,2370,10,5,202103
12,2,381,45,491,714,10,67,72,1780,1643,3423,10,5,202103
12,3,467,65,539,778,29,52,2,1932,978,2910,11,5,202103
12,4,347,26,532,789,105,65,28,1892,1311,3203,9,5,202103
12,5,265,33,300,298,5,23,135,1059,1303,2362,10,5,202103
12,6,393,19,319,559,23,20,40,1373,1439,2812,10,5,202103
12,7,341,25,394,642,3,44,70,1519,1091,2610,6,5,202103
12,8,388,21,339,510,1,44,4,1307,882,2189,9,5,202103
12,9,342,30,575,1076,58,38,13,2132,1080,3212,9,5,202103
13,1,395,18,257,522,88,43,149,1472,1422,2894,9,5,202103
13,2,256,16,141,204,137,271,52,1077,961,2038,6,5,202103
13,3,398,26,331,447,260,62,45,1569,1387,2956,11,5,202103
13,4,432,26,325,435,128,39,190,1575,1319,2894,8,5,202103
13,5,514,27,381,396,116,91,116,1641,1720,3361,9,5,202103
13,6,578,57,600,660,39,86,136,2156,2030,4186,11,5,202103
13,7,423,30,538,617,57,37,7,1709,1045,2754,8,5,202103
14,1,207,41,253,113,111,15,33,773,479,1252,6,5,202103
14,2,225,22,260,240,57,65,5,874,801,1675,5,5,202103
14,3,394,34,545,240,27,130,39,1409,1344,2753,8,5,202103
14,4,397,40,689,524,29,64,47,1790,1477,3267,10,5,202103
14,5,304,35,654,408,45,63,1,1510,1098,2608,9,5,202103
14,6,414,32,588,380,24,109,25,1572,1126,2698,9,5,202103
14,7,231,12,290,264,0,28,6,831,538,1369,6,5,202103
14,8,485,47,922,771,3,65,21,2314,2077,4391,10,5,202103
14,9,304,13,433,614,18,38,45,1465,1348,2813,9,5,202103
14,10,272,29,516,228,22,57,37,1161,1167,2328,6,5,202103
14,11,180,10,211,192,40,50,136,819,1041,1860,5,5,202103
14,12,413,18,532,350,24,30,7,1374,1080,2454,9,5,202103
14,13,278,19,379,258,7,34,45,1020,1025,2045,6,5,202103
14,14,273,33,320,396,36,83,58,1199,870,2069,7,5,202103
14,15,372,62,455,387,142,85,111,1614,1237,2851,10,5,202103
14,16,226,33,315,299,14,52,34,973,840,1813,5,5,202103
14,17,229,31,290,131,37,155,6,879,681,1560,7,5,202103
14,18,384,53,474,302,172,80,132,1597,1391,2988,8,5,202103
14,19,290,52,521,390,55,66,57,1431,983,2414,8,5,202103
14,20,443,44,673,501,3,78,5,1747,1458,3205,10,5,202103
15,1,315,7,229,146,282,18,28,1025,737,1762,7,5,202103
15,2,223,8,258,250,154,9,15,917,683,1600,6,5,202103
15,3,409,19,255,311,331,61,148,1534,1496,3030,10,5,202103
15,4,257,8,158,291,29,29,29,801,554,1355,4,5,202103
15,5,328,26,319,391,49,29,88,1230,918,2148,8,5,202103
15,6,254,5,293,406,18,43,90,1109,925,2034,8,5,202103
15,7,223,14,718,10,70,9,0,1044,872,1916,10,5,202103
15,8,171,20,130,249,15,24,81,690,518,1208,4,5,202103
15,9,304,14,205,171,155,69,28,946,738,1684,9,5,202103
15,10,230,5,215,307,34,36,37,864,685,1549,6,5,202103
15,11,244,14,282,453,69,41,16,1119,947,2066,8,5,202103
15,12,374,15,481,445,57,45,3,1420,1149,2569,8,5,202103
15,13,126,15,148,207,128,45,15,684,780,1464,8,5,202103
15,14,167,8,126,297,30,40,29,697,642,1339,4,5,202103
15,15,186,74,158,271,56,23,66,834,682,1516,6,5,202103
15,16,378,32,322,698,23,50,89,1592,1376,2968,8,5,202103
15,17,204,20,173,227,32,51,136,843,1088,1931,8,5,202103
15,18,342,18,456,441,45,74,41,1417,1156,2573,7,5,202103
15,19,329,50,366,944,14,58,39,1800,1288,3088,9,5,202103
15,20,121,18,293,231,17,21,25,726,814,1540,6,5,202103
15,21,209,7,132,209,35,174,20,786,538,1324,6,5,202103
15,22,376,53,485,701,28,88,114,1845,1784,3629,14,5,202103
15,23,312,15,228,431,17,57,51,1111,700,1811,6,5,202103
15,24,195,24,174,251,38,63,17,762,571,1333,4,5,202103
15,25,245,27,223,286,45,37,52,915,741,1656,6,5,202103
15,26,321,5,260,389,121,25,39,1160,892,2052,8,5,202103
15,27,303,18,367,329,17,54,154,1242,1006,2248,9,5,202103
15,28,399,21,581,452,41,42,35,1571,916,2487,9,5,202103
15,29,314,20,376,610,8,123,73,1524,1506,3030,7,5,202103
15,30,417,46,407,455,71,131,88,1615,1303,2918,15,5,202103
15,31,262,94,246,439,27,34,9,1111,998,2109,6,5,202103
15,32,313,19,240,453,32,68,41,1166,873,2039,9,5,202103
15,33,297,21,375,393,44,44,2,1176,795,1971,7,5,202103
15,34,201,9,243,418,14,24,9,918,822,1740,8,5,202103
15,35,406,12,261,602,9,49,36,1375,1080,2455,9,5,202103
15,36,399,37,322,659,68,37,14,1536,1374,2910,9,5,202103
15,37,273,16,333,437,85,66,63,1273,1014,2287,7,5,202103
15,38,311,30,302,326,70,29,42,1110,773,1883,6,5,202103
15,39,285,23,218,259,33,40,37,895,901,1796,4,5,202103
15,40,447,36,313,426,163,36,15,1436,1409,2845,9,4.666666667,202103
15,41,422,13,631,584,80,64,103,1897,1540,3437,13,5,202103
16,1,283,46,655,402,31,20,4,1441,1548,2989,7,5,202103
16,2,230,48,281,361,28,53,48,1049,653,1702,9,5,202103
16,3,330,32,390,463,39,67,12,1333,1099,2432,10,5,202103
16,4,279,44,353,298,92,63,21,1150,648,1798,8,5,202103
16,5,201,22,209,347,45,40,21,885,695,1580,10,5,202103
16,6,335,65,401,364,110,92,11,1378,983,2361,12,5,202103
16,7,393,66,554,504,81,73,14,1685,1410,3095,9,5,202103
16,8,427,27,709,664,20,37,36,1920,1762,3682,12,5,202103
16,9,294,29,266,345,12,262,52,1260,1200,2460,9,5,202103
16,10,233,24,442,403,18,75,3,1198,979,2177,6,5,202103
16,11,326,34,387,355,168,95,29,1394,1141,2535,10,5,202103
16,12,374,33,508,264,50,112,6,1347,590,1937,10,5,202103
17,1,258,31,435,633,30,46,48,1481,1417,2898,8,5,202103
17,2,329,23,471,646,15,55,107,1646,1237,2883,9,5,202103
17,3,399,33,546,632,39,81,36,1766,1418,3184,8,5,202103
17,4,397,21,519,636,50,53,129,1805,1577,3382,10,5,202103
17,5,180,11,182,234,25,30,4,666,457,1123,5,5,202103
18,1,247,23,233,342,67,31,48,991,851,1842,7,5,202103
18,2,351,40,494,677,75,80,48,1765,1530,3295,8,5,202103
18,3,264,31,532,417,12,42,33,1331,872,2203,8,5,202103
19,1,356,16,498,521,20,104,102,1617,1477,3094,9,5,202103
19,2,385,19,514,466,28,57,20,1489,1100,2589,9,5,202103
19,3,455,19,652,378,57,153,42,1756,731,2487,7,5,202103
19,4,286,9,292,190,93,60,176,1106,835,1941,5,5,202103
19,5,522,46,595,533,34,92,196,2018,1817,3835,8,5,202103
19,6,227,10,488,504,7,67,96,1399,1290,2689,5,5,202103
19,7,452,18,829,595,16,96,15,2021,1130,3151,10,5,202103
19,8,212,13,343,402,13,41,4,1028,671,1699,7,5,202103
19,9,441,31,517,437,61,159,50,1696,831,2527,9,4.75,202103
19,10,228,13,351,319,11,66,131,1119,1057,2176,5,5,202103
19,11,582,51,552,889,15,129,165,2383,2080,4463,13,5,202103
19,12,459,15,830,312,21,36,7,1680,1222,2902,13,5,202103
20,1,294,16,304,232,136,33,132,1147,654,1801,7,5,202103
20,2,338,36,455,373,52,25,1,1280,527,1807,6,5,202103
20,3,250,7,240,143,153,49,115,957,900,1857,6,4.333333333,202103
20,4,245,13,207,239,54,74,136,968,789,1757,6,5,202103
20,5,219,4,298,591,47,16,1,1176,737,1913,11,5,202103
20,6,474,13,334,238,191,55,105,1410,1141,2551,8,5,202103
20,7,356,10,428,587,46,39,42,1508,813,2321,7,5,202103
20,8,554,26,745,987,50,67,140,2569,1805,4374,13,5,202103
20,9,429,20,391,364,256,67,97,1624,991,2615,8,5,202103
20,10,450,17,613,375,92,33,13,1593,703,2296,9,5,202103
21,1,422,18,487,479,29,32,15,1482,1234,2716,9,5,202103
21,2,291,16,342,275,126,34,12,1096,954,2050,9,5,202103
21,3,457,22,429,266,144,74,105,1497,1041,2538,8,5,202103
21,4,258,9,201,152,119,65,50,854,777,1631,6,5,202103
21,5,376,19,567,458,44,65,88,1617,1448,3065,7,5,202103
21,6,288,12,250,220,41,252,9,1072,652,1724,5,5,202103
21,7,381,11,252,390,67,174,24,1299,946,2245,9,5,202103
21,8,444,15,531,295,103,107,123,1618,905,2523,9,5,202103
21,9,356,16,450,422,97,85,125,1551,1069,2620,8,5,202103
21,10,263,14,253,251,27,78,136,1022,930,1952,5,5,202103
21,11,177,5,292,178,30,19,25,726,667,1393,4,5,202103
21,12,619,32,957,754,87,112,329,2890,2312,5202,15,5,202103
21,13,310,15,351,328,75,74,33,1186,1142,2328,7,5,202103
21,14,191,12,220,172,104,65,66,830,665,1495,8,5,202103
21,15,456,10,320,276,56,154,130,1402,946,2348,7,5,202103
22,1,461,104,441,585,30,37,15,1673,827,2500,11,5,202103
22,2,312,33,464,400,115,81,8,1413,1057,2470,7,5,202103
22,3,471,38,842,658,25,61,22,2117,1632,3749,9,5,202103
22,4,313,51,660,577,29,53,30,1713,1436,3149,8,5,202103
22,5,434,31,735,478,100,76,57,1911,1365,3276,10,5,202103
23,1,391,7,1047,225,60,42,50,1822,1592,3414,14,5,202103
23,2,344,19,591,374,30,25,33,1416,957,2373,10,5,202103
23,3,590,42,1542,832,89,39,63,3197,2010,5207,19,5,202103
23,4,193,4,435,202,38,209,19,1100,971,2071,6,5,202103
24,1,360,33,327,361,19,38,60,1198,870,2068,10,5,202103
24,2,210,40,219,172,27,38,35,741,710,1451,6,5,202103
24,3,299,56,294,273,101,40,13,1076,747,1823,9,5,202103
24,4,219,24,245,256,47,40,133,964,851,1815,5,5,202103
24,5,475,62,753,698,10,52,2,2052,1659,3711,9,5,202103
24,6,447,150,578,466,32,45,3,1721,1056,2777,6,5,202103
24,7,369,44,383,408,63,24,1,1292,771,2063,9,5,202103
25,1,371,12,488,419,43,76,302,1711,1053,2764,10,5,202103
25,2,290,40,319,554,8,16,3,1230,836,2066,5,5,202103
25,3,345,10,336,580,52,51,94,1468,1033,2501,7,5,202103
25,4,310,25,402,721,85,26,2,1571,1083,2654,8,5,202103
25,5,396,12,599,890,45,51,90,2083,1571,3654,8,5,202103
25,6,340,12,412,391,71,67,144,1437,1070,2507,6,5,202103
25,7,336,12,513,627,4,22,0,1514,1067,2581,5,5,202103
26,1,316,11,445,585,5,71,20,1453,956,2409,9,5,202103
26,2,452,21,526,814,8,64,27,1912,1772,3684,12,5,202103
26,3,384,14,427,529,15,79,83,1531,1497,3028,13,5,202103
26,4,245,5,293,305,81,46,2,977,657,1634,9,4.4,202103
26,5,310,18,428,563,44,85,9,1457,1241,2698,14,5,202103
26,6,284,27,320,442,20,114,18,1225,1154,2379,10,5,202103
26,7,331,37,297,501,126,48,21,1361,879,2240,10,5,202103
27,1,396,13,416,466,109,51,18,1469,1372,2841,8,5,202103
27,2,294,21,296,496,13,27,60,1207,1021,2228,8,5,202103
27,3,336,13,278,626,7,29,82,1371,1084,2455,6,5,202103
27,4,295,6,352,399,21,286,4,1363,1090,2453,7,5,202103
27,5,316,2,236,359,21,147,5,1086,898,1984,6,5,202103
27,6,341,11,356,613,3,36,10,1370,1128,2498,7,5,202103
28,1,368,37,764,694,8,37,8,1916,1025,2941,10,5,202103
28,2,470,50,848,528,48,95,374,2413,1662,4075,13,5,202103
28,3,248,23,305,230,14,43,147,1010,653,1663,8,5,202103
28,4,478,36,719,417,110,97,238,2095,2451,4546,13,5,202103
28,5,447,48,863,325,73,163,67,1986,1674,3660,10,5,202103
28,6,295,38,440,446,44,40,78,1381,951,2332,13,5,202103
28,7,336,25,476,359,58,35,228,1517,1580,3097,9,5,202103
28,8,340,21,436,311,54,223,57,1442,1178,2620,12,5,202103
28,9,224,9,384,142,18,223,22,1022,517,1539,6,5,202103
29,1,487,40,521,719,85,66,53,1971,1513,3484,10,5,202103
29,2,523,16,454,487,44,92,341,1957,1424,3381,10,5,202103
29,3,274,16,271,442,38,61,3,1105,1070,2175,4,5,202103
30,1,197,24,382,280,66,26,50,1025,750,1775,7,5,202103
30,2,352,19,342,169,114,35,290,1321,749,2070,10,5,202103
30,3,245,7,440,167,143,46,172,1220,1075,2295,6,5,202103
30,4,218,5,370,301,57,57,3,1011,654,1665,8,5,202103
30,5,309,12,597,511,18,60,6,1513,1057,2570,9,5,202103
30,6,263,10,330,250,39,28,33,953,653,1606,9,4,202103
30,7,404,16,388,294,152,43,52,1349,1291,2640,11,5,202103
30,8,381,18,625,408,115,71,53,1671,1356,3027,11,5,202103
30,9,370,8,427,306,104,43,254,1512,1228,2740,8,5,202103
30,10,298,22,547,441,49,51,206,1614,1221,2835,6,5,202103
30,11,347,19,798,717,22,41,7,1951,940,2891,9,5,202103
30,12,335,12,758,769,59,63,5,2001,1644,3645,10,5,202103
30,13,375,23,415,372,223,76,273,1757,1155,2912,10,5,202103
30,14,293,15,440,343,119,50,149,1409,873,2282,8,5,202103
30,15,413,19,391,369,176,114,280,1762,1028,2790,11,5,202103
30,16,344,14,457,363,99,65,372,1714,1453,3167,10,5,202103
30,17,394,22,599,661,57,71,61,1865,869,2734,8,5,202103
30,18,371,13,269,387,84,110,102,1336,832,2168,8,5,202103
30,19,339,17,720,302,201,20,0,1599,858,2457,11,5,202103
30,20,271,12,356,718,127,48,8,1540,749,2289,8,5,202103
31,1,437,17,534,72,340,24,4,1428,1100,2528,8,5,202103
31,2,227,4,266,29,273,31,1,831,619,1450,6,5,202103
31,3,877,46,1335,1112,134,82,10,3596,2189,5785,18,5,202103
31,4,264,12,393,128,231,42,73,1143,769,1912,4,5,202103
31,5,458,14,470,234,38,42,23,1279,416,1695,6,5,202103
32,1,438,72,367,398,73,100,164,1612,901,2513,12,4.6,202103
32,2,420,55,386,312,139,88,121,1521,943,2464,13,5,202103
32,3,398,90,386,597,14,56,128,1669,998,2667,13,5,202103
32,4,518,83,493,580,41,72,66,1853,1180,3033,12,5,202103
1,1,455,90,616,569,99,193,75,2097,1772,3869,13,5,202104
1,2,508,93,825,555,83,86,144,2294,2252,4546,8,5,202104
1,3,382,109,788,603,67,89,153,2191,2093,4284,7,5,202104
2,1,357,11,460,430,28,241,82,1609,1532,3141,9,5,202104
2,2,316,21,342,615,10,75,2,1381,1065,2446,5,5,202104
2,3,445,18,549,452,21,162,113,1760,1145,2905,10,5,202104
2,4,294,12,505,182,65,36,65,1159,1085,2244,8,5,202104
2,5,507,15,798,469,253,128,65,2235,1916,4151,10,5,202104
2,6,329,15,419,392,53,109,70,1387,1222,2609,7,5,202104
2,7,420,26,558,412,54,118,106,1694,1737,3431,12,5,202104
2,8,282,6,419,301,32,66,138,1244,1050,2294,4,5,202104
3,1,323,16,497,519,29,55,77,1516,1389,2905,11,4.166666667,202104
3,2,267,12,738,351,70,24,21,1483,1267,2750,8,5,202104
4,1,490,25,584,593,247,84,176,2199,1965,4164,11,5,202104
4,2,537,25,685,556,166,64,225,2258,1792,4050,14,5,202104
5,1,467,19,500,564,58,84,69,1761,1549,3310,9,5,202104
5,2,398,31,503,523,55,86,58,1654,1175,2829,10,5,202104
5,3,359,19,406,573,88,59,35,1539,1142,2681,11,5,202104
5,4,611,59,899,869,28,72,205,2743,2131,4874,11,5,202104
5,5,495,29,412,362,19,594,10,1921,1610,3531,10,5,202104
5,6,302,21,418,281,15,129,141,1307,1103,2410,9,5,202104
5,7,351,33,336,440,56,47,47,1310,1099,2409,10,5,202104
6,1,395,28,714,444,43,77,259,1960,1851,3811,12,5,202104
6,2,268,13,486,252,69,51,142,1281,867,2148,8,5,202104
7,1,352,9,376,223,14,46,0,1020,675,1695,9,5,202104
7,2,539,6,290,1245,101,23,0,2204,962,3166,9,5,202104
7,3,373,3,319,181,166,44,11,1097,675,1772,7,5,202104
7,4,601,49,487,453,10,100,90,1790,1139,2929,11,5,202104
7,5,473,44,271,609,46,36,8,1487,1029,2516,11,5,202104
7,6,390,10,506,419,71,113,69,1578,1385,2963,8,5,202104
7,7,452,12,546,416,125,155,17,1723,1189,2912,8,5,202104
7,8,516,80,329,487,60,57,8,1537,1039,2576,12,5,202104
7,9,334,39,356,403,57,111,11,1311,1103,2414,9,5,202104
7,10,334,6,453,957,277,30,1,2058,743,2801,9,5,202104
7,11,246,7,201,240,66,26,1,787,450,1237,6,5,202104
7,12,488,8,544,685,9,34,21,1789,1011,2800,9,5,202104
7,13,292,19,393,801,4,31,3,1543,472,2015,9,4.75,202104
8,1,255,5,426,218,2,11,0,917,578,1495,4,5,202104
8,2,594,105,954,811,19,63,11,2557,1546,4103,16,5,202104
8,3,342,39,448,493,36,58,197,1613,1216,2829,4,5,202104
8,4,333,56,737,633,62,100,219,2140,1801,3941,11,5,202104
8,5,287,74,397,508,23,16,19,1324,410,1734,8,3.75,202104
8,6,390,46,484,476,38,69,112,1615,1493,3108,7,5,202104
8,7,360,71,428,521,15,56,6,1457,867,2324,7,5,202104
8,8,517,56,715,1002,8,93,11,2402,2317,4719,10,5,202104
8,9,494,54,433,429,97,141,119,1767,1230,2997,10,5,202104
9,1,124,9,129,122,79,21,20,504,456,960,4,5,202104
9,2,415,24,488,717,115,90,13,1862,2746,4608,9,5,202104
9,3,146,6,215,308,26,34,45,780,820,1600,4,5,202104
9,4,328,18,306,590,56,52,108,1458,1444,2902,7,5,202104
9,5,339,4,367,550,62,116,0,1438,1370,2808,7,5,202104
9,6,205,22,180,314,100,36,4,861,845,1706,7,5,202104
9,7,230,14,432,628,7,34,0,1345,1442,2787,9,5,202104
9,8,145,21,258,273,49,47,51,844,890,1734,3,5,202104
9,9,278,5,192,297,37,32,41,882,898,1780,3,5,202104
9,10,128,19,244,269,26,91,1,778,530,1308,3,5,202104
9,11,206,6,276,338,137,70,1,1034,1203,2237,7,5,202104
9,12,206,59,484,587,53,70,25,1484,1601,3085,8,5,202104
9,13,197,16,219,235,81,24,50,822,771,1593,4,5,202104
9,14,188,5,220,247,59,35,102,856,1205,2061,5,5,202104
9,15,241,12,695,538,71,122,114,1793,1547,3340,8,5,202104
9,16,385,106,457,777,36,39,2,1802,1990,3792,11,5,202104
9,17,229,12,356,385,44,35,1,1062,1109,2171,6,5,202104
9,18,255,20,304,466,120,78,58,1301,951,2252,8,5,202104
9,19,235,41,296,352,112,65,61,1162,943,2105,3,5,202104
9,20,116,5,143,125,60,20,48,517,476,993,3,5,202104
9,21,149,12,169,227,48,14,30,649,741,1390,3,5,202104
9,22,157,8,90,145,52,22,28,502,611,1113,3,5,202104
9,23,187,17,409,366,83,83,41,1186,1267,2453,6,5,202104
9,24,407,30,656,874,218,86,3,2274,2307,4581,11,5,202104
10,1,561,68,606,662,82,35,235,2249,1312,3561,17,4.5,202104
10,2,529,42,502,797,31,76,26,2003,1025,3028,8,5.25,202104
10,3,424,35,321,515,88,86,173,1642,994,2636,11,5,202104
10,4,475,73,511,936,16,69,15,2095,1672,3767,11,5,202104
11,1,433,78,325,256,86,80,59,1317,1243,2560,6,5,202104
11,2,365,58,361,315,68,216,23,1406,1195,2601,7,5,202104
11,3,201,31,191,207,44,23,23,720,706,1426,3,5,202104
11,4,368,102,343,470,99,41,17,1440,1179,2619,7,5,202104
11,5,473,90,520,613,33,99,78,1906,1637,3543,7,5,202104
11,6,262,32,287,270,30,49,46,976,1361,2337,8,5,202104
11,7,445,57,566,642,38,64,17,1829,1459,3288,9,5,202104
11,8,382,79,429,609,174,151,34,1858,1602,3460,9,5,202104
11,9,158,36,127,215,0,31,1,568,443,1011,4,1.666666667,202104
11,10,417,83,441,508,46,199,121,1815,1786,3601,10,5,202104
11,11,288,39,333,435,15,48,7,1165,1012,2177,5,5,202104
11,12,411,100,477,478,41,43,50,1600,1529,3129,7,5,202104
11,13,296,68,275,305,44,42,124,1154,712,1866,8,5,202104
11,14,269,55,351,316,88,35,4,1118,972,2090,8,5,202104
11,15,353,52,387,354,39,70,175,1430,1229,2659,7,5,202104
12,1,509,98,509,247,183,198,115,1859,1113,2972,10,5,202104
12,2,400,34,460,655,20,51,50,1670,1743,3413,10,5,202104
12,3,404,39,597,775,33,45,5,1898,1370,3268,11,5,202104
12,4,298,22,520,731,78,45,25,1719,1730,3449,9,5,202104
12,5,380,34,346,366,9,21,130,1286,1053,2339,10,5,202104
12,6,419,27,308,457,22,19,12,1264,1112,2376,10,5,202104
12,7,348,25,419,602,18,36,66,1514,1471,2985,6,5,202104
12,8,497,21,385,551,8,43,1,1506,801,2307,9,5,202104
12,9,381,29,617,861,92,65,15,2060,1757,3817,9,5,202104
13,1,440,19,307,563,99,31,232,1691,1337,3028,9,5,202104
13,2,264,20,163,224,125,276,34,1106,743,1849,6,5.333333333,202104
13,3,438,35,405,468,188,61,48,1643,1470,3113,11,5,202104
13,4,430,25,421,455,149,51,210,1741,1543,3284,8,6,202104
13,5,494,29,493,463,119,79,179,1856,1560,3416,9,6.25,202104
13,6,626,55,584,712,36,65,107,2185,2123,4308,11,5,202104
13,7,415,28,603,664,55,49,4,1818,1693,3511,8,5,202104
14,1,132,50,213,102,47,27,12,583,438,1021,5,4,202104
14,2,274,25,262,219,66,77,0,923,887,1810,5,5.333333333,202104
14,3,402,29,520,285,31,84,52,1403,1312,2715,8,5,202104
14,4,416,35,693,493,23,68,67,1795,1404,3199,10,5,202104
14,5,273,24,675,367,25,70,8,1442,1312,2754,9,5,202104
14,6,400,28,635,393,18,60,14,1548,1501,3049,9,5,202104
14,7,241,23,273,245,0,19,5,806,756,1562,6,5,202104
14,8,475,28,840,806,8,85,9,2251,2007,4258,10,5,202104
14,9,312,20,456,595,17,42,42,1484,1377,2861,9,5,202104
14,10,272,41,462,223,11,66,22,1097,1063,2160,6,5,202104
14,11,283,14,341,300,57,72,150,1217,793,2010,5,5,202104
14,12,448,28,526,302,38,24,1,1367,1337,2704,9,5,202104
14,13,301,21,345,293,12,43,20,1035,651,1686,6,5,202104
14,14,248,18,329,373,51,44,98,1161,1155,2316,7,5,202104
14,15,398,71,494,361,130,91,118,1663,1400,3063,10,5,202104
14,16,226,18,288,283,19,47,35,916,850,1766,5,5,202104
14,17,263,24,350,122,37,126,9,931,655,1586,7,5,202104
14,18,429,54,554,308,167,86,144,1742,1313,3055,8,5,202104
14,19,372,49,553,347,56,52,56,1485,1265,2750,8,5,202104
14,20,471,32,687,540,5,63,3,1801,1584,3385,10,5,202104
15,1,331,6,225,126,362,33,23,1106,1019,2125,7,5,202104
15,2,216,12,281,221,124,22,26,902,899,1801,6,5,202104
15,3,427,14,216,392,312,35,144,1540,1238,2778,10,5,202104
15,4,244,12,154,297,35,28,28,798,776,1574,4,5,202104
15,5,322,28,298,363,54,37,90,1192,1148,2340,8,5,202104
15,6,247,8,315,423,26,33,91,1143,911,2054,8,5,202104
15,7,240,16,681,5,55,4,0,1001,1007,2008,10,5,202104
15,8,152,9,136,214,20,22,53,606,683,1289,4,5,202104
15,9,293,11,179,135,149,73,32,872,963,1835,9,5,202104
15,10,217,2,239,313,19,32,52,874,884,1758,6,5,202104
15,11,253,16,263,343,54,40,14,983,1049,2032,8,5,202104
15,12,349,12,512,423,55,23,4,1378,1295,2673,8,5,202104
15,13,134,10,145,187,122,45,24,667,731,1398,8,5,202104
15,14,154,12,168,257,41,39,29,700,732,1432,4,5,202104
15,15,175,73,227,248,57,23,47,850,752,1602,6,5,202104
15,16,340,26,335,731,24,43,58,1557,1637,3194,8,5,202104
15,17,191,12,200,251,31,52,111,848,752,1600,8,5,202104
15,18,376,22,419,419,40,76,31,1383,1249,2632,7,5,202104
15,19,335,46,374,845,8,57,39,1704,1318,3022,9,5,202104
15,20,136,8,236,193,34,22,31,660,714,1374,6,5,202104
15,21,239,9,159,210,39,156,12,824,697,1521,6,5,202104
15,22,379,66,501,753,29,127,100,1955,1784,3739,14,5,202104
15,23,311,10,214,433,20,64,33,1085,902,1987,6,5,202104
15,24,180,30,175,219,44,74,4,726,460,1186,4,5,202104
15,25,217,26,222,249,46,39,65,864,956,1820,6,5,202104
15,26,311,11,280,354,138,42,36,1172,1094,2266,8,5,202104
15,27,366,16,448,371,19,59,186,1465,1143,2608,9,5,202104
15,28,385,27,572,414,46,47,61,1552,1805,3357,9,5,202104
15,29,357,25,406,710,8,109,65,1680,1538,3218,7,5,202104
15,30,427,52,411,425,61,171,82,1629,1494,3123,15,5,202104
15,31,232,101,205,457,14,33,8,1050,1085,2135,6,5,202104
15,32,348,15,260,437,60,87,45,1252,1104,2356,9,5,202104
15,33,278,27,355,354,42,26,2,1084,1428,2512,7,5,202104
15,34,252,11,251,439,18,37,13,1021,906,1927,8,5,202104
15,35,372,17,242,525,9,68,31,1264,1280,2544,9,5,202104
15,36,372,12,326,596,55,49,16,1426,1675,3101,9,5,202104
15,37,338,16,333,459,104,71,66,1387,1305,2692,7,5,202104
15,38,299,30,309,283,75,33,29,1058,919,1977,6,5,202104
15,39,239,27,207,248,39,52,22,834,857,1691,4,5,202104
15,40,488,53,381,570,208,49,14,1763,1406,3169,9,5,202104
15,41,427,27,662,524,102,54,106,1902,1977,3879,13,5,202104
16,1,233,22,443,263,22,16,5,1004,853,1857,5,3.333333333,202104
16,2,223,42,210,356,15,52,71,969,715,1684,9,5,202104
16,3,429,33,442,548,54,98,34,1638,1435,3073,10,5,202104
16,4,281,32,282,277,107,64,28,1071,969,2040,8,5,202104
16,5,287,27,243,237,63,36,101,994,1058,2052,10,5,202104
16,6,375,93,419,346,102,97,9,1441,1117,2558,12,5,202104
16,7,388,78,559,527,85,74,13,1724,1502,3226,9,5,202104
16,8,458,36,759,767,18,52,54,2144,1875,4019,12,5,202104
16,9,366,42,412,590,43,95,47,1595,1269,2864,9,5,202104
16,10,257,25,459,419,13,55,1,1229,1278,2507,6,5,202104
16,11,530,28,459,413,218,94,31,1773,1374,3147,10,5,202104
16,12,272,41,522,278,23,106,10,1252,784,2036,10,5,202104
17,1,287,21,444,582,27,57,51,1469,1491,2960,8,5,202104
17,2,355,20,541,632,9,54,100,1711,1580,3291,9,5,202104
17,3,502,21,555,553,37,77,17,1762,1886,3648,8,5,202104
17,4,406,32,659,631,51,70,87,1936,1903,3839,10,5,202104
17,5,167,15,213,283,26,38,13,755,608,1363,5,5,202104
18,1,315,26,327,473,105,41,63,1350,811,2161,7,6,202104
18,2,458,36,698,849,71,91,78,2281,1697,3978,8,6,202104
18,3,371,36,726,498,14,34,49,1728,1033,2761,8,6,202104
19,1,378,24,545,533,16,92,123,1711,1731,3442,9,5,202104
19,2,448,16,536,499,7,57,0,1563,1260,2823,9,5,202104
19,3,475,21,684,411,60,161,40,1852,944,2796,7,5,202104
19,4,258,9,284,201,101,82,204,1139,1186,2325,5,5,202104
19,5,589,52,623,603,30,90,153,2140,2157,4297,8,5,202104
19,6,246,13,498,472,11,90,124,1454,1516,2970,5,5,202104
19,7,523,17,889,671,16,82,9,2207,1874,4081,10,5,202104
19,8,203,9,370,388,10,42,1,1023,822,1845,7,5,202104
19,9,400,36,534,534,57,133,43,1737,1075,2812,9,5,202104
19,10,229,15,345,351,9,70,131,1150,1171,2321,5,5,202104
19,11,607,39,718,1003,8,143,193,2711,2972,5683,13,5,202104
19,12,487,17,944,301,14,33,12,1808,735,2543,13,5,202104
20,1,362,16,324,228,137,39,151,1257,829,2086,7,5,202104
20,2,326,32,542,425,54,14,0,1393,657,2050,6,5,202104
20,3,162,5,153,127,77,22,84,630,880,1510,4,3.333333333,202104
20,4,171,16,196,142,98,56,111,790,619,1409,6,5,202104
20,5,398,20,438,527,45,43,3,1474,908,2382,11,5,202104
20,6,354,9,270,198,215,75,77,1198,1260,2458,8,5,202104
20,7,388,26,511,681,36,39,42,1723,891,2614,7,5,202104
20,8,562,13,764,798,59,59,93,2348,2592,4940,13,5,202104
20,9,469,23,445,406,292,41,103,1779,1198,2977,8,5,202104
20,10,446,21,485,441,91,27,12,1523,1136,2659,9,5,202104
21,1,499,20,567,529,33,51,7,1706,1287,2993,9,5,202104
21,2,313,14,443,341,157,41,16,1325,1124,2449,9,5,202104
21,3,499,21,547,325,165,84,103,1744,1368,3112,8,5,202104
21,4,300,10,262,189,138,63,44,1006,552,1558,6,5,202104
21,5,427,18,625,471,47,76,81,1745,1627,3372,7,5,202104
21,6,322,10,237,194,44,248,7,1062,1059,2121,5,5,202104
21,7,389,13,248,326,99,176,21,1272,1031,2303,9,5,202104
21,8,482,22,680,315,79,114,145,1837,885,2722,9,5,202104
21,9,369,18,562,420,125,84,117,1695,1538,3233,8,5,202104
21,10,310,16,272,261,20,99,133,1111,999,2110,5,5,202104
21,11,198,5,339,179,45,20,29,815,730,1545,4,5,202104
21,12,708,34,1060,878,90,89,333,3192,2800,5992,15,6,202104
21,13,326,27,363,300,54,73,14,1157,1202,2359,7,5,202104
21,14,262,11,231,219,130,45,65,963,804,1767,8,5,202104
21,15,462,16,326,319,29,154,117,1423,1178,2601,7,5,202104
22,1,540,107,608,672,32,46,6,2011,1267,3278,11,5,202104
22,2,391,48,471,497,124,53,15,1599,1226,2825,7,5,202104
22,3,577,93,887,817,26,72,35,2507,1894,4401,9,5,202104
22,4,395,52,839,692,33,67,40,2118,1756,3874,8,5,202104
22,5,462,36,882,515,138,128,46,2207,1645,3852,10,5,202104
23,1,380,11,934,259,64,34,44,1726,1703,3429,14,5,202104
23,2,415,22,713,392,53,22,33,1650,1362,3012,10,5,202104
23,3,589,19,1460,912,82,42,72,3176,2848,6024,19,5,202104
23,4,198,8,431,192,56,214,26,1125,1038,2163,6,5,202104
24,1,475,58,397,451,38,55,46,1520,879,2399,10,5,202104
24,2,260,33,230,140,25,31,15,734,656,1390,6,5,202104
24,3,442,63,361,294,116,57,7,1340,581,1921,9,5,202104
24,4,295,23,240,280,40,55,121,1054,893,1947,5,5,202104
24,5,528,59,696,665,11,40,4,2003,1907,3910,9,5,202104
24,6,402,152,465,420,49,33,9,1530,1656,3186,6,5,202104
24,7,495,44,504,526,82,30,0,1681,987,2668,9,5,202104
25,1,345,11,501,419,45,71,307,1699,1412,3111,10,5,202104
25,2,301,53,317,520,10,22,1,1224,1251,2475,5,5,202104
25,3,319,15,374,594,45,43,92,1482,1386,2868,7,5,202104
25,4,280,27,381,581,77,19,1,1366,1059,2425,8,5,202104
25,5,333,21,692,879,46,77,84,2132,1841,3973,8,5,202104
25,6,332,18,465,415,70,55,123,1478,1354,2832,6,5,202104
25,7,342,13,570,677,7,39,2,1650,1484,3134,5,5,202104
26,1,401,18,526,762,11,95,16,1829,672,2501,9,5,202104
26,2,465,19,634,997,7,73,47,2242,1786,4028,12,5,202104
26,3,388,18,426,495,20,84,73,1504,1416,2920,13,5,202104
26,4,213,14,355,327,82,27,3,1021,825,1846,8,4.2,202104
26,5,343,12,476,544,19,94,6,1494,1297,2791,14,5,202104
26,6,402,14,409,604,6,105,14,1554,996,2550,10,5,202104
26,7,333,28,364,521,101,36,38,1421,1132,2553,10,5,202104
27,1,421,16,539,468,133,85,34,1696,1025,2721,8,5,202104
27,2,377,16,328,564,21,43,74,1423,890,2313,8,5,202104
27,3,416,13,305,631,12,40,123,1540,1238,2778,6,5,202104
27,4,400,8,386,488,19,381,8,1690,1026,2716,7,5,202104
27,5,339,10,261,363,14,193,10,1190,747,1937,6,5,202104
27,6,419,23,411,909,8,30,11,1811,1195,3006,7,5,202104
28,1,355,42,811,741,8,49,5,2011,1689,3700,10,5,202104
28,2,523,58,912,446,41,117,439,2536,2209,4745,13,5,202104
28,3,224,22,351,284,19,45,141,1086,938,2024,8,5,202104
28,4,509,53,960,383,78,78,81,2142,2043,4185,13,5,202104
28,5,386,40,748,332,89,152,45,1792,1948,3740,10,5,202104
28,6,304,31,525,611,29,56,93,1649,797,2446,13,5,202104
28,7,307,26,504,394,92,58,269,1650,1572,3222,9,5,202104
28,8,371,24,566,309,49,189,45,1553,1341,2894,12,5,202104
28,9,247,15,409,188,21,244,58,1182,803,1985,6,5,202104
29,1,494,65,567,666,87,70,45,1994,1727,3721,9,5,202104
29,2,526,16,489,562,45,81,265,1984,1769,3753,10,5,202104
29,3,295,28,287,406,18,50,3,1087,1092,2179,5,5,202104
30,1,215,33,410,354,64,29,69,1174,619,1793,7,5.333333333,202104
30,2,405,15,408,185,110,37,366,1526,1396,2922,10,5.25,202104
30,3,250,5,454,272,173,65,185,1404,1302,2706,6,5,202104
30,4,241,7,401,330,63,62,0,1104,935,2039,8,6,202104
30,5,304,16,601,446,11,43,1,1422,1682,3104,9,5,202104
30,6,261,16,419,351,53,35,27,1162,1055,2217,9,5,202104
30,7,432,22,421,338,184,72,90,1559,887,2446,11,5.25,202104
30,8,453,23,662,430,133,88,53,1842,1263,3105,11,5,202104
30,9,441,14,480,339,138,76,258,1746,1273,3019,8,4.75,202104
30,10,332,13,550,335,48,47,200,1525,1370,2895,6,5,202104
30,11,348,35,864,703,24,39,7,2020,1512,3532,9,6.666666667,202104
30,12,461,11,887,891,57,100,19,2426,1774,4200,10,6,202104
30,13,451,16,580,393,216,109,326,2091,1355,3446,10,5.2,202104
30,14,294,13,425,380,136,50,129,1427,1183,2610,8,5.5,202104
30,15,498,16,478,342,175,111,268,1888,1541,3429,11,6,202104
30,16,328,14,431,342,67,74,359,1615,1734,3349,10,5,202104
30,17,528,33,757,908,58,108,69,2461,1421,3882,8,6,202104
30,18,385,15,297,469,115,146,115,1542,782,2324,8,5,202104
30,19,379,27,768,422,280,32,2,1910,790,2700,11,5,202104
30,20,322,20,395,729,128,45,39,1678,1261,2939,8,5,202104
31,1,484,13,633,47,293,38,8,1516,1315,2831,8,5,202104
31,2,271,4,349,20,276,38,5,963,888,1851,6,5,202104
31,3,1135,48,1562,1032,75,92,5,3949,3475,7424,18,5,202104
31,4,305,12,394,94,183,51,70,1109,1115,2224,4,5,202104
31,5,506,13,494,261,51,57,17,1399,770,2169,6,5,202104
32,1,418,90,463,397,63,81,153,1665,1483,3148,12,5,202104
32,2,347,60,439,324,133,64,116,1483,1118,2601,13,4.857142857,202104
32,3,372,98,402,586,17,81,130,1686,1485,3171,13,5,202104
32,4,443,90,469,537,37,84,71,1731,1706,3437,12,5,202104
1,1,519,82,730,581,132,263,61,2368,1990,4358,13,6,202105
1,2,522,93,881,647,112,93,153,2501,2413,4914,8,6,202105
1,3,423,87,1005,593,92,101,165,2466,2185,4651,7,6,202105
2,1,381,26,399,384,34,260,102,1586,1960,3546,9,5,202105
2,2,294,20,367,640,9,78,3,1411,1279,2690,5,5,202105
2,3,360,17,428,375,22,125,109,1436,1291,2727,10,5,202105
2,4,306,7,551,178,53,35,36,1166,1005,2171,8,5,202105
2,5,483,23,708,445,207,139,79,2084,3777,5861,10,5,202105
2,6,318,23,368,344,57,155,83,1348,1142,2490,7,5,202105
2,7,425,27,607,370,44,117,104,1694,1936,3630,12,5,202105
2,8,286,15,349,265,37,69,152,1173,1031,2204,4,5,202105
3,1,392,9,579,488,19,67,99,1653,1524,3177,11,4.833333333,202105
3,2,301,23,796,327,54,18,48,1567,1617,3184,8,5.666666667,202105
4,1,431,27,589,577,267,92,131,2114,1943,4057,11,5,202105
4,2,506,28,728,525,297,71,221,2376,1742,4118,14,5,202105
5,1,560,28,585,645,56,68,95,2037,1876,3913,9,6,202105
5,2,510,49,786,735,102,72,77,2331,1760,4091,10,6,202105
5,3,391,31,518,575,115,77,43,1750,1489,3239,11,6,202105
5,4,681,69,979,866,30,100,236,2961,2353,5314,11,6,202105
5,5,560,37,507,443,14,728,9,2298,1491,3789,10,6,202105
5,6,368,46,516,331,8,130,212,1611,1275,2886,9,6,202105
5,7,419,46,479,476,48,46,71,1585,163,1748,10,6,202105
6,1,397,39,699,414,45,87,230,1911,1838,3749,12,5,202105
6,2,296,16,503,199,61,38,137,1250,1041,2291,8,5,202105
7,1,483,15,500,272,18,60,5,1353,743,2096,9,5,202105
7,2,705,17,398,817,76,20,3,2036,1149,3185,9,5,202105
7,3,419,9,332,157,183,39,11,1150,465,1615,7,5,202105
7,4,390,50,473,496,21,114,65,1609,1291,2900,11,4.2,202105
7,5,619,34,318,581,79,38,7,1676,1329,3005,11,5,202105
7,6,538,17,537,437,59,120,68,1776,1620,3396,8,5,202105
7,7,464,16,606,410,158,143,24,1821,1576,3397,8,5,202105
7,8,630,73,378,559,66,49,21,1776,1012,2788,12,5,202105
7,9,371,22,360,386,57,127,5,1328,1232,2560,9,5,202105
7,10,355,3,453,985,250,30,0,2076,1326,3402,9,5,202105
7,11,271,7,283,185,66,42,3,857,651,1508,6,5.333333333,202105
7,12,582,11,634,720,8,29,29,2013,1648,3661,9,5.5,202105
7,13,258,17,260,361,4,21,7,928,750,1678,9,4,202105
8,1,260,10,414,213,0,26,6,929,969,1898,4,5,202105
8,2,574,117,925,863,29,39,19,2566,2115,4681,16,5,202105
8,3,394,44,540,487,66,60,227,1818,1156,2974,4,5,202105
8,4,409,54,698,626,60,94,184,2125,2187,4312,11,5,202105
8,5,314,87,351,428,27,15,22,1244,1224,2468,9,4,202105
8,6,368,53,523,413,31,56,134,1578,1431,3009,7,5,202105
8,7,394,163,474,817,6,59,20,1933,1143,3076,7,5,202105
8,8,479,68,733,1001,16,69,37,2403,2074,4477,10,5,202105
8,9,537,57,532,401,72,176,174,1949,1280,3229,10,4.8,202105
9,1,152,8,95,122,105,31,40,553,519,1072,4,5,202105
9,2,512,42,616,913,123,111,44,2361,2062,4423,9,5,202105
9,3,170,5,207,313,38,25,51,809,917,1726,4,5,202105
9,4,344,18,342,537,65,61,98,1465,1493,2958,7,5,202105
9,5,359,3,367,586,63,97,1,1476,1409,2885,7,5,202105
9,6,182,24,217,273,115,23,10,844,1125,1969,7,5,202105
9,7,232,17,398,698,9,51,4,1409,1479,2888,9,5,202105
9,8,147,12,308,340,10,46,40,903,898,1801,3,5,202105
9,9,242,8,202,316,45,33,77,923,1389,2312,3,5,202105
9,10,147,7,246,248,38,58,16,760,564,1324,3,5,202105
9,11,206,18,313,393,122,60,3,1115,2061,3176,7,5,202105
9,12,226,40,510,617,59,99,10,1561,1730,3291,8,5,202105
9,13,172,17,226,235,58,39,54,801,840,1641,4,5,202105
9,14,192,5,257,267,45,52,88,906,1265,2171,5,5,202105
9,15,287,14,820,628,113,119,136,2117,1631,3748,8,5,202105
9,16,331,71,412,770,11,71,7,1673,1974,3647,11,5,202105
9,17,234,8,386,396,50,31,1,1106,1074,2180,6,5,202105
9,18,248,10,259,371,102,54,30,1074,1080,2154,8,5,202105
9,19,232,48,246,343,119,65,23,1076,1158,2234,3,5,202105
9,20,168,5,146,171,90,19,51,650,705,1355,3,5,202105
9,21,174,9,157,234,48,19,52,693,711,1404,3,5,202105
9,22,162,5,105,167,80,44,31,594,762,1356,3,5,202105
9,23,214,17,393,407,99,51,35,1216,1232,2448,6,5,202105
9,24,454,17,633,799,268,75,7,2253,2406,4659,11,5,202105
10,1,509,62,526,497,86,41,213,1934,1622,3556,17,4.666666667,202105
10,2,547,53,682,750,35,68,41,2176,1792,3968,8,5.25,202105
10,3,450,43,394,486,93,132,198,1796,1476,3272,11,5.2,202105
10,4,509,81,583,1025,20,53,12,2283,2062,4345,11,6,202105
11,1,426,60,368,257,110,77,60,1358,1353,2711,6,5,202105
11,2,409,56,424,315,84,225,56,1569,1329,2898,7,5,202105
11,3,229,41,194,219,35,20,34,772,731,1503,3,5,202105
11,4,336,75,342,482,84,57,31,1407,1604,3011,7,5,202105
11,5,481,120,570,607,37,86,78,1979,1907,3886,7,5,202105
11,6,240,41,306,263,52,34,65,1001,1015,2016,8,5,202105
11,7,468,64,569,680,46,71,22,1920,1903,3823,9,5,202105
11,8,415,67,421,598,215,151,37,1904,1826,3730,9,5,202105
11,9,210,48,186,268,1,24,2,739,639,1378,6,3.333333333,202105
11,10,391,78,495,442,47,190,96,1739,1985,3724,10,5,202105
11,11,294,46,298,328,10,47,22,1045,810,1855,5,5,202105
11,12,422,99,561,554,39,51,48,1774,1889,3663,7,5,202105
11,13,267,66,253,283,44,35,128,1076,1303,2379,8,5,202105
11,14,276,48,372,322,87,31,3,1139,1202,2341,8,5,202105
11,15,343,59,402,305,24,76,179,1388,1295,2683,6,5,202105
12,1,438,76,468,303,124,172,78,1659,1688,3347,10,5,202105
12,2,367,63,561,744,30,55,76,1896,1508,3404,10,6,202105
12,3,380,59,689,802,22,50,9,2011,1707,3718,11,7,202105
12,4,321,39,624,710,72,69,50,1885,1693,3578,9,7,202105
12,5,451,65,365,438,6,28,119,1472,1296,2768,10,5.25,202105
12,6,405,21,349,484,13,17,44,1333,1351,2684,10,6.25,202105
12,7,409,40,435,667,15,30,104,1700,1978,3678,6,5.5,202105
12,8,553,39,600,736,9,61,6,2004,1321,3325,9,7,202105
12,9,402,49,701,1082,83,123,13,2453,2067,4520,9,7,202105
13,1,400,36,332,544,80,47,226,1665,1108,2773,9,5,202105
13,2,293,21,187,233,119,337,37,1227,1126,2353,6,5.666666667,202105
13,3,492,39,390,538,262,53,30,1804,1516,3320,11,5,202105
13,4,562,44,556,588,147,63,259,2219,1554,3773,8,7,202105
13,5,640,32,643,560,166,95,296,2432,1588,4020,9,7,202105
13,6,672,81,685,742,50,79,161,2470,2196,4666,11,6.333333333,202105
13,7,530,45,897,858,67,77,11,2485,1627,4112,8,7,202105
14,1,237,58,241,133,77,29,13,788,542,1330,6,4.75,202105
14,2,273,28,292,231,63,56,4,947,808,1755,5,5.333333333,202105
14,3,444,36,608,253,30,167,45,1583,1472,3055,8,5,202105
14,4,438,32,676,478,31,57,77,1789,2077,3866,10,5,202105
14,5,320,20,679,366,32,89,3,1509,1438,2947,9,5,202105
14,6,433,18,701,346,17,74,53,1642,1407,3049,9,5,202105
14,7,244,19,304,255,0,22,2,846,818,1664,6,5,202105
14,8,510,39,1068,843,8,105,16,2589,2303,4892,10,5,202105
14,9,330,30,428,588,24,57,49,1506,1470,2976,9,5,202105
14,10,238,37,414,247,19,54,29,1038,1362,2400,6,5,202105
14,11,287,14,354,260,58,66,153,1192,1005,2197,5,5,202105
14,12,426,26,557,304,32,24,6,1375,1329,2704,9,5,202105
14,13,303,21,436,247,5,33,24,1069,965,2034,6,5,202105
14,14,256,17,344,382,57,50,89,1195,1315,2510,7,5,202105
14,15,471,74,476,358,196,95,106,1776,1478,3254,10,5,202105
14,16,244,22,317,281,23,43,24,954,951,1905,5,5,202105
14,17,257,35,405,164,40,109,25,1035,1022,2057,7,5,202105
14,18,469,57,622,289,224,116,156,1933,1579,3512,8,5,202105
14,19,432,44,634,405,59,75,44,1693,1435,3128,8,5,202105
14,20,441,29,759,562,10,62,6,1869,2335,4204,10,5,202105
15,1,383,17,247,155,423,34,15,1274,1193,2467,7,5,202105
15,2,260,17,293,256,148,21,37,1032,916,1948,6,5,202105
15,3,449,10,298,347,379,40,111,1634,1607,3241,10,5,202105
15,4,238,16,140,281,39,41,24,779,845,1624,4,5,202105
15,5,389,28,413,365,54,58,96,1403,1263,2666,8,5,202105
15,6,258,5,296,363,33,39,85,1079,1084,2163,8,5,202105
15,7,235,20,691,2,66,5,0,1019,1102,2121,10,5,202105
15,8,148,2,128,182,11,19,55,545,650,1195,4,5,202105
15,9,446,17,249,179,270,107,31,1299,893,2192,9,5,202105
15,10,231,5,225,259,4,24,54,802,865,1667,6,5,202105
15,11,256,20,239,337,50,35,19,956,1075,2031,8,5,202105
15,12,385,12,600,491,78,34,6,1606,1368,2974,8,5,202105
15,13,117,12,161,210,132,36,21,689,691,1380,8,5,202105
15,14,180,14,168,234,34,46,31,707,693,1400,4,5,202105
15,15,202,89,180,263,84,22,65,905,983,1888,6,5,202105
15,16,388,22,340,743,18,51,57,1619,1543,3162,8,5,202105
15,17,227,27,219,313,61,53,106,1006,917,1923,8,5,202105
15,18,413,12,498,426,37,84,38,1508,1366,2874,7,5,202105
15,19,345,39,381,767,13,39,62,1646,2304,3950,9,5,202105
15,20,148,27,306,242,25,16,30,794,677,1471,6,5,202105
15,21,254,7,191,212,67,194,13,938,754,1692,6,5,202105
15,22,474,51,514,700,34,138,108,2019,1975,3994,14,5,202105
15,23,324,7,252,465,22,62,32,1164,1081,2245,6,5,202105
15,24,234,40,168,191,33,73,11,750,867,1617,4,5,202105
15,25,237,31,185,240,47,28,63,831,945,1776,6,5,202105
15,26,351,11,260,383,118,40,27,1190,1372,2562,8,5,202105
15,27,417,32,482,348,22,59,191,1551,1358,2909,9,5,202105
15,28,353,19,559,432,36,41,37,1477,1735,3212,9,5,202105
15,29,372,21,443,675,8,108,69,1696,1442,3138,7,5,202105
15,30,455,52,427,405,83,156,75,1653,1687,3340,15,5,202105
15,31,221,127,176,402,10,26,12,974,1086,2060,6,5,202105
15,32,344,28,314,504,61,55,63,1369,1189,2558,9,5,202105
15,33,369,28,395,460,53,35,1,1341,1278,2619,7,5,202105
15,34,276,13,267,396,20,30,20,1022,955,1977,8,5,202105
15,35,523,22,340,583,7,68,38,1581,1343,2924,9,5,202105
15,36,372,26,379,582,77,53,29,1518,1644,3162,9,5,202105
15,37,421,14,382,517,115,67,67,1583,1304,2887,7,5,202105
15,38,287,41,323,252,78,19,38,1038,1107,2145,6,5,202105
15,39,291,33,172,222,39,62,22,841,854,1695,4,5,202105
15,40,508,48,348,497,203,67,19,1690,1760,3450,9,5,202105
15,41,440,24,631,526,86,49,112,1868,2096,3964,13,5,202105
16,1,333,37,590,362,22,21,5,1370,941,2311,7,5,202105
16,2,275,61,276,348,21,45,72,1098,1037,2135,9,5,202105
16,3,372,16,337,410,42,80,16,1273,1128,2401,10,5,202105
16,4,261,41,347,294,117,49,28,1137,1176,2313,8,5,202105
16,5,247,30,299,274,56,32,80,1018,780,1798,10,5,202105
16,6,396,92,416,292,92,64,9,1361,1364,2725,12,5,202105
16,7,419,63,649,574,86,42,14,1847,1562,3409,9,5,202105
16,8,523,27,816,723,8,50,57,2204,1926,4130,12,5,202105
16,9,408,39,470,619,30,68,40,1674,1530,3204,9,5,202105
16,10,259,26,533,464,7,92,4,1385,1141,2526,6,5,202105
16,11,377,32,487,390,221,65,23,1595,1182,2777,10,5.4,202105
16,12,315,60,457,307,14,92,9,1254,1247,2501,10,5.25,202105
17,1,293,29,463,596,30,48,71,1530,1563,3093,8,5,202105
17,2,358,19,554,631,15,61,75,1713,1450,3163,9,5,202105
17,3,529,33,539,518,70,63,21,1773,1528,3301,8,5,202105
17,4,493,31,762,518,54,58,95,2011,1601,3612,10,5.333333333,202105
17,5,225,13,258,309,29,49,19,902,681,1583,5,5,202105
18,1,387,29,358,485,78,58,81,1476,1158,2634,7,6,202105
18,2,500,51,750,845,75,64,77,2362,1827,4189,8,6,202105
18,3,444,38,853,446,8,44,47,1880,1132,3012,8,6,202105
19,1,354,30,597,594,13,85,94,1767,1620,3387,9,5,202105
19,2,504,28,728,569,15,62,2,1908,1328,3236,9,5,202105
19,3,526,21,639,421,46,83,40,1776,1597,3373,7,5,202105
19,4,290,10,270,184,113,65,177,1109,1101,2210,5,5,202105
19,5,539,45,505,634,24,94,114,1955,1917,3872,8,5,202105
19,6,243,14,500,522,10,76,161,1526,1426,2952,5,5,202105
19,7,422,20,954,532,17,73,23,2041,1947,3988,10,5,202105
19,8,248,15,367,400,6,45,4,1085,1053,2138,7,5,202105
19,9,395,31,716,415,69,117,45,1788,1685,3473,9,5,202105
19,10,291,12,352,329,6,72,155,1217,1049,2266,5,5,202105
19,11,651,52,811,1100,12,165,199,2990,2377,5367,13,5,202105
19,12,449,23,936,351,17,50,20,1846,1646,3492,13,5,202105
20,1,382,19,331,217,142,37,139,1267,556,1823,7,5,202105
20,2,326,25,512,349,85,13,2,1312,517,1829,6,5,202105
20,3,279,7,321,122,134,63,115,1041,1038,2079,6,5,202105
20,4,311,14,185,208,69,177,104,1068,587,1655,6,5,202105
20,5,391,15,482,527,55,39,6,1515,796,2311,11,5,202105
20,6,434,10,338,232,179,63,92,1348,799,2147,8,5,202105
20,7,482,24,552,718,33,48,102,1959,1149,3108,7,5,202105
20,8,601,19,740,788,68,85,67,2368,2248,4616,13,5,202105
20,9,434,28,484,379,268,53,127,1773,1398,3171,8,5,202105
20,10,481,15,506,352,79,24,19,1476,776,2252,9,5,202105
21,1,563,20,696,550,48,64,24,1965,1400,3365,9,5.4,202105
21,2,415,21,461,317,168,40,34,1456,1081,2537,9,5,202105
21,3,667,19,534,389,195,87,67,1958,1211,3169,8,5,202105
21,4,345,15,259,164,151,46,56,1036,1049,2085,6,5,202105
21,5,493,30,782,499,57,55,65,1981,1818,3799,7,5,202105
21,6,338,13,290,221,72,277,30,1241,1135,2376,5,6,202105
21,7,512,18,257,331,106,191,15,1430,1191,2621,9,5,202105
21,8,562,21,586,304,111,127,164,1875,1394,3269,9,5,202105
21,9,476,17,657,485,137,90,132,1994,1722,3716,8,5.5,202105
21,10,358,15,351,288,24,92,152,1280,986,2266,6,4,202105
21,11,273,9,384,201,52,21,26,966,743,1709,4,6,202105
21,12,843,53,1141,1000,102,113,412,3664,3363,7027,15,6,202105
21,13,369,12,380,350,56,76,22,1265,1264,2529,7,5,202105
21,14,287,10,286,235,117,73,84,1092,923,2015,8,5,202105
21,15,588,12,523,422,45,158,168,1916,1356,3272,7,5.5,202105
22,1,517,155,567,664,36,66,19,2024,1939,3963,11,5,202105
22,2,396,58,547,565,124,34,22,1746,1302,3048,7,5.5,202105
22,3,604,88,1117,923,33,83,58,2906,2348,5254,9,5.666666667,202105
22,4,461,63,981,775,42,56,30,2408,2080,4488,8,6,202105
22,5,511,42,997,504,160,210,34,2458,1964,4422,10,5.5,202105
23,1,377,15,1170,275,68,40,51,1996,1685,3681,14,5,202105
23,2,329,20,721,337,45,29,32,1513,1706,3219,10,5,202105
23,3,549,25,1530,873,59,46,82,3164,3412,6576,19,5,202105
23,4,208,5,556,187,78,26,117,1177,1084,2261,6,5,202105
24,1,447,57,400,449,59,49,63,1524,1252,2776,10,5,202105
24,2,246,27,236,181,31,49,26,796,760,1556,6,5,202105
24,3,398,62,400,321,90,38,7,1316,1031,2347,9,5,202105
24,4,294,21,278,245,40,47,115,1040,878,1918,5,5,202105
24,5,466,62,587,601,8,20,4,1748,1819,3567,9,5,202105
24,6,400,99,438,447,27,28,7,1446,1487,2933,6,5,202105
24,7,554,49,595,497,75,37,2,1809,1526,3335,9,5,202105
25,1,355,8,563,416,55,66,337,1800,1588,3388,10,6,202105
25,2,295,51,315,512,4,18,0,1195,1143,2338,5,5,202105
25,3,366,15,435,597,31,39,97,1580,1227,2807,7,5,202105
25,4,310,29,424,640,71,19,4,1497,1522,3019,8,5,202105
25,5,440,16,776,941,51,69,77,2370,1956,4326,8,5,202105
25,6,302,4,456,409,95,44,151,1461,1377,2838,6,5,202105
25,7,453,11,719,769,4,26,4,1986,1620,3606,5,6,202105
26,1,428,25,589,857,5,90,27,2021,664,2685,9,5,202105
26,2,430,17,607,816,16,54,38,1978,1570,3548,12,5,202105
26,3,460,17,546,586,29,103,140,1881,1080,2961,13,5.5,202105
26,4,225,15,406,312,74,29,13,1074,896,1970,9,4.2,202105
26,5,315,22,470,547,35,91,9,1489,1084,2573,14,5,202105
26,6,498,32,464,585,15,125,121,1840,1050,2890,10,6,202105
26,7,365,23,402,559,135,34,46,1564,1278,2842,10,5,202105
27,1,438,17,450,500,176,112,38,1731,1276,3007,8,5,202105
27,2,404,17,344,628,14,40,79,1526,1195,2721,8,5,202105
27,3,476,12,353,648,7,52,258,1806,1240,3046,6,5,202105
27,4,447,14,404,562,16,329,8,1780,1530,3310,7,5,202105
27,5,328,10,290,370,24,216,41,1279,1136,2415,6,5,202105
27,6,430,21,461,825,6,31,27,1801,1676,3477,7,5,202105
28,1,358,47,733,734,4,38,10,1924,1940,3864,10,5,202105
28,2,537,49,976,430,60,105,419,2576,2340,4916,13,5,202105
28,3,238,30,389,235,14,49,144,1099,877,1976,8,5,202105
28,4,537,58,1021,350,97,79,75,2217,2217,4434,13,5,202105
28,5,409,41,941,371,108,142,52,2064,2004,4068,10,5,202105
28,6,372,22,767,643,57,51,89,2001,1488,3489,13,5,202105
28,7,339,35,517,427,75,52,221,1666,1465,3131,9,5,202105
28,8,361,20,649,251,37,159,24,1501,1322,2823,12,5,202105
28,9,216,13,486,226,14,190,134,1279,1018,2297,6,5,202105
29,1,584,40,634,677,79,64,86,2164,1098,3262,9,5,202105
29,2,457,22,443,469,63,71,289,1814,1976,3790,10,5,202105
29,3,339,24,320,494,26,53,21,1277,614,1891,5,5,202105
30,1,269,43,426,346,75,24,59,1242,966,2208,7,5.333333333,202105
30,2,349,16,460,163,72,29,403,1492,1150,2642,10,5.25,202105
30,3,360,11,513,220,189,47,163,1503,1620,3123,6,5,202105
30,4,238,5,411,286,47,63,1,1051,989,2040,8,6,202105
30,5,278,18,719,489,16,45,5,1570,1474,3044,9,5,202105
30,6,345,13,577,352,64,33,31,1415,1040,2455,9,5,202105
30,7,467,27,473,351,205,55,74,1652,1415,3067,11,5.25,202105
30,8,463,22,700,400,147,92,53,1877,1617,3494,11,5,202105
30,9,514,21,602,361,154,73,207,1932,1529,3461,8,4.75,202105
30,10,426,25,796,419,72,65,234,2037,1412,3449,6,6,202105
30,11,391,15,868,832,16,48,9,2179,1878,4057,9,6.666666667,202105
30,12,491,23,1030,933,57,90,18,2642,2066,4708,10,6,202105
30,13,584,17,662,386,320,133,266,2368,1457,3825,10,5.6,202105
30,14,369,14,468,319,189,43,143,1545,1164,2709,8,5.5,202105
30,15,543,28,504,392,185,111,266,2029,1813,3842,11,6,202105
30,16,376,12,508,414,71,90,378,1849,1629,3478,10,5,202105
30,17,522,31,849,970,87,85,108,2652,2709,5361,8,6,202105
30,18,412,20,353,416,117,155,108,1581,1176,2757,8,5,202105
30,19,358,23,738,405,296,21,3,1844,1473,3317,11,5,202105
30,20,335,11,412,691,118,50,42,1659,1688,3347,8,5,202105
31,1,434,15,730,71,277,32,9,1568,1135,2703,8,5,202105
31,2,263,4,382,25,293,42,14,1023,569,1592,6,5,202105
31,3,1274,72,1546,911,86,89,16,3994,3969,7963,18,5,202105
31,4,327,10,454,117,130,47,71,1156,685,1841,4,5,202105
31,5,614,10,487,260,37,52,13,1473,660,2133,6,5,202105
32,1,409,93,385,382,60,94,168,1591,1537,3128,12,5,202105
32,2,393,64,439,310,168,98,123,1595,1537,3132,13,5,202105
32,3,420,107,468,641,28,106,132,1902,1601,3503,13,5,202105
32,4,484,103,543,577,16,96,79,1898,1796,3694,12,5,202105
1,1,589,95,863,707,116,305,81,2756,1545,4301,13,6,202106
1,2,727,130,1442,821,108,147,193,3568,1140,4708,8,6,202106
1,3,545,139,1484,814,98,179,186,3445,977,4422,7,6,202106
2,1,770,40,848,678,46,444,242,3068,116,3184,9,6,202106
2,2,586,33,649,828,14,177,2,2289,2,2291,5,6,202106
2,3,805,25,862,613,18,192,188,2703,102,2805,10,6,202106
2,4,885,10,1141,458,120,92,100,2806,9,2815,8,6,202106
2,5,947,48,1466,697,371,224,116,3869,204,4073,10,6,202106
2,6,570,23,771,604,72,193,119,2352,15,2367,7,6,202106
2,7,951,54,1133,573,89,245,202,3247,133,3380,12,6,202106
2,8,428,13,629,396,45,85,195,1791,181,1972,4,6,202106
3,1,512,31,953,704,36,133,107,2476,1889,4365,12,5.666666667,202106
3,2,491,34,1352,463,110,53,24,2527,149,2676,8,6,202106
4,1,491,30,826,764,227,97,108,2543,188,2731,11,6,202106
4,2,600,40,1131,755,178,90,288,3082,475,3557,14,6,202106
5,1,651,36,642,633,71,102,93,2228,1741,3969,9,6,202106
5,2,646,60,1088,832,127,70,91,2914,965,3879,10,6,202106
5,3,446,46,657,690,115,75,62,2091,736,2827,11,6,202106
5,4,814,80,1219,923,36,124,204,3400,1049,4449,11,6,202106
5,5,529,37,584,419,12,756,16,2353,805,3158,10,6,202106
5,6,422,34,634,353,28,169,278,1918,963,2881,9,6,202106
5,7,494,46,545,489,61,62,40,1737,108,1845,10,6,202106
6,1,573,62,1106,614,77,109,265,2806,1597,4403,12,7,202106
6,2,505,32,767,277,80,54,147,1862,676,2538,8,7,202106
7,1,720,21,698,373,13,77,9,1911,931,2842,9,6,202106
7,2,983,15,554,1122,142,52,2,2870,1033,3903,9,6,202106
7,3,1030,11,484,199,132,109,21,1986,1211,3197,7,6,202106
7,4,535,32,825,636,28,143,51,2250,1317,3567,11,5.6,202106
7,5,899,50,408,875,104,64,13,2413,1532,3945,11,6,202106
7,6,920,22,948,629,76,141,111,2847,558,3405,8,6,202106
7,7,745,32,887,662,185,212,14,2737,1433,4170,8,6,202106
7,8,878,44,557,679,63,61,15,2297,860,3157,12,6,202106
7,9,763,25,605,398,40,95,16,1942,704,2646,9,6,202106
7,10,652,11,636,1210,244,56,2,2811,1115,3926,9,6,202106
7,11,632,4,317,211,49,32,1,1246,122,1368,6,6,202106
7,12,784,17,774,851,6,46,31,2509,789,3298,9,6,202106
7,13,486,36,563,690,3,54,10,1842,1764,3606,9,6,202106
8,1,326,13,670,298,13,39,32,1391,727,2118,4,6,202106
8,2,767,156,1343,1134,35,78,10,3523,2765,6288,16,5.5,202106
8,3,540,59,710,619,56,100,281,2365,762,3127,4,6,202106
8,4,561,76,1049,864,79,149,230,3008,1347,4355,11,6,202106
8,5,754,204,863,1013,84,63,44,3025,1025,4050,10,6,202106
8,6,455,50,866,552,72,114,164,2273,157,2430,7,5,202106
8,7,577,130,754,870,17,91,20,2459,487,2946,7,5.25,202106
8,8,631,64,1328,1400,22,156,51,3652,149,3801,10,6,202106
8,9,676,83,828,765,147,246,216,2961,1136,4097,10,7,202106
9,1,347,14,256,183,110,35,49,994,436,1430,4,6,202106
9,2,1083,88,1185,1303,207,193,48,4107,616,4723,10,6,202106
9,3,455,22,500,545,82,66,71,1741,0,1741,5,6,202106
9,4,748,32,818,1172,119,111,162,3162,248,3410,8,6,202106
9,5,737,3,737,599,108,150,5,2339,236,2575,7,6,202106
9,6,458,57,441,443,167,91,10,1667,4,1671,7,6,202106
9,7,545,23,660,853,7,77,5,2170,179,2349,9,6,202106
9,8,293,10,557,500,43,73,37,1513,12,1525,5,6,202106
9,9,487,17,514,560,89,81,122,1870,7,1877,5,6,202106
9,10,226,16,483,370,40,82,21,1238,191,1429,6,6,202106
9,11,584,20,709,691,283,143,5,2435,128,2563,7,6,202106
9,12,546,94,1047,1002,91,157,28,2965,668,3633,10,6,202106
9,13,336,22,309,375,140,57,62,1301,186,1487,4,6,202106
9,14,417,13,428,490,85,90,121,1644,12,1656,5,6,202106
9,15,597,27,1439,892,136,232,120,3443,717,4160,9,6,202106
9,16,795,243,710,1276,94,92,17,3227,1006,4233,15,6,202106
9,17,500,25,744,604,100,54,7,2034,105,2139,6,6,202106
9,18,645,29,734,843,206,135,98,2690,24,2714,12,6,202106
9,19,602,59,520,534,141,93,74,2023,247,2270,5,6,202106
9,20,324,11,270,262,131,33,68,1099,529,1628,5,6,202106
9,21,390,9,326,442,96,32,76,1371,521,1892,3,6,202106
9,22,563,25,337,410,186,55,76,1652,1,1653,3,6,202106
9,23,498,24,726,509,133,62,75,2027,43,2070,6,6,202106
9,24,875,45,1127,1291,396,125,11,3870,2027,5897,14,6,202106
10,1,553,91,825,870,53,51,281,2724,1099,3823,15,5.333333333,202106
10,2,781,42,802,1042,65,132,92,2956,657,3613,8,5.5,202106
10,3,480,68,493,599,132,157,227,2156,864,3020,11,5.6,202106
10,4,721,123,967,1389,38,99,31,3368,999,4367,12,5.666666667,202106
11,1,628,93,537,379,116,126,86,1965,1176,3141,6,6,202106
11,2,630,106,689,402,120,364,69,2380,418,2798,7,6,202106
11,3,308,61,304,281,49,40,43,1086,746,1832,3,6,202106
11,4,606,120,573,725,102,109,60,2295,1097,3392,7,6.333333333,202106
11,5,866,142,724,686,29,121,68,2636,1514,4150,7,6,202106
11,6,645,39,601,270,52,59,90,1756,844,2600,8,6,202106
11,7,710,95,935,1086,61,131,28,3046,1548,4594,9,6,202106
11,8,490,103,552,736,188,237,65,2371,1270,3641,9,5.75,202106
11,9,817,242,688,896,17,77,87,2824,1756,4580,10,6,202106
11,10,546,115,732,639,87,259,121,2499,1670,4169,10,6,202106
11,11,504,81,489,564,17,65,8,1728,903,2631,5,6,202106
11,12,957,196,1123,909,67,87,62,3401,44,3445,7,6,202106
11,13,574,77,447,357,72,53,152,1732,540,2272,8,6,202106
11,14,513,93,572,434,116,69,26,1823,1049,2872,8,6,202106
11,15,450,86,527,471,37,92,169,1832,1267,3099,7,6,202106
12,1,408,79,540,330,85,143,96,1681,558,2239,10,5.4,202106
12,2,461,64,700,951,41,112,97,2426,1715,4141,10,6,202106
12,3,399,60,764,920,29,65,8,2245,1772,4017,11,6.2,202106
12,4,360,36,839,1055,69,53,63,2475,1260,3735,9,7,202106
12,5,807,78,674,680,14,30,179,2462,1334,3796,10,6,202106
12,6,331,17,336,443,23,35,52,1237,1110,2347,10,5.5,202106
12,7,746,58,770,925,11,49,98,2657,339,2996,8,6.333333333,202106
12,8,662,49,796,751,23,88,4,2373,1224,3597,9,5.75,202106
12,9,380,43,618,980,59,99,5,2184,2086,4270,9,7,202106
13,1,569,50,477,645,132,56,240,2169,447,2616,9,6.333333333,202106
13,2,417,35,221,312,145,452,29,1611,698,2309,6,5.666666667,202106
13,3,697,36,604,695,341,109,59,2541,1459,4000,11,6.25,202106
13,4,702,51,662,613,179,107,285,2599,1630,4229,8,6.666666667,202106
13,5,921,52,750,612,193,141,330,2999,514,3513,9,7,202106
13,6,1030,108,1186,876,48,144,116,3508,590,4098,11,6.333333333,202106
13,7,633,45,1019,873,98,77,11,2756,1180,3936,8,7,202106
14,1,450,85,530,227,133,51,70,1546,110,1656,6,5.5,202106
14,2,404,32,385,309,92,87,3,1312,0,1312,5,5.666666667,202106
14,3,511,51,792,357,32,142,52,1937,346,2283,8,5,202106
14,4,638,44,1054,574,39,111,83,2543,7,2550,10,6,202106
14,5,442,32,923,593,40,114,14,2158,10,2168,9,5,202106
14,6,697,43,1274,608,35,123,56,2836,10,2846,9,7,202106
14,7,383,25,515,383,0,45,8,1359,11,1370,6,5,202106
14,8,816,73,1703,1404,14,171,39,4220,412,4632,10,5.5,202106
14,9,514,44,683,909,15,89,63,2317,157,2474,9,7,202106
14,10,458,34,735,248,23,109,22,1629,11,1640,6,5.5,202106
14,11,378,21,522,423,55,118,208,1725,5,1730,5,6,202106
14,12,639,33,918,467,32,34,3,2126,19,2145,9,6,202106
14,13,591,36,710,426,17,97,37,1914,54,1968,6,6.5,202106
14,14,420,39,591,549,71,90,126,1886,17,1903,7,6,202106
14,15,555,89,606,485,157,109,178,2179,1118,3297,10,6,202106
14,16,451,27,595,432,30,64,52,1651,11,1662,5,6,202106
14,17,392,59,635,198,69,127,56,1536,25,1561,7,7,202106
14,18,678,49,823,328,184,83,152,2297,301,2598,8,5,202106
14,19,581,58,934,501,72,73,54,2273,554,2827,8,6,202106
14,20,684,45,1091,811,6,92,2,2731,18,2749,10,6,202106
15,1,548,10,357,188,374,61,14,1552,761,2313,7,6,202106
15,2,440,12,334,295,163,26,47,1317,858,2175,6,6,202106
15,3,829,22,489,438,430,65,122,2395,1374,3769,10,6,202106
15,4,452,9,277,293,24,55,30,1140,449,1589,4,6,202106
15,5,672,57,603,516,68,73,107,2096,879,2975,8,6,202106
15,6,507,20,533,521,43,78,125,1827,726,2553,8,6,202106
15,7,453,29,806,0,74,11,0,1373,553,1926,10,6,202106
15,8,293,17,275,311,33,25,60,1014,459,1473,4,6,202106
15,9,686,15,374,270,311,158,35,1849,898,2747,9,6,202106
15,10,552,11,464,483,28,55,60,1653,788,2441,6,6,202106
15,11,474,16,340,411,61,54,8,1364,814,2178,8,6,202106
15,12,923,30,1023,723,101,62,9,2871,882,3753,8,6,202106
15,13,365,18,318,300,168,77,25,1271,493,1764,8,6,202106
15,14,312,22,262,347,30,72,34,1079,646,1725,4,6,202106
15,15,487,91,357,428,108,41,36,1548,1054,2602,6,6,202106
15,16,851,48,672,1084,38,126,121,2940,472,3412,8,6,202106
15,17,395,30,307,332,44,64,150,1322,815,2137,8,6,202106
15,18,656,28,638,415,41,110,47,1935,593,2528,7,6,202106
15,19,588,30,610,1066,14,90,78,2476,1718,4194,9,6,202106
15,20,380,33,568,351,32,26,10,1400,311,1711,6,6,202106
15,21,405,14,258,279,61,228,15,1260,736,1996,6,6,202106
15,22,796,102,829,918,49,174,65,2933,1826,4759,14,6,202106
15,23,607,22,361,549,33,101,54,1727,713,2440,6,6,202106
15,24,449,31,312,261,28,82,9,1172,396,1568,4,6,202106
15,25,464,32,389,344,36,50,66,1381,586,1967,6,6,202106
15,26,459,16,367,435,121,53,41,1492,1106,2598,8,6,202106
15,27,777,25,766,371,36,104,172,2251,343,2594,9,6,202106
15,28,761,25,882,478,28,60,36,2270,560,2830,9,6,202106
15,29,684,27,605,883,9,174,91,2473,782,3255,7,6,202106
15,30,1000,60,856,569,77,233,129,2924,48,2972,15,6,202106
15,31,456,138,339,367,18,48,4,1370,139,1509,6,6,202106
15,32,531,36,548,659,59,74,79,1986,1007,2993,9,6,202106
15,33,488,45,723,565,53,74,2,1950,1115,3065,7,6,202106
15,34,351,15,413,503,31,48,13,1374,587,1961,8,6,202106
15,35,810,24,534,715,10,116,65,2274,1113,3387,9,6,202106
15,36,636,31,656,862,66,94,15,2360,829,3189,9,6,202106
15,37,642,30,588,705,146,104,90,2305,385,2690,7,6,202106
15,38,593,42,506,304,111,31,30,1617,921,2538,6,6,202106
15,39,400,38,341,390,62,78,25,1334,800,2134,4,6,202106
15,40,1035,59,640,654,185,102,35,2710,1267,3977,9,6,202106
15,41,1030,40,1143,698,121,101,152,3285,621,3906,13,6,202106
16,1,328,52,733,396,12,31,5,1557,731,2288,7,5.333333333,202106
16,2,272,53,316,449,30,76,51,1247,1004,2251,9,5.5,202106
16,3,379,26,463,461,44,75,25,1473,1248,2721,10,5.25,202106
16,4,358,48,495,423,142,80,9,1555,1068,2623,8,5.5,202106
16,5,360,51,386,383,72,54,115,1421,960,2381,10,6,202106
16,6,454,99,547,442,103,75,13,1733,776,2509,12,5.75,202106
16,7,524,87,778,627,107,71,21,2215,1183,3398,9,5.5,202106
16,8,678,61,1235,1081,12,73,40,3180,109,3289,12,6,202106
16,9,498,58,649,745,41,115,68,2174,656,2830,9,6,202106
16,10,348,44,715,605,19,98,3,1832,1213,3045,6,6,202106
16,11,526,43,635,495,215,89,21,2024,1332,3356,10,5.4,202106
16,12,442,45,532,305,54,127,1,1506,1028,2534,10,5.5,202106
17,1,596,47,791,788,46,110,89,2467,4,2471,8,6,202106
17,2,558,28,921,961,25,123,99,2715,104,2819,9,5,202106
17,3,654,41,700,678,41,83,19,2216,347,2563,8,6,202106
17,4,705,30,1081,572,43,98,70,2599,187,2786,10,5.333333333,202106
17,5,384,17,408,476,41,86,23,1435,218,1653,5,5.5,202106
18,1,464,35,598,586,114,73,90,1960,623,2583,7,7,202106
18,2,683,70,1054,1179,106,123,90,3305,997,4302,8,7,202106
18,3,613,41,1268,531,20,60,41,2574,730,3304,8,7,202106
19,1,528,23,1080,696,13,105,135,2580,284,2864,9,6,202106
19,2,653,26,882,641,25,86,18,2331,1053,3384,9,6,202106
19,3,752,30,824,499,64,137,31,2337,1610,3947,7,6,202106
19,4,438,16,479,166,69,85,157,1410,700,2110,5,6,202106
19,5,713,52,896,732,38,112,172,2715,394,3109,8,6,202106
19,6,336,20,612,495,15,142,137,1757,1498,3255,5,5,202106
19,7,540,23,1080,558,18,79,9,2307,1458,3765,10,5,202106
19,8,365,24,471,558,14,64,3,1499,767,2266,7,6,202106
19,9,415,41,732,630,85,124,40,2067,1834,3901,9,5,202106
19,10,382,20,499,397,8,112,162,1580,16,1596,5,6,202106
19,11,814,63,1168,1244,13,215,254,3771,2523,6294,13,6,202106
19,12,617,24,1219,372,36,56,6,2330,1749,4079,13,6,202106
20,1,569,28,538,288,175,50,204,1852,25,1877,7,6,202106
20,2,456,41,676,455,109,38,2,1777,327,2104,6,6,202106
20,3,329,7,497,171,246,75,72,1397,497,1894,6,5,202106
20,4,498,31,422,283,117,184,94,1629,190,1819,6,5.666666667,202106
20,5,453,18,682,612,35,41,6,1847,508,2355,11,5,202106
20,6,433,13,466,246,211,64,86,1519,396,1915,8,5.25,202106
20,7,776,47,972,875,40,94,76,2880,167,3047,7,6,202106
20,8,1176,37,1347,1309,72,128,145,4214,234,4448,13,6.5,202106
20,9,685,24,617,371,390,57,153,2297,1028,3325,8,6,202106
20,10,464,20,596,392,134,38,5,1649,304,1953,9,5,202106
21,1,728,25,1038,672,62,76,47,2648,1206,3854,9,6.4,202106
21,2,655,22,915,391,112,73,8,2176,363,2539,9,6,202106
21,3,957,27,836,528,163,162,75,2748,719,3467,8,7,202106
21,4,675,22,517,253,189,135,89,1880,89,1969,6,7,202106
21,5,722,36,1094,651,63,98,113,2777,324,3101,7,6,202106
21,6,717,16,489,347,89,389,24,2071,34,2105,5,6,202106
21,7,929,22,481,352,118,239,31,2172,429,2601,9,7,202106
21,8,764,36,1034,455,132,238,201,2860,185,3045,9,6,202106
21,9,1000,44,1264,772,170,202,207,3659,133,3792,8,7,202106
21,10,584,16,555,471,36,129,146,1937,122,2059,6,6.5,202106
21,11,419,13,570,274,62,47,40,1425,257,1682,4,6,202106
21,12,1195,61,1534,1001,120,181,370,4462,112,4574,15,6.5,202106
21,13,742,19,674,566,80,122,48,2251,18,2269,7,6.333333333,202106
21,14,556,17,522,297,168,90,85,1735,550,2285,8,6.333333333,202106
21,15,888,28,617,541,35,158,219,2486,559,3045,7,7,202106
22,1,565,158,787,812,39,83,7,2451,1235,3686,11,6.2,202106
22,2,477,63,774,694,166,46,15,2235,643,2878,7,6,202106
22,3,920,122,1599,1220,41,99,53,4054,556,4610,9,6.333333333,202106
22,4,698,69,1450,888,35,107,47,3294,492,3786,8,7,202106
22,5,698,79,1531,780,188,125,68,3469,1035,4504,10,6.5,202106
23,1,531,17,1720,397,96,80,79,2920,850,3770,14,5.6,202106
23,2,374,36,891,427,62,35,47,1872,783,2655,10,5,202106
23,3,774,57,2211,1184,109,56,78,4469,427,4896,19,6,202106
23,4,409,8,1001,270,85,70,138,1981,393,2374,6,5.5,202106
24,1,518,69,608,540,64,73,107,1979,121,2100,10,5.8,202106
24,2,482,58,476,348,54,66,47,1531,101,1632,6,6,202106
24,3,500,103,584,455,132,63,19,1856,1168,3024,9,6,202106
24,4,482,33,464,358,87,92,167,1683,381,2064,5,5.5,202106
24,5,777,87,1043,912,11,73,6,2909,1358,4267,9,6,202106
24,6,654,110,959,767,60,76,8,2634,699,3333,6,6,202106
24,7,772,68,812,663,108,33,4,2460,1051,3511,9,6,202106
25,1,400,20,785,609,57,115,328,2314,1356,3670,10,6,202106
25,2,604,101,650,820,14,21,1,2211,99,2310,5,6,202106
25,3,471,25,653,847,48,95,128,2267,1186,3453,7,5.5,202106
25,4,441,41,543,780,95,37,4,1941,1107,3048,8,6,202106
25,5,540,37,1091,1123,51,91,73,3006,1952,4958,8,6,202106
25,6,408,13,843,563,152,87,195,2261,985,3246,6,5.75,202106
25,7,496,23,904,864,8,29,3,2327,1637,3964,5,6,202106
26,1,570,33,776,1013,9,150,16,2567,518,3085,9,6,202106
26,2,699,34,1035,1146,26,129,97,3166,1347,4513,12,6,202106
26,3,645,32,927,717,42,167,214,2744,28,2772,13,6,202106
26,4,460,37,758,643,155,57,10,2120,799,2919,9,6,202106
26,5,504,32,772,561,42,161,8,2080,798,2878,14,6,202106
26,6,599,21,587,422,29,164,293,2115,414,2529,10,6,202106
26,7,396,19,536,742,86,63,34,1876,1271,3147,10,6,202106
27,1,460,24,618,520,182,82,51,1937,1502,3439,8,5.5,202106
27,2,557,21,482,722,16,54,68,1920,1040,2960,8,5.666666667,202106
27,3,610,16,427,647,12,64,282,2058,1435,3493,6,5.666666667,202106
27,4,576,22,609,873,26,191,12,2309,879,3188,8,5.333333333,202106
27,5,345,16,376,377,21,234,77,1446,887,2333,6,5.333333333,202106
27,6,548,28,533,864,10,38,25,2046,1880,3926,7,5.5,202106
28,1,391,48,922,885,10,68,6,2330,1616,3946,10,6,202106
28,2,718,69,1426,619,74,171,662,3739,1286,5025,13,6,202106
28,3,446,48,678,400,33,86,206,1897,193,2090,8,6,202106
28,4,750,66,1626,469,110,130,95,3246,541,3787,13,6,202106
28,5,433,53,1445,504,132,246,92,2905,1772,4677,10,6,202106
28,6,410,61,902,765,66,70,76,2350,1096,3446,13,6.166666667,202106
28,7,619,41,1126,661,100,122,374,3043,352,3395,9,6,202106
28,8,448,38,903,377,64,177,27,2034,483,2517,12,6,202106
28,9,277,22,699,215,20,247,178,1658,367,2025,6,6,202106
29,1,881,66,978,1015,122,149,94,3305,179,3484,9,7,202106
29,2,792,34,826,742,80,155,433,3062,184,3246,10,7,202106
29,3,678,53,688,592,28,177,9,2225,70,2295,5,7,202106
30,1,318,24,571,412,76,52,108,1561,1081,2642,7,5.333333333,202106
30,2,522,17,658,258,92,64,401,2012,918,2930,10,5.25,202106
30,3,506,17,624,268,169,78,173,1835,1018,2853,6,5,202106
30,4,362,8,579,355,70,41,1,1416,3,1419,8,6,202106
30,5,388,19,949,628,15,88,8,2095,558,2653,9,5.333333333,202106
30,6,503,18,785,474,95,71,46,1992,920,2912,9,6.666666667,202106
30,7,680,27,691,426,241,98,110,2273,909,3182,11,6.25,202106
30,8,624,33,1112,603,183,113,69,2737,843,3580,11,5.4,202106
30,9,730,17,860,501,210,121,292,2731,948,3679,8,7,202106
30,10,621,22,998,593,86,103,233,2656,749,3405,6,6,202106
30,11,526,29,1121,1058,34,65,10,2843,450,3293,9,6.666666667,202106
30,12,852,24,1344,1243,82,149,28,3722,2048,5770,10,7,202106
30,13,662,24,796,637,288,144,366,2917,1854,4771,10,5.8,202106
30,14,503,19,690,410,195,85,159,2061,737,2798,8,5.5,202106
30,15,635,38,662,450,199,143,327,2454,1109,3563,11,6,202106
30,16,507,13,658,547,74,121,485,2405,1742,4147,10,5.333333333,202106
30,17,509,32,878,913,54,109,103,2598,2704,5302,8,6,202106
30,18,594,14,480,469,111,166,90,1924,933,2857,8,6,202106
30,19,434,21,907,482,302,36,1,2183,1882,4065,11,5.5,202106
30,20,424,14,564,819,179,80,77,2157,1502,3659,8,6,202106
31,1,547,23,978,71,254,48,4,1925,1086,3011,8,5.5,202106
31,2,399,11,597,37,389,89,5,1527,159,1686,6,5,202106
31,3,1614,61,2033,1209,109,138,19,5183,1229,6412,18,5.333333333,202106
31,4,479,29,692,168,125,77,87,1657,56,1713,4,6,202106
31,5,502,16,706,342,45,62,8,1681,697,2378,6,6,202106
32,1,552,128,611,558,87,135,279,2350,983,3333,12,7,202106
32,2,612,114,846,553,230,134,221,2710,1313,4023,13,7,202106
32,3,655,179,862,1089,19,164,180,3148,1066,4214,13,7,202106
32,4,654,129,796,844,39,158,117,2737,721,3458,12,7,202106
1,1,451,69,749,468,73,212,24,2046,398,2444,13,5,202107
1,2,574,89,1013,711,76,106,106,2675,100,2775,8,5,202107
1,3,402,105,1073,714,62,143,129,2628,129,2757,6,5,202107
2,1,615,31,585,423,29,276,173,2132,272,2404,9,5,202107
2,2,506,30,447,371,5,106,0,1465,80,1545,7,5,202107
2,3,678,31,640,368,15,150,102,1984,45,2029,0,3,202107
2,4,700,12,824,338,73,57,62,2066,153,2219,9,5,202107
2,5,960,36,1277,553,243,179,97,3345,17,3362,0,3,202107
2,6,576,31,739,500,77,199,100,2222,4,2226,0,3,202107
2,7,740,29,784,382,58,175,100,2268,167,2435,8,4.5,202107
2,8,543,15,622,352,22,109,163,1826,9,1835,0,3,202107
3,1,418,25,826,489,20,101,77,1956,883,2839,10,4.666666667,202107
3,2,369,27,1031,313,73,54,16,1883,205,2088,8,5,202107
4,1,480,32,847,691,166,102,84,2402,293,2695,11,5.25,202107
4,2,559,24,895,507,177,65,198,2425,423,2848,12,4.6,202107
5,1,479,25,524,419,38,87,68,1640,363,2003,6,4,202107
5,2,494,55,753,593,74,63,51,2083,358,2441,6,4,202107
5,3,348,24,495,514,88,85,41,1595,276,1871,11,4.666666667,202107
5,4,742,63,1034,753,28,105,169,2894,160,3054,7,3.5,202107
5,5,523,23,564,379,21,649,16,2175,167,2342,0,3,202107
5,6,416,26,442,293,11,167,149,1504,822,2326,9,4,202107
5,7,393,25,436,373,45,57,26,1355,145,1500,10,4.5,202107
6,1,497,41,924,492,47,131,198,2330,1045,3375,9,5,202107
6,2,504,27,609,247,45,41,113,1586,507,2093,8,5,202107
7,1,841,13,706,369,6,78,6,2019,287,2306,9,4.75,202107
7,2,600,11,373,493,35,32,4,1548,1371,2919,9,4.75,202107
7,3,717,7,349,139,106,61,16,1395,477,1872,7,5,202107
7,4,550,13,904,383,13,141,53,2057,724,2781,5,3.8,202107
7,5,620,25,271,539,63,49,13,1580,633,2213,11,5,202107
7,6,691,18,684,390,81,107,66,2037,275,2312,8,5.333333333,202107
7,7,573,27,692,355,79,127,12,1865,1013,2878,6,4.5,202107
7,8,749,34,489,300,50,111,10,1743,456,2199,7,4.5,202107
7,9,653,21,601,211,29,97,11,1623,34,1657,6,4.333333333,202107
7,10,672,16,650,542,17,49,6,1952,745,2697,7,4.5,202107
7,11,447,8,250,117,34,26,1,883,362,1245,6,5,202107
7,12,626,5,612,427,5,43,19,1737,464,2201,9,4.5,202107
7,13,419,27,538,595,1,38,13,1631,1357,2988,9,5,202107
8,1,388,19,711,307,16,34,27,1502,103,1605,4,5,202107
8,2,878,159,1249,934,31,76,13,3340,1558,4898,3,4,202107
8,3,477,46,547,492,35,59,203,1859,488,2347,4,4,202107
8,4,396,39,754,611,65,125,147,2137,1026,3163,11,5,202107
8,5,510,136,549,540,32,47,30,1844,1464,3308,10,5,202107
8,6,375,34,667,431,39,66,100,1712,159,1871,7,5,202107
8,7,414,107,557,551,11,86,27,1753,704,2457,7,5,202107
8,8,434,48,773,805,7,101,41,2209,126,2335,10,5,202107
8,9,533,57,701,394,58,159,144,2046,829,2875,8,4.2,202107
9,1,310,9,240,101,66,41,48,815,2,817,0,3,202107
9,2,871,86,1001,1085,202,165,61,3471,462,3933,5,3.5,202107
9,3,469,22,531,483,80,75,69,1729,0,1729,0,3,202107
9,4,602,25,605,704,75,87,112,2210,0,2210,0,3,202107
9,5,530,12,535,392,56,118,0,1643,52,1695,7,5,202107
9,6,334,44,355,317,133,63,6,1252,6,1258,0,3,202107
9,7,372,11,482,558,6,56,2,1487,64,1551,0,3,202107
9,8,341,16,579,395,40,69,64,1504,4,1508,0,3,202107
9,9,465,13,414,412,84,75,90,1553,6,1559,0,3,202107
9,10,244,13,447,266,30,81,23,1104,3,1107,0,3,202107
9,11,520,25,683,533,189,123,6,2079,21,2100,0,3,202107
9,12,517,65,868,701,51,122,11,2335,610,2945,5,4,202107
9,13,378,17,383,343,96,68,51,1336,2,1338,0,3,202107
9,14,380,8,379,378,46,73,83,1347,5,1352,0,3,202107
9,15,580,25,1164,786,97,179,103,2934,22,2956,5,4,202107
9,16,698,180,607,806,51,67,39,2448,209,2657,15,5,202107
9,17,426,19,578,391,74,42,5,1535,121,1656,6,6,202107
9,18,503,19,598,655,106,121,85,2087,50,2137,6,3.5,202107
9,19,548,25,476,455,142,91,61,1798,35,1833,0,3,202107
9,20,271,12,275,214,117,26,62,977,47,1024,0,3,202107
9,21,387,7,243,240,77,31,37,1022,36,1058,0,3,202107
9,22,600,26,429,443,205,79,79,1861,3,1864,0,3,202107
9,23,489,17,600,487,118,50,65,1826,22,1848,6,6,202107
9,24,875,36,898,902,273,145,8,3137,556,3693,0,3,202107
10,1,589,69,670,699,39,53,195,2314,753,3067,15,4.833333333,202107
10,2,605,38,625,842,29,110,73,2322,503,2825,8,5,202107
10,3,565,63,455,561,104,154,284,2186,782,2968,11,5,202107
10,4,609,81,723,966,26,123,17,2545,446,2991,12,5,202107
11,1,489,65,354,262,88,99,32,1389,516,1905,6,5,202107
11,2,565,62,452,244,81,263,45,1712,511,2223,7,5,202107
11,3,385,59,360,279,53,66,56,1258,58,1316,3,5,202107
11,4,422,77,394,551,75,100,24,1643,205,1848,7,4,202107
11,5,746,126,572,468,27,120,26,2085,626,2711,7,5,202107
11,6,536,14,405,150,45,70,53,1273,175,1448,8,4,202107
11,7,621,73,646,732,44,92,30,2238,705,2943,9,5,202107
11,8,383,56,414,524,155,182,12,1726,463,2189,9,4.75,202107
11,9,609,156,522,634,21,69,61,2072,640,2712,10,4.333333333,202107
11,10,490,82,415,494,40,189,94,1804,1293,3097,10,5,202107
11,11,697,82,554,589,18,104,11,2055,418,2473,0,3,202107
11,12,698,136,811,685,59,79,41,2509,60,2569,7,4,202107
11,13,527,59,314,285,50,71,65,1371,376,1747,8,4.5,202107
11,14,398,61,407,322,62,56,21,1327,811,2138,8,5,202107
11,15,391,70,393,362,25,76,143,1460,297,1757,9,5,202107
12,1,352,77,487,327,90,85,33,1451,881,2332,10,4.6,202107
12,2,335,42,561,608,14,69,84,1713,1023,2736,10,4.75,202107
12,3,376,39,638,706,19,67,2,1847,1450,3297,11,5,202107
12,4,281,29,621,847,52,59,64,1953,956,2909,9,5,202107
12,5,472,43,488,322,4,29,75,1433,283,1716,10,4.75,202107
12,6,383,24,310,531,21,26,32,1327,1273,2600,10,5,202107
12,7,625,49,759,631,6,55,45,2170,527,2697,4,4,202107
12,8,524,29,620,470,10,50,2,1705,1258,2963,9,4,202107
12,9,358,42,634,828,30,82,7,1981,824,2805,9,5,202107
13,1,496,24,344,371,38,55,120,1448,597,2045,8,5,202107
13,2,482,34,268,293,143,499,40,1759,153,1912,0,3,202107
13,3,545,45,487,580,264,97,40,2058,599,2657,2,3.25,202107
13,4,525,31,437,418,112,76,174,1773,723,2496,9,5,202107
13,5,669,27,465,382,124,119,201,1987,481,2468,9,5,202107
13,6,1022,95,820,468,29,122,81,2637,113,2750,5,4.333333333,202107
13,7,538,36,773,554,51,89,14,2055,888,2943,7,5,202107
14,1,484,77,429,166,71,70,71,1368,83,1451,5,5,202107
14,2,364,44,367,254,79,91,8,1207,10,1217,2,3.333333333,202107
14,3,465,35,542,285,28,101,44,1500,749,2249,8,4.6,202107
14,4,571,27,704,425,23,87,43,1880,165,2045,10,4,202107
14,5,496,45,921,519,40,118,8,2147,211,2358,6,4.5,202107
14,6,596,30,877,406,18,95,33,2055,7,2062,0,3,202107
14,7,286,15,433,314,0,43,4,1095,47,1142,6,4,202107
14,8,779,47,1351,934,2,139,25,3277,214,3491,8,4.5,202107
14,9,420,30,553,606,11,71,44,1735,124,1859,9,5,202107
14,10,504,30,630,167,11,94,24,1460,27,1487,4,3.5,202107
14,11,409,24,413,315,56,92,138,1447,36,1483,5,5,202107
14,12,613,32,689,407,32,37,11,1821,8,1829,0,3,202107
14,13,525,20,509,290,16,62,32,1454,68,1522,3,4,202107
14,14,366,30,359,366,56,86,86,1349,72,1421,7,4,202107
14,15,459,76,496,359,131,96,123,1740,294,2034,10,4.8,202107
14,16,394,30,439,347,18,56,28,1312,68,1380,5,5,202107
14,17,373,41,485,159,50,99,44,1251,38,1289,5,4.5,202107
14,18,615,54,635,240,119,104,95,1862,197,2059,8,5,202107
14,19,520,56,743,425,51,74,33,1902,228,2130,8,4,202107
14,20,621,46,913,511,7,80,4,2182,150,2332,4,3.666666667,202107
15,1,519,7,337,127,233,45,6,1274,412,1686,7,5,202107
15,2,456,15,353,231,108,54,50,1267,179,1446,4,3.5,202107
15,3,707,14,390,338,329,89,60,1927,640,2567,10,4.333333333,202107
15,4,870,8,379,214,18,71,11,1571,115,1686,0,3,202107
15,5,568,47,496,419,35,60,65,1690,174,1864,8,4,202107
15,6,399,8,424,356,23,67,95,1372,112,1484,8,4,202107
15,7,432,18,549,80,67,1,0,1147,14,1161,0,3,202107
15,8,272,13,259,189,8,17,30,788,90,878,4,4,202107
15,9,679,16,281,163,159,108,19,1425,702,2127,9,5,202107
15,10,434,7,334,343,24,61,46,1249,109,1358,0,3,202107
15,11,442,15,331,368,63,48,11,1278,6,1284,6,4,202107
15,12,717,17,663,457,57,58,7,1976,17,1993,2,3.333333333,202107
15,13,362,15,290,219,148,77,31,1142,1,1143,0,3,202107
15,14,280,22,206,277,33,60,25,903,72,975,4,4,202107
15,15,414,74,290,321,88,34,36,1257,467,1724,6,4,202107
15,16,700,46,498,632,23,104,60,2063,92,2155,8,4.5,202107
15,17,442,29,308,286,21,98,154,1338,112,1450,0,3,202107
15,18,613,29,529,289,20,123,36,1639,288,1927,3,3.333333333,202107
15,19,530,41,566,878,19,87,51,2172,574,2746,10,4,202107
15,20,286,35,406,198,17,34,17,993,83,1076,6,4,202107
15,21,358,8,246,228,35,198,9,1082,204,1286,6,4,202107
15,22,720,74,668,545,30,154,50,2241,380,2621,14,4,202107
15,23,526,13,332,555,14,93,22,1555,485,2040,6,4.666666667,202107
15,24,416,29,281,249,14,70,13,1072,86,1158,4,4,202107
15,25,591,37,376,265,32,62,46,1409,119,1528,0,3,202107
15,26,441,10,262,340,86,70,35,1244,304,1548,7,4,202107
15,27,623,27,665,415,19,87,113,1949,280,2229,9,4.333333333,202107
15,28,741,22,907,398,56,86,26,2236,48,2284,0,3,202107
15,29,582,32,471,683,6,139,51,1964,59,2023,8,4,202107
15,30,832,49,701,354,49,119,93,2197,77,2274,10,4,202107
15,31,446,116,303,355,9,34,2,1265,72,1337,6,4,202107
15,32,509,30,449,507,40,56,58,1649,741,2390,8,4,202107
15,33,692,42,773,619,49,81,6,2262,443,2705,0,3,202107
15,34,328,11,288,378,18,56,19,1098,127,1225,6,4,202107
15,35,757,58,440,386,2,100,27,1770,706,2476,9,4,202107
15,36,520,23,461,727,71,59,26,1887,878,2765,9,4.25,202107
15,37,666,23,529,479,128,93,86,2004,150,2154,0,3,202107
15,38,614,51,528,250,73,61,24,1601,54,1655,2,4,202107
15,39,345,41,316,280,46,74,14,1116,76,1192,0,3,202107
15,40,830,48,429,513,140,86,22,2068,338,2406,9,4.333333333,202107
15,41,1285,29,1344,497,117,100,155,3527,445,3972,5,3.666666667,202107
16,1,269,42,519,291,12,33,2,1168,369,1537,2,3.666666667,202107
16,2,306,32,290,343,30,58,66,1125,605,1730,7,4.5,202107
16,3,454,27,425,471,35,75,14,1501,1291,2792,10,5,202107
16,4,321,35,521,363,93,68,24,1425,688,2113,5,4,202107
16,5,330,29,325,303,35,65,66,1153,571,1724,10,5,202107
16,6,401,80,536,342,83,89,7,1538,815,2353,12,5,202107
16,7,476,50,592,611,58,67,15,1869,761,2630,9,5,202107
16,8,579,63,945,628,8,58,33,2314,82,2396,12,5,202107
16,9,443,36,499,584,16,73,25,1676,260,1936,9,5,202107
16,10,394,34,670,508,16,119,5,1746,1014,2760,6,6,202107
16,11,494,25,489,335,143,83,4,1573,1818,3391,10,5,202107
16,12,326,36,405,277,23,95,3,1165,1168,2333,8,4.5,202107
17,1,614,34,808,703,42,105,81,2387,3,2390,4,4,202107
17,2,459,31,754,587,23,99,84,2037,77,2114,4,4.333333333,202107
17,3,581,26,529,458,39,70,11,1714,250,1964,2,4,202107
17,4,681,12,954,274,17,82,74,2094,144,2238,6,4,202107
17,5,356,28,417,373,25,71,9,1279,56,1335,2,4,202107
18,1,386,23,399,400,81,68,48,1405,330,1735,5,4,202107
18,2,667,43,977,959,76,94,57,2873,135,3008,4,3.666666667,202107
18,3,469,19,797,294,6,62,23,1670,788,2458,8,4.75,202107
19,1,389,22,684,465,13,102,106,1781,7,1788,0,3,202107
19,2,666,18,876,472,13,86,12,2143,493,2636,9,5,202107
19,3,715,30,811,394,47,138,35,2170,536,2706,3,4,202107
19,4,287,12,385,171,39,83,138,1115,325,1440,5,5,202107
19,5,802,47,779,560,33,154,186,2561,588,3149,8,5,202107
19,6,274,18,516,432,9,100,110,1459,573,2032,5,5,202107
19,7,542,22,1030,446,6,79,10,2135,738,2873,10,5,202107
19,8,263,16,380,377,3,57,4,1100,687,1787,7,5,202107
19,9,372,31,750,558,67,103,38,1919,1441,3360,9,5,202107
19,10,304,18,397,327,7,95,84,1232,49,1281,5,5,202107
19,11,756,71,913,829,9,201,215,2994,836,3830,13,5,202107
19,12,556,18,1033,323,14,65,0,2009,392,2401,4,4.333333333,202107
20,1,452,13,458,187,125,60,151,1446,271,1717,7,5,202107
20,2,388,26,563,245,59,28,3,1312,365,1677,4,4.333333333,202107
20,3,327,12,473,176,151,80,83,1302,337,1639,4,4.333333333,202107
20,4,337,14,258,193,30,111,37,980,528,1508,6,5,202107
20,5,354,13,509,362,18,36,9,1301,360,1661,11,5,202107
20,6,354,7,347,229,135,52,60,1184,489,1673,8,5,202107
20,7,622,25,901,714,27,108,53,2450,175,2625,5,4.5,202107
20,8,826,25,1037,922,35,104,125,3074,27,3101,4,4,202107
20,9,430,13,601,235,261,38,98,1676,257,1933,8,5,202107
20,10,336,14,489,285,71,31,8,1234,673,1907,9,5,202107
21,1,654,25,922,477,52,75,18,2223,249,2472,7,4.6,202107
21,2,540,22,811,213,73,90,12,1761,197,1958,9,5,202107
21,3,755,16,558,314,122,128,64,1957,140,2097,3,3.5,202107
21,4,544,7,388,144,84,106,36,1309,128,1437,6,5,202107
21,5,619,26,730,383,37,96,72,1963,145,2108,6,4.333333333,202107
21,6,632,17,426,262,60,284,18,1699,6,1705,0,3,202107
21,7,760,16,377,214,72,181,25,1645,79,1724,2,3.666666667,202107
21,8,703,25,857,273,70,201,121,2250,98,2348,9,5,202107
21,9,720,36,796,380,98,156,176,2362,33,2395,8,5,202107
21,10,827,12,636,346,42,177,159,2199,12,2211,5,4,202107
21,11,288,11,440,187,40,39,34,1039,22,1061,0,3,202107
21,12,918,28,1144,657,79,132,202,3160,82,3242,6,4,202107
21,13,680,25,551,443,69,110,38,1916,112,2028,1,3.666666667,202107
21,14,554,12,490,215,81,106,69,1527,163,1690,2,3.666666667,202107
21,15,703,17,468,322,34,123,165,1832,526,2358,7,5,202107
22,1,545,144,635,643,20,83,10,2080,1031,3111,9,4.6,202107
22,2,374,50,504,408,89,62,12,1499,231,1730,7,5,202107
22,3,793,108,1143,668,12,78,27,2829,409,3238,9,5.333333333,202107
22,4,517,64,982,559,20,70,25,2237,140,2377,8,5,202107
22,5,549,59,1099,539,109,76,15,2446,570,3016,10,5,202107
23,1,680,25,1990,398,107,70,80,3350,387,3737,2,3.4,202107
23,2,374,26,794,425,44,38,23,1724,1041,2765,10,5,202107
23,3,542,23,1366,738,73,47,39,2828,780,3608,19,5,202107
23,4,363,7,915,235,68,54,111,1753,346,2099,6,5.5,202107
24,1,546,67,544,443,51,89,97,1837,191,2028,10,5,202107
24,2,515,67,474,289,67,74,39,1525,26,1551,0,3,202107
24,3,437,78,530,283,105,45,3,1481,732,2213,9,5,202107
24,4,344,36,328,296,45,80,84,1213,340,1553,5,5,202107
24,5,776,63,884,786,4,71,6,2590,356,2946,0,3,202107
24,6,525,82,664,685,24,71,11,2062,87,2149,6,5,202107
24,7,587,45,719,517,86,45,1,2000,817,2817,9,5,202107
25,1,362,16,625,426,41,115,247,1832,319,2151,8,4.333333333,202107
25,2,622,111,566,654,12,30,2,1997,118,2115,5,6,202107
25,3,492,29,541,780,34,70,68,2014,614,2628,7,5,202107
25,4,340,29,425,582,61,14,2,1453,547,2000,8,5,202107
25,5,513,32,855,902,42,82,51,2477,765,3242,8,5,202107
25,6,475,25,739,479,125,115,131,2089,311,2400,5,4.5,202107
25,7,423,29,657,632,3,43,4,1791,648,2439,5,5,202107
26,1,493,20,658,680,6,125,18,2000,133,2133,5,4.5,202107
26,2,612,21,861,805,13,133,79,2524,497,3021,3,4.2,202107
26,3,533,28,749,417,18,186,118,2049,383,2432,13,5,202107
26,4,429,29,607,458,128,60,16,1727,613,2340,9,5,202107
26,5,388,17,541,488,28,131,7,1600,272,1872,14,5,202107
26,6,557,20,447,253,22,145,261,1705,44,1749,3,4.333333333,202107
26,7,372,19,372,529,89,58,28,1467,935,2402,10,5,202107
27,1,358,23,536,379,132,67,33,1528,954,2482,8,4.75,202107
27,2,479,13,371,506,13,45,31,1458,520,1978,8,5,202107
27,3,391,17,361,417,5,43,190,1424,577,2001,6,5,202107
27,4,454,10,491,789,14,85,14,1857,779,2636,8,5,202107
27,5,281,8,404,273,15,148,58,1187,381,1568,6,5,202107
27,6,441,26,404,642,2,42,23,1580,614,2194,7,5,202107
28,1,361,33,887,617,2,53,5,1958,340,2298,10,5,202107
28,2,551,83,1028,466,46,123,437,2734,214,2948,0,3,202107
28,3,311,51,527,220,13,79,128,1329,150,1479,8,5,202107
28,4,793,87,1611,478,114,98,55,3236,148,3384,0,3,202107
28,5,386,36,1083,384,102,199,56,2246,44,2290,1,4,202107
28,6,329,27,734,526,34,79,58,1787,1382,3169,13,5,202107
28,7,529,49,925,430,64,144,174,2315,100,2415,9,5,202107
28,8,335,26,734,260,34,135,15,1539,270,1809,12,5,202107
28,9,256,19,421,139,19,170,114,1138,17,1155,0,3,202107
29,1,912,87,1130,921,80,145,56,3331,273,3604,8,4.75,202107
29,2,1093,43,1027,712,75,239,386,3575,48,3623,10,6,202107
29,3,631,39,699,448,20,152,12,2001,155,2156,5,5.333333333,202107
30,1,283,35,573,293,44,54,82,1364,708,2072,7,4.333333333,202107
30,2,526,28,748,219,60,74,310,1965,239,2204,8,4.5,202107
30,3,430,11,560,162,109,85,130,1487,942,2429,6,5,202107
30,4,398,10,595,262,58,68,1,1392,0,1392,0,3,202107
30,5,430,13,840,522,14,79,8,1906,280,2186,9,4.333333333,202107
30,6,558,14,764,379,52,71,23,1861,405,2266,2,3.666666667,202107
30,7,598,31,580,332,199,58,70,1868,199,2067,0,3,202107
30,8,598,42,1008,476,120,109,48,2401,431,2832,6,4.2,202107
30,9,595,16,661,328,158,98,172,2028,189,2217,6,3.75,202107
30,10,462,22,771,344,48,113,145,1905,238,2143,6,4,202107
30,11,422,18,881,667,27,69,13,2097,221,2318,7,3.666666667,202107
30,12,628,29,1082,903,43,159,26,2870,186,3056,10,4,202107
30,13,665,25,713,430,186,179,274,2472,667,3139,10,5,202107
30,14,612,30,712,389,167,63,213,2186,420,2606,6,4.25,202107
30,15,727,40,606,348,150,141,262,2274,48,2322,0,3,202107
30,16,522,8,592,465,61,142,337,2127,1059,3186,10,5,202107
30,17,513,34,837,734,57,128,46,2349,1179,3528,4,4,202107
30,18,538,20,434,383,65,147,38,1625,173,1798,0,3,202107
30,19,411,26,760,448,95,36,5,1781,930,2711,11,4.75,202107
30,20,355,12,591,584,173,77,60,1852,834,2686,8,5,202107
31,1,455,30,780,69,202,51,10,1597,204,1801,8,5,202107
31,2,373,9,629,21,302,93,3,1430,79,1509,2,3.666666667,202107
31,3,1260,70,1682,959,69,152,23,4215,383,4598,18,5.333333333,202107
31,4,429,30,689,124,98,95,73,1538,4,1542,0,3,202107
31,5,507,11,715,291,23,91,16,1654,325,1979,6,5.333333333,202107
32,1,457,69,481,422,81,101,135,1746,218,1964,12,5,202107
32,2,454,52,545,405,143,130,128,1857,833,2690,13,5,202107
32,3,543,164,671,796,14,156,97,2441,344,2785,13,5,202107
32,4,592,107,664,702,22,139,76,2302,492,2794,12,5,202107
1,1,0,0,0,245,0,0,0,245,2563,2808,13,5,202109
1,2,0,0,0,665,0,0,0,665,1781,2446,8,5,202109
1,3,0,0,0,427,0,0,0,427,1430,1857,6,5,202109
2,1,0,0,0,421,0,0,0,421,1777,2198,9,5,202109
2,2,0,0,0,271,0,0,0,271,1882,2153,7,5,202109
2,3,0,0,0,554,0,0,0,554,1757,2311,11,5,202109
2,4,0,0,0,495,0,0,0,495,1209,1704,9,5,202109
2,5,0,0,0,554,0,0,0,554,2309,2863,11,5,202109
2,6,0,0,0,471,0,0,0,471,2168,2639,7,5,202109
2,7,0,0,0,418,0,0,0,418,3542,3960,12,5,202109
2,8,0,0,0,525,0,0,0,525,2356,2881,6,5,202109
3,1,0,0,0,411,0,0,0,411,1635,2046,12,4.833333333,202109
3,2,0,0,0,297,0,0,0,297,2379,2676,9,5,202109
4,1,0,0,0,275,0,0,0,275,2421,2696,11,5,202109
4,2,0,0,0,223,0,0,0,223,2669,2892,14,5,202109
5,1,0,0,0,84,0,0,0,84,1039,1123,9,3,202109
5,2,0,0,0,90,0,0,0,90,1952,2042,10,4.4,202109
5,3,0,0,0,146,0,0,0,146,1879,2025,11,4,202109
5,4,0,0,0,672,0,0,0,672,2603,3275,11,5,202109
5,5,0,0,0,485,0,0,0,485,2348,2833,10,5,202109
5,6,0,0,0,368,0,0,0,368,1519,1887,9,5,202109
5,7,0,0,0,360,0,0,0,360,1945,2305,10,5,202109
6,1,0,0,0,259,0,0,0,259,2351,2610,9,5,202109
6,2,0,0,0,380,0,0,0,380,869,1249,8,5,202109
7,1,0,0,0,122,0,0,0,122,1657,1779,9,5,202109
7,2,0,0,0,84,0,0,0,84,2280,2364,9,5,202109
7,3,0,0,0,189,0,0,0,189,1532,1721,7,5,202109
7,4,0,0,0,109,0,0,0,109,1679,1788,11,5,202109
7,5,0,0,0,321,0,0,0,321,2004,2325,11,5,202109
7,6,0,0,0,348,0,0,0,348,1683,2031,8,5,202109
7,7,0,0,0,394,0,0,0,394,1352,1746,8,5,202109
7,8,0,0,0,276,0,0,0,276,2100,2376,12,5,202109
7,9,0,0,0,756,0,0,0,756,1246,2002,9,5,202109
7,10,0,0,0,268,0,0,0,268,2260,2528,9,5,202109
7,11,0,0,0,142,0,0,0,142,1489,1631,6,5,202109
7,12,0,0,0,592,0,0,0,592,2301,2893,9,5,202109
7,13,0,0,0,47,0,0,0,47,1238,1285,9,5,202109
8,1,0,0,0,90,0,0,0,90,883,973,4,4,202109
8,2,0,0,0,119,0,0,0,119,2605,2724,16,4,202109
8,3,0,0,0,137,0,0,0,137,2218,2355,4,3,202109
8,4,0,0,0,219,0,0,0,219,1462,1681,11,4,202109
8,5,0,0,0,89,0,0,0,89,1854,1943,10,5,202109
8,6,0,0,0,324,0,0,0,324,2888,3212,7,5,202109
8,7,0,0,0,80,0,0,0,80,1494,1574,7,4.5,202109
8,8,0,0,0,481,0,0,0,481,3151,3632,10,5,202109
8,9,0,0,0,45,0,0,0,45,2382,2427,10,5,202109
9,1,0,0,0,216,0,0,0,216,335,551,4,5,202109
9,2,0,0,0,1026,0,0,0,1026,3331,4357,12,5,202109
9,3,0,0,0,483,0,0,0,483,890,1373,7,5,202109
9,4,0,0,0,702,0,0,0,702,1474,2176,11,5,202109
9,5,0,0,0,486,0,0,0,486,1059,1545,7,5,202109
9,6,0,0,0,363,0,0,0,363,686,1049,7,5,202109
9,7,0,0,0,399,0,0,0,399,2627,3026,9,5,202109
9,8,0,0,0,431,0,0,0,431,826,1257,5,5,202109
9,9,0,0,0,393,0,0,0,393,1681,2074,4,5,202109
9,10,0,0,0,325,0,0,0,325,1788,2113,4,5,202109
9,11,0,0,0,634,0,0,0,634,1251,1885,7,5,202109
9,12,0,0,0,768,0,0,0,768,2308,3076,10,5,202109
9,13,0,0,0,384,0,0,0,384,1563,1947,4,5,202109
9,14,0,0,0,391,0,0,0,391,1350,1741,5,5,202109
9,15,0,0,0,1005,0,0,0,1005,2327,3332,9,5,202109
9,16,0,0,0,975,0,0,0,975,1421,2396,13,5,202109
9,17,0,0,0,349,0,0,0,349,1382,1731,6,5,202109
9,18,0,0,0,576,0,0,0,576,2334,2910,12,5,202109
9,19,0,0,0,641,0,0,0,641,1296,1937,5,5,202109
9,20,0,0,0,220,0,0,0,220,306,526,5,5,202109
9,21,0,0,0,373,0,0,0,373,1125,1498,3,5,202109
9,22,0,0,0,450,0,0,0,450,1793,2243,5,5,202109
9,23,0,0,0,636,0,0,0,636,2700,3336,6,5,202109
9,24,0,0,0,1058,0,0,0,1058,3075,4133,14,5,202109
10,1,0,0,0,233,0,0,0,233,1492,1725,15,4.666666667,202109
10,2,0,0,0,381,0,0,0,381,971,1352,8,5,202109
10,3,0,0,0,248,0,0,0,248,1664,1912,11,5,202109
10,4,0,0,0,544,0,0,0,544,2368,2912,11,5,202109
11,1,0,0,0,321,0,0,0,321,1158,1479,6,5,202109
11,2,0,0,0,404,0,0,0,404,2441,2845,7,5,202109
11,3,0,0,0,445,0,0,0,445,765,1210,3,5,202109
11,4,0,0,0,220,0,0,0,220,1408,1628,7,5,202109
11,5,0,0,0,1020,0,0,0,1020,1836,2856,7,5,202109
11,6,0,0,0,623,0,0,0,623,1104,1727,8,5,202109
11,7,0,0,0,291,0,0,0,291,2228,2519,9,5,202109
11,8,0,0,0,519,0,0,0,519,1489,2008,9,5,202109
11,9,0,0,0,504,0,0,0,504,990,1494,10,5,202109
11,10,0,0,0,339,0,0,0,339,1674,2013,9,5,202109
11,11,0,0,0,560,0,0,0,560,816,1376,5,5,202109
11,12,0,0,0,764,0,0,0,764,1718,2482,7,5,202109
11,13,0,0,0,252,0,0,0,252,1201,1453,8,5,202109
11,14,0,0,0,217,0,0,0,217,880,1097,8,5,202109
11,15,0,0,0,348,0,0,0,348,745,1093,7,5,202109
12,1,0,0,0,147,0,0,0,147,1842,1989,10,5,202109
12,2,0,0,0,376,0,0,0,376,1666,2042,10,5,202109
12,3,0,0,0,167,0,0,0,167,1418,1585,11,4.8,202109
12,4,0,0,0,469,0,0,0,469,2043,2512,9,5,202109
12,5,0,0,0,179,0,0,0,179,1256,1435,10,5,202109
12,6,0,0,0,108,0,0,0,108,1459,1567,10,5,202109
12,7,0,0,0,420,0,0,0,420,2086,2506,6,5,202109
12,8,0,0,0,76,0,0,0,76,1525,1601,9,5,202109
12,9,0,0,0,481,0,0,0,481,3113,3594,9,5,202109
13,1,0,0,0,83,0,0,0,83,1549,1632,9,5,202109
13,2,0,0,0,87,0,0,0,87,1253,1340,6,5,202109
13,3,0,0,0,192,0,0,0,192,2669,2861,11,5,202109
13,4,0,0,0,231,0,0,0,231,1460,1691,8,5,202109
13,5,0,0,0,454,0,0,0,454,2442,2896,9,5,202109
13,6,0,0,0,731,0,0,0,731,2124,2855,11,5,202109
13,7,0,0,0,284,0,0,0,284,2636,2920,8,5,202109
14,1,0,0,0,65,0,0,0,65,1263,1328,6,5,202109
14,2,0,0,0,168,0,0,0,168,681,849,5,5,202109
14,3,0,0,0,85,0,0,0,85,1495,1580,8,5,202109
14,4,0,0,0,580,0,0,0,580,2150,2730,10,5,202109
14,5,0,0,0,324,0,0,0,324,1520,1844,9,5,202109
14,6,0,0,0,790,0,0,0,790,1463,2253,11,5,202109
14,7,0,0,0,266,0,0,0,266,1360,1626,6,5,202109
14,8,0,0,0,812,0,0,0,812,3081,3893,10,5,202109
14,9,0,0,0,345,0,0,0,345,1445,1790,9,5,202109
14,10,0,0,0,713,0,0,0,713,1203,1916,7,5,202109
14,11,0,0,0,357,0,0,0,357,894,1251,5,5,202109
14,12,0,0,0,174,0,0,0,174,1310,1484,9,5,202109
14,13,0,0,0,401,0,0,0,401,1747,2148,6,5,202109
14,14,0,0,0,408,0,0,0,408,1662,2070,7,5,202109
14,15,0,0,0,247,0,0,0,247,1714,1961,10,5,202109
14,16,0,0,0,376,0,0,0,376,1568,1944,5,5,202109
14,17,0,0,0,69,0,0,0,69,1237,1306,7,5,202109
14,18,0,0,0,223,0,0,0,223,1834,2057,9,5,202109
14,19,0,0,0,278,0,0,0,278,1284,1562,8,5,202109
14,20,0,0,0,156,0,0,0,156,1929,2085,10,5,202109
15,1,0,0,0,176,0,0,0,176,2152,2328,7,5,202109
15,2,0,0,0,688,0,0,0,688,894,1582,6,5,202109
15,3,0,0,0,674,0,0,0,674,1381,2055,10,5,202109
15,4,0,0,0,638,0,0,0,638,1060,1698,4,5,202109
15,5,0,0,0,400,0,0,0,400,1827,2227,8,5,202109
15,6,0,0,0,638,0,0,0,638,1081,1719,8,5,202109
15,7,0,0,0,747,0,0,0,747,883,1630,9,5,202109
15,8,0,0,0,430,0,0,0,430,321,751,4,5,202109
15,9,0,0,0,229,0,0,0,229,1415,1644,9,5,202109
15,10,0,0,0,503,0,0,0,503,709,1212,6,5,202109
15,11,0,0,0,677,0,0,0,677,473,1150,6,5,202109
15,12,0,0,0,855,0,0,0,855,1769,2624,8,5,202109
15,13,0,0,0,449,0,0,0,449,721,1170,4,5,202109
15,14,0,0,0,577,0,0,0,577,691,1268,4,5,202109
15,15,0,0,0,557,0,0,0,557,1978,2535,6,5,202109
15,16,0,0,0,957,0,0,0,957,1172,2129,8,5,202109
15,17,0,0,0,436,0,0,0,436,1738,2174,8,5,202109
15,18,0,0,0,799,0,0,0,799,1352,2151,7,5,202109
15,19,0,0,0,1120,0,0,0,1120,1231,2351,10,5,202109
15,20,0,0,0,495,0,0,0,495,705,1200,6,5,202109
15,21,0,0,0,281,0,0,0,281,683,964,6,5,202109
15,22,0,0,0,1184,0,0,0,1184,1582,2766,14,5,202109
15,23,0,0,0,418,0,0,0,418,1174,1592,6,5,202109
15,24,0,0,0,446,0,0,0,446,1943,2389,4,5,202109
15,25,0,0,0,830,0,0,0,830,828,1658,4,5,202109
15,26,0,0,0,554,0,0,0,554,670,1224,7,5,202109
15,27,0,0,0,968,0,0,0,968,2036,3004,9,5,202109
15,28,0,0,0,652,0,0,0,652,1683,2335,9,5,202109
15,29,0,0,0,723,0,0,0,723,1171,1894,8,5,202109
15,30,0,0,0,841,0,0,0,841,3067,3908,16,5,202109
15,31,0,0,0,653,0,0,0,653,826,1479,6,5,202109
15,32,0,0,0,556,0,0,0,556,1524,2080,8,5,202109
15,33,0,0,0,510,0,0,0,510,1411,1921,7,5,202109
15,34,0,0,0,425,0,0,0,425,902,1327,6,5,202109
15,35,0,0,0,705,0,0,0,705,1131,1836,9,5,202109
15,36,0,0,0,306,0,0,0,306,2172,2478,9,5,202109
15,37,0,0,0,826,0,0,0,826,1978,2804,7,5,202109
15,38,0,0,0,418,0,0,0,418,922,1340,5,5,202109
15,39,0,0,0,489,0,0,0,489,675,1164,4,5,202109
15,40,0,0,0,747,0,0,0,747,1319,2066,9,5,202109
15,41,0,0,0,1223,0,0,0,1223,2092,3315,13,5,202109
16,1,0,0,0,130,0,0,0,130,750,880,7,5,202109
16,2,0,0,0,43,0,0,0,43,856,899,9,5,202109
16,3,0,0,0,221,0,0,0,221,1019,1240,10,5,202109
16,4,0,0,0,196,0,0,0,196,1338,1534,8,5,202109
16,5,0,0,0,265,0,0,0,265,1066,1331,10,5,202109
16,6,0,0,0,57,0,0,0,57,1388,1445,12,4.25,202109
16,7,0,0,0,270,0,0,0,270,2493,2763,9,5,202109
16,8,0,0,0,583,0,0,0,583,2768,3351,12,5,202109
16,9,0,0,0,305,0,0,0,305,1687,1992,9,5,202109
16,10,0,0,0,327,0,0,0,327,1678,2005,6,5,202109
16,11,0,0,0,122,0,0,0,122,1697,1819,10,5,202109
16,12,0,0,0,87,0,0,0,87,1226,1313,10,5,202109
17,1,0,0,0,401,0,0,0,401,2171,2572,4,5,202109
17,2,0,0,0,422,0,0,0,422,2369,2791,7,5,202109
17,3,0,0,0,474,0,0,0,474,5350,5824,6,5,202109
17,4,0,0,0,494,0,0,0,494,2260,2754,6,5,202109
17,5,0,0,0,166,0,0,0,166,854,1020,5,5,202109
18,1,0,0,0,81,0,0,0,81,1514,1595,7,5,202109
18,2,0,0,0,475,0,0,0,475,1754,2229,8,5,202109
18,3,0,0,0,430,0,0,0,430,2497,2927,8,5,202109
19,1,0,0,0,331,0,0,0,331,1844,2175,9,4.5,202109
19,2,0,0,0,440,0,0,0,440,2005,2445,9,3.5,202109
19,3,0,0,0,358,0,0,0,358,1129,1487,7,4.5,202109
19,4,0,0,0,207,0,0,0,207,920,1127,5,3,202109
19,5,0,0,0,557,0,0,0,557,1909,2466,8,5,202109
19,6,0,0,0,191,0,0,0,191,786,977,5,5,202109
19,7,0,0,0,205,0,0,0,205,1574,1779,10,4,202109
19,8,0,0,0,149,0,0,0,149,803,952,7,4,202109
19,9,0,0,0,62,0,0,0,62,1422,1484,9,5,202109
19,10,0,0,0,267,0,0,0,267,1247,1514,5,5,202109
19,11,0,0,0,570,0,0,0,570,2029,2599,13,4,202109
19,12,0,0,0,167,0,0,0,167,1212,1379,13,4.333333333,202109
20,1,0,0,0,221,0,0,0,221,900,1121,7,5,202109
20,2,0,0,0,17,0,0,0,17,3028,3045,6,5,202109
20,3,0,0,0,101,0,0,0,101,1531,1632,6,5,202109
20,4,0,0,0,85,0,0,0,85,924,1009,6,5,202109
20,5,0,0,0,185,0,0,0,185,1096,1281,11,5,202109
20,6,0,0,0,74,0,0,0,74,1333,1407,8,5,202109
20,7,0,0,0,324,0,0,0,324,2338,2662,7,5,202109
20,8,0,0,0,1061,0,0,0,1061,2356,3417,13,5,202109
20,9,0,0,0,242,0,0,0,242,2056,2298,8,5,202109
20,10,0,0,0,78,0,0,0,78,1628,1706,9,5,202109
21,1,0,0,0,173,0,0,0,173,2507,2680,9,5,202109
21,2,0,0,0,180,0,0,0,180,1547,1727,9,5,202109
21,3,0,0,0,291,0,0,0,291,1781,2072,8,5,202109
21,4,0,0,0,113,0,0,0,113,1746,1859,6,5,202109
21,5,0,0,0,452,0,0,0,452,1953,2405,7,5,202109
21,6,0,0,0,536,0,0,0,536,1352,1888,5,5,202109
21,7,0,0,0,331,0,0,0,331,2328,2659,9,5,202109
21,8,0,0,0,68,0,0,0,68,1726,1794,9,5,202109
21,9,0,0,0,719,0,0,0,719,951,1670,8,5,202109
21,10,0,0,0,448,0,0,0,448,697,1145,6,5,202109
21,11,0,0,0,253,0,0,0,253,314,567,4,5,202109
21,12,0,0,0,828,0,0,0,828,2008,2836,15,5,202109
21,13,0,0,0,322,0,0,0,322,1577,1899,7,5,202109
21,14,0,0,0,179,0,0,0,179,767,946,8,5,202109
21,15,0,0,0,435,0,0,0,435,668,1103,7,5,202109
22,1,0,0,0,70,0,0,0,70,2076,2146,11,5,202109
22,2,0,0,0,394,0,0,0,394,1300,1694,7,5,202109
22,3,0,0,0,1112,0,0,0,1112,1569,2681,7,5,202109
22,4,0,0,0,830,0,0,0,830,2148,2978,8,5,202109
22,5,0,0,0,325,0,0,0,325,2595,2920,10,5,202109
23,1,0,0,0,409,0,0,0,409,1003,1412,14,5,202109
23,2,0,0,0,176,0,0,0,176,2128,2304,10,5,202109
23,3,0,0,0,474,0,0,0,474,3484,3958,19,5,202109
23,4,0,0,0,536,0,0,0,536,2048,2584,6,5,202109
24,1,0,0,0,65,0,0,0,65,2445,2510,10,5,202109
24,2,0,0,0,211,0,0,0,211,1167,1378,6,5,202109
24,3,0,0,0,57,0,0,0,57,1513,1570,9,5,202109
24,4,0,0,0,215,0,0,0,215,867,1082,5,5,202109
24,5,0,0,0,715,0,0,0,715,2140,2855,9,5,202109
24,6,0,0,0,583,0,0,0,583,1065,1648,6,5,202109
24,7,0,0,0,60,0,0,0,60,2141,2201,9,5,202109
25,1,0,0,0,372,0,0,0,372,2617,2989,10,5,202109
25,2,0,0,0,329,0,0,0,329,1789,2118,5,5,202109
25,3,0,0,0,407,0,0,0,407,1867,2274,7,5,202109
25,4,0,0,0,347,0,0,0,347,1487,1834,8,5,202109
25,5,0,0,0,566,0,0,0,566,1929,2495,8,5,202109
25,6,0,0,0,343,0,0,0,343,1923,2266,6,5,202109
25,7,0,0,0,540,0,0,0,540,1307,1847,5,5,202109
26,1,0,0,0,265,0,0,0,265,2710,2975,9,5,202109
26,2,0,0,0,465,0,0,0,465,2893,3358,12,5,202109
26,3,0,0,0,627,0,0,0,627,2238,2865,13,5,202109
26,4,0,0,0,145,0,0,0,145,1393,1538,9,5,202109
26,5,0,0,0,423,0,0,0,423,1401,1824,14,5,202109
26,6,0,0,0,291,0,0,0,291,1621,1912,9,5,202109
26,7,0,0,0,267,0,0,0,267,1468,1735,10,5,202109
27,1,0,0,0,264,0,0,0,264,1779,2043,8,5,202109
27,2,0,0,0,372,0,0,0,372,1268,1640,8,5,202109
27,3,0,0,0,321,0,0,0,321,1720,2041,6,5,202109
27,4,0,0,0,596,0,0,0,596,1810,2406,7,5,202109
27,5,0,0,0,91,0,0,0,91,1104,1195,6,5,202109
27,6,0,0,0,379,0,0,0,379,1377,1756,7,5,202109
28,1,0,0,0,129,0,0,0,129,1148,1277,10,4,202109
28,2,0,0,0,310,0,0,0,310,2308,2618,13,4,202109
28,3,0,0,0,90,0,0,0,90,1073,1163,8,4,202109
28,4,0,0,0,186,0,0,0,186,1732,1918,13,4,202109
28,5,0,0,0,141,0,0,0,141,2621,2762,10,5,202109
28,6,0,0,0,58,0,0,0,58,2741,2799,13,5,202109
28,7,0,0,0,459,0,0,0,459,1809,2268,9,5,202109
28,8,0,0,0,225,0,0,0,225,1342,1567,12,5,202109
28,9,0,0,0,0,0,0,0,0,982,982,6,4,202109
29,1,0,0,0,429,0,0,0,429,2032,2461,8,5,202109
29,2,0,0,0,457,0,0,0,457,1310,1767,8,5,202109
29,3,0,0,0,379,0,0,0,379,1148,1527,5,5,202109
30,1,0,0,0,32,0,0,0,32,1247,1279,7,5,202109
30,2,0,0,0,50,0,0,0,50,1288,1338,8,5,202109
30,3,0,0,0,179,0,0,0,179,1620,1799,6,5,202109
30,4,0,0,0,313,0,0,0,313,940,1253,8,5,202109
30,5,0,0,0,162,0,0,0,162,1415,1577,9,5,202109
30,6,0,0,0,82,0,0,0,82,2155,2237,9,5,202109
30,7,0,0,0,123,0,0,0,123,2257,2380,11,5,202109
30,8,0,0,0,220,0,0,0,220,3445,3665,11,5,202109
30,9,0,0,0,124,0,0,0,124,1911,2035,8,5,202109
30,10,0,0,0,302,0,0,0,302,3207,3509,6,5,202109
30,11,0,0,0,266,0,0,0,266,2265,2531,9,5,202109
30,12,0,0,0,498,0,0,0,498,2222,2720,10,5,202109
30,13,0,0,0,118,0,0,0,118,2420,2538,10,5,202109
30,14,0,0,0,140,0,0,0,140,1583,1723,8,5,202109
30,15,0,0,0,286,0,0,0,286,1207,1493,11,5,202109
30,16,0,0,0,244,0,0,0,244,2456,2700,10,5,202109
30,17,0,0,0,143,0,0,0,143,2317,2460,8,5,202109
30,18,0,0,0,29,0,0,0,29,1790,1819,8,4.75,202109
30,19,0,0,0,80,0,0,0,80,1669,1749,11,5,202109
30,20,0,0,0,126,0,0,0,126,1740,1866,8,5,202109
31,1,0,0,0,228,0,0,0,228,1726,1954,8,5,202109
31,2,0,0,0,118,0,0,0,118,1003,1121,6,5,202109
31,3,0,0,0,1246,0,0,0,1246,4912,6158,18,5,202109
31,4,0,0,0,577,0,0,0,577,1127,1704,4,5,202109
31,5,0,0,0,160,0,0,0,160,1865,2025,6,5,202109
32,1,0,0,0,169,0,0,0,169,1581,1750,12,5,202109
32,2,0,0,0,114,0,0,0,114,1794,1908,13,5,202109
32,3,0,0,0,215,0,0,0,215,2558,2773,13,5,202109
32,4,0,0,0,163,0,0,0,163,2607,2770,12,5,202109
1,1,0,0,0,259,0,0,0,259,2567,2826,13,5.5,202110
1,2,0,0,0,625,0,0,0,625,3001,3626,8,6,202110
1,3,0,0,0,464,0,0,0,464,2782,3246,6,6,202110
2,1,0,0,0,563,0,0,0,563,2136,2699,9,6,202110
2,2,0,0,0,361,0,0,0,361,2533,2894,7,6,202110
2,3,0,0,0,920,0,0,0,920,2440,3360,11,5.666666667,202110
2,4,0,0,0,487,0,0,0,487,1599,2086,9,6,202110
2,5,0,0,0,891,0,0,0,891,3195,4086,11,6.5,202110
2,6,0,0,0,483,0,0,0,483,1659,2142,7,6.5,202110
2,7,0,0,0,585,0,0,0,585,4386,4971,12,5.75,202110
2,8,0,0,0,760,0,0,0,760,1834,2594,6,7,202110
3,1,0,0,0,399,0,0,0,399,2324,2723,12,6,202110
3,2,0,0,0,481,0,0,0,481,2010,2491,9,5.666666667,202110
4,1,0,0,0,436,0,0,0,436,2433,2869,9,6,202110
4,2,0,0,0,236,0,0,0,236,3581,3817,13,6,202110
5,1,0,0,0,517,0,0,0,517,3113,3630,9,6,202110
5,2,0,0,0,83,0,0,0,83,2755,2838,10,5.4,202110
5,3,0,0,0,324,0,0,0,324,3065,3389,11,5.666666667,202110
5,4,0,0,0,873,0,0,0,873,2842,3715,10,6,202110
5,5,0,0,0,628,0,0,0,628,3448,4076,10,6,202110
5,6,0,0,0,411,0,0,0,411,1724,2135,9,6,202110
5,7,0,0,0,484,0,0,0,484,1740,2224,8,5.5,202110
6,1,0,0,0,345,0,0,0,345,2119,2464,9,6,202110
6,2,0,0,0,418,0,0,0,418,1238,1656,8,6,202110
7,1,0,0,0,85,0,0,0,85,2102,2187,9,6,202110
7,2,0,0,0,72,0,0,0,72,1873,1945,9,6,202110
7,3,0,0,0,277,0,0,0,277,1600,1877,7,6,202110
7,4,0,0,0,123,0,0,0,123,2897,3020,11,6,202110
7,5,0,0,0,346,0,0,0,346,2420,2766,11,6,202110
7,6,0,0,0,458,0,0,0,458,2811,3269,8,6,202110
7,7,0,0,0,287,0,0,0,287,1785,2072,8,6,202110
7,8,0,0,0,410,0,0,0,410,2122,2532,12,6,202110
7,9,0,0,0,644,0,0,0,644,1715,2359,9,6,202110
7,10,0,0,0,184,0,0,0,184,1655,1839,9,6,202110
7,11,0,0,0,83,0,0,0,83,1056,1139,6,6,202110
7,12,0,0,0,513,0,0,0,513,2964,3477,9,6,202110
7,13,0,0,0,61,0,0,0,61,1260,1321,9,6,202110
8,1,0,0,0,172,0,0,0,172,2119,2291,4,6,202110
8,2,0,0,0,476,0,0,0,476,3326,3802,16,5.5,202110
8,3,0,0,0,403,0,0,0,403,2814,3217,4,7,202110
8,4,0,0,0,461,0,0,0,461,3447,3908,11,6,202110
8,5,0,0,0,163,0,0,0,163,2529,2692,10,5.5,202110
8,6,0,0,0,434,0,0,0,434,2918,3352,7,6,202110
8,7,0,0,0,126,0,0,0,126,2827,2953,7,5.25,202110
8,8,0,0,0,682,0,0,0,682,3705,4387,10,6,202110
8,9,0,0,0,58,0,0,0,58,2369,2427,10,5.2,202110
9,1,0,0,0,325,0,0,0,325,672,997,4,7,202110
9,2,0,0,0,1795,0,0,0,1795,5522,7317,12,7,202110
9,3,0,0,0,757,0,0,0,757,1268,2025,7,7,202110
9,4,0,0,0,1091,0,0,0,1091,2164,3255,11,7,202110
9,5,0,0,0,703,0,0,0,703,1522,2225,7,7,202110
9,6,0,0,0,586,0,0,0,586,1628,2214,7,7,202110
9,7,0,0,0,673,0,0,0,673,2704,3377,9,7,202110
9,8,0,0,0,724,0,0,0,724,1068,1792,5,7,202110
9,9,0,0,0,656,0,0,0,656,2319,2975,4,7,202110
9,10,0,0,0,480,0,0,0,480,2110,2590,4,7,202110
9,11,0,0,0,1038,0,0,0,1038,1952,2990,7,7,202110
9,12,0,0,0,1179,0,0,0,1179,2742,3921,10,7,202110
9,13,0,0,0,651,0,0,0,651,2013,2664,4,7,202110
9,14,0,0,0,450,0,0,0,450,1571,2021,5,7,202110
9,15,0,0,0,1393,0,0,0,1393,2919,4312,9,7,202110
9,16,0,0,0,1524,0,0,0,1524,1241,2765,13,7,202110
9,17,0,0,0,532,0,0,0,532,1710,2242,6,7,202110
9,18,0,0,0,969,0,0,0,969,2866,3835,12,7,202110
9,19,0,0,0,976,0,0,0,976,3018,3994,5,7,202110
9,20,0,0,0,302,0,0,0,302,1490,1792,5,6,202110
9,21,0,0,0,511,0,0,0,511,1476,1987,3,7,202110
9,22,0,0,0,739,0,0,0,739,2085,2824,5,7,202110
9,23,0,0,0,971,0,0,0,971,2987,3958,6,7,202110
9,24,0,0,0,1514,0,0,0,1514,3678,5192,14,7,202110
10,1,0,0,0,241,0,0,0,241,2643,2884,15,5.666666667,202110
10,2,0,0,0,467,0,0,0,467,2136,2603,8,6,202110
10,3,0,0,0,195,0,0,0,195,2147,2342,11,6,202110
10,4,0,0,0,584,0,0,0,584,2881,3465,11,6,202110
11,1,0,0,0,282,0,0,0,282,1559,1841,6,6,202110
11,2,0,0,0,417,0,0,0,417,2358,2775,7,6,202110
11,3,0,0,0,322,0,0,0,322,984,1306,3,6,202110
11,4,0,0,0,232,0,0,0,232,1892,2124,7,6,202110
11,5,0,0,0,881,0,0,0,881,3129,4010,7,6,202110
11,6,0,0,0,485,0,0,0,485,1795,2280,8,6,202110
11,7,0,0,0,280,0,0,0,280,3325,3605,9,6,202110
11,8,0,0,0,472,0,0,0,472,2225,2697,9,5.75,202110
11,9,0,0,0,357,0,0,0,357,2187,2544,10,6,202110
11,10,0,0,0,337,0,0,0,337,2595,2932,10,6,202110
11,11,0,0,0,696,0,0,0,696,1459,2155,5,6,202110
11,12,0,0,0,724,0,0,0,724,3750,4474,7,6,202110
11,13,0,0,0,285,0,0,0,285,1561,1846,8,5.5,202110
11,14,0,0,0,281,0,0,0,281,1254,1535,8,6,202110
11,15,0,0,0,378,0,0,0,378,1708,2086,7,6,202110
12,1,0,0,0,185,0,0,0,185,2513,2698,10,6.8,202110
12,2,0,0,0,356,0,0,0,356,1975,2331,10,7,202110
12,3,0,0,0,175,0,0,0,175,2286,2461,11,7,202110
12,4,0,0,0,479,0,0,0,479,2499,2978,9,7,202110
12,5,0,0,0,158,0,0,0,158,1871,2029,10,7,202110
12,6,0,0,0,116,0,0,0,116,1400,1516,10,7,202110
12,7,0,0,0,380,0,0,0,380,2676,3056,6,7,202110
12,8,0,0,0,92,0,0,0,92,1521,1613,9,7,202110
12,9,0,0,0,493,0,0,0,493,2113,2606,9,7,202110
13,1,0,0,0,115,0,0,0,115,2263,2378,9,7,202110
13,2,0,0,0,147,0,0,0,147,1745,1892,6,7,202110
13,3,0,0,0,201,0,0,0,201,3342,3543,11,7,202110
13,4,0,0,0,357,0,0,0,357,2184,2541,8,7,202110
13,5,0,0,0,508,0,0,0,508,3743,4251,9,7,202110
13,6,0,0,0,1065,0,0,0,1065,4627,5692,11,7,202110
13,7,0,0,0,316,0,0,0,316,3257,3573,8,7,202110
14,1,0,0,0,74,0,0,0,74,1895,1969,6,6,202110
14,2,0,0,0,148,0,0,0,148,863,1011,5,5.666666667,202110
14,3,0,0,0,107,0,0,0,107,2591,2698,8,6,202110
14,4,0,0,0,614,0,0,0,614,2572,3186,10,6,202110
14,5,0,0,0,370,0,0,0,370,1759,2129,9,6,202110
14,6,0,0,0,814,0,0,0,814,2887,3701,8,6,202110
14,7,0,0,0,339,0,0,0,339,1787,2126,6,6,202110
14,8,0,0,0,995,0,0,0,995,4869,5864,10,6,202110
14,9,0,0,0,351,0,0,0,351,3349,3700,9,6,202110
14,10,0,0,0,667,0,0,0,667,1886,2553,7,6,202110
14,11,0,0,0,416,0,0,0,416,1315,1731,4,6,202110
14,12,0,0,0,227,0,0,0,227,1862,2089,9,6,202110
14,13,0,0,0,444,0,0,0,444,1263,1707,6,6,202110
14,14,0,0,0,509,0,0,0,509,1747,2256,7,6,202110
14,15,0,0,0,250,0,0,0,250,2577,2827,10,6,202110
14,16,0,0,0,507,0,0,0,507,1701,2208,6,6,202110
14,17,0,0,0,120,0,0,0,120,1313,1433,7,6,202110
14,18,0,0,0,249,0,0,0,249,2149,2398,10,6,202110
14,19,0,0,0,199,0,0,0,199,2455,2654,8,6,202110
14,20,0,0,0,216,0,0,0,216,2237,2453,10,6,202110
15,1,0,0,0,239,0,0,0,239,1357,1596,7,6,202110
15,2,0,0,0,536,0,0,0,536,1819,2355,6,6,202110
15,3,0,0,0,664,0,0,0,664,2737,3401,10,6,202110
15,4,0,0,0,798,0,0,0,798,2092,2890,4,6,202110
15,5,0,0,0,451,0,0,0,451,1969,2420,8,6,202110
15,6,0,0,0,687,0,0,0,687,1826,2513,8,6,202110
15,7,0,0,0,912,0,0,0,912,2185,3097,9,6,202110
15,8,0,0,0,473,0,0,0,473,982,1455,4,6,202110
15,9,0,0,0,366,0,0,0,366,2061,2427,9,6,202110
15,10,0,0,0,580,0,0,0,580,1652,2232,6,6,202110
15,11,0,0,0,769,0,0,0,769,1450,2219,6,6,202110
15,12,0,0,0,919,0,0,0,919,2769,3688,8,6,202110
15,13,0,0,0,537,0,0,0,537,1335,1872,4,6,202110
15,14,0,0,0,594,0,0,0,594,1338,1932,4,6,202110
15,15,0,0,0,789,0,0,0,789,905,1694,6,6,202110
15,16,0,0,0,968,0,0,0,968,2495,3463,8,6,202110
15,17,0,0,0,486,0,0,0,486,1563,2049,8,6,202110
15,18,0,0,0,810,0,0,0,810,2445,3255,7,6,202110
15,19,0,0,0,1255,0,0,0,1255,2627,3882,10,6,202110
15,20,0,0,0,417,0,0,0,417,1435,1852,6,6,202110
15,21,0,0,0,299,0,0,0,299,1313,1612,6,6,202110
15,22,0,0,0,1391,0,0,0,1391,2963,4354,14,6,202110
15,23,0,0,0,328,0,0,0,328,1926,2254,6,6,202110
15,24,0,0,0,732,0,0,0,732,1062,1794,4,6,202110
15,25,0,0,0,846,0,0,0,846,1280,2126,4,6,202110
15,26,0,0,0,535,0,0,0,535,2302,2837,7,6,202110
15,27,0,0,0,896,0,0,0,896,2401,3297,9,6,202110
15,28,0,0,0,671,0,0,0,671,3053,3724,9,6,202110
15,29,0,0,0,719,0,0,0,719,3756,4475,8,6,202110
15,30,0,0,0,847,0,0,0,847,3281,4128,16,6,202110
15,31,0,0,0,755,0,0,0,755,1229,1984,6,6,202110
15,32,0,0,0,633,0,0,0,633,2409,3042,8,6,202110
15,33,0,0,0,757,0,0,0,757,2006,2763,7,6,202110
15,34,0,0,0,428,0,0,0,428,1368,1796,6,6,202110
15,35,0,0,0,688,0,0,0,688,2339,3027,9,6,202110
15,36,0,0,0,340,0,0,0,340,2164,2504,9,6,202110
15,37,0,0,0,763,0,0,0,763,3129,3892,7,6,202110
15,38,0,0,0,634,0,0,0,634,1577,2211,5,6,202110
15,39,0,0,0,500,0,0,0,500,1371,1871,4,6,202110
15,40,0,0,0,736,0,0,0,736,2960,3696,9,6,202110
15,41,0,0,0,1346,0,0,0,1346,3692,5038,13,6,202110
16,1,0,0,0,203,0,0,0,203,1361,1564,7,5.333333333,202110
16,2,0,0,0,70,0,0,0,70,1306,1376,9,5.25,202110
16,3,0,0,0,186,0,0,0,186,1356,1542,10,5.25,202110
16,4,0,0,0,232,0,0,0,232,1022,1254,8,5.5,202110
16,5,0,0,0,232,0,0,0,232,1773,2005,10,5.666666667,202110
16,6,0,0,0,66,0,0,0,66,1247,1313,12,4.25,202110
16,7,0,0,0,298,0,0,0,298,1655,1953,9,5.5,202110
16,8,0,0,0,590,0,0,0,590,4622,5212,12,6,202110
16,9,0,0,0,305,0,0,0,305,2829,3134,9,6,202110
16,10,0,0,0,336,0,0,0,336,1960,2296,6,6,202110
16,11,0,0,0,172,0,0,0,172,1972,2144,10,5.4,202110
16,12,0,0,0,164,0,0,0,164,1155,1319,10,5.25,202110
17,1,0,0,0,646,0,0,0,646,2044,2690,4,6,202110
17,2,0,0,0,442,0,0,0,442,2667,3109,7,5.666666667,202110
17,3,0,0,0,719,0,0,0,719,1312,2031,6,6,202110
17,4,0,0,0,467,0,0,0,467,2181,2648,6,5.666666667,202110
17,5,0,0,0,254,0,0,0,254,1269,1523,5,5.5,202110
18,1,0,0,0,101,0,0,0,101,2070,2171,7,6,202110
18,2,0,0,0,517,0,0,0,517,2203,2720,8,6,202110
18,3,0,0,0,307,0,0,0,307,3003,3310,8,6,202110
19,1,0,0,0,617,0,0,0,617,2145,2762,9,6,202110
19,2,0,0,0,817,0,0,0,817,3322,4139,9,6,202110
19,3,0,0,0,725,0,0,0,725,1978,2703,7,6,202110
19,4,0,0,0,362,0,0,0,362,1633,1995,5,6,202110
19,5,0,0,0,943,0,0,0,943,2711,3654,8,6,202110
19,6,0,0,0,279,0,0,0,279,1456,1735,5,6,202110
19,7,0,0,0,350,0,0,0,350,3076,3426,10,6,202110
19,8,0,0,0,240,0,0,0,240,1298,1538,7,6,202110
19,9,0,0,0,101,0,0,0,101,1696,1797,9,6,202110
19,10,0,0,0,385,0,0,0,385,2162,2547,5,6,202110
19,11,0,0,0,944,0,0,0,944,4442,5386,13,6,202110
19,12,0,0,0,338,0,0,0,338,1678,2016,13,6,202110
20,1,0,0,0,277,0,0,0,277,2915,3192,7,6,202110
20,2,0,0,0,25,0,0,0,25,1921,1946,6,6,202110
20,3,0,0,0,114,0,0,0,114,1342,1456,6,5.333333333,202110
20,4,0,0,0,72,0,0,0,72,1733,1805,6,6,202110
20,5,0,0,0,166,0,0,0,166,1871,2037,11,6,202110
20,6,0,0,0,75,0,0,0,75,1409,1484,8,5.25,202110
20,7,0,0,0,283,0,0,0,283,2886,3169,7,6,202110
20,8,0,0,0,1258,0,0,0,1258,2968,4226,13,6,202110
20,9,0,0,0,284,0,0,0,284,1729,2013,8,5.666666667,202110
20,10,0,0,0,73,0,0,0,73,1460,1533,9,6,202110
21,1,0,0,0,198,0,0,0,198,2038,2236,9,6,202110
21,2,0,0,0,211,0,0,0,211,1812,2023,9,6,202110
21,3,0,0,0,435,0,0,0,435,2603,3038,8,6,202110
21,4,0,0,0,103,0,0,0,103,1572,1675,6,6,202110
21,5,0,0,0,399,0,0,0,399,2874,3273,7,6,202110
21,6,0,0,0,623,0,0,0,623,1898,2521,5,6,202110
21,7,0,0,0,422,0,0,0,422,1508,1930,9,6,202110
21,8,0,0,0,103,0,0,0,103,3726,3829,9,6,202110
21,9,0,0,0,739,0,0,0,739,2200,2939,8,6,202110
21,10,0,0,0,702,0,0,0,702,1299,2001,6,6,202110
21,11,0,0,0,290,0,0,0,290,888,1178,4,6,202110
21,12,0,0,0,1097,0,0,0,1097,4791,5888,15,6,202110
21,13,0,0,0,363,0,0,0,363,2857,3220,7,6,202110
21,14,0,0,0,191,0,0,0,191,2265,2456,8,6,202110
21,15,0,0,0,529,0,0,0,529,1284,1813,7,6,202110
22,1,0,0,0,102,0,0,0,102,2550,2652,11,6,202110
22,2,0,0,0,404,0,0,0,404,2095,2499,7,6,202110
22,3,0,0,0,960,0,0,0,960,3584,4544,9,6,202110
22,4,0,0,0,781,0,0,0,781,3332,4113,8,6,202110
22,5,0,0,0,330,0,0,0,330,3631,3961,10,6,202110
23,1,0,0,0,981,0,0,0,981,2419,3400,14,6,202110
23,2,0,0,0,249,0,0,0,249,1783,2032,10,6,202110
23,3,0,0,0,660,0,0,0,660,3903,4563,19,6,202110
23,4,0,0,0,558,0,0,0,558,2687,3245,6,6,202110
24,1,0,0,0,101,0,0,0,101,2169,2270,10,5.2,202110
24,2,0,0,0,135,0,0,0,135,1353,1488,6,5.5,202110
24,3,0,0,0,82,0,0,0,82,2041,2123,9,5,202110
24,4,0,0,0,231,0,0,0,231,1346,1577,5,5.5,202110
24,5,0,0,0,646,0,0,0,646,3709,4355,9,6,202110
24,6,0,0,0,637,0,0,0,637,2237,2874,4,6,202110
24,7,0,0,0,70,0,0,0,70,2499,2569,9,5.25,202110
25,1,0,0,0,364,0,0,0,364,2060,2424,10,6,202110
25,2,0,0,0,772,0,0,0,772,3515,4287,5,6,202110
25,3,0,0,0,407,0,0,0,407,2782,3189,7,6,202110
25,4,0,0,0,266,0,0,0,266,2167,2433,8,6,202110
25,5,0,0,0,533,0,0,0,533,3497,4030,8,6,202110
25,6,0,0,0,383,0,0,0,383,2230,2613,6,6,202110
25,7,0,0,0,662,0,0,0,662,2049,2711,5,6,202110
26,1,0,0,0,327,0,0,0,327,2667,2994,9,5.5,202110
26,2,0,0,0,607,0,0,0,607,3298,3905,12,5.4,202110
26,3,0,0,0,785,0,0,0,785,2541,3326,13,6,202110
26,4,0,0,0,233,0,0,0,233,2212,2445,9,5.2,202110
26,5,0,0,0,560,0,0,0,560,1793,2353,14,5.5,202110
26,6,0,0,0,463,0,0,0,463,2018,2481,9,6,202110
26,7,0,0,0,381,0,0,0,381,1617,1998,10,6,202110
27,1,0,0,0,218,0,0,0,218,1338,1556,8,7,202110
27,2,0,0,0,349,0,0,0,349,2489,2838,8,7,202110
27,3,0,0,0,376,0,0,0,376,1653,2029,6,7,202110
27,4,0,0,0,786,0,0,0,786,2283,3069,7,7,202110
27,5,0,0,0,128,0,0,0,128,1790,1918,6,7,202110
27,6,0,0,0,437,0,0,0,437,2027,2464,7,7,202110
28,1,0,0,0,292,0,0,0,292,3246,3538,10,6,202110
28,2,0,0,0,525,0,0,0,525,4274,4799,13,6,202110
28,3,0,0,0,135,0,0,0,135,1599,1734,8,6,202110
28,4,0,0,0,475,0,0,0,475,3494,3969,13,6,202110
28,5,0,0,0,297,0,0,0,297,2353,2650,10,6,202110
28,6,0,0,0,109,0,0,0,109,2814,2923,13,7,202110
28,7,0,0,0,477,0,0,0,477,3326,3803,9,6,202110
28,8,0,0,0,266,0,0,0,266,2216,2482,12,6,202110
28,9,0,0,0,116,0,0,0,116,1537,1653,6,6,202110
29,1,0,0,0,515,0,0,0,515,3068,3583,8,6,202110
29,2,0,0,0,566,0,0,0,566,3075,3641,8,6,202110
29,3,0,0,0,414,0,0,0,414,1853,2267,5,6,202110
30,1,0,0,0,90,0,0,0,90,1573,1663,7,5.333333333,202110
30,2,0,0,0,94,0,0,0,94,1412,1506,10,6,202110
30,3,0,0,0,273,0,0,0,273,1435,1708,6,6,202110
30,4,0,0,0,465,0,0,0,465,1847,2312,8,6,202110
30,5,0,0,0,303,0,0,0,303,3096,3399,9,5.666666667,202110
30,6,0,0,0,128,0,0,0,128,1724,1852,9,6,202110
30,7,0,0,0,195,0,0,0,195,2115,2310,11,6,202110
30,8,0,0,0,341,0,0,0,341,3199,3540,11,6,202110
30,9,0,0,0,233,0,0,0,233,2097,2330,8,6,202110
30,10,0,0,0,467,0,0,0,467,2949,3416,6,6,202110
30,11,0,0,0,431,0,0,0,431,4138,4569,9,5.666666667,202110
30,12,0,0,0,835,0,0,0,835,3485,4320,10,6,202110
30,13,0,0,0,154,0,0,0,154,3028,3182,10,5.4,202110
30,14,0,0,0,219,0,0,0,219,2040,2259,8,5.5,202110
30,15,0,0,0,505,0,0,0,505,1927,2432,11,6,202110
30,16,0,0,0,428,0,0,0,428,1816,2244,10,5.333333333,202110
30,17,0,0,0,209,0,0,0,209,2658,2867,8,6,202110
30,18,0,0,0,69,0,0,0,69,2205,2274,8,5.25,202110
30,19,0,0,0,152,0,0,0,152,2267,2419,11,6,202110
30,20,0,0,0,160,0,0,0,160,2200,2360,8,6,202110
31,1,0,0,0,231,0,0,0,231,2253,2484,8,5.5,202110
31,2,0,0,0,71,0,0,0,71,1215,1286,6,5.333333333,202110
31,3,0,0,0,1312,0,0,0,1312,5265,6577,18,6,202110
31,4,0,0,0,547,0,0,0,547,1145,1692,4,6,202110
31,5,0,0,0,195,0,0,0,195,1112,1307,6,5.333333333,202110
32,1,0,0,0,137,0,0,0,137,1965,2102,12,6,202110
32,2,0,0,0,51,0,0,0,51,2239,2290,13,6,202110
32,3,0,0,0,182,0,0,0,182,2618,2800,13,6,202110
32,4,0,0,0,196,0,0,0,196,2703,2899,12,6,202110
1,1,0,0,0,211,0,0,0,211,2234,2445,13,5,202111
1,2,0,0,0,624,0,0,0,624,3625,4249,8,5,202111
1,3,0,0,0,442,0,0,0,442,3328,3770,6,5,202111
2,1,0,0,0,522,0,0,0,522,2326,2848,9,5,202111
2,2,0,0,0,366,0,0,0,366,1674,2040,7,5,202111
2,3,0,0,0,713,0,0,0,713,1751,2464,11,5,202111
2,4,0,0,0,483,0,0,0,483,2893,3376,9,5,202111
2,5,0,0,0,778,0,0,0,778,4125,4903,11,5,202111
2,6,0,0,0,530,0,0,0,530,2453,2983,7,5,202111
2,7,0,0,0,545,0,0,0,545,3350,3895,12,5,202111
2,8,0,0,0,750,0,0,0,750,2305,3055,6,5,202111
3,1,0,0,0,383,0,0,0,383,1121,1504,12,5,202111
3,2,0,0,0,370,0,0,0,370,1879,2249,9,5,202111
4,1,0,0,0,393,0,0,0,393,2238,2631,9,5,202111
4,2,0,0,0,222,0,0,0,222,2625,2847,13,5,202111
5,1,0,0,0,438,0,0,0,438,1341,1779,9,5,202111
5,2,0,0,0,91,0,0,0,91,2373,2464,10,5,202111
5,3,0,0,0,336,0,0,0,336,1144,1480,11,5,202111
5,4,0,0,0,648,0,0,0,648,3173,3821,10,5,202111
5,5,0,0,0,580,0,0,0,580,2076,2656,10,5,202111
5,6,0,0,0,383,0,0,0,383,1269,1652,9,5,202111
5,7,0,0,0,338,0,0,0,338,1629,1967,8,5,202111
6,1,0,0,0,292,0,0,0,292,1398,1690,9,5,202111
6,2,0,0,0,340,0,0,0,340,1578,1918,8,5,202111
7,1,0,0,0,76,0,0,0,76,1633,1709,9,5,202111
7,2,0,0,0,102,0,0,0,102,2519,2621,9,5,202111
7,3,0,0,0,232,0,0,0,232,1856,2088,7,5,202111
7,4,0,0,0,106,0,0,0,106,954,1060,11,4.8,202111
7,5,0,0,0,340,0,0,0,340,648,988,11,5,202111
7,6,0,0,0,368,0,0,0,368,2726,3094,8,5,202111
7,7,0,0,0,287,0,0,0,287,2214,2501,8,5,202111
7,8,0,0,0,273,0,0,0,273,2597,2870,12,5,202111
7,9,0,0,0,571,0,0,0,571,1865,2436,9,5,202111
7,10,0,0,0,139,0,0,0,139,2097,2236,9,5,202111
7,11,0,0,0,61,0,0,0,61,669,730,6,5,202111
7,12,0,0,0,478,0,0,0,478,2093,2571,9,5,202111
7,13,0,0,0,39,0,0,0,39,994,1033,9,5,202111
8,1,0,0,0,275,0,0,0,275,567,842,4,5,202111
8,2,0,0,0,446,0,0,0,446,2314,2760,16,5,202111
8,3,0,0,0,464,0,0,0,464,598,1062,4,5,202111
8,4,0,0,0,413,0,0,0,413,1186,1599,11,5,202111
8,5,0,0,0,136,0,0,0,136,1409,1545,10,5,202111
8,6,0,0,0,442,0,0,0,442,710,1152,7,5,202111
8,7,0,0,0,142,0,0,0,142,1691,1833,7,5,202111
8,8,0,0,0,665,0,0,0,665,2894,3559,10,5,202111
8,9,0,0,0,67,0,0,0,67,1552,1619,10,5,202111
9,1,0,0,0,485,0,0,0,485,772,1257,4,5,202111
9,2,0,0,0,1627,0,0,0,1627,2247,3874,12,5,202111
9,3,0,0,0,709,0,0,0,709,1800,2509,7,5,202111
9,4,0,0,0,781,0,0,0,781,2469,3250,11,5,202111
9,5,0,0,0,587,0,0,0,587,2026,2613,7,5,202111
9,6,0,0,0,553,0,0,0,553,1495,2048,7,5,202111
9,7,0,0,0,487,0,0,0,487,393,880,9,5,202111
9,8,0,0,0,557,0,0,0,557,1849,2406,5,5,202111
9,9,0,0,0,592,0,0,0,592,1812,2404,4,5,202111
9,10,0,0,0,519,0,0,0,519,1463,1982,4,5,202111
9,11,0,0,0,930,0,0,0,930,1804,2734,7,5,202111
9,12,0,0,0,881,0,0,0,881,1979,2860,10,5,202111
9,13,0,0,0,637,0,0,0,637,1320,1957,4,5,202111
9,14,0,0,0,464,0,0,0,464,1816,2280,5,5,202111
9,15,0,0,0,1276,0,0,0,1276,2813,4089,9,5,202111
9,16,0,0,0,1414,0,0,0,1414,2612,4026,13,5,202111
9,17,0,0,0,526,0,0,0,526,1730,2256,6,5,202111
9,18,0,0,0,815,0,0,0,815,2114,2929,12,5,202111
9,19,0,0,0,838,0,0,0,838,2180,3018,5,5,202111
9,20,0,0,0,301,0,0,0,301,976,1277,5,5,202111
9,21,0,0,0,382,0,0,0,382,1461,1843,3,5,202111
9,22,0,0,0,623,0,0,0,623,1240,1863,5,5,202111
9,23,0,0,0,749,0,0,0,749,1092,1841,6,5,202111
9,24,0,0,0,1377,0,0,0,1377,2155,3532,14,5,202111
10,1,0,0,0,223,0,0,0,223,2079,2302,15,4.666666667,202111
10,2,0,0,0,398,0,0,0,398,2803,3201,8,5,202111
10,3,0,0,0,186,0,0,0,186,1929,2115,11,5,202111
10,4,0,0,0,518,0,0,0,518,2558,3076,11,5,202111
11,1,0,0,0,213,0,0,0,213,1527,1740,6,5,202111
11,2,0,0,0,381,0,0,0,381,1148,1529,7,5,202111
11,3,0,0,0,305,0,0,0,305,1213,1518,3,5,202111
11,4,0,0,0,219,0,0,0,219,1412,1631,7,5,202111
11,5,0,0,0,796,0,0,0,796,1931,2727,7,5,202111
11,6,0,0,0,321,0,0,0,321,981,1302,8,5,202111
11,7,0,0,0,247,0,0,0,247,824,1071,9,5,202111
11,8,0,0,0,461,0,0,0,461,1733,2194,9,5,202111
11,9,0,0,0,335,0,0,0,335,2058,2393,10,5,202111
11,10,0,0,0,324,0,0,0,324,1360,1684,10,5,202111
11,11,0,0,0,602,0,0,0,602,1707,2309,5,5,202111
11,12,0,0,0,652,0,0,0,652,2901,3553,7,5,202111
11,13,0,0,0,214,0,0,0,214,1656,1870,8,5,202111
11,14,0,0,0,263,0,0,0,263,1126,1389,8,5,202111
11,15,0,0,0,298,0,0,0,298,1832,2130,7,5,202111
12,1,0,0,0,123,0,0,0,123,885,1008,10,5,202111
12,2,0,0,0,299,0,0,0,299,1678,1977,10,5,202111
12,3,0,0,0,131,0,0,0,131,1552,1683,11,5,202111
12,4,0,0,0,472,0,0,0,472,948,1420,9,5,202111
12,5,0,0,0,96,0,0,0,96,1600,1696,10,5,202111
12,6,0,0,0,98,0,0,0,98,815,913,10,5,202111
12,7,0,0,0,318,0,0,0,318,1924,2242,6,5,202111
12,8,0,0,0,106,0,0,0,106,1596,1702,9,5,202111
12,9,0,0,0,434,0,0,0,434,691,1125,9,5,202111
13,1,0,0,0,117,0,0,0,117,1431,1548,9,5,202111
13,2,0,0,0,149,0,0,0,149,1322,1471,6,5,202111
13,3,0,0,0,262,0,0,0,262,500,762,11,5,202111
13,4,0,0,0,327,0,0,0,327,1764,2091,8,5,202111
13,5,0,0,0,459,0,0,0,459,1943,2402,9,5,202111
13,6,0,0,0,951,0,0,0,951,3592,4543,11,5,202111
13,7,0,0,0,583,0,0,0,583,999,1582,8,5,202111
14,1,0,0,0,83,0,0,0,83,891,974,6,5,202111
14,2,0,0,0,130,0,0,0,130,1181,1311,5,5,202111
14,3,0,0,0,85,0,0,0,85,1659,1744,8,5,202111
14,4,0,0,0,523,0,0,0,523,2329,2852,10,5,202111
14,5,0,0,0,345,0,0,0,345,1961,2306,9,5,202111
14,6,0,0,0,664,0,0,0,664,2027,2691,8,5,202111
14,7,0,0,0,340,0,0,0,340,716,1056,6,5,202111
14,8,0,0,0,858,0,0,0,858,3208,4066,10,5,202111
14,9,0,0,0,328,0,0,0,328,1446,1774,9,5,202111
14,10,0,0,0,531,0,0,0,531,1595,2126,7,5,202111
14,11,0,0,0,315,0,0,0,315,1596,1911,4,5,202111
14,12,0,0,0,259,0,0,0,259,1802,2061,9,5,202111
14,13,0,0,0,487,0,0,0,487,1868,2355,6,5,202111
14,14,0,0,0,417,0,0,0,417,1452,1869,7,5,202111
14,15,0,0,0,255,0,0,0,255,1505,1760,10,5,202111
14,16,0,0,0,409,0,0,0,409,1626,2035,6,5,202111
14,17,0,0,0,87,0,0,0,87,816,903,7,5,202111
14,18,0,0,0,223,0,0,0,223,1307,1530,9,5,202111
14,19,0,0,0,234,0,0,0,234,1735,1969,8,5,202111
14,20,0,0,0,190,0,0,0,190,2361,2551,10,5,202111
15,1,0,0,0,192,0,0,0,192,448,640,7,5,202111
15,2,0,0,0,559,0,0,0,559,1218,1777,6,5,202111
15,3,0,0,0,589,0,0,0,589,1777,2366,10,5,202111
15,4,0,0,0,734,0,0,0,734,1215,1949,4,5,202111
15,5,0,0,0,428,0,0,0,428,1431,1859,8,5,202111
15,6,0,0,0,593,0,0,0,593,1838,2431,8,5,202111
15,7,0,0,0,824,0,0,0,824,1108,1932,10,5,202111
15,8,0,0,0,385,0,0,0,385,913,1298,4,5,202111
15,9,0,0,0,248,0,0,0,248,720,968,9,5,202111
15,10,0,0,0,476,0,0,0,476,1609,2085,6,5,202111
15,11,0,0,0,719,0,0,0,719,1879,2598,7,5,202111
15,12,0,0,0,744,0,0,0,744,2294,3038,8,5,202111
15,13,0,0,0,499,0,0,0,499,1666,2165,4,5,202111
15,14,0,0,0,461,0,0,0,461,945,1406,4,5,202111
15,15,0,0,0,637,0,0,0,637,662,1299,6,5,202111
15,16,0,0,0,793,0,0,0,793,3156,3949,8,5,202111
15,17,0,0,0,444,0,0,0,444,818,1262,8,5,202111
15,18,0,0,0,678,0,0,0,678,1798,2476,7,5,202111
15,19,0,0,0,1073,0,0,0,1073,2575,3648,10,5,202111
15,20,0,0,0,259,0,0,0,259,1287,1546,6,4,202111
15,21,0,0,0,281,0,0,0,281,1104,1385,6,5,202111
15,22,0,0,0,1080,0,0,0,1080,2076,3156,14,5,202111
15,23,0,0,0,330,0,0,0,330,1326,1656,6,5,202111
15,24,0,0,0,528,0,0,0,528,788,1316,4,5,202111
15,25,0,0,0,704,0,0,0,704,1654,2358,6,5,202111
15,26,0,0,0,569,0,0,0,569,727,1296,6,5,202111
15,27,0,0,0,766,0,0,0,766,2076,2842,9,5,202111
15,28,0,0,0,641,0,0,0,641,2193,2834,9,5,202111
15,29,0,0,0,630,0,0,0,630,2162,2792,7,5,202111
15,30,0,0,0,630,0,0,0,630,1746,2376,16,5,202111
15,31,0,0,0,669,0,0,0,669,1747,2416,6,5,202111
15,32,0,0,0,553,0,0,0,553,1123,1676,8,5,202111
15,33,0,0,0,664,0,0,0,664,1364,2028,7,5,202111
15,34,0,0,0,409,0,0,0,409,1584,1993,6,5,202111
15,35,0,0,0,665,0,0,0,665,1901,2566,8,5,202111
15,36,0,0,0,313,0,0,0,313,1209,1522,9,5,202111
15,37,0,0,0,742,0,0,0,742,1557,2299,7,5,202111
15,38,0,0,0,504,0,0,0,504,1907,2411,5,5,202111
15,39,0,0,0,415,0,0,0,415,1668,2083,4,5,202111
15,40,0,0,0,695,0,0,0,695,1828,2523,9,5,202111
15,41,0,0,0,1001,0,0,0,1001,4262,5263,13,5,202111
16,1,0,0,0,167,0,0,0,167,1357,1524,7,5,202111
16,2,0,0,0,53,0,0,0,53,815,868,9,5,202111
16,3,0,0,0,180,0,0,0,180,1083,1263,10,5,202111
16,4,0,0,0,236,0,0,0,236,1335,1571,8,5,202111
16,5,0,0,0,210,0,0,0,210,589,799,10,5,202111
16,6,0,0,0,71,0,0,0,71,1423,1494,12,4.5,202111
16,7,0,0,0,271,0,0,0,271,1419,1690,9,5,202111
16,8,0,0,0,591,0,0,0,591,1684,2275,12,5,202111
16,9,0,0,0,348,0,0,0,348,1559,1907,8,5,202111
16,10,0,0,0,320,0,0,0,320,575,895,5,5,202111
16,11,0,0,0,143,0,0,0,143,1687,1830,10,5,202111
16,12,0,0,0,147,0,0,0,147,1213,1360,10,5,202111
17,1,0,0,0,668,0,0,0,668,1784,2452,4,5,202111
17,2,0,0,0,421,0,0,0,421,2077,2498,7,5,202111
17,3,0,0,0,632,0,0,0,632,848,1480,6,5,202111
17,4,0,0,0,390,0,0,0,390,3121,3511,6,5,202111
17,5,0,0,0,193,0,0,0,193,1328,1521,5,5,202111
18,1,0,0,0,98,0,0,0,98,1129,1227,7,5,202111
18,2,0,0,0,480,0,0,0,480,2713,3193,8,5,202111
18,3,0,0,0,297,0,0,0,297,1968,2265,8,5,202111
19,1,0,0,0,528,0,0,0,528,2308,2836,9,5,202111
19,2,0,0,0,691,0,0,0,691,2499,3190,9,5,202111
19,3,0,0,0,677,0,0,0,677,2504,3181,7,5,202111
19,4,0,0,0,288,0,0,0,288,752,1040,5,5,202111
19,5,0,0,0,838,0,0,0,838,2416,3254,8,5,202111
19,6,0,0,0,230,0,0,0,230,1523,1753,5,5,202111
19,7,0,0,0,263,0,0,0,263,1928,2191,10,5,202111
19,8,0,0,0,197,0,0,0,197,1245,1442,7,5,202111
19,9,0,0,0,84,0,0,0,84,1323,1407,9,5,202111
19,10,0,0,0,394,0,0,0,394,1224,1618,5,5,202111
19,11,0,0,0,850,0,0,0,850,3132,3982,13,5,202111
19,12,0,0,0,282,0,0,0,282,1898,2180,13,5,202111
20,1,0,0,0,213,0,0,0,213,1087,1300,7,5,202111
20,2,0,0,0,20,0,0,0,20,1588,1608,6,5,202111
20,3,0,0,0,98,0,0,0,98,790,888,6,5,202111
20,4,0,0,0,66,0,0,0,66,1418,1484,6,5,202111
20,5,0,0,0,144,0,0,0,144,2070,2214,11,5,202111
20,6,0,0,0,80,0,0,0,80,1197,1277,8,5,202111
20,7,0,0,0,269,0,0,0,269,2384,2653,7,5,202111
20,8,0,0,0,1145,0,0,0,1145,3925,5070,13,5,202111
20,9,0,0,0,234,0,0,0,234,1892,2126,8,5,202111
20,10,0,0,0,63,0,0,0,63,1107,1170,9,5,202111
21,1,0,0,0,183,0,0,0,183,1735,1918,9,5,202111
21,2,0,0,0,129,0,0,0,129,1977,2106,9,5,202111
21,3,0,0,0,347,0,0,0,347,2356,2703,8,5,202111
21,4,0,0,0,112,0,0,0,112,892,1004,6,5,202111
21,5,0,0,0,383,0,0,0,383,2182,2565,7,5,202111
21,6,0,0,0,589,0,0,0,589,1761,2350,5,5,202111
21,7,0,0,0,368,0,0,0,368,1265,1633,9,5,202111
21,8,0,0,0,135,0,0,0,135,1677,1812,9,5,202111
21,9,0,0,0,612,0,0,0,612,3513,4125,8,5,202111
21,10,0,0,0,575,0,0,0,575,1942,2517,6,5,202111
21,11,0,0,0,254,0,0,0,254,1058,1312,4,5,202111
21,12,0,0,0,940,0,0,0,940,3917,4857,15,5,202111
21,13,0,0,0,313,0,0,0,313,2417,2730,7,5,202111
21,14,0,0,0,251,0,0,0,251,1220,1471,8,5,202111
21,15,0,0,0,451,0,0,0,451,2113,2564,7,5,202111
22,1,0,0,0,88,0,0,0,88,1279,1367,11,5,202111
22,2,0,0,0,391,0,0,0,391,2295,2686,7,5,202111
22,3,0,0,0,772,0,0,0,772,3741,4513,7,5,202111
22,4,0,0,0,761,0,0,0,761,2431,3192,8,5,202111
22,5,0,0,0,312,0,0,0,312,1714,2026,10,5,202111
23,1,0,0,0,823,0,0,0,823,1908,2731,14,5,202111
23,2,0,0,0,242,0,0,0,242,1237,1479,10,5,202111
23,3,0,0,0,621,0,0,0,621,4143,4764,19,5,202111
23,4,0,0,0,421,0,0,0,421,1392,1813,6,5,202111
24,1,0,0,0,70,0,0,0,70,1241,1311,10,5,202111
24,2,0,0,0,116,0,0,0,116,1487,1603,6,5,202111
24,3,0,0,0,87,0,0,0,87,743,830,9,5,202111
24,4,0,0,0,202,0,0,0,202,1144,1346,5,5,202111
24,5,0,0,0,607,0,0,0,607,2153,2760,9,5,202111
24,6,0,0,0,525,0,0,0,525,2933,3458,4,5,202111
24,7,0,0,0,89,0,0,0,89,1199,1288,9,5,202111
25,1,0,0,0,282,0,0,0,282,802,1084,8,3.333333333,202111
25,2,0,0,0,524,0,0,0,524,1450,1974,5,5,202111
25,3,0,0,0,290,0,0,0,290,1112,1402,7,5,202111
25,4,0,0,0,167,0,0,0,167,1161,1328,8,5,202111
25,5,0,0,0,543,0,0,0,543,2027,2570,8,5,202111
25,6,0,0,0,326,0,0,0,326,1418,1744,6,5,202111
25,7,0,0,0,593,0,0,0,593,2275,2868,5,5,202111
26,1,0,0,0,381,0,0,0,381,2437,2818,9,5,202111
26,2,0,0,0,561,0,0,0,561,2035,2596,12,5,202111
26,3,0,0,0,646,0,0,0,646,2321,2967,13,5,202111
26,4,0,0,0,185,0,0,0,185,1098,1283,9,5,202111
26,5,0,0,0,409,0,0,0,409,1732,2141,14,5,202111
26,6,0,0,0,464,0,0,0,464,2011,2475,9,5,202111
26,7,0,0,0,331,0,0,0,331,1009,1340,10,5,202111
27,1,0,0,0,241,0,0,0,241,1785,2026,8,5,202111
27,2,0,0,0,280,0,0,0,280,1497,1777,8,5,202111
27,3,0,0,0,332,0,0,0,332,1590,1922,6,5,202111
27,4,0,0,0,647,0,0,0,647,2202,2849,7,5,202111
27,5,0,0,0,105,0,0,0,105,1215,1320,6,5,202111
27,6,0,0,0,416,0,0,0,416,1589,2005,7,5,202111
28,1,0,0,0,352,0,0,0,352,1528,1880,10,5,202111
28,2,0,0,0,482,0,0,0,482,2702,3184,13,5,202111
28,3,0,0,0,103,0,0,0,103,1105,1208,8,5,202111
28,4,0,0,0,2182,0,0,0,2182,2631,4813,13,5,202111
28,5,0,0,0,273,0,0,0,273,1681,1954,10,5,202111
28,6,0,0,0,89,0,0,0,89,509,598,13,5,202111
28,7,0,0,0,450,0,0,0,450,2484,2934,9,5,202111
28,8,0,0,0,235,0,0,0,235,1762,1997,12,5,202111
28,9,0,0,0,135,0,0,0,135,1564,1699,6,5,202111
29,1,0,0,0,72,0,0,0,72,1236,1308,4,3.75,202111
29,2,0,0,0,497,0,0,0,497,2341,2838,7,5,202111
29,3,0,0,0,299,0,0,0,299,1748,2047,5,5,202111
30,1,0,0,0,88,0,0,0,88,919,1007,7,5,202111
30,2,0,0,0,68,0,0,0,68,1696,1764,10,5,202111
30,3,0,0,0,228,0,0,0,228,848,1076,6,5,202111
30,4,0,0,0,325,0,0,0,325,1178,1503,8,5,202111
30,5,0,0,0,237,0,0,0,237,1148,1385,9,5,202111
30,6,0,0,0,121,0,0,0,121,1206,1327,9,5,202111
30,7,0,0,0,151,0,0,0,151,2146,2297,11,5,202111
30,8,0,0,0,289,0,0,0,289,1628,1917,11,5,202111
30,9,0,0,0,189,0,0,0,189,2002,2191,8,5,202111
30,10,0,0,0,459,0,0,0,459,1361,1820,6,5,202111
30,11,0,0,0,352,0,0,0,352,1997,2349,9,5,202111
30,12,0,0,0,714,0,0,0,714,3049,3763,10,5,202111
30,13,0,0,0,173,0,0,0,173,973,1146,10,5,202111
30,14,0,0,0,200,0,0,0,200,1409,1609,8,5,202111
30,15,0,0,0,406,0,0,0,406,2224,2630,11,5,202111
30,16,0,0,0,340,0,0,0,340,654,994,10,5,202111
30,17,0,0,0,232,0,0,0,232,891,1123,8,5,202111
30,18,0,0,0,49,0,0,0,49,1196,1245,8,5,202111
30,19,0,0,0,146,0,0,0,146,1552,1698,11,5,202111
30,20,0,0,0,137,0,0,0,137,633,770,8,5,202111
31,1,0,0,0,206,0,0,0,206,1231,1437,8,5,202111
31,2,0,0,0,74,0,0,0,74,233,307,6,5,202111
31,3,0,0,0,1060,0,0,0,1060,3222,4282,15,5,202111
31,4,0,0,0,436,0,0,0,436,1282,1718,4,5,202111
31,5,0,0,0,134,0,0,0,134,1445,1579,6,5,202111
32,1,0,0,0,129,0,0,0,129,1640,1769,12,5,202111
32,2,0,0,0,62,0,0,0,62,1067,1129,13,5,202111
32,3,0,0,0,169,0,0,0,169,1821,1990,13,5,202111
32,4,0,0,0,185,0,0,0,185,1547,1732,12,5,202111
1,1,0,0,0,214,0,0,0,214,791,1005,13,5,202112
1,2,0,0,0,628,0,0,0,628,1803,2431,8,5,202112
1,3,0,0,0,459,0,0,0,459,1821,2280,6,5,202112
2,1,0,0,0,466,0,0,0,466,2150,2616,9,5,202112
2,2,0,0,0,337,0,0,0,337,966,1303,7,5,202112
2,3,0,0,0,626,0,0,0,626,2309,2935,11,4,202112
2,4,0,0,0,426,0,0,0,426,2549,2975,9,4,202112
2,5,0,0,0,683,0,0,0,683,3034,3717,11,5,202112
2,6,0,0,0,487,0,0,0,487,2275,2762,7,4,202112
2,7,0,0,0,545,0,0,0,545,1431,1976,12,5,202112
2,8,0,0,0,606,0,0,0,606,1659,2265,6,5,202112
3,1,0,0,0,345,0,0,0,345,638,983,12,5,202112
3,2,0,0,0,395,0,0,0,395,777,1172,9,5,202112
4,1,0,0,0,308,0,0,0,308,1770,2078,9,5,202112
4,2,0,0,0,235,0,0,0,235,1366,1601,13,4.8,202112
5,1,0,0,0,417,0,0,0,417,758,1175,9,5,202112
5,2,0,0,0,83,0,0,0,83,868,951,10,5,202112
5,3,0,0,0,320,0,0,0,320,667,987,11,5,202112
5,4,0,0,0,635,0,0,0,635,3059,3694,10,5,202112
5,5,0,0,0,477,0,0,0,477,998,1475,10,5,202112
5,6,0,0,0,362,0,0,0,362,545,907,9,5,202112
5,7,0,0,0,340,0,0,0,340,1739,2079,8,5,202112
6,1,0,0,0,288,0,0,0,288,841,1129,9,4.8,202112
6,2,0,0,0,292,0,0,0,292,1377,1669,8,5,202112
7,1,0,0,0,73,0,0,0,73,951,1024,9,4.5,202112
7,2,0,0,0,68,0,0,0,68,1023,1091,9,5,202112
7,3,0,0,0,202,0,0,0,202,1091,1293,7,5,202112
7,4,0,0,0,114,0,0,0,114,1214,1328,11,5,202112
7,5,0,0,0,309,0,0,0,309,430,739,11,5,202112
7,6,0,0,0,350,0,0,0,350,703,1053,8,5,202112
7,7,0,0,0,280,0,0,0,280,968,1248,8,4.75,202112
7,8,0,0,0,303,0,0,0,303,846,1149,12,5,202112
7,9,0,0,0,563,0,0,0,563,799,1362,9,5,202112
7,10,0,0,0,148,0,0,0,148,1739,1887,9,5,202112
7,11,0,0,0,51,0,0,0,51,807,858,6,5,202112
7,12,0,0,0,461,0,0,0,461,868,1329,9,5,202112
7,13,0,0,0,59,0,0,0,59,2509,2568,9,5,202112
8,1,0,0,0,284,0,0,0,284,286,570,2,5,202112
8,2,0,0,0,461,0,0,0,461,1306,1767,16,5,202112
8,3,0,0,0,441,0,0,0,441,392,833,4,5,202112
8,4,0,0,0,422,0,0,0,422,588,1010,10,5,202112
8,5,0,0,0,184,0,0,0,184,1335,1519,10,5,202112
8,6,0,0,0,362,0,0,0,362,573,935,7,5,202112
8,7,0,0,0,141,0,0,0,141,1192,1333,7,5,202112
8,8,0,0,0,584,0,0,0,584,994,1578,10,5,202112
8,9,0,0,0,89,0,0,0,89,1382,1471,10,5,202112
9,1,0,0,0,402,0,0,0,402,852,1254,4,5,202112
9,2,0,0,0,1407,0,0,0,1407,2345,3752,12,4.5,202112
9,3,0,0,0,720,0,0,0,720,1789,2509,7,5,202112
9,4,0,0,0,802,0,0,0,802,2120,2922,11,5,202112
9,5,0,0,0,548,0,0,0,548,2267,2815,7,5,202112
9,6,0,0,0,493,0,0,0,493,1847,2340,7,5,202112
9,7,0,0,0,422,0,0,0,422,931,1353,9,4,202112
9,8,0,0,0,500,0,0,0,500,1889,2389,5,5,202112
9,9,0,0,0,512,0,0,0,512,1173,1685,4,5,202112
9,10,0,0,0,510,0,0,0,510,1228,1738,4,5,202112
9,11,0,0,0,904,0,0,0,904,1796,2700,7,5,202112
9,12,0,0,0,776,0,0,0,776,1597,2373,10,4,202112
9,13,0,0,0,733,0,0,0,733,863,1596,4,5,202112
9,14,0,0,0,454,0,0,0,454,1049,1503,5,5,202112
9,15,0,0,0,1120,0,0,0,1120,2775,3895,9,5,202112
9,16,0,0,0,1152,0,0,0,1152,3516,4668,13,5,202112
9,17,0,0,0,487,0,0,0,487,1453,1940,6,5,202112
9,18,0,0,0,694,0,0,0,694,2082,2776,12,4.5,202112
9,19,0,0,0,837,0,0,0,837,1619,2456,5,5,202112
9,20,0,0,0,222,0,0,0,222,644,866,5,4,202112
9,21,0,0,0,299,0,0,0,299,516,815,3,4,202112
9,22,0,0,0,492,0,0,0,492,991,1483,5,4,202112
9,23,0,0,0,719,0,0,0,719,999,1718,6,5,202112
9,24,0,0,0,1239,0,0,0,1239,1356,2595,14,5,202112
10,1,0,0,0,214,0,0,0,214,1882,2096,15,4.833333333,202112
10,2,0,0,0,380,0,0,0,380,2386,2766,8,5,202112
10,3,0,0,0,187,0,0,0,187,1225,1412,11,5,202112
10,4,0,0,0,524,0,0,0,524,1778,2302,11,5,202112
11,1,0,0,0,222,0,0,0,222,670,892,6,5,202112
11,2,0,0,0,311,0,0,0,311,552,863,7,5,202112
11,3,0,0,0,262,0,0,0,262,859,1121,3,4,202112
11,4,0,0,0,157,0,0,0,157,533,690,7,4.333333333,202112
11,5,0,0,0,704,0,0,0,704,1108,1812,7,5,202112
11,6,0,0,0,347,0,0,0,347,454,801,8,5,202112
11,7,0,0,0,236,0,0,0,236,539,775,9,5,202112
11,8,0,0,0,488,0,0,0,488,1442,1930,9,5,202112
11,9,0,0,0,341,0,0,0,341,784,1125,10,5,202112
11,10,0,0,0,263,0,0,0,263,963,1226,10,5,202112
11,11,0,0,0,533,0,0,0,533,1045,1578,5,5,202112
11,12,0,0,0,608,0,0,0,608,1170,1778,7,5,202112
11,13,0,0,0,210,0,0,0,210,795,1005,8,4.5,202112
11,14,0,0,0,225,0,0,0,225,440,665,8,5,202112
11,15,0,0,0,366,0,0,0,366,693,1059,7,5,202112
12,1,0,0,0,115,0,0,0,115,604,719,10,4.6,202112
12,2,0,0,0,359,0,0,0,359,931,1290,6,5,202112
12,3,0,0,0,128,0,0,0,128,456,584,11,4.8,202112
12,4,0,0,0,432,0,0,0,432,695,1127,9,4.666666667,202112
12,5,0,0,0,102,0,0,0,102,1170,1272,10,5,202112
12,6,0,0,0,75,0,0,0,75,1081,1156,10,5,202112
12,7,0,0,0,326,0,0,0,326,894,1220,6,5,202112
12,8,0,0,0,96,0,0,0,96,1058,1154,9,5,202112
12,9,0,0,0,372,0,0,0,372,644,1016,9,4.666666667,202112
13,1,0,0,0,73,0,0,0,73,1209,1282,9,5,202112
13,2,0,0,0,133,0,0,0,133,949,1082,6,5,202112
13,3,0,0,0,253,0,0,0,253,449,702,11,5,202112
13,4,0,0,0,338,0,0,0,338,1048,1386,8,5,202112
13,5,0,0,0,392,0,0,0,392,1163,1555,9,5,202112
13,6,0,0,0,950,0,0,0,950,1755,2705,11,5,202112
13,7,0,0,0,459,0,0,0,459,774,1233,8,5,202112
14,1,0,0,0,75,0,0,0,75,467,542,6,5,202112
14,2,0,0,0,134,0,0,0,134,1210,1344,5,5,202112
14,3,0,0,0,92,0,0,0,92,596,688,8,5,202112
14,4,0,0,0,471,0,0,0,471,1600,2071,10,5,202112
14,5,0,0,0,336,0,0,0,336,1737,2073,9,5,202112
14,6,0,0,0,604,0,0,0,604,1810,2414,8,5,202112
14,7,0,0,0,199,0,0,0,199,476,675,6,5,202112
14,8,0,0,0,851,0,0,0,851,1798,2649,10,4.75,202112
14,9,0,0,0,297,0,0,0,297,692,989,9,5,202112
14,10,0,0,0,515,0,0,0,515,1195,1710,7,4.5,202112
14,11,0,0,0,309,0,0,0,309,1598,1907,4,4,202112
14,12,0,0,0,225,0,0,0,225,1551,1776,9,5,202112
14,13,0,0,0,513,0,0,0,513,1169,1682,6,5,202112
14,14,0,0,0,403,0,0,0,403,1370,1773,7,5,202112
14,15,0,0,0,230,0,0,0,230,679,909,10,5,202112
14,16,0,0,0,467,0,0,0,467,852,1319,6,5,202112
14,17,0,0,0,105,0,0,0,105,843,948,7,4.75,202112
14,18,0,0,0,210,0,0,0,210,1446,1656,9,5,202112
14,19,0,0,0,219,0,0,0,219,1260,1479,8,5,202112
14,20,0,0,0,229,0,0,0,229,1615,1844,10,5,202112
15,1,0,0,0,194,0,0,0,194,364,558,7,5,202112
15,2,0,0,0,539,0,0,0,539,594,1133,6,5,202112
15,3,0,0,0,538,0,0,0,538,885,1423,10,5,202112
15,4,0,0,0,671,0,0,0,671,649,1320,4,5,202112
15,5,0,0,0,426,0,0,0,426,1021,1447,8,5,202112
15,6,0,0,0,504,0,0,0,504,993,1497,8,5,202112
15,7,0,0,0,632,0,0,0,632,875,1507,10,5,202112
15,8,0,0,0,355,0,0,0,355,545,900,4,5,202112
15,9,0,0,0,212,0,0,0,212,447,659,9,5,202112
15,10,0,0,0,454,0,0,0,454,663,1117,6,5,202112
15,11,0,0,0,615,0,0,0,615,1571,2186,7,5,202112
15,12,0,0,0,737,0,0,0,737,1431,2168,8,5,202112
15,13,0,0,0,503,0,0,0,503,653,1156,4,5,202112
15,14,0,0,0,413,0,0,0,413,751,1164,4,4,202112
15,15,0,0,0,627,0,0,0,627,1047,1674,6,5,202112
15,16,0,0,0,722,0,0,0,722,2293,3015,8,5,202112
15,17,0,0,0,379,0,0,0,379,612,991,8,5,202112
15,18,0,0,0,622,0,0,0,622,1326,1948,7,5,202112
15,19,0,0,0,929,0,0,0,929,1126,2055,10,5,202112
15,20,0,0,0,307,0,0,0,307,637,944,6,5,202112
15,21,0,0,0,253,0,0,0,253,373,626,6,5,202112
15,22,0,0,0,995,0,0,0,995,1437,2432,14,4.5,202112
15,23,0,0,0,352,0,0,0,352,674,1026,6,5,202112
15,24,0,0,0,425,0,0,0,425,1212,1637,4,4,202112
15,25,0,0,0,597,0,0,0,597,1187,1784,6,5,202112
15,26,0,0,0,550,0,0,0,550,417,967,6,5,202112
15,27,0,0,0,682,0,0,0,682,1724,2406,9,5,202112
15,28,0,0,0,604,0,0,0,604,1141,1745,9,5,202112
15,29,0,0,0,525,0,0,0,525,1221,1746,7,5,202112
15,30,0,0,0,547,0,0,0,547,1053,1600,16,5,202112
15,31,0,0,0,667,0,0,0,667,791,1458,6,5,202112
15,32,0,0,0,467,0,0,0,467,767,1234,8,5,202112
15,33,0,0,0,540,0,0,0,540,1073,1613,7,5,202112
15,34,0,0,0,408,0,0,0,408,764,1172,6,5,202112
15,35,0,0,0,596,0,0,0,596,1040,1636,8,5,202112
15,36,0,0,0,329,0,0,0,329,892,1221,9,5,202112
15,37,0,0,0,684,0,0,0,684,960,1644,7,5,202112
15,38,0,0,0,419,0,0,0,419,1286,1705,5,5,202112
15,39,0,0,0,400,0,0,0,400,740,1140,4,5,202112
15,40,0,0,0,615,0,0,0,615,875,1490,9,5,202112
15,41,0,0,0,980,0,0,0,980,1793,2773,13,5,202112
16,1,0,0,0,153,0,0,0,153,1493,1646,7,5,202112
16,2,0,0,0,57,0,0,0,57,738,795,9,5,202112
16,3,0,0,0,176,0,0,0,176,694,870,10,5,202112
16,4,0,0,0,199,0,0,0,199,752,951,8,5,202112
16,5,0,0,0,198,0,0,0,198,353,551,10,5,202112
16,6,0,0,0,202,0,0,0,202,647,849,12,5,202112
16,7,0,0,0,267,0,0,0,267,1089,1356,9,5,202112
16,8,0,0,0,519,0,0,0,519,1034,1553,12,5,202112
16,9,0,0,0,283,0,0,0,283,647,930,8,5,202112
16,10,0,0,0,284,0,0,0,284,395,679,5,5,202112
16,11,0,0,0,158,0,0,0,158,546,704,10,5,202112
16,12,0,0,0,124,0,0,0,124,452,576,10,5,202112
17,1,0,0,0,604,0,0,0,604,2565,3169,4,5,202112
17,2,0,0,0,392,0,0,0,392,847,1239,7,5,202112
17,3,0,0,0,617,0,0,0,617,683,1300,6,5,202112
17,4,0,0,0,349,0,0,0,349,1155,1504,6,5,202112
17,5,0,0,0,191,0,0,0,191,802,993,5,5,202112
18,1,0,0,0,104,0,0,0,104,632,736,7,5,202112
18,2,0,0,0,476,0,0,0,476,2354,2830,8,5,202112
18,3,0,0,0,287,0,0,0,287,661,948,8,4.25,202112
19,1,0,0,0,431,0,0,0,431,1302,1733,9,4,202112
19,2,0,0,0,682,0,0,0,682,1142,1824,9,5,202112
19,3,0,0,0,541,0,0,0,541,2630,3171,7,4,202112
19,4,0,0,0,304,0,0,0,304,517,821,5,5,202112
19,5,0,0,0,763,0,0,0,763,2242,3005,8,5,202112
19,6,0,0,0,251,0,0,0,251,675,926,5,5,202112
19,7,0,0,0,210,0,0,0,210,776,986,10,5,202112
19,8,0,0,0,219,0,0,0,219,484,703,7,5,202112
19,9,0,0,0,86,0,0,0,86,907,993,9,5,202112
19,10,0,0,0,361,0,0,0,361,577,938,5,4,202112
19,11,0,0,0,851,0,0,0,851,1346,2197,13,5,202112
19,12,0,0,0,266,0,0,0,266,1471,1737,13,4.666666667,202112
20,1,0,0,0,216,0,0,0,216,954,1170,7,5,202112
20,2,0,0,0,33,0,0,0,33,1315,1348,6,5,202112
20,3,0,0,0,110,0,0,0,110,508,618,6,5,202112
20,4,0,0,0,69,0,0,0,69,730,799,6,4.666666667,202112
20,5,0,0,0,145,0,0,0,145,1111,1256,11,5,202112
20,6,0,0,0,54,0,0,0,54,833,887,8,5,202112
20,7,0,0,0,199,0,0,0,199,2154,2353,7,5,202112
20,8,0,0,0,968,0,0,0,968,3927,4895,13,4,202112
20,9,0,0,0,221,0,0,0,221,1033,1254,8,5,202112
20,10,0,0,0,74,0,0,0,74,631,705,9,5,202112
21,1,0,0,0,219,0,0,0,219,873,1092,9,5,202112
21,2,0,0,0,140,0,0,0,140,969,1109,9,5,202112
21,3,0,0,0,303,0,0,0,303,1266,1569,8,5,202112
21,4,0,0,0,87,0,0,0,87,558,645,6,4.25,202112
21,5,0,0,0,374,0,0,0,374,1080,1454,7,4.666666667,202112
21,6,0,0,0,474,0,0,0,474,714,1188,5,5,202112
21,7,0,0,0,347,0,0,0,347,589,936,9,4.333333333,202112
21,8,0,0,0,90,0,0,0,90,1460,1550,9,5,202112
21,9,0,0,0,549,0,0,0,549,2660,3209,8,5,202112
21,10,0,0,0,436,0,0,0,436,1996,2432,6,5,202112
21,11,0,0,0,227,0,0,0,227,1112,1339,4,5,202112
21,12,0,0,0,843,0,0,0,843,3332,4175,15,5,202112
21,13,0,0,0,289,0,0,0,289,574,863,7,5,202112
21,14,0,0,0,225,0,0,0,225,723,948,8,4.833333333,202112
21,15,0,0,0,421,0,0,0,421,2618,3039,7,5,202112
22,1,0,0,0,92,0,0,0,92,413,505,11,4.8,202112
22,2,0,0,0,356,0,0,0,356,997,1353,7,5,202112
22,3,0,0,0,781,0,0,0,781,3134,3915,7,4.666666667,202112
22,4,0,0,0,729,0,0,0,729,1966,2695,8,4.5,202112
22,5,0,0,0,158,0,0,0,158,945,1103,10,4,202112
23,1,0,0,0,754,0,0,0,754,2871,3625,14,5,202112
23,2,0,0,0,256,0,0,0,256,597,853,10,5,202112
23,3,0,0,0,601,0,0,0,601,1880,2481,19,5,202112
23,4,0,0,0,422,0,0,0,422,503,925,6,5,202112
24,1,0,0,0,71,0,0,0,71,783,854,10,5,202112
24,2,0,0,0,126,0,0,0,126,1073,1199,6,5,202112
24,3,0,0,0,53,0,0,0,53,271,324,9,5,202112
24,4,0,0,0,193,0,0,0,193,1187,1380,5,5,202112
24,5,0,0,0,550,0,0,0,550,1084,1634,9,4.666666667,202112
24,6,0,0,0,528,0,0,0,528,1250,1778,4,5,202112
24,7,0,0,0,90,0,0,0,90,370,460,9,5,202112
25,1,0,0,0,382,0,0,0,382,693,1075,10,5,202112
25,2,0,0,0,436,0,0,0,436,713,1149,5,5,202112
25,3,0,0,0,232,0,0,0,232,549,781,7,5,202112
25,4,0,0,0,165,0,0,0,165,645,810,8,5,202112
25,5,0,0,0,449,0,0,0,449,888,1337,8,5,202112
25,6,0,0,0,312,0,0,0,312,735,1047,6,5,202112
25,7,0,0,0,486,0,0,0,486,855,1341,5,5,202112
26,1,0,0,0,337,0,0,0,337,1649,1986,9,4.5,202112
26,2,0,0,0,543,0,0,0,543,830,1373,12,5,202112
26,3,0,0,0,563,0,0,0,563,1094,1657,10,4,202112
26,4,0,0,0,187,0,0,0,187,556,743,9,5,202112
26,5,0,0,0,410,0,0,0,410,860,1270,14,4.5,202112
26,6,0,0,0,491,0,0,0,491,1725,2216,8,5,202112
26,7,0,0,0,303,0,0,0,303,479,782,10,5,202112
27,1,0,0,0,267,0,0,0,267,587,854,8,4.75,202112
27,2,0,0,0,323,0,0,0,323,554,877,8,4.666666667,202112
27,3,0,0,0,301,0,0,0,301,450,751,6,5,202112
27,4,0,0,0,717,0,0,0,717,1240,1957,7,5,202112
27,5,0,0,0,117,0,0,0,117,385,502,6,5,202112
27,6,0,0,0,411,0,0,0,411,711,1122,7,5,202112
28,1,0,0,0,312,0,0,0,312,722,1034,10,5,202112
28,2,0,0,0,491,0,0,0,491,1481,1972,13,5,202112
28,3,0,0,0,112,0,0,0,112,1116,1228,8,5,202112
28,4,0,0,0,395,0,0,0,395,1801,2196,13,5,202112
28,5,0,0,0,274,0,0,0,274,1019,1293,10,5,202112
28,6,0,0,0,93,0,0,0,93,264,357,13,5,202112
28,7,0,0,0,416,0,0,0,416,1055,1471,9,5,202112
28,8,0,0,0,241,0,0,0,241,684,925,12,5,202112
28,9,0,0,0,144,0,0,0,144,724,868,6,5,202112
29,1,0,0,0,651,0,0,0,651,1979,2630,8,4.75,202112
29,2,0,0,0,460,0,0,0,460,1748,2208,7,4.666666667,202112
29,3,0,0,0,348,0,0,0,348,1633,1981,5,4.666666667,202112
30,1,0,0,0,87,0,0,0,87,318,405,7,5,202112
30,2,0,0,0,73,0,0,0,73,789,862,10,5,202112
30,3,0,0,0,226,0,0,0,226,557,783,6,5,202112
30,4,0,0,0,311,0,0,0,311,1326,1637,8,5,202112
30,5,0,0,0,252,0,0,0,252,641,893,9,5,202112
30,6,0,0,0,119,0,0,0,119,801,920,9,5,202112
30,7,0,0,0,141,0,0,0,141,446,587,11,5,202112
30,8,0,0,0,246,0,0,0,246,528,774,11,5,202112
30,9,0,0,0,203,0,0,0,203,1331,1534,8,5,202112
30,10,0,0,0,463,0,0,0,463,874,1337,6,5,202112
30,11,0,0,0,375,0,0,0,375,660,1035,9,5,202112
30,12,0,0,0,641,0,0,0,641,1727,2368,10,5,202112
30,13,0,0,0,142,0,0,0,142,1126,1268,10,5,202112
30,14,0,0,0,161,0,0,0,161,927,1088,8,4.75,202112
30,15,0,0,0,416,0,0,0,416,1983,2399,11,5,202112
30,16,0,0,0,371,0,0,0,371,482,853,10,5,202112
30,17,0,0,0,189,0,0,0,189,415,604,8,5,202112
30,18,0,0,0,57,0,0,0,57,395,452,8,4.75,202112
30,19,0,0,0,105,0,0,0,105,368,473,11,4.75,202112
30,20,0,0,0,151,0,0,0,151,233,384,8,5,202112
31,1,0,0,0,146,0,0,0,146,868,1014,8,5,202112
31,2,0,0,0,58,0,0,0,58,265,323,6,5,202112
31,3,0,0,0,1002,0,0,0,1002,2628,3630,15,4.666666667,202112
31,4,0,0,0,377,0,0,0,377,1442,1819,4,5,202112
31,5,0,0,0,94,0,0,0,94,1494,1588,6,5,202112
32,1,0,0,0,150,0,0,0,150,785,935,12,4.8,202112
32,2,0,0,0,123,0,0,0,123,571,694,13,5,202112
32,3,0,0,0,214,0,0,0,214,843,1057,13,4.8,202112
32,4,0,0,0,217,0,0,0,217,834,1051,12,5,202112
1,1,0,0,0,187,0,0,0,187,397,584,13,4,202113
1,2,0,0,0,534,0,0,0,534,817,1351,8,4,202113
1,3,0,0,0,402,0,0,0,402,687,1089,6,4,202113
2,1,0,0,0,398,0,0,0,398,1212,1610,9,4,202113
2,2,0,0,0,334,0,0,0,334,600,934,7,4,202113
2,3,0,0,0,589,0,0,0,589,2423,3012,11,4,202113
2,4,0,0,0,420,0,0,0,420,635,1055,9,4,202113
2,5,0,0,0,596,0,0,0,596,880,1476,11,4,202113
2,6,0,0,0,430,0,0,0,430,1651,2081,7,4,202113
2,7,0,0,0,486,0,0,0,486,906,1392,12,4,202113
2,8,0,0,0,534,0,0,0,534,2228,2762,6,4,202113
3,1,0,0,0,329,0,0,0,329,517,846,12,4,202113
3,2,0,0,0,334,0,0,0,334,490,824,9,4,202113
4,1,0,0,0,320,0,0,0,320,628,948,9,4,202113
4,2,0,0,0,247,0,0,0,247,644,891,13,4,202113
5,1,0,0,0,357,0,0,0,357,671,1028,9,4,202113
5,2,0,0,0,70,0,0,0,70,308,378,10,4,202113
5,3,0,0,0,255,0,0,0,255,337,592,11,4,202113
5,4,0,0,0,509,0,0,0,509,1145,1654,10,4,202113
5,5,0,0,0,447,0,0,0,447,744,1191,10,4,202113
5,6,0,0,0,361,0,0,0,361,572,933,9,4,202113
5,7,0,0,0,271,0,0,0,271,620,891,8,4,202113
6,1,0,0,0,287,0,0,0,287,610,897,9,4,202113
6,2,0,0,0,257,0,0,0,257,1034,1291,8,4,202113
7,1,0,0,0,87,0,0,0,87,211,298,9,4,202113
7,2,0,0,0,56,0,0,0,56,520,576,9,4,202113
7,3,0,0,0,129,0,0,0,129,585,714,7,4,202113
7,4,0,0,0,108,0,0,0,108,424,532,11,4,202113
7,5,0,0,0,279,0,0,0,279,316,595,11,4,202113
7,6,0,0,0,318,0,0,0,318,575,893,8,4,202113
7,7,0,0,0,238,0,0,0,238,824,1062,8,4,202113
7,8,0,0,0,233,0,0,0,233,396,629,12,4,202113
7,9,0,0,0,437,0,0,0,437,634,1071,9,4,202113
7,10,0,0,0,140,0,0,0,140,1266,1406,9,4,202113
7,11,0,0,0,35,0,0,0,35,200,235,6,4,202113
7,12,0,0,0,412,0,0,0,412,524,936,9,4,202113
7,13,0,0,0,47,0,0,0,47,1071,1118,9,4,202113
8,1,0,0,0,168,0,0,0,168,413,581,2,4,202113
8,2,0,0,0,389,0,0,0,389,642,1031,16,4,202113
8,3,0,0,0,410,0,0,0,410,483,893,4,4,202113
8,4,0,0,0,379,0,0,0,379,521,900,10,4,202113
8,5,0,0,0,176,0,0,0,176,323,499,10,4,202113
8,6,0,0,0,305,0,0,0,305,480,785,7,4,202113
8,7,0,0,0,119,0,0,0,119,469,588,7,4,202113
8,8,0,0,0,500,0,0,0,500,733,1233,10,4,202113
8,9,0,0,0,60,0,0,0,60,931,991,10,4,202113
9,1,0,0,0,341,0,0,0,341,562,903,4,4,202113
9,2,0,0,0,1232,0,0,0,1232,2122,3354,12,4,202113
9,3,0,0,0,590,0,0,0,590,905,1495,7,4,202113
9,4,0,0,0,703,0,0,0,703,2272,2975,11,4,202113
9,5,0,0,0,473,0,0,0,473,1009,1482,7,4,202113
9,6,0,0,0,426,0,0,0,426,594,1020,7,4,202113
9,7,0,0,0,374,0,0,0,374,765,1139,9,4,202113
9,8,0,0,0,440,0,0,0,440,633,1073,5,4,202113
9,9,0,0,0,420,0,0,0,420,587,1007,4,4,202113
9,10,0,0,0,391,0,0,0,391,949,1340,4,4,202113
9,11,0,0,0,727,0,0,0,727,1354,2081,7,4,202113
9,12,0,0,0,673,0,0,0,673,1542,2215,10,4,202113
9,13,0,0,0,572,0,0,0,572,613,1185,4,4,202113
9,14,0,0,0,360,0,0,0,360,564,924,5,4,202113
9,15,0,0,0,958,0,0,0,958,1557,2515,9,4,202113
9,16,0,0,0,1021,0,0,0,1021,2129,3150,13,4,202113
9,17,0,0,0,445,0,0,0,445,685,1130,6,4,202113
9,18,0,0,0,606,0,0,0,606,1375,1981,12,4,202113
9,19,0,0,0,715,0,0,0,715,842,1557,5,4,202113
9,20,0,0,0,202,0,0,0,202,370,572,5,4,202113
9,21,0,0,0,270,0,0,0,270,461,731,3,4,202113
9,22,0,0,0,432,0,0,0,432,890,1322,5,4,202113
9,23,0,0,0,581,0,0,0,581,742,1323,6,4,202113
9,24,0,0,0,1026,0,0,0,1026,1407,2433,14,4,202113
10,1,0,0,0,224,0,0,0,224,1063,1287,15,4,202113
10,2,0,0,0,365,0,0,0,365,1396,1761,8,4,202113
10,3,0,0,0,144,0,0,0,144,713,857,11,4,202113
10,4,0,0,0,509,0,0,0,509,722,1231,11,4,202113
11,1,0,0,0,180,0,0,0,180,288,468,6,4,202113
11,2,0,0,0,274,0,0,0,274,455,729,7,4,202113
11,3,0,0,0,267,0,0,0,267,412,679,3,4,202113
11,4,0,0,0,194,0,0,0,194,244,438,7,4,202113
11,5,0,0,0,561,0,0,0,561,1070,1631,7,4,202113
11,6,0,0,0,305,0,0,0,305,701,1006,8,4,202113
11,7,0,0,0,219,0,0,0,219,402,621,9,4,202113
11,8,0,0,0,418,0,0,0,418,829,1247,9,4,202113
11,9,0,0,0,273,0,0,0,273,464,737,10,4,202113
11,10,0,0,0,269,0,0,0,269,891,1160,10,4,202113
11,11,0,0,0,426,0,0,0,426,868,1294,5,4,202113
11,12,0,0,0,534,0,0,0,534,878,1412,7,4,202113
11,13,0,0,0,186,0,0,0,186,304,490,8,4,202113
11,14,0,0,0,198,0,0,0,198,333,531,8,4,202113
11,15,0,0,0,339,0,0,0,339,466,805,7,4,202113
12,1,0,0,0,104,0,0,0,104,433,537,10,4,202113
12,2,0,0,0,301,0,0,0,301,490,791,6,4,202113
12,3,0,0,0,131,0,0,0,131,310,441,11,4,202113
12,4,0,0,0,378,0,0,0,378,555,933,9,4,202113
12,5,0,0,0,141,0,0,0,141,675,816,10,4,202113
12,6,0,0,0,85,0,0,0,85,204,289,10,4,202113
12,7,0,0,0,287,0,0,0,287,599,886,6,4,202113
12,8,0,0,0,113,0,0,0,113,334,447,9,4,202113
12,9,0,0,0,438,0,0,0,438,521,959,9,4,202113
13,1,0,0,0,98,0,0,0,98,244,342,9,4,202113
13,2,0,0,0,114,0,0,0,114,605,719,6,4,202113
13,3,0,0,0,214,0,0,0,214,306,520,11,4,202113
13,4,0,0,0,279,0,0,0,279,560,839,8,4,202113
13,5,0,0,0,338,0,0,0,338,718,1056,9,4,202113
13,6,0,0,0,708,0,0,0,708,973,1681,11,4,202113
13,7,0,0,0,373,0,0,0,373,575,948,8,4,202113
14,1,0,0,0,46,0,0,0,46,526,572,6,4,202113
14,2,0,0,0,94,0,0,0,94,698,792,5,4,202113
14,3,0,0,0,107,0,0,0,107,259,366,8,4,202113
14,4,0,0,0,413,0,0,0,413,784,1197,10,4,202113
14,5,0,0,0,268,0,0,0,268,741,1009,9,4,202113
14,6,0,0,0,525,0,0,0,525,1064,1589,8,4,202113
14,7,0,0,0,237,0,0,0,237,474,711,6,4,202113
14,8,0,0,0,766,0,0,0,766,1212,1978,10,4,202113
14,9,0,0,0,305,0,0,0,305,526,831,9,4,202113
14,10,0,0,0,454,0,0,0,454,845,1299,7,4,202113
14,11,0,0,0,316,0,0,0,316,598,914,4,4,202113
14,12,0,0,0,216,0,0,0,216,523,739,9,4,202113
14,13,0,0,0,368,0,0,0,368,660,1028,6,4,202113
14,14,0,0,0,349,0,0,0,349,637,986,7,4,202113
14,15,0,0,0,225,0,0,0,225,311,536,10,4,202113
14,16,0,0,0,383,0,0,0,383,353,736,6,4,202113
14,17,0,0,0,86,0,0,0,86,599,685,7,4,202113
14,18,0,0,0,160,0,0,0,160,730,890,9,4,202113
14,19,0,0,0,198,0,0,0,198,457,655,8,4,202113
14,20,0,0,0,165,0,0,0,165,536,701,10,4,202113
15,1,0,0,0,165,0,0,0,165,327,492,7,4,202113
15,2,0,0,0,425,0,0,0,425,565,990,6,4,202113
15,3,0,0,0,448,0,0,0,448,638,1086,10,4,202113
15,4,0,0,0,600,0,0,0,600,582,1182,4,4,202113
15,5,0,0,0,363,0,0,0,363,654,1017,8,4,202113
15,6,0,0,0,427,0,0,0,427,1020,1447,8,4,202113
15,7,0,0,0,539,0,0,0,539,1171,1710,10,4,202113
15,8,0,0,0,307,0,0,0,307,337,644,4,4,202113
15,9,0,0,0,191,0,0,0,191,348,539,9,4,202113
15,10,0,0,0,407,0,0,0,407,557,964,6,4,202113
15,11,0,0,0,545,0,0,0,545,665,1210,7,4,202113
15,12,0,0,0,560,0,0,0,560,909,1469,8,4,202113
15,13,0,0,0,412,0,0,0,412,526,938,4,4,202113
15,14,0,0,0,374,0,0,0,374,640,1014,4,4,202113
15,15,0,0,0,487,0,0,0,487,565,1052,6,4,202113
15,16,0,0,0,672,0,0,0,672,1132,1804,8,4,202113
15,17,0,0,0,293,0,0,0,293,732,1025,8,4,202113
15,18,0,0,0,542,0,0,0,542,951,1493,7,4,202113
15,19,0,0,0,794,0,0,0,794,1326,2120,10,4,202113
15,20,0,0,0,254,0,0,0,254,388,642,6,4,202113
15,21,0,0,0,200,0,0,0,200,308,508,6,4,202113
15,22,0,0,0,827,0,0,0,827,1352,2179,14,4,202113
15,23,0,0,0,275,0,0,0,275,498,773,6,4,202113
15,24,0,0,0,395,0,0,0,395,499,894,4,4,202113
15,25,0,0,0,540,0,0,0,540,1037,1577,6,4,202113
15,26,0,0,0,463,0,0,0,463,502,965,6,4,202113
15,27,0,0,0,592,0,0,0,592,1124,1716,9,4,202113
15,28,0,0,0,587,0,0,0,587,737,1324,9,4,202113
15,29,0,0,0,497,0,0,0,497,689,1186,7,4,202113
15,30,0,0,0,497,0,0,0,497,775,1272,16,4,202113
15,31,0,0,0,531,0,0,0,531,966,1497,6,4,202113
15,32,0,0,0,424,0,0,0,424,577,1001,8,4,202113
15,33,0,0,0,465,0,0,0,465,1035,1500,7,4,202113
15,34,0,0,0,345,0,0,0,345,483,828,6,4,202113
15,35,0,0,0,494,0,0,0,494,831,1325,8,4,202113
15,36,0,0,0,258,0,0,0,258,513,771,9,4,202113
15,37,0,0,0,509,0,0,0,509,887,1396,7,4,202113
15,38,0,0,0,391,0,0,0,391,196,587,5,4,202113
15,39,0,0,0,334,0,0,0,334,450,784,4,4,202113
15,40,0,0,0,545,0,0,0,545,1046,1591,9,4,202113
15,41,0,0,0,884,0,0,0,884,1167,2051,13,4,202113
16,1,0,0,0,141,0,0,0,141,537,678,7,4,202113
16,2,0,0,0,61,0,0,0,61,140,201,9,4,202113
16,3,0,0,0,148,0,0,0,148,443,591,10,4,202113
16,4,0,0,0,163,0,0,0,163,264,427,8,4,202113
16,5,0,0,0,207,0,0,0,207,245,452,10,4,202113
16,6,0,0,0,138,0,0,0,138,558,696,12,4,202113
16,7,0,0,0,228,0,0,0,228,515,743,9,4,202113
16,8,0,0,0,489,0,0,0,489,924,1413,12,4,202113
16,9,0,0,0,260,0,0,0,260,438,698,8,4,202113
16,10,0,0,0,272,0,0,0,272,386,658,5,4,202113
16,11,0,0,0,171,0,0,0,171,210,381,10,4,202113
16,12,0,0,0,119,0,0,0,119,329,448,10,4,202113
17,1,0,0,0,559,0,0,0,559,768,1327,4,4,202113
17,2,0,0,0,357,0,0,0,357,524,881,7,4,202113
17,3,0,0,0,514,0,0,0,514,546,1060,6,4,202113
17,4,0,0,0,367,0,0,0,367,496,863,6,4,202113
17,5,0,0,0,178,0,0,0,178,295,473,5,4,202113
18,1,0,0,0,92,0,0,0,92,214,306,7,4,202113
18,2,0,0,0,434,0,0,0,434,1137,1571,8,4,202113
18,3,0,0,0,241,0,0,0,241,511,752,8,4,202113
19,1,0,0,0,448,0,0,0,448,705,1153,9,4,202113
19,2,0,0,0,547,0,0,0,547,884,1431,9,4,202113
19,3,0,0,0,567,0,0,0,567,895,1462,7,4,202113
19,4,0,0,0,246,0,0,0,246,296,542,5,4,202113
19,5,0,0,0,633,0,0,0,633,1046,1679,8,4,202113
19,6,0,0,0,210,0,0,0,210,381,591,5,4,202113
19,7,0,0,0,181,0,0,0,181,470,651,10,4,202113
19,8,0,0,0,185,0,0,0,185,242,427,7,4,202113
19,9,0,0,0,80,0,0,0,80,388,468,9,4,202113
19,10,0,0,0,317,0,0,0,317,416,733,5,4,202113
19,11,0,0,0,689,0,0,0,689,970,1659,13,4,202113
19,12,0,0,0,310,0,0,0,310,913,1223,13,4,202113
20,1,0,0,0,196,0,0,0,196,390,586,7,4,202113
20,2,0,0,0,24,0,0,0,24,920,944,6,4,202113
20,3,0,0,0,88,0,0,0,88,730,818,6,4,202113
20,4,0,0,0,68,0,0,0,68,489,557,6,4,202113
20,5,0,0,0,124,0,0,0,124,920,1044,11,4,202113
20,6,0,0,0,72,0,0,0,72,1082,1154,8,4,202113
20,7,0,0,0,192,0,0,0,192,825,1017,7,4,202113
20,8,0,0,0,919,0,0,0,919,1500,2419,13,4,202113
20,9,0,0,0,200,0,0,0,200,860,1060,8,4,202113
20,10,0,0,0,79,0,0,0,79,756,835,9,4,202113
21,1,0,0,0,165,0,0,0,165,371,536,9,4,202113
21,2,0,0,0,84,0,0,0,84,383,467,9,4,202113
21,3,0,0,0,267,0,0,0,267,952,1219,8,4,202113
21,4,0,0,0,67,0,0,0,67,405,472,6,4,202113
21,5,0,0,0,350,0,0,0,350,657,1007,7,4,202113
21,6,0,0,0,463,0,0,0,463,620,1083,5,4,202113
21,7,0,0,0,312,0,0,0,312,1133,1445,9,4,202113
21,8,0,0,0,113,0,0,0,113,718,831,9,4,202113
21,9,0,0,0,541,0,0,0,541,1100,1641,8,4,202113
21,10,0,0,0,405,0,0,0,405,1124,1529,6,4,202113
21,11,0,0,0,217,0,0,0,217,696,913,4,4,202113
21,12,0,0,0,737,0,0,0,737,1507,2244,15,4,202113
21,13,0,0,0,264,0,0,0,264,275,539,7,4,202113
21,14,0,0,0,162,0,0,0,162,454,616,8,4,202113
21,15,0,0,0,357,0,0,0,357,1264,1621,7,4,202113
22,1,0,0,0,105,0,0,0,105,361,466,11,4,202113
22,2,0,0,0,274,0,0,0,274,504,778,7,4,202113
22,3,0,0,0,712,0,0,0,712,1407,2119,7,4,202113
22,4,0,0,0,696,0,0,0,696,1139,1835,8,4,202113
22,5,0,0,0,238,0,0,0,238,556,794,10,4,202113
23,1,0,0,0,654,0,0,0,654,1931,2585,14,4,202113
23,2,0,0,0,199,0,0,0,199,479,678,10,4,202113
23,3,0,0,0,520,0,0,0,520,831,1351,19,4,202113
23,4,0,0,0,364,0,0,0,364,563,927,6,4,202113
24,1,0,0,0,85,0,0,0,85,308,393,10,4,202113
24,2,0,0,0,96,0,0,0,96,371,467,6,4,202113
24,3,0,0,0,68,0,0,0,68,271,339,9,4,202113
24,4,0,0,0,186,0,0,0,186,484,670,5,4,202113
24,5,0,0,0,531,0,0,0,531,875,1406,9,4,202113
24,6,0,0,0,442,0,0,0,442,867,1309,4,4,202113
24,7,0,0,0,86,0,0,0,86,259,345,9,4,202113
25,1,0,0,0,326,0,0,0,326,587,913,10,4,202113
25,2,0,0,0,414,0,0,0,414,522,936,5,4,202113
25,3,0,0,0,224,0,0,0,224,530,754,7,4,202113
25,4,0,0,0,167,0,0,0,167,373,540,8,4,202113
25,5,0,0,0,382,0,0,0,382,655,1037,8,4,202113
25,6,0,0,0,279,0,0,0,279,506,785,6,4,202113
25,7,0,0,0,449,0,0,0,449,621,1070,5,4,202113
26,1,0,0,0,311,0,0,0,311,627,938,9,4,202113
26,2,0,0,0,491,0,0,0,491,679,1170,12,4,202113
26,3,0,0,0,558,0,0,0,558,1157,1715,9,4,202113
26,4,0,0,0,200,0,0,0,200,368,568,9,4,202113
26,5,0,0,0,352,0,0,0,352,618,970,14,4,202113
26,6,0,0,0,423,0,0,0,423,911,1334,8,4,202113
26,7,0,0,0,291,0,0,0,291,538,829,10,4,202113
27,1,0,0,0,190,0,0,0,190,323,513,8,4,202113
27,2,0,0,0,241,0,0,0,241,383,624,8,4,202113
27,3,0,0,0,255,0,0,0,255,389,644,6,4,202113
27,4,0,0,0,492,0,0,0,492,779,1271,7,4,202113
27,5,0,0,0,92,0,0,0,92,447,539,6,4,202113
27,6,0,0,0,345,0,0,0,345,501,846,7,4,202113
28,1,0,0,0,328,0,0,0,328,485,813,13,4,202113
28,2,0,0,0,405,0,0,0,405,816,1221,15,4,202113
28,3,0,0,0,97,0,0,0,97,373,470,7,4,202113
28,4,0,0,0,341,0,0,0,341,1073,1414,13,4,202113
28,5,0,0,0,258,0,0,0,258,482,740,10,4,202113
28,6,0,0,0,65,0,0,0,65,221,286,13,4,202113
28,7,0,0,0,355,0,0,0,355,542,897,11,4,202113
28,8,0,0,0,204,0,0,0,204,517,721,12,4,202113
28,9,0,0,0,116,0,0,0,116,260,376,6,4,202113
29,1,0,0,0,386,0,0,0,386,2702,3088,7,3,202113
29,2,0,0,0,418,0,0,0,418,1848,2266,7,4,202113
29,3,0,0,0,241,0,0,0,241,1077,1318,5,4,202113
30,1,0,0,0,62,0,0,0,62,150,212,7,4,202113
30,2,0,0,0,61,0,0,0,61,906,967,10,4,202113
30,3,0,0,0,174,0,0,0,174,258,432,6,4,202113
30,4,0,0,0,270,0,0,0,270,555,825,8,4,202113
30,5,0,0,0,241,0,0,0,241,410,651,9,4,202113
30,6,0,0,0,108,0,0,0,108,676,784,9,4,202113
30,7,0,0,0,115,0,0,0,115,766,881,11,4,202113
30,8,0,0,0,232,0,0,0,232,386,618,11,4,202113
30,9,0,0,0,144,0,0,0,144,458,602,8,4,202113
30,10,0,0,0,460,0,0,0,460,508,968,6,4,202113
30,11,0,0,0,325,0,0,0,325,571,896,9,4,202113
30,12,0,0,0,657,0,0,0,657,864,1521,10,4,202113
30,13,0,0,0,128,0,0,0,128,376,504,10,4,202113
30,14,0,0,0,153,0,0,0,153,1345,1498,8,4,202113
30,15,0,0,0,354,0,0,0,354,601,955,11,4,202113
30,16,0,0,0,360,0,0,0,360,464,824,10,4,202113
30,17,0,0,0,193,0,0,0,193,404,597,8,4,202113
30,18,0,0,0,29,0,0,0,29,420,449,8,4,202113
30,19,0,0,0,111,0,0,0,111,172,283,11,4,202113
30,20,0,0,0,137,0,0,0,137,240,377,8,4,202113
31,1,0,0,0,122,0,0,0,122,551,673,8,4,202113
31,2,0,0,0,46,0,0,0,46,405,451,6,4,202113
31,3,0,0,0,840,0,0,0,840,1604,2444,15,4,202113
31,4,0,0,0,319,0,0,0,319,807,1126,4,4,202113
31,5,0,0,0,92,0,0,0,92,1122,1214,6,4,202113
32,1,0,0,0,164,0,0,0,164,360,524,12,4,202113
32,2,0,0,0,86,0,0,0,86,281,367,13,4,202113
32,3,0,0,0,228,0,0,0,228,364,592,13,4,202113
32,4,0,0,0,231,0,0,0,231,466,697,12,4,202113
1,1,0,0,0,213,0,0,0,213,315,528,13,5,202114
1,2,0,0,0,633,0,0,0,633,767,1400,8,5,202114
1,3,0,0,0,451,0,0,0,451,599,1050,6,5,202114
2,1,0,0,0,489,0,0,0,489,853,1342,9,5,202114
2,2,0,0,0,416,0,0,0,416,489,905,7,5,202114
2,3,0,0,0,683,0,0,0,683,2014,2697,11,5,202114
2,4,0,0,0,507,0,0,0,507,728,1235,9,5,202114
2,5,0,0,0,753,0,0,0,753,838,1591,11,5,202114
2,6,0,0,0,555,0,0,0,555,1355,1910,7,5,202114
2,7,0,0,0,624,0,0,0,624,772,1396,12,5,202114
2,8,0,0,0,674,0,0,0,674,1062,1736,6,5,202114
3,1,0,0,0,351,0,0,0,351,611,962,12,5,202114
3,2,0,0,0,294,0,0,0,294,649,943,9,5,202114
4,1,0,0,0,388,0,0,0,388,469,857,9,5,202114
4,2,0,0,0,254,0,0,0,254,510,764,13,5,202114
5,1,0,0,0,422,0,0,0,422,683,1105,9,5,202114
5,2,0,0,0,96,0,0,0,96,292,388,10,5,202114
5,3,0,0,0,311,0,0,0,311,387,698,11,5,202114
5,4,0,0,0,580,0,0,0,580,992,1572,11,5,202114
5,5,0,0,0,553,0,0,0,553,706,1259,10,5,202114
5,6,0,0,0,380,0,0,0,380,691,1071,9,5,202114
5,7,0,0,0,339,0,0,0,339,681,1020,8,5,202114
6,1,0,0,0,324,0,0,0,324,527,851,9,5,202114
6,2,0,0,0,313,0,0,0,313,1188,1501,8,5,202114
7,1,0,0,0,76,0,0,0,76,209,285,9,5,202114
7,2,0,0,0,86,0,0,0,86,161,247,9,5,202114
7,3,0,0,0,140,0,0,0,140,946,1086,7,5,202114
7,4,0,0,0,125,0,0,0,125,668,793,11,5,202114
7,5,0,0,0,303,0,0,0,303,390,693,11,5,202114
7,6,0,0,0,437,0,0,0,437,1101,1538,8,5,202114
7,7,0,0,0,279,0,0,0,279,620,899,8,5,202114
7,8,0,0,0,303,0,0,0,303,383,686,12,5,202114
7,9,0,0,0,544,0,0,0,544,786,1330,9,5,202114
7,10,0,0,0,134,0,0,0,134,1624,1758,9,5,202114
7,11,0,0,0,37,0,0,0,37,115,152,6,5,202114
7,12,0,0,0,467,0,0,0,467,488,955,9,5,202114
7,13,0,0,0,40,0,0,0,40,710,750,9,5,202114
8,1,0,0,0,227,0,0,0,227,328,555,2,5,202114
8,2,0,0,0,470,0,0,0,470,747,1217,16,5,202114
8,3,0,0,0,449,0,0,0,449,759,1208,4,5,202114
8,4,0,0,0,419,0,0,0,419,635,1054,10,5,202114
8,5,0,0,0,189,0,0,0,189,303,492,10,5,202114
8,6,0,0,0,448,0,0,0,448,471,919,7,5,202114
8,7,0,0,0,147,0,0,0,147,268,415,7,5,202114
8,8,0,0,0,623,0,0,0,623,709,1332,10,5,202114
8,9,0,0,0,71,0,0,0,71,455,526,10,5,202114
9,1,0,0,0,395,0,0,0,395,649,1044,4,5,202114
9,2,0,0,0,1433,0,0,0,1433,1830,3263,12,5,202114
9,3,0,0,0,747,0,0,0,747,928,1675,7,5,202114
9,4,0,0,0,734,0,0,0,734,1323,2057,11,5,202114
9,5,0,0,0,556,0,0,0,556,988,1544,7,5,202114
9,6,0,0,0,469,0,0,0,469,625,1094,7,5,202114
9,7,0,0,0,432,0,0,0,432,644,1076,9,5,202114
9,8,0,0,0,513,0,0,0,513,637,1150,5,5,202114
9,9,0,0,0,462,0,0,0,462,625,1087,4,5,202114
9,10,0,0,0,534,0,0,0,534,756,1290,4,5,202114
9,11,0,0,0,860,0,0,0,860,1536,2396,7,5,202114
9,12,0,0,0,771,0,0,0,771,1998,2769,10,5,202114
9,13,0,0,0,767,0,0,0,767,748,1515,4,5,202114
9,14,0,0,0,463,0,0,0,463,603,1066,5,5,202114
9,15,0,0,0,1081,0,0,0,1081,1702,2783,9,5,202114
9,16,0,0,0,1195,0,0,0,1195,2344,3539,13,5,202114
9,17,0,0,0,485,0,0,0,485,630,1115,6,5,202114
9,18,0,0,0,655,0,0,0,655,1681,2336,12,5,202114
9,19,0,0,0,787,0,0,0,787,1549,2336,5,5,202114
9,20,0,0,0,237,0,0,0,237,373,610,5,5,202114
9,21,0,0,0,271,0,0,0,271,375,646,3,5,202114
9,22,0,0,0,423,0,0,0,423,980,1403,5,5,202114
9,23,0,0,0,639,0,0,0,639,677,1316,6,5,202114
9,24,0,0,0,1218,0,0,0,1218,1707,2925,14,5,202114
10,1,0,0,0,225,0,0,0,225,1065,1290,15,4.666666667,202114
10,2,0,0,0,351,0,0,0,351,679,1030,8,5,202114
10,3,0,0,0,171,0,0,0,171,397,568,11,5,202114
10,4,0,0,0,589,0,0,0,589,794,1383,11,5,202114
11,1,0,0,0,204,0,0,0,204,276,480,6,5,202114
11,2,0,0,0,301,0,0,0,301,314,615,7,5,202114
11,3,0,0,0,318,0,0,0,318,474,792,3,5,202114
11,4,0,0,0,203,0,0,0,203,285,488,7,5,202114
11,5,0,0,0,681,0,0,0,681,854,1535,7,5,202114
11,6,0,0,0,297,0,0,0,297,660,957,8,5,202114
11,7,0,0,0,245,0,0,0,245,476,721,9,5,202114
11,8,0,0,0,499,0,0,0,499,668,1167,9,5,202114
11,9,0,0,0,252,0,0,0,252,449,701,10,5,202114
11,10,0,0,0,267,0,0,0,267,858,1125,10,5,202114
11,11,0,0,0,513,0,0,0,513,948,1461,5,5,202114
11,12,0,0,0,621,0,0,0,621,853,1474,7,5,202114
11,13,0,0,0,160,0,0,0,160,284,444,8,5,202114
11,14,0,0,0,221,0,0,0,221,297,518,8,5,202114
11,15,0,0,0,323,0,0,0,323,490,813,7,5,202114
12,1,0,0,0,128,0,0,0,128,264,392,10,5.2,202114
12,2,0,0,0,329,0,0,0,329,563,892,6,6,202114
12,3,0,0,0,157,0,0,0,157,288,445,11,5.2,202114
12,4,0,0,0,484,0,0,0,484,587,1071,9,5.666666667,202114
12,5,0,0,0,99,0,0,0,99,227,326,10,5.25,202114
12,6,0,0,0,87,0,0,0,87,167,254,10,5.25,202114
12,7,0,0,0,339,0,0,0,339,425,764,6,5.5,202114
12,8,0,0,0,102,0,0,0,102,501,603,9,5.25,202114
12,9,0,0,0,499,0,0,0,499,646,1145,9,5.666666667,202114
13,1,0,0,0,101,0,0,0,101,222,323,9,5,202114
13,2,0,0,0,132,0,0,0,132,169,301,6,5,202114
13,3,0,0,0,244,0,0,0,244,313,557,11,5,202114
13,4,0,0,0,338,0,0,0,338,696,1034,8,5,202114
13,5,0,0,0,413,0,0,0,413,685,1098,9,5,202114
13,6,0,0,0,908,0,0,0,908,988,1896,11,5,202114
13,7,0,0,0,421,0,0,0,421,556,977,8,5,202114
14,1,0,0,0,71,0,0,0,71,210,281,6,5,202114
14,2,0,0,0,111,0,0,0,111,242,353,5,5,202114
14,3,0,0,0,111,0,0,0,111,307,418,8,5,202114
14,4,0,0,0,492,0,0,0,492,661,1153,10,5,202114
14,5,0,0,0,316,0,0,0,316,526,842,9,5,202114
14,6,0,0,0,571,0,0,0,571,1027,1598,8,5,202114
14,7,0,0,0,297,0,0,0,297,312,609,6,5,202114
14,8,0,0,0,876,0,0,0,876,1136,2012,10,5,202114
14,9,0,0,0,345,0,0,0,345,475,820,9,5,202114
14,10,0,0,0,500,0,0,0,500,794,1294,7,5,202114
14,11,0,0,0,361,0,0,0,361,518,879,4,5,202114
14,12,0,0,0,227,0,0,0,227,411,638,9,5,202114
14,13,0,0,0,514,0,0,0,514,726,1240,6,5,202114
14,14,0,0,0,327,0,0,0,327,556,883,7,5,202114
14,15,0,0,0,251,0,0,0,251,282,533,10,5,202114
14,16,0,0,0,438,0,0,0,438,533,971,6,5,202114
14,17,0,0,0,78,0,0,0,78,382,460,7,5,202114
14,18,0,0,0,215,0,0,0,215,762,977,9,5,202114
14,19,0,0,0,212,0,0,0,212,458,670,8,5,202114
14,20,0,0,0,203,0,0,0,203,497,700,10,5,202114
15,1,0,0,0,152,0,0,0,152,443,595,7,5,202114
15,2,0,0,0,540,0,0,0,540,660,1200,6,5,202114
15,3,0,0,0,456,0,0,0,456,669,1125,10,5,202114
15,4,0,0,0,664,0,0,0,664,854,1518,4,5,202114
15,5,0,0,0,383,0,0,0,383,550,933,8,5,202114
15,6,0,0,0,488,0,0,0,488,659,1147,8,5,202114
15,7,0,0,0,628,0,0,0,628,1235,1863,10,5,202114
15,8,0,0,0,329,0,0,0,329,428,757,4,5,202114
15,9,0,0,0,253,0,0,0,253,361,614,9,5,202114
15,10,0,0,0,495,0,0,0,495,538,1033,6,5,202114
15,11,0,0,0,540,0,0,0,540,729,1269,7,5,202114
15,12,0,0,0,624,0,0,0,624,886,1510,8,5,202114
15,13,0,0,0,504,0,0,0,504,586,1090,4,5,202114
15,14,0,0,0,394,0,0,0,394,615,1009,4,5,202114
15,15,0,0,0,530,0,0,0,530,482,1012,6,5,202114
15,16,0,0,0,690,0,0,0,690,933,1623,8,5,202114
15,17,0,0,0,349,0,0,0,349,484,833,8,5,202114
15,18,0,0,0,627,0,0,0,627,886,1513,7,5,202114
15,19,0,0,0,897,0,0,0,897,1693,2590,10,5,202114
15,20,0,0,0,302,0,0,0,302,385,687,6,5,202114
15,21,0,0,0,240,0,0,0,240,294,534,6,5,202114
15,22,0,0,0,918,0,0,0,918,1317,2235,14,5,202114
15,23,0,0,0,288,0,0,0,288,451,739,6,5,202114
15,24,0,0,0,427,0,0,0,427,542,969,4,5,202114
15,25,0,0,0,628,0,0,0,628,882,1510,6,5,202114
15,26,0,0,0,554,0,0,0,554,693,1247,6,5,202114
15,27,0,0,0,631,0,0,0,631,1052,1683,9,5,202114
15,28,0,0,0,774,0,0,0,774,798,1572,9,5,202114
15,29,0,0,0,596,0,0,0,596,652,1248,7,5,202114
15,30,0,0,0,505,0,0,0,505,897,1402,16,5,202114
15,31,0,0,0,628,0,0,0,628,1353,1981,6,5,202114
15,32,0,0,0,500,0,0,0,500,604,1104,8,5,202114
15,33,0,0,0,543,0,0,0,543,662,1205,7,5,202114
15,34,0,0,0,415,0,0,0,415,502,917,6,5,202114
15,35,0,0,0,522,0,0,0,522,727,1249,8,5,202114
15,36,0,0,0,252,0,0,0,252,581,833,9,5,202114
15,37,0,0,0,608,0,0,0,608,869,1477,7,5,202114
15,38,0,0,0,438,0,0,0,438,551,989,5,5,202114
15,39,0,0,0,346,0,0,0,346,426,772,4,5,202114
15,40,0,0,0,651,0,0,0,651,1110,1761,9,5,202114
15,41,0,0,0,987,0,0,0,987,1050,2037,13,5,202114
16,1,0,0,0,167,0,0,0,167,170,337,7,5,202114
16,2,0,0,0,50,0,0,0,50,150,200,9,5,202114
16,3,0,0,0,173,0,0,0,173,322,495,10,5,202114
16,4,0,0,0,235,0,0,0,235,277,512,8,5,202114
16,5,0,0,0,233,0,0,0,233,260,493,10,5,202114
16,6,0,0,0,181,0,0,0,181,353,534,12,5,202114
16,7,0,0,0,257,0,0,0,257,415,672,9,5,202114
16,8,0,0,0,582,0,0,0,582,741,1323,12,5,202114
16,9,0,0,0,319,0,0,0,319,369,688,8,5,202114
16,10,0,0,0,326,0,0,0,326,414,740,5,5,202114
16,11,0,0,0,191,0,0,0,191,246,437,8,4,202114
16,12,0,0,0,138,0,0,0,138,425,563,10,5,202114
17,1,0,0,0,642,0,0,0,642,740,1382,4,5,202114
17,2,0,0,0,407,0,0,0,407,574,981,7,5,202114
17,3,0,0,0,574,0,0,0,574,660,1234,6,5,202114
17,4,0,0,0,389,0,0,0,389,550,939,6,5,202114
17,5,0,0,0,178,0,0,0,178,283,461,5,5,202114
18,1,0,0,0,107,0,0,0,107,200,307,7,5,202114
18,2,0,0,0,499,0,0,0,499,741,1240,8,5,202114
18,3,0,0,0,270,0,0,0,270,553,823,8,5,202114
19,1,0,0,0,561,0,0,0,561,1324,1885,9,5,202114
19,2,0,0,0,741,0,0,0,741,780,1521,9,5,202114
19,3,0,0,0,501,0,0,0,501,741,1242,7,4,202114
19,4,0,0,0,282,0,0,0,282,364,646,5,5,202114
19,5,0,0,0,848,0,0,0,848,1076,1924,8,5,202114
19,6,0,0,0,259,0,0,0,259,399,658,5,5,202114
19,7,0,0,0,242,0,0,0,242,416,658,10,5,202114
19,8,0,0,0,197,0,0,0,197,219,416,7,5,202114
19,9,0,0,0,87,0,0,0,87,333,420,9,5,202114
19,10,0,0,0,400,0,0,0,400,557,957,5,5,202114
19,11,0,0,0,848,0,0,0,848,1022,1870,13,5,202114
19,12,0,0,0,320,0,0,0,320,571,891,13,5,202114
20,1,0,0,0,167,0,0,0,167,750,917,7,4,202114
20,2,0,0,0,33,0,0,0,33,195,228,6,5,202114
20,3,0,0,0,107,0,0,0,107,452,559,6,5,202114
20,4,0,0,0,67,0,0,0,67,212,279,6,5,202114
20,5,0,0,0,154,0,0,0,154,848,1002,11,5,202114
20,6,0,0,0,76,0,0,0,76,810,886,8,5,202114
20,7,0,0,0,183,0,0,0,183,371,554,7,5,202114
20,8,0,0,0,957,0,0,0,957,1476,2433,13,5,202114
20,9,0,0,0,233,0,0,0,233,798,1031,8,5,202114
20,10,0,0,0,63,0,0,0,63,596,659,9,5,202114
21,1,0,0,0,211,0,0,0,211,355,566,9,5,202114
21,2,0,0,0,120,0,0,0,120,265,385,9,5,202114
21,3,0,0,0,273,0,0,0,273,606,879,8,5,202114
21,4,0,0,0,73,0,0,0,73,270,343,6,5,202114
21,5,0,0,0,396,0,0,0,396,615,1011,7,5,202114
21,6,0,0,0,500,0,0,0,500,666,1166,5,5,202114
21,7,0,0,0,326,0,0,0,326,685,1011,9,5,202114
21,8,0,0,0,97,0,0,0,97,298,395,9,5,202114
21,9,0,0,0,593,0,0,0,593,1098,1691,8,5,202114
21,10,0,0,0,537,0,0,0,537,828,1365,6,5,202114
21,11,0,0,0,225,0,0,0,225,591,816,4,5,202114
21,12,0,0,0,929,0,0,0,929,1208,2137,15,5,202114
21,13,0,0,0,322,0,0,0,322,491,813,7,5,202114
21,14,0,0,0,165,0,0,0,165,355,520,8,5,202114
21,15,0,0,0,384,0,0,0,384,586,970,7,5,202114
22,1,0,0,0,122,0,0,0,122,293,415,11,5,202114
22,2,0,0,0,336,0,0,0,336,573,909,7,5,202114
22,3,0,0,0,867,0,0,0,867,1230,2097,7,5,202114
22,4,0,0,0,777,0,0,0,777,1073,1850,8,5,202114
22,5,0,0,0,365,0,0,0,365,535,900,10,5,202114
23,1,0,0,0,746,0,0,0,746,1164,1910,14,5,202114
23,2,0,0,0,247,0,0,0,247,514,761,10,5,202114
23,3,0,0,0,623,0,0,0,623,915,1538,19,5,202114
23,4,0,0,0,411,0,0,0,411,470,881,6,5,202114
24,1,0,0,0,93,0,0,0,93,274,367,10,5,202114
24,2,0,0,0,132,0,0,0,132,281,413,6,5,202114
24,3,0,0,0,85,0,0,0,85,300,385,9,5,202114
24,4,0,0,0,204,0,0,0,204,372,576,5,5,202114
24,5,0,0,0,606,0,0,0,606,716,1322,9,5,202114
24,6,0,0,0,589,0,0,0,589,738,1327,4,5,202114
24,7,0,0,0,105,0,0,0,105,357,462,9,5,202114
25,1,0,0,0,382,0,0,0,382,651,1033,10,5,202114
25,2,0,0,0,524,0,0,0,524,597,1121,5,5,202114
25,3,0,0,0,287,0,0,0,287,444,731,7,5,202114
25,4,0,0,0,177,0,0,0,177,293,470,8,5,202114
25,5,0,0,0,435,0,0,0,435,595,1030,8,5,202114
25,6,0,0,0,327,0,0,0,327,464,791,6,5,202114
25,7,0,0,0,550,0,0,0,550,596,1146,5,5,202114
26,1,0,0,0,326,0,0,0,326,559,885,9,5,202114
26,2,0,0,0,522,0,0,0,522,719,1241,12,5,202114
26,3,0,0,0,670,0,0,0,670,856,1526,9,5,202114
26,4,0,0,0,218,0,0,0,218,450,668,9,5,202114
26,5,0,0,0,387,0,0,0,387,767,1154,14,5,202114
26,6,0,0,0,640,0,0,0,640,945,1585,8,5,202114
26,7,0,0,0,311,0,0,0,311,454,765,10,5,202114
27,1,0,0,0,243,0,0,0,243,353,596,8,5,202114
27,2,0,0,0,299,0,0,0,299,395,694,8,5,202114
27,3,0,0,0,332,0,0,0,332,460,792,6,5,202114
27,4,0,0,0,688,0,0,0,688,794,1482,7,5,202114
27,5,0,0,0,110,0,0,0,110,252,362,6,5,202114
27,6,0,0,0,395,0,0,0,395,441,836,7,5,202114
28,1,0,0,0,372,0,0,0,372,404,776,10,5,202114
28,2,0,0,0,525,0,0,0,525,669,1194,13,5,202114
28,3,0,0,0,129,0,0,0,129,301,430,8,5,202114
28,4,0,0,0,2275,0,0,0,2275,802,3077,13,5,202114
28,5,0,0,0,365,0,0,0,365,293,658,10,5,202114
28,6,0,0,0,118,0,0,0,118,202,320,13,5,202114
28,7,0,0,0,412,0,0,0,412,549,961,9,5,202114
28,8,0,0,0,268,0,0,0,268,325,593,12,5,202114
28,9,0,0,0,106,0,0,0,106,227,333,6,5,202114
29,1,0,0,0,468,0,0,0,468,977,1445,8,5,202114
29,2,0,0,0,519,0,0,0,519,1381,1900,7,5,202114
29,3,0,0,0,332,0,0,0,332,555,887,5,5,202114
30,1,0,0,0,75,0,0,0,75,154,229,7,5,202114
30,2,0,0,0,72,0,0,0,72,471,543,10,5,202114
30,3,0,0,0,193,0,0,0,193,472,665,6,5,202114
30,4,0,0,0,279,0,0,0,279,399,678,8,5,202114
30,5,0,0,0,240,0,0,0,240,348,588,9,5,202114
30,6,0,0,0,109,0,0,0,109,248,357,9,5,202114
30,7,0,0,0,162,0,0,0,162,397,559,11,5,202114
30,8,0,0,0,260,0,0,0,260,503,763,11,5,202114
30,9,0,0,0,234,0,0,0,234,314,548,8,5,202114
30,10,0,0,0,481,0,0,0,481,670,1151,6,5,202114
30,11,0,0,0,391,0,0,0,391,474,865,9,5,202114
30,12,0,0,0,792,0,0,0,792,842,1634,10,5,202114
30,13,0,0,0,160,0,0,0,160,297,457,10,5,202114
30,14,0,0,0,160,0,0,0,160,404,564,8,5,202114
30,15,0,0,0,400,0,0,0,400,815,1215,11,5,202114
30,16,0,0,0,334,0,0,0,334,490,824,10,5,202114
30,17,0,0,0,228,0,0,0,228,547,775,8,5,202114
30,18,0,0,0,40,0,0,0,40,275,315,8,5,202114
30,19,0,0,0,129,0,0,0,129,188,317,11,5,202114
30,20,0,0,0,147,0,0,0,147,286,433,8,5,202114
31,1,0,0,0,226,0,0,0,226,358,584,8,5,202114
31,2,0,0,0,79,0,0,0,79,1106,1185,6,5,202114
31,3,0,0,0,1070,0,0,0,1070,1348,2418,15,5,202114
31,4,0,0,0,381,0,0,0,381,1076,1457,4,5,202114
31,5,0,0,0,99,0,0,0,99,522,621,6,5,202114
32,1,0,0,0,207,0,0,0,207,349,556,12,5,202114
32,2,0,0,0,136,0,0,0,136,238,374,13,5,202114
32,3,0,0,0,224,0,0,0,224,365,589,13,5,202114
32,4,0,0,0,259,0,0,0,259,463,722,12,5,202114
1,1,0,0,0,143,0,0,0,143,206,349,13,3,202115
1,2,0,0,0,380,0,0,0,380,513,893,8,3,202115
1,3,0,0,0,311,0,0,0,311,450,761,6,3,202115
2,1,0,0,0,300,0,0,0,300,505,805,9,3,202115
2,2,0,0,0,266,0,0,0,266,283,549,7,3,202115
2,3,0,0,0,409,0,0,0,409,822,1231,11,3,202115
2,4,0,0,0,333,0,0,0,333,368,701,9,3,202115
2,5,0,0,0,467,0,0,0,467,520,987,11,3,202115
2,6,0,0,0,345,0,0,0,345,490,835,7,3,202115
2,7,0,0,0,368,0,0,0,368,520,888,12,3,202115
2,8,0,0,0,400,0,0,0,400,444,844,6,3,202115
3,1,0,0,0,231,0,0,0,231,309,540,12,3,202115
3,2,0,0,0,201,0,0,0,201,330,531,9,3,202115
4,1,0,0,0,224,0,0,0,224,313,537,9,3,202115
4,2,0,0,0,159,0,0,0,159,442,601,13,3,202115
5,1,0,0,0,242,0,0,0,242,358,600,9,3,202115
5,2,0,0,0,48,0,0,0,48,170,218,10,3,202115
5,3,0,0,0,184,0,0,0,184,276,460,11,3,202115
5,4,0,0,0,391,0,0,0,391,587,978,11,3,202115
5,5,0,0,0,405,0,0,0,405,533,938,10,3,202115
5,6,0,0,0,249,0,0,0,249,374,623,9,3,202115
5,7,0,0,0,201,0,0,0,201,504,705,8,3,202115
6,1,0,0,0,213,0,0,0,213,289,502,9,3,202115
6,2,0,0,0,191,0,0,0,191,390,581,8,3,202115
7,1,0,0,0,46,0,0,0,46,112,158,7,2.25,202115
7,2,0,0,0,44,0,0,0,44,110,154,9,3,202115
7,3,0,0,0,89,0,0,0,89,763,852,7,3,202115
7,4,0,0,0,62,0,0,0,62,206,268,11,3,202115
7,5,0,0,0,191,0,0,0,191,349,540,11,3.333333333,202115
7,6,0,0,0,244,0,0,0,244,540,784,8,3,202115
7,7,0,0,0,183,0,0,0,183,306,489,8,3,202115
7,8,0,0,0,154,0,0,0,154,263,417,12,3,202115
7,9,0,0,0,307,0,0,0,307,493,800,9,3,202115
7,10,0,0,0,80,0,0,0,80,215,295,9,3,202115
7,11,0,0,0,30,0,0,0,30,95,125,6,3,202115
7,12,0,0,0,271,0,0,0,271,354,625,9,3,202115
7,13,0,0,0,33,0,0,0,33,175,208,9,3,202115
8,1,0,0,0,166,0,0,0,166,205,371,2,3,202115
8,2,0,0,0,358,0,0,0,358,474,832,16,3,202115
8,3,0,0,0,320,0,0,0,320,447,767,4,3,202115
8,4,0,0,0,302,0,0,0,302,444,746,10,3,202115
8,5,0,0,0,110,0,0,0,110,197,307,10,3,202115
8,6,0,0,0,231,0,0,0,231,334,565,7,3,202115
8,7,0,0,0,109,0,0,0,109,182,291,7,3,202115
8,8,0,0,0,416,0,0,0,416,425,841,10,3,202115
8,9,0,0,0,60,0,0,0,60,141,201,10,3,202115
9,1,0,0,0,229,0,0,0,229,442,671,4,3,202115
9,2,0,0,0,401,0,0,0,401,383,784,12,3,202115
9,3,0,0,0,436,0,0,0,436,660,1096,7,3,202115
9,4,0,0,0,458,0,0,0,458,667,1125,11,3,202115
9,5,0,0,0,379,0,0,0,379,550,929,7,3,202115
9,6,0,0,0,324,0,0,0,324,374,698,7,3,202115
9,7,0,0,0,406,0,0,0,406,471,877,9,3,202115
9,8,0,0,0,307,0,0,0,307,404,711,5,3,202115
9,9,0,0,0,313,0,0,0,313,330,643,4,3,202115
9,10,0,0,0,288,0,0,0,288,449,737,4,3,202115
9,11,0,0,0,492,0,0,0,492,736,1228,7,3,202115
9,12,0,0,0,531,0,0,0,531,776,1307,10,3,202115
9,13,0,0,0,433,0,0,0,433,479,912,4,3,202115
9,14,0,0,0,264,0,0,0,264,289,553,5,3,202115
9,15,0,0,0,725,0,0,0,725,972,1697,9,3,202115
9,16,0,0,0,831,0,0,0,831,971,1802,13,3,202115
9,17,0,0,0,311,0,0,0,311,306,617,6,3,202115
9,18,0,0,0,509,0,0,0,509,1001,1510,12,3,202115
9,19,0,0,0,467,0,0,0,467,720,1187,5,3,202115
9,20,0,0,0,135,0,0,0,135,169,304,5,3,202115
9,21,0,0,0,161,0,0,0,161,197,358,3,3,202115
9,22,0,0,0,294,0,0,0,294,851,1145,5,3,202115
9,23,0,0,0,394,0,0,0,394,344,738,6,3,202115
9,24,0,0,0,804,0,0,0,804,1191,1995,14,3,202115
10,1,0,0,0,141,0,0,0,141,776,917,15,2.833333333,202115
10,2,0,0,0,232,0,0,0,232,324,556,8,3,202115
10,3,0,0,0,117,0,0,0,117,234,351,11,3,202115
10,4,0,0,0,332,0,0,0,332,476,808,11,3,202115
11,1,0,0,0,132,0,0,0,132,171,303,6,3,202115
11,2,0,0,0,188,0,0,0,188,222,410,7,3,202115
11,3,0,0,0,199,0,0,0,199,245,444,3,3,202115
11,4,0,0,0,120,0,0,0,120,202,322,7,3,202115
11,5,0,0,0,391,0,0,0,391,612,1003,7,3,202115
11,6,0,0,0,175,0,0,0,175,273,448,8,3,202115
11,7,0,0,0,130,0,0,0,130,253,383,9,3,202115
11,8,0,0,0,264,0,0,0,264,381,645,9,3,202115
11,9,0,0,0,169,0,0,0,169,354,523,10,3,202115
11,10,0,0,0,197,0,0,0,197,442,639,10,3,202115
11,11,0,0,0,296,0,0,0,296,541,837,5,3,202115
11,12,0,0,0,321,0,0,0,321,618,939,7,3,202115
11,13,0,0,0,80,0,0,0,80,153,233,8,3,202115
11,14,0,0,0,131,0,0,0,131,215,346,8,3,202115
11,15,0,0,0,227,0,0,0,227,268,495,7,3,202115
12,1,0,0,0,87,0,0,0,87,197,284,10,3.2,202115
12,2,0,0,0,198,0,0,0,198,231,429,6,3,202115
12,3,0,0,0,80,0,0,0,80,146,226,11,3,202115
12,4,0,0,0,311,0,0,0,311,357,668,9,3,202115
12,5,0,0,0,49,0,0,0,49,179,228,10,2.75,202115
12,6,0,0,0,61,0,0,0,61,147,208,10,3,202115
12,7,0,0,0,182,0,0,0,182,242,424,6,3,202115
12,8,0,0,0,73,0,0,0,73,202,275,9,3,202115
12,9,0,0,0,285,0,0,0,285,373,658,9,3,202115
13,1,0,0,0,68,0,0,0,68,129,197,9,3,202115
13,2,0,0,0,80,0,0,0,80,125,205,6,3,202115
13,3,0,0,0,129,0,0,0,129,357,486,11,3,202115
13,4,0,0,0,208,0,0,0,208,323,531,8,3,202115
13,5,0,0,0,268,0,0,0,268,383,651,9,3,202115
13,6,0,0,0,551,0,0,0,551,648,1199,11,3,202115
13,7,0,0,0,256,0,0,0,256,400,656,8,3,202115
14,1,0,0,0,39,0,0,0,39,114,153,6,3,202115
14,2,0,0,0,81,0,0,0,81,100,181,5,3,202115
14,3,0,0,0,58,0,0,0,58,165,223,8,3,202115
14,4,0,0,0,263,0,0,0,263,400,663,10,3,202115
14,5,0,0,0,190,0,0,0,190,290,480,9,3,202115
14,6,0,0,0,366,0,0,0,366,463,829,8,3,202115
14,7,0,0,0,185,0,0,0,185,205,390,6,3,202115
14,8,0,0,0,500,0,0,0,500,578,1078,10,3,202115
14,9,0,0,0,184,0,0,0,184,376,560,9,3,202115
14,10,0,0,0,338,0,0,0,338,701,1039,7,3,202115
14,11,0,0,0,181,0,0,0,181,301,482,4,3,202115
14,12,0,0,0,142,0,0,0,142,172,314,9,3,202115
14,13,0,0,0,273,0,0,0,273,534,807,6,3,202115
14,14,0,0,0,239,0,0,0,239,349,588,7,3,202115
14,15,0,0,0,144,0,0,0,144,240,384,10,3,202115
14,16,0,0,0,295,0,0,0,295,274,569,6,3,202115
14,17,0,0,0,72,0,0,0,72,267,339,7,3,202115
14,18,0,0,0,122,0,0,0,122,453,575,9,3,202115
14,19,0,0,0,127,0,0,0,127,234,361,8,3,202115
14,20,0,0,0,127,0,0,0,127,246,373,10,3,202115
15,1,0,0,0,86,0,0,0,86,208,294,7,3,202115
15,2,0,0,0,310,0,0,0,310,420,730,6,3,202115
15,3,0,0,0,327,0,0,0,327,405,732,10,3,202115
15,4,0,0,0,425,0,0,0,425,459,884,4,3,202115
15,5,0,0,0,214,0,0,0,214,307,521,8,3,202115
15,6,0,0,0,318,0,0,0,318,456,774,8,3,202115
15,7,0,0,0,398,0,0,0,398,772,1170,10,3,202115
15,8,0,0,0,235,0,0,0,235,286,521,4,3,202115
15,9,0,0,0,160,0,0,0,160,223,383,9,3,202115
15,10,0,0,0,261,0,0,0,261,321,582,6,3,202115
15,11,0,0,0,344,0,0,0,344,399,743,7,3,202115
15,12,0,0,0,435,0,0,0,435,728,1163,8,3,202115
15,13,0,0,0,284,0,0,0,284,424,708,4,3,202115
15,14,0,0,0,255,0,0,0,255,311,566,4,3,202115
15,15,0,0,0,335,0,0,0,335,522,857,6,3,202115
15,16,0,0,0,431,0,0,0,431,628,1059,8,3,202115
15,17,0,0,0,272,0,0,0,272,293,565,8,3,202115
15,18,0,0,0,374,0,0,0,374,641,1015,7,3,202115
15,19,0,0,0,550,0,0,0,550,840,1390,10,3,202115
15,20,0,0,0,160,0,0,0,160,225,385,6,3,202115
15,21,0,0,0,153,0,0,0,153,249,402,6,3,202115
15,22,0,0,0,637,0,0,0,637,751,1388,14,3,202115
15,23,0,0,0,158,0,0,0,158,306,464,6,3,202115
15,24,0,0,0,269,0,0,0,269,310,579,4,3,202115
15,25,0,0,0,385,0,0,0,385,376,761,6,3,202115
15,26,0,0,0,308,0,0,0,308,614,922,6,3,202115
15,27,0,0,0,388,0,0,0,388,650,1038,9,3,202115
15,28,0,0,0,415,0,0,0,415,532,947,9,3,202115
15,29,0,0,0,379,0,0,0,379,367,746,7,3,202115
15,30,0,0,0,351,0,0,0,351,500,851,16,3,202115
15,31,0,0,0,357,0,0,0,357,654,1011,6,3,202115
15,32,0,0,0,311,0,0,0,311,358,669,8,3,202115
15,33,0,0,0,365,0,0,0,365,422,787,7,3,202115
15,34,0,0,0,219,0,0,0,219,270,489,6,3,202115
15,35,0,0,0,328,0,0,0,328,360,688,8,3,202115
15,36,0,0,0,167,0,0,0,167,335,502,9,3,202115
15,37,0,0,0,445,0,0,0,445,511,956,7,3,202115
15,38,0,0,0,228,0,0,0,228,306,534,5,3,202115
15,39,0,0,0,224,0,0,0,224,277,501,4,3,202115
15,40,0,0,0,385,0,0,0,385,640,1025,9,3,202115
15,41,0,0,0,575,0,0,0,575,730,1305,13,3,202115
16,1,0,0,0,85,0,0,0,85,161,246,7,3,202115
16,2,0,0,0,42,0,0,0,42,105,147,9,3,202115
16,3,0,0,0,103,0,0,0,103,168,271,10,3,202115
16,4,0,0,0,107,0,0,0,107,168,275,8,3,202115
16,5,0,0,0,145,0,0,0,145,218,363,10,3,202115
16,6,0,0,0,118,0,0,0,118,173,291,12,3,202115
16,7,0,0,0,152,0,0,0,152,244,396,7,2.25,202115
16,8,0,0,0,365,0,0,0,365,458,823,12,3,202115
16,9,0,0,0,175,0,0,0,175,220,395,8,3,202115
16,10,0,0,0,188,0,0,0,188,292,480,5,3,202115
16,11,0,0,0,115,0,0,0,115,172,287,10,3,202115
16,12,0,0,0,93,0,0,0,93,170,263,8,2.25,202115
17,1,0,0,0,459,0,0,0,459,559,1018,4,3,202115
17,2,0,0,0,241,0,0,0,241,380,621,7,3,202115
17,3,0,0,0,354,0,0,0,354,388,742,6,3,202115
17,4,0,0,0,245,0,0,0,245,342,587,6,2.666666667,202115
17,5,0,0,0,89,0,0,0,89,163,252,5,3,202115
18,1,0,0,0,58,0,0,0,58,105,163,7,3,202115
18,2,0,0,0,277,0,0,0,277,557,834,6,3,202115
18,3,0,0,0,182,0,0,0,182,226,408,8,3,202115
19,1,0,0,0,328,0,0,0,328,575,903,9,3,202115
19,2,0,0,0,416,0,0,0,416,500,916,9,3,202115
19,3,0,0,0,308,0,0,0,308,533,841,7,3,202115
19,4,0,0,0,184,0,0,0,184,330,514,5,3,202115
19,5,0,0,0,538,0,0,0,538,744,1282,8,3,202115
19,6,0,0,0,145,0,0,0,145,271,416,5,3,202115
19,7,0,0,0,128,0,0,0,128,296,424,10,3,202115
19,8,0,0,0,118,0,0,0,118,107,225,7,3,202115
19,9,0,0,0,63,0,0,0,63,131,194,9,3,202115
19,10,0,0,0,208,0,0,0,208,269,477,5,3,202115
19,11,0,0,0,465,0,0,0,465,700,1165,13,3,202115
19,12,0,0,0,190,0,0,0,190,300,490,13,3,202115
20,1,0,0,0,132,0,0,0,132,402,534,7,3,202115
20,2,0,0,0,24,0,0,0,24,181,205,6,3,202115
20,3,0,0,0,80,0,0,0,80,161,241,6,3,202115
20,4,0,0,0,35,0,0,0,35,164,199,6,3,202115
20,5,0,0,0,100,0,0,0,100,425,525,11,3,202115
20,6,0,0,0,60,0,0,0,60,294,354,8,3,202115
20,7,0,0,0,132,0,0,0,132,167,299,7,3,202115
20,8,0,0,0,653,0,0,0,653,987,1640,13,3,202115
20,9,0,0,0,151,0,0,0,151,394,545,8,3,202115
20,10,0,0,0,45,0,0,0,45,803,848,9,3,202115
21,1,0,0,0,128,0,0,0,128,240,368,9,3,202115
21,2,0,0,0,62,0,0,0,62,181,243,9,3,202115
21,3,0,0,0,203,0,0,0,203,302,505,8,3,202115
21,4,0,0,0,54,0,0,0,54,101,155,6,3,202115
21,5,0,0,0,225,0,0,0,225,389,614,7,3,202115
21,6,0,0,0,326,0,0,0,326,629,955,5,3,202115
21,7,0,0,0,235,0,0,0,235,472,707,9,3,202115
21,8,0,0,0,74,0,0,0,74,223,297,9,3,202115
21,9,0,0,0,399,0,0,0,399,635,1034,8,3,202115
21,10,0,0,0,297,0,0,0,297,631,928,6,3,202115
21,11,0,0,0,161,0,0,0,161,256,417,4,3,202115
21,12,0,0,0,605,0,0,0,605,812,1417,15,3,202115
21,13,0,0,0,162,0,0,0,162,275,437,7,3,202115
21,14,0,0,0,107,0,0,0,107,211,318,8,3,202115
21,15,0,0,0,269,0,0,0,269,330,599,7,3,202115
22,1,0,0,0,73,0,0,0,73,188,261,11,3,202115
22,2,0,0,0,248,0,0,0,248,356,604,7,3,202115
22,3,0,0,0,531,0,0,0,531,821,1352,7,3,202115
22,4,0,0,0,474,0,0,0,474,797,1271,8,3,202115
22,5,0,0,0,140,0,0,0,140,372,512,10,3,202115
23,1,0,0,0,452,0,0,0,452,617,1069,14,3,202115
23,2,0,0,0,144,0,0,0,144,505,649,10,3,202115
23,3,0,0,0,383,0,0,0,383,610,993,9,3,202115
23,4,0,0,0,311,0,0,0,311,366,677,6,3,202115
24,1,0,0,0,70,0,0,0,70,159,229,10,3,202115
24,2,0,0,0,87,0,0,0,87,190,277,6,3,202115
24,3,0,0,0,58,0,0,0,58,128,186,9,3,202115
24,4,0,0,0,137,0,0,0,137,285,422,5,3,202115
24,5,0,0,0,452,0,0,0,452,561,1013,9,3,202115
24,6,0,0,0,349,0,0,0,349,429,778,4,3,202115
24,7,0,0,0,72,0,0,0,72,230,302,9,3,202115
25,1,0,0,0,252,0,0,0,252,408,660,10,3,202115
25,2,0,0,0,290,0,0,0,290,335,625,5,3,202115
25,3,0,0,0,153,0,0,0,153,459,612,7,3,202115
25,4,0,0,0,127,0,0,0,127,209,336,8,3,202115
25,5,0,0,0,221,0,0,0,221,342,563,8,3,202115
25,6,0,0,0,176,0,0,0,176,259,435,6,3,202115
25,7,0,0,0,296,0,0,0,296,365,661,5,3,202115
26,1,0,0,0,185,0,0,0,185,228,413,9,3,202115
26,2,0,0,0,308,0,0,0,308,439,747,12,2.6,202115
26,3,0,0,0,385,0,0,0,385,633,1018,9,3,202115
26,4,0,0,0,136,0,0,0,136,238,374,9,3,202115
26,5,0,0,0,242,0,0,0,242,322,564,14,3,202115
26,6,0,0,0,338,0,0,0,338,530,868,8,3,202115
26,7,0,0,0,201,0,0,0,201,268,469,10,3,202115
27,1,0,0,0,165,0,0,0,165,204,369,8,3,202115
27,2,0,0,0,157,0,0,0,157,269,426,8,3,202115
27,3,0,0,0,188,0,0,0,188,185,373,6,3,202115
27,4,0,0,0,382,0,0,0,382,435,817,7,3,202115
27,5,0,0,0,59,0,0,0,59,103,162,6,3,202115
27,6,0,0,0,253,0,0,0,253,345,598,7,3,202115
28,1,0,0,0,254,0,0,0,254,284,538,10,3,202115
28,2,0,0,0,345,0,0,0,345,445,790,13,3,202115
28,3,0,0,0,58,0,0,0,58,188,246,8,3,202115
28,4,0,0,0,285,0,0,0,285,399,684,13,3,202115
28,5,0,0,0,177,0,0,0,177,250,427,10,3,202115
28,6,0,0,0,61,0,0,0,61,125,186,13,3,202115
28,7,0,0,0,274,0,0,0,274,313,587,9,3,202115
28,8,0,0,0,161,0,0,0,161,380,541,12,3,202115
28,9,0,0,0,67,0,0,0,67,131,198,6,3,202115
29,1,0,0,0,273,0,0,0,273,425,698,8,3,202115
29,2,0,0,0,329,0,0,0,329,566,895,7,3,202115
29,3,0,0,0,199,0,0,0,199,303,502,5,3,202115
30,1,0,0,0,45,0,0,0,45,97,142,7,3,202115
30,2,0,0,0,50,0,0,0,50,296,346,10,3,202115
30,3,0,0,0,119,0,0,0,119,222,341,6,3,202115
30,4,0,0,0,186,0,0,0,186,299,485,8,3,202115
30,5,0,0,0,169,0,0,0,169,189,358,9,3,202115
30,6,0,0,0,77,0,0,0,77,128,205,9,3,202115
30,7,0,0,0,135,0,0,0,135,213,348,11,3,202115
30,8,0,0,0,168,0,0,0,168,297,465,11,3,202115
30,9,0,0,0,163,0,0,0,163,282,445,8,3,202115
30,10,0,0,0,303,0,0,0,303,352,655,6,3,202115
30,11,0,0,0,255,0,0,0,255,373,628,9,3,202115
30,12,0,0,0,428,0,0,0,428,616,1044,10,3,202115
30,13,0,0,0,109,0,0,0,109,215,324,10,3,202115
30,14,0,0,0,105,0,0,0,105,224,329,8,3,202115
30,15,0,0,0,265,0,0,0,265,382,647,11,3,202115
30,16,0,0,0,246,0,0,0,246,375,621,10,3,202115
30,17,0,0,0,138,0,0,0,138,272,410,8,3,202115
30,18,0,0,0,19,0,0,0,19,250,269,8,3,202115
30,19,0,0,0,82,0,0,0,82,196,278,11,3,202115
30,20,0,0,0,120,0,0,0,120,238,358,8,3,202115
31,1,0,0,0,116,0,0,0,116,192,308,8,3,202115
31,2,0,0,0,37,0,0,0,37,642,679,6,3,202115
31,3,0,0,0,652,0,0,0,652,918,1570,15,3,202115
31,4,0,0,0,265,0,0,0,265,697,962,4,3,202115
31,5,0,0,0,63,0,0,0,63,99,162,6,3,202115
32,1,0,0,0,123,0,0,0,123,206,329,12,3,202115
32,2,0,0,0,27,0,0,0,27,212,239,13,3,202115
32,3,0,0,0,113,0,0,0,113,237,350,13,3,202115
32,4,0,0,0,102,0,0,0,102,283,385,12,3,202115
1,1,0,0,0,264,0,0,0,264,370,634,13,6,202116
1,2,0,0,0,675,0,0,0,675,829,1504,8,6,202116
1,3,0,0,0,539,0,0,0,539,737,1276,6,6,202116
2,1,0,0,0,499,0,0,0,499,758,1257,9,6,202116
2,2,0,0,0,418,0,0,0,418,442,860,7,6,202116
2,3,0,0,0,696,0,0,0,696,981,1677,11,6,202116
2,4,0,0,0,562,0,0,0,562,635,1197,9,6,202116
2,5,0,0,0,811,0,0,0,811,1063,1874,11,6,202116
2,6,0,0,0,605,0,0,0,605,930,1535,7,6,202116
2,7,0,0,0,629,0,0,0,629,887,1516,12,6,202116
2,8,0,0,0,700,0,0,0,700,941,1641,6,6,202116
3,1,0,0,0,409,0,0,0,409,632,1041,12,6,202116
3,2,0,0,0,294,0,0,0,294,453,747,9,6,202116
4,1,0,0,0,371,0,0,0,371,565,936,9,6,202116
4,2,0,0,0,257,0,0,0,257,603,860,13,6,202116
5,1,0,0,0,410,0,0,0,410,595,1005,9,6,202116
5,2,0,0,0,86,0,0,0,86,349,435,10,6,202116
5,3,0,0,0,299,0,0,0,299,440,739,11,6,202116
5,4,0,0,0,682,0,0,0,682,878,1560,11,6,202116
5,5,0,0,0,736,0,0,0,736,708,1444,10,6,202116
5,6,0,0,0,377,0,0,0,377,575,952,9,6,202116
5,7,0,0,0,357,0,0,0,357,675,1032,8,6,202116
6,1,0,0,0,340,0,0,0,340,701,1041,9,6,202116
6,2,0,0,0,283,0,0,0,283,893,1176,8,6,202116
7,1,0,0,0,84,0,0,0,84,133,217,9,6,202116
7,2,0,0,0,65,0,0,0,65,170,235,9,6,202116
7,3,0,0,0,138,0,0,0,138,288,426,7,6,202116
7,4,0,0,0,121,0,0,0,121,344,465,11,6,202116
7,5,0,0,0,309,0,0,0,309,368,677,11,6,202116
7,6,0,0,0,404,0,0,0,404,802,1206,8,6,202116
7,7,0,0,0,256,0,0,0,256,433,689,8,6,202116
7,8,0,0,0,244,0,0,0,244,476,720,12,6,202116
7,9,0,0,0,577,0,0,0,577,1002,1579,9,6,202116
7,10,0,0,0,152,0,0,0,152,383,535,9,6,202116
7,11,0,0,0,36,0,0,0,36,98,134,6,6,202116
7,12,0,0,0,484,0,0,0,484,549,1033,9,6,202116
7,13,0,0,0,49,0,0,0,49,335,384,9,6,202116
8,1,0,0,0,314,0,0,0,314,245,559,2,6,202116
8,2,0,0,0,497,0,0,0,497,815,1312,16,6,202116
8,3,0,0,0,502,0,0,0,502,721,1223,4,6,202116
8,4,0,0,0,489,0,0,0,489,896,1385,11,6,202116
8,5,0,0,0,223,0,0,0,223,392,615,10,6,202116
8,6,0,0,0,464,0,0,0,464,527,991,7,6,202116
8,7,0,0,0,182,0,0,0,182,473,655,7,6,202116
8,8,0,0,0,719,0,0,0,719,921,1640,10,6,202116
8,9,0,0,0,94,0,0,0,94,322,416,10,5.6,202116
9,1,0,0,0,458,0,0,0,458,849,1307,4,6,202116
9,2,0,0,0,705,0,0,0,705,1530,2235,10,6,202116
9,3,0,0,0,853,0,0,0,853,1472,2325,7,6,202116
9,4,0,0,0,782,0,0,0,782,822,1604,11,6,202116
9,5,0,0,0,571,0,0,0,571,818,1389,7,6,202116
9,6,0,0,0,468,0,0,0,468,618,1086,7,6,202116
9,7,0,0,0,694,0,0,0,694,637,1331,9,6,202116
9,8,0,0,0,500,0,0,0,500,815,1315,5,6,202116
9,9,0,0,0,434,0,0,0,434,523,957,4,6,202116
9,10,0,0,0,679,0,0,0,679,698,1377,4,6,202116
9,11,0,0,0,802,0,0,0,802,1526,2328,7,6,202116
9,12,0,0,0,811,0,0,0,811,1528,2339,10,6,202116
9,13,0,0,0,843,0,0,0,843,767,1610,4,6,202116
9,14,0,0,0,529,0,0,0,529,619,1148,5,6,202116
9,15,0,0,0,1115,0,0,0,1115,1727,2842,9,6,202116
9,16,0,0,0,1239,0,0,0,1239,1634,2873,13,6,202116
9,17,0,0,0,488,0,0,0,488,730,1218,6,6,202116
9,18,0,0,0,689,0,0,0,689,1151,1840,12,6,202116
9,19,0,0,0,773,0,0,0,773,968,1741,5,6,202116
9,20,0,0,0,222,0,0,0,222,338,560,5,6,202116
9,21,0,0,0,270,0,0,0,270,376,646,3,6,202116
9,22,0,0,0,467,0,0,0,467,1075,1542,5,6,202116
9,23,0,0,0,615,0,0,0,615,839,1454,6,6,202116
9,24,0,0,0,1212,0,0,0,1212,2122,3334,14,6,202116
10,1,0,0,0,224,0,0,0,224,931,1155,15,5.666666667,202116
10,2,0,0,0,407,0,0,0,407,545,952,8,6,202116
10,3,0,0,0,205,0,0,0,205,344,549,11,6,202116
10,4,0,0,0,676,0,0,0,676,749,1425,11,6,202116
11,1,0,0,0,207,0,0,0,207,270,477,6,6,202116
11,2,0,0,0,310,0,0,0,310,436,746,7,6,202116
11,3,0,0,0,370,0,0,0,370,401,771,3,6,202116
11,4,0,0,0,186,0,0,0,186,335,521,7,6,202116
11,5,0,0,0,725,0,0,0,725,1000,1725,7,6,202116
11,6,0,0,0,316,0,0,0,316,439,755,8,6,202116
11,7,0,0,0,254,0,0,0,254,342,596,9,6,202116
11,8,0,0,0,501,0,0,0,501,601,1102,9,6,202116
11,9,0,0,0,261,0,0,0,261,510,771,10,6,202116
11,10,0,0,0,281,0,0,0,281,690,971,10,6,202116
11,11,0,0,0,578,0,0,0,578,744,1322,5,6,202116
11,12,0,0,0,556,0,0,0,556,773,1329,7,6,202116
11,13,0,0,0,157,0,0,0,157,230,387,8,6,202116
11,14,0,0,0,240,0,0,0,240,395,635,8,6,202116
11,15,0,0,0,365,0,0,0,365,536,901,7,6,202116
12,1,0,0,0,130,0,0,0,130,237,367,10,6,202116
12,2,0,0,0,358,0,0,0,358,491,849,6,6,202116
12,3,0,0,0,143,0,0,0,143,239,382,11,6,202116
12,4,0,0,0,510,0,0,0,510,575,1085,9,6,202116
12,5,0,0,0,140,0,0,0,140,470,610,10,6,202116
12,6,0,0,0,87,0,0,0,87,348,435,10,5.5,202116
12,7,0,0,0,345,0,0,0,345,491,836,6,6,202116
12,8,0,0,0,109,0,0,0,109,269,378,9,6,202116
12,9,0,0,0,463,0,0,0,463,561,1024,9,6,202116
13,1,0,0,0,105,0,0,0,105,355,460,9,6,202116
13,2,0,0,0,118,0,0,0,118,234,352,6,6,202116
13,3,0,0,0,194,0,0,0,194,334,528,11,6,202116
13,4,0,0,0,334,0,0,0,334,675,1009,8,6,202116
13,5,0,0,0,455,0,0,0,455,681,1136,9,6,202116
13,6,0,0,0,1011,0,0,0,1011,1517,2528,11,6,202116
13,7,0,0,0,410,0,0,0,410,643,1053,8,6,202116
14,1,0,0,0,48,0,0,0,48,238,286,6,6,202116
14,2,0,0,0,144,0,0,0,144,185,329,5,6,202116
14,3,0,0,0,104,0,0,0,104,272,376,8,6,202116
14,4,0,0,0,478,0,0,0,478,814,1292,10,6,202116
14,5,0,0,0,318,0,0,0,318,488,806,9,6,202116
14,6,0,0,0,597,0,0,0,597,826,1423,8,6,202116
14,7,0,0,0,305,0,0,0,305,300,605,6,6,202116
14,8,0,0,0,898,0,0,0,898,1294,2192,10,6,202116
14,9,0,0,0,322,0,0,0,322,527,849,9,6,202116
14,10,0,0,0,606,0,0,0,606,1058,1664,7,6,202116
14,11,0,0,0,329,0,0,0,329,534,863,4,6,202116
14,12,0,0,0,275,0,0,0,275,303,578,9,6,202116
14,13,0,0,0,505,0,0,0,505,738,1243,6,6,202116
14,14,0,0,0,340,0,0,0,340,496,836,7,6,202116
14,15,0,0,0,232,0,0,0,232,373,605,10,6,202116
14,16,0,0,0,435,0,0,0,435,593,1028,6,6,202116
14,17,0,0,0,80,0,0,0,80,278,358,7,6,202116
14,18,0,0,0,206,0,0,0,206,595,801,9,6,202116
14,19,0,0,0,236,0,0,0,236,371,607,8,6,202116
14,20,0,0,0,212,0,0,0,212,427,639,10,6,202116
15,1,0,0,0,164,0,0,0,164,273,437,7,6,202116
15,2,0,0,0,572,0,0,0,572,697,1269,6,6,202116
15,3,0,0,0,529,0,0,0,529,686,1215,10,6,202116
15,4,0,0,0,792,0,0,0,792,916,1708,4,6,202116
15,5,0,0,0,469,0,0,0,469,525,994,8,6,202116
15,6,0,0,0,523,0,0,0,523,740,1263,8,6,202116
15,7,0,0,0,711,0,0,0,711,874,1585,10,6,202116
15,8,0,0,0,361,0,0,0,361,625,986,4,6,202116
15,9,0,0,0,261,0,0,0,261,364,625,9,6,202116
15,10,0,0,0,424,0,0,0,424,583,1007,6,6,202116
15,11,0,0,0,597,0,0,0,597,617,1214,7,6,202116
15,12,0,0,0,732,0,0,0,732,944,1676,8,6,202116
15,13,0,0,0,492,0,0,0,492,396,888,4,6,202116
15,14,0,0,0,465,0,0,0,465,519,984,4,6,202116
15,15,0,0,0,602,0,0,0,602,706,1308,6,6,202116
15,16,0,0,0,810,0,0,0,810,818,1628,8,6,202116
15,17,0,0,0,404,0,0,0,404,607,1011,8,6,202116
15,18,0,0,0,643,0,0,0,643,1025,1668,7,6,202116
15,19,0,0,0,992,0,0,0,992,1233,2225,10,6,202116
15,20,0,0,0,312,0,0,0,312,413,725,6,6,202116
15,21,0,0,0,206,0,0,0,206,331,537,6,6,202116
15,22,0,0,0,1094,0,0,0,1094,1366,2460,14,6,202116
15,23,0,0,0,165,0,0,0,165,405,570,6,6,202116
15,24,0,0,0,468,0,0,0,468,520,988,4,6,202116
15,25,0,0,0,644,0,0,0,644,876,1520,6,6,202116
15,26,0,0,0,544,0,0,0,544,962,1506,6,6,202116
15,27,0,0,0,778,0,0,0,778,871,1649,9,6,202116
15,28,0,0,0,789,0,0,0,789,650,1439,9,6,202116
15,29,0,0,0,597,0,0,0,597,954,1551,6,6,202116
15,30,0,0,0,501,0,0,0,501,838,1339,16,6,202116
15,31,0,0,0,762,0,0,0,762,876,1638,6,6,202116
15,32,0,0,0,532,0,0,0,532,618,1150,8,6,202116
15,33,0,0,0,558,0,0,0,558,833,1391,7,6,202116
15,34,0,0,0,356,0,0,0,356,456,812,6,6,202116
15,35,0,0,0,509,0,0,0,509,684,1193,8,6,202116
15,36,0,0,0,308,0,0,0,308,646,954,9,6,202116
15,37,0,0,0,666,0,0,0,666,990,1656,7,6,202116
15,38,0,0,0,433,0,0,0,433,643,1076,5,6,202116
15,39,0,0,0,401,0,0,0,401,389,790,4,6,202116
15,40,0,0,0,617,0,0,0,617,915,1532,9,6,202116
15,41,0,0,0,1035,0,0,0,1035,1063,2098,13,6,202116
16,1,0,0,0,152,0,0,0,152,219,371,7,6,202116
16,2,0,0,0,55,0,0,0,55,190,245,9,6,202116
16,3,0,0,0,194,0,0,0,194,288,482,10,6,202116
16,4,0,0,0,228,0,0,0,228,268,496,8,6,202116
16,5,0,0,0,238,0,0,0,238,289,527,10,6,202116
16,6,0,0,0,166,0,0,0,166,267,433,12,6,202116
16,7,0,0,0,278,0,0,0,278,378,656,9,6,202116
16,8,0,0,0,625,0,0,0,625,756,1381,12,6,202116
16,9,0,0,0,337,0,0,0,337,439,776,8,6,202116
16,10,0,0,0,320,0,0,0,320,385,705,5,6,202116
16,11,0,0,0,169,0,0,0,169,210,379,8,4.8,202116
16,12,0,0,0,133,0,0,0,133,258,391,10,6,202116
17,1,0,0,0,690,0,0,0,690,774,1464,4,6,202116
17,2,0,0,0,394,0,0,0,394,642,1036,7,6,202116
17,3,0,0,0,575,0,0,0,575,700,1275,6,6,202116
17,4,0,0,0,422,0,0,0,422,517,939,6,6,202116
17,5,0,0,0,184,0,0,0,184,233,417,5,6,202116
18,1,0,0,0,114,0,0,0,114,229,343,7,6,202116
18,2,0,0,0,547,0,0,0,547,839,1386,8,6,202116
18,3,0,0,0,229,0,0,0,229,549,778,8,6,202116
19,1,0,0,0,537,0,0,0,537,938,1475,9,6,202116
19,2,0,0,0,730,0,0,0,730,882,1612,9,6,202116
19,3,0,0,0,664,0,0,0,664,895,1559,7,6,202116
19,4,0,0,0,323,0,0,0,323,579,902,5,6,202116
19,5,0,0,0,834,0,0,0,834,1057,1891,8,6,202116
19,6,0,0,0,286,0,0,0,286,466,752,5,6,202116
19,7,0,0,0,304,0,0,0,304,399,703,10,6,202116
19,8,0,0,0,223,0,0,0,223,370,593,7,6,202116
19,9,0,0,0,87,0,0,0,87,273,360,9,6,202116
19,10,0,0,0,422,0,0,0,422,542,964,5,6,202116
19,11,0,0,0,871,0,0,0,871,1020,1891,13,6,202116
19,12,0,0,0,296,0,0,0,296,527,823,13,6,202116
20,1,0,0,0,205,0,0,0,205,330,535,7,6,202116
20,2,0,0,0,27,0,0,0,27,398,425,6,6,202116
20,3,0,0,0,124,0,0,0,124,198,322,6,6,202116
20,4,0,0,0,56,0,0,0,56,260,316,6,6,202116
20,5,0,0,0,175,0,0,0,175,554,729,11,6,202116
20,6,0,0,0,80,0,0,0,80,503,583,8,6,202116
20,7,0,0,0,193,0,0,0,193,227,420,7,6,202116
20,8,0,0,0,1046,0,0,0,1046,1432,2478,13,6,202116
20,9,0,0,0,245,0,0,0,245,1000,1245,8,6,202116
20,10,0,0,0,92,0,0,0,92,696,788,9,6,202116
21,1,0,0,0,198,0,0,0,198,466,664,9,6,202116
21,2,0,0,0,127,0,0,0,127,629,756,9,6,202116
21,3,0,0,0,358,0,0,0,358,503,861,8,6,202116
21,4,0,0,0,82,0,0,0,82,336,418,6,6,202116
21,5,0,0,0,395,0,0,0,395,639,1034,7,6,202116
21,6,0,0,0,570,0,0,0,570,1217,1787,5,6,202116
21,7,0,0,0,384,0,0,0,384,767,1151,9,6,202116
21,8,0,0,0,130,0,0,0,130,501,631,9,6,202116
21,9,0,0,0,654,0,0,0,654,1298,1952,8,6,202116
21,10,0,0,0,568,0,0,0,568,1023,1591,6,6,202116
21,11,0,0,0,276,0,0,0,276,445,721,4,6,202116
21,12,0,0,0,1042,0,0,0,1042,1523,2565,15,6,202116
21,13,0,0,0,274,0,0,0,274,489,763,7,6,202116
21,14,0,0,0,142,0,0,0,142,415,557,8,6,202116
21,15,0,0,0,371,0,0,0,371,380,751,7,6,202116
22,1,0,0,0,132,0,0,0,132,354,486,11,6,202116
22,2,0,0,0,356,0,0,0,356,569,925,7,6,202116
22,3,0,0,0,951,0,0,0,951,1244,2195,8,6,202116
22,4,0,0,0,964,0,0,0,964,1342,2306,8,6,202116
22,5,0,0,0,314,0,0,0,314,705,1019,10,6,202116
23,1,0,0,0,763,0,0,0,763,1212,1975,14,6,202116
23,2,0,0,0,199,0,0,0,199,551,750,10,6,202116
23,3,0,0,0,631,0,0,0,631,966,1597,19,6,202116
23,4,0,0,0,516,0,0,0,516,578,1094,6,6,202116
24,1,0,0,0,109,0,0,0,109,293,402,10,6,202116
24,2,0,0,0,168,0,0,0,168,269,437,6,6,202116
24,3,0,0,0,115,0,0,0,115,312,427,9,6,202116
24,4,0,0,0,236,0,0,0,236,480,716,5,6,202116
24,5,0,0,0,699,0,0,0,699,1101,1800,9,6,202116
24,6,0,0,0,562,0,0,0,562,832,1394,4,6,202116
24,7,0,0,0,102,0,0,0,102,388,490,9,6,202116
25,1,0,0,0,378,0,0,0,378,588,966,10,6,202116
25,2,0,0,0,511,0,0,0,511,603,1114,5,6,202116
25,3,0,0,0,262,0,0,0,262,387,649,7,6,202116
25,4,0,0,0,209,0,0,0,209,298,507,8,6,202116
25,5,0,0,0,409,0,0,0,409,599,1008,8,6,202116
25,6,0,0,0,391,0,0,0,391,467,858,6,6,202116
25,7,0,0,0,566,0,0,0,566,627,1193,5,6,202116
26,1,0,0,0,290,0,0,0,290,680,970,9,6,202116
26,2,0,0,0,517,0,0,0,517,717,1234,12,6,202116
26,3,0,0,0,680,0,0,0,680,1092,1772,9,6,202116
26,4,0,0,0,190,0,0,0,190,460,650,9,6,202116
26,5,0,0,0,429,0,0,0,429,693,1122,14,6,202116
26,6,0,0,0,710,0,0,0,710,972,1682,8,6,202116
26,7,0,0,0,295,0,0,0,295,489,784,10,6,202116
27,1,0,0,0,240,0,0,0,240,435,675,8,6,202116
27,2,0,0,0,272,0,0,0,272,337,609,8,6,202116
27,3,0,0,0,321,0,0,0,321,510,831,6,6,202116
27,4,0,0,0,670,0,0,0,670,929,1599,7,6,202116
27,5,0,0,0,121,0,0,0,121,198,319,6,6,202116
27,6,0,0,0,403,0,0,0,403,462,865,7,6,202116
28,1,0,0,0,419,0,0,0,419,612,1031,10,6,202116
28,2,0,0,0,542,0,0,0,542,754,1296,13,6,202116
28,3,0,0,0,110,0,0,0,110,245,355,8,6,202116
28,4,0,0,0,463,0,0,0,463,594,1057,13,6,202116
28,5,0,0,0,340,0,0,0,340,479,819,10,6,202116
28,6,0,0,0,108,0,0,0,108,225,333,13,6,202116
28,7,0,0,0,499,0,0,0,499,632,1131,9,6,202116
28,8,0,0,0,307,0,0,0,307,477,784,12,6,202116
28,9,0,0,0,181,0,0,0,181,222,403,6,6,202116
29,1,0,0,0,443,0,0,0,443,800,1243,8,6,202116
29,2,0,0,0,659,0,0,0,659,822,1481,7,6,202116
29,3,0,0,0,375,0,0,0,375,477,852,5,6,202116
30,1,0,0,0,89,0,0,0,89,170,259,7,6,202116
30,2,0,0,0,87,0,0,0,87,258,345,10,6,202116
30,3,0,0,0,240,0,0,0,240,277,517,6,6,202116
30,4,0,0,0,327,0,0,0,327,474,801,8,6,202116
30,5,0,0,0,314,0,0,0,314,531,845,9,6,202116
30,6,0,0,0,139,0,0,0,139,315,454,9,6,202116
30,7,0,0,0,217,0,0,0,217,398,615,11,6,202116
30,8,0,0,0,265,0,0,0,265,507,772,11,6,202116
30,9,0,0,0,243,0,0,0,243,421,664,8,6,202116
30,10,0,0,0,518,0,0,0,518,631,1149,6,6,202116
30,11,0,0,0,469,0,0,0,469,565,1034,9,6,202116
30,12,0,0,0,740,0,0,0,740,1037,1777,10,6,202116
30,13,0,0,0,177,0,0,0,177,295,472,10,6,202116
30,14,0,0,0,185,0,0,0,185,245,430,8,6,202116
30,15,0,0,0,461,0,0,0,461,656,1117,11,6,202116
30,16,0,0,0,393,0,0,0,393,503,896,10,6,202116
30,17,0,0,0,238,0,0,0,238,500,738,8,6,202116
30,18,0,0,0,38,0,0,0,38,256,294,8,6,202116
30,19,0,0,0,143,0,0,0,143,257,400,11,6,202116
30,20,0,0,0,174,0,0,0,174,387,561,8,6,202116
31,1,0,0,0,184,0,0,0,184,557,741,8,6,202116
31,2,0,0,0,59,0,0,0,59,788,847,6,6,202116
31,3,0,0,0,1068,0,0,0,1068,1348,2416,15,6,202116
31,4,0,0,0,418,0,0,0,418,740,1158,4,6,202116
31,5,0,0,0,103,0,0,0,103,456,559,6,6,202116
32,1,0,0,0,174,0,0,0,174,362,536,12,6,202116
32,2,0,0,0,52,0,0,0,52,242,294,13,6,202116
32,3,0,0,0,197,0,0,0,197,407,604,13,6,202116
32,4,0,0,0,247,0,0,0,247,464,711,12,6,202116
